name,length,duration,num_positives,num_negatives,num_puppetmaster,num_sockpuppets,min_message_length,ave_message_length,max_message_length,max_page_length,ave_page_length,min_page_length
Category_Wikipedia_sockpuppets_of_Jishnusavith.csv,9081,50695820.0,2837,6244,500,2337,0,50.14117387952869,499,59,17.881731086884706,3
Category_Wikipedia_sockpuppets_of_Namuslu.csv,1810,27028117.0,572,1238,500,72,0,42.51933701657459,254,47,11.064640883977901,3
Category_Wikipedia_sockpuppets_of_Auroranorth.csv,2125,23150875.0,684,1441,500,184,0,32.77741176470588,255,94,26.028235294117646,2
Category_Wikipedia_sockpuppets_of_Gokulakannan_SK.csv,78,18681807.0,52,26,51,1,0,31.833333333333332,130,42,21.974358974358974,12
Category_Wikipedia_sockpuppets_of_Susanjane102.csv,403,65858096.0,115,288,40,75,0,37.8287841191067,263,59,19.732009925558312,6
Category_Wikipedia_sockpuppets_of_Paris91.csv,4571,38131477.0,1651,2920,500,1151,0,44.74732006125574,503,79,18.05381754539488,3
Category_Wikipedia_sockpuppets_of_Elspeth_Monro.csv,7134,275872673.0,2406,4728,500,1906,0,39.12755817213345,255,96,19.236192879170172,3
Category_Wikipedia_sockpuppets_of_Sanjay_Mehta_07.csv,136,425960.0,69,67,28,41,0,34.25735294117647,236,33,14.713235294117647,6
Category_Wikipedia_sockpuppets_of_Melissaburner.csv,82,777579.0,30,52,28,2,0,40.926829268292686,212,24,16.414634146341463,10
Category_Wikipedia_sockpuppets_of_Hamzaramzan123.csv,166,5914471.0,66,100,18,48,0,49.234939759036145,238,31,15.289156626506024,5
Category_Wikipedia_sockpuppets_of_CSpotifyRemix1394.csv,38,7646697.0,16,22,13,3,0,56.421052631578945,227,35,27.973684210526315,21
Category_Wikipedia_sockpuppets_of_Goat_boy_doyle.csv,38,2111.0,12,26,8,4,0,75.26315789473684,215,30,14.552631578947368,5
Category_Wikipedia_sockpuppets_of_ArmanAfifeh.csv,5273,226133712.0,1815,3458,199,1616,0,49.012706239332445,494,65,20.034136165370757,4
Category_Wikipedia_sockpuppets_of_Zionzina.csv,296,48394186.0,89,207,55,34,0,55.695945945945944,218,38,19.091216216216218,4
Category_Wikipedia_sockpuppets_of_Spidey369.csv,37,924171.0,33,4,25,8,0,53.86486486486486,396,18,17.91891891891892,17
Category_Wikipedia_sockpuppets_of_Edsheeranhater.csv,1399,5841630.0,499,900,337,162,0,37.507505360972125,291,53,13.69120800571837,3
Category_Wikipedia_sockpuppets_of_AgentSullivan17.csv,77,8654855.0,46,31,42,4,0,28.16883116883117,350,12,12.0,12
Category_Wikipedia_sockpuppets_of_Altman.csv,6342,414692906.0,2153,4189,500,1653,0,43.065279091769156,255,72,19.807316304005045,3
Category_Wikipedia_sockpuppets_of_The_Right_Honourable_Bonney_Eberndu.csv,83,424376.0,32,51,17,15,0,48.66265060240964,220,46,13.25301204819277,8
Category_Wikipedia_sockpuppets_of_NPOV_npov.csv,121,7505916.0,38,83,17,21,0,46.099173553719005,225,52,21.00826446280992,11
Category_Wikipedia_sockpuppets_of_Bob_Marly_and_the_Seven_Cats.csv,33,510092.0,13,20,13,0,0,25.12121212121212,160,20,10.515151515151516,6
Category_Wikipedia_sockpuppets_of_Rayanmou07.csv,306,12268444.0,112,194,61,51,0,57.27450980392157,423,54,32.745098039215684,7
Category_Wikipedia_sockpuppets_of_Punk_Rocker.csv,2806,90929012.0,673,2133,500,173,0,30.672843905915894,217,60,16.131147540983605,2
Category_Wikipedia_sockpuppets_of_SilviaGrisenti.csv,140,64110918.0,90,50,22,68,0,44.97142857142857,213,36,20.814285714285713,12
Category_Wikipedia_sockpuppets_of_Dxasadakbar.csv,8,39183.0,4,4,4,0,10,61.5,146,23,21.75,21
Category_Wikipedia_sockpuppets_of_Cuddlyable3.csv,6239,276634820.0,1617,4622,500,1117,0,51.48741785542555,261,74,32.18977400224395,3
Category_Wikipedia_sockpuppets_of_Random_account_39949472.csv,10282,179536987.0,3365,6917,500,2865,0,37.4169422291383,255,93,19.94718926278934,3
Category_Wikipedia_sockpuppets_of_Editor940.csv,1236,32973681.0,484,752,430,54,0,39.733818770226534,373,53,24.39482200647249,9
Category_Wikipedia_sockpuppets_of_Hungry_Hungry_Troll.csv,1283,124960730.0,319,964,268,51,0,36.354637568199536,246,71,27.835541699142635,2
Category_Wikipedia_sockpuppets_of_Ghumen.csv,1629,279297694.0,435,1194,182,253,0,46.3683241252302,363,39,17.65377532228361,5
Category_Wikipedia_sockpuppets_of_Chris_sirleaf_dukuly.csv,13,2830673.0,10,3,7,3,0,8.76923076923077,71,12,12.0,12
Category_Wikipedia_sockpuppets_of_Weelandlka.csv,1543,13035226.0,517,1026,500,17,0,60.31302657161374,371,66,18.946856772521063,6
Category_Wikipedia_sockpuppets_of_Viewpointassist.csv,56,111720401.0,14,42,6,8,0,40.339285714285715,351,13,12.482142857142858,12
Category_Wikipedia_sockpuppets_of_All-American_Politics_Fan.csv,15,497901.0,10,5,1,9,50,106.06666666666666,199,44,33.333333333333336,16
Category_Wikipedia_sockpuppets_of_Una667770.csv,57,326095.0,26,31,25,1,0,46.45614035087719,188,38,27.07017543859649,12
Category_Wikipedia_sockpuppets_of_Superamb.csv,1,0.0,1,0,1,0,195,195.0,195,9,9.0,9
Category_Wikipedia_sockpuppets_of_Goramon.csv,726,29345696.0,253,473,139,114,0,58.51790633608815,217,63,24.18732782369146,8
Category_Wikipedia_sockpuppets_of_Aojt_Hep_Wuo.csv,62,40855288.0,19,43,5,14,0,34.04838709677419,187,37,25.612903225806452,8
Category_Wikipedia_sockpuppets_of_OttomanJackson.csv,1867,87962476.0,559,1308,500,59,0,46.59346545259775,257,75,21.898768077129084,5
Category_Wikipedia_sockpuppets_of_Sol_Goldstone.csv,1545,9597040.0,501,1044,500,1,0,49.36116504854369,234,80,28.697734627831714,6
Category_Wikipedia_sockpuppets_of_Explicition.csv,744,32467357.0,242,502,226,16,0,57.333333333333336,329,93,16.29032258064516,4
Category_Wikipedia_sockpuppets_of_Gafanhaozacharyx1998.csv,34,9611409.0,10,24,7,3,0,67.79411764705883,251,30,24.235294117647058,17
Category_Wikipedia_sockpuppets_of_Wikiya007.csv,266,10202740.0,91,175,36,55,0,41.545112781954884,211,66,22.345864661654137,8
Category_Wikipedia_sockpuppets_of_JustMyOpi√±on.csv,1583,155469665.0,419,1164,140,279,0,55.23120656980417,496,62,17.519898926089702,4
Category_Wikipedia_sockpuppets_of_JRfougnazal.csv,323,152363774.0,122,201,96,26,0,52.424148606811144,375,42,18.60061919504644,8
Category_Wikipedia_sockpuppets_of_Panagiotis16.csv,50,25058624.0,26,24,15,11,0,55.56,231,17,14.84,12
Category_Wikipedia_sockpuppets_of_Christine5797.csv,93,26126733.0,31,62,15,16,0,43.526881720430104,199,31,12.623655913978494,3
Category_Wikipedia_sockpuppets_of_Mikesanders70.csv,8,19512703.0,5,3,5,0,0,35.25,59,59,26.625,22
Category_Wikipedia_sockpuppets_of_Chilmy23.csv,5255,13456151.0,1798,3457,500,1298,0,23.597716460513798,496,44,16.99257849666984,6
Category_Wikipedia_sockpuppets_of_Sajjad_Altaf.csv,1650,310231549.0,589,1061,500,89,0,52.412727272727274,490,71,18.36,5
Category_Wikipedia_sockpuppets_of_Sciquest_marketing.csv,68,104342.0,53,15,47,6,0,33.338235294117645,130,54,20.808823529411764,5
Category_Wikipedia_sockpuppets_of_JordanMicahBennett.csv,313,134936445.0,123,190,109,14,0,49.00958466453674,255,73,26.766773162939298,12
Category_Wikipedia_sockpuppets_of_RASSIOPEIA.csv,603,29211277.0,197,406,132,65,0,52.830845771144276,500,53,24.500829187396352,8
Category_Wikipedia_sockpuppets_of_Mandalaneni_Radha_krishna.csv,24,11689.0,9,15,8,1,0,43.125,208,38,15.041666666666666,13
Category_Wikipedia_sockpuppets_of_Art3m1a1.csv,466,80037652.0,126,340,43,83,0,54.73390557939914,352,65,17.551502145922747,3
Category_Wikipedia_sockpuppets_of_Daredevils56.csv,2422,5787749.0,829,1593,500,329,0,42.30057803468208,494,48,23.158959537572255,7
Category_Wikipedia_sockpuppets_of_Bacefook.csv,620,240280569.0,178,442,167,11,0,45.38225806451613,376,67,17.88225806451613,4
Category_Wikipedia_sockpuppets_of_Spitfire000.csv,12,10469.0,7,5,6,1,29,57.333333333333336,128,26,24.75,21
Category_Wikipedia_sockpuppets_of_Redmoon660.csv,1406,12809848.0,763,643,500,263,0,43.62446657183499,253,34,24.182076813655762,9
Category_Wikipedia_sockpuppets_of_Moab12.csv,704,52258551.0,211,493,112,99,0,64.03125,330,73,25.477272727272727,7
Category_Wikipedia_sockpuppets_of_Wertzt.csv,400,26006143.0,140,260,131,9,0,49.0925,255,46,24.085,3
Category_Wikipedia_sockpuppets_of_Ayush0112.csv,17,1968370.0,10,7,5,5,0,89.41176470588235,337,11,11.0,11
Category_Wikipedia_sockpuppets_of_Bobesh8.csv,96,3203325.0,38,58,22,16,0,25.375,189,36,22.15625,7
Category_Wikipedia_sockpuppets_of_Dr_Meena_Journalist.csv,31,1051715.0,11,20,7,4,0,37.516129032258064,194,51,38.12903225806452,19
Category_Wikipedia_sockpuppets_of_Ljlas20.csv,4397,238793254.0,1213,3184,500,713,0,40.00068228337503,500,75,19.30020468501251,3
Category_Wikipedia_sockpuppets_of_Indrajith79.csv,3,1230.0,3,0,3,0,0,33.666666666666664,101,24,24.0,24
Category_Wikipedia_sockpuppets_of_Jamin_Day.csv,72,85871.0,51,21,27,24,0,21.875,198,52,23.98611111111111,10
Category_Wikipedia_sockpuppets_of_IRCAM_3000.csv,189,6982007.0,77,112,13,64,0,51.65079365079365,235,45,22.211640211640212,8
Category_Wikipedia_sockpuppets_of_Roop_chandra.csv,2,0.0,1,1,1,0,196,196.0,196,25,25.0,25
Category_Wikipedia_sockpuppets_of_OAS_Helicopters.csv,29,229148.0,24,5,19,5,0,34.03448275862069,500,34,30.379310344827587,19
Category_Wikipedia_sockpuppets_of_Labor_Watch.csv,2402,154977135.0,676,1726,500,176,0,45.29059117402165,247,88,23.05370524562864,3
Category_Wikipedia_sockpuppets_of_Fled_Sebr.csv,5,184366.0,3,2,1,2,0,49.0,113,13,13.0,13
Category_Wikipedia_sockpuppets_of_Aman_pathak7045.csv,11,675413.0,7,4,5,2,14,15.181818181818182,20,18,18.0,18
Category_Wikipedia_sockpuppets_of_Watsonboss.csv,16,4398117.0,8,8,5,3,12,67.875,463,38,17.9375,5
Category_Wikipedia_sockpuppets_of_Sith_Order_of_Lord_Maul.csv,8,1155.0,5,3,4,1,0,32.5,130,14,14.0,14
Category_Wikipedia_sockpuppets_of_Sofia_Koutsouveli.csv,6307,130632128.0,1665,4642,500,1165,0,50.549389567147614,348,77,17.88806088473125,2
Category_Wikipedia_sockpuppets_of_Iman_naseem.csv,17,51161.0,11,6,8,3,0,2.411764705882353,22,16,13.764705882352942,11
Category_Wikipedia_sockpuppets_of_Gracewan2012.csv,25,50908947.0,9,16,6,3,0,40.52,188,47,20.16,17
Category_Wikipedia_sockpuppets_of_Srimant_ROSHAN.csv,1406,99713621.0,530,876,500,30,0,43.352062588904694,496,85,16.91465149359886,4
Category_Wikipedia_sockpuppets_of_Freeman020203.csv,18,11133539.0,15,3,9,6,0,86.0,496,23,19.555555555555557,7
Category_Wikipedia_sockpuppets_of_Consettlad.csv,67,56656048.0,19,48,8,11,0,59.37313432835821,248,17,9.373134328358208,7
Category_Wikipedia_sockpuppets_of_Call_800_800_1800.csv,28,90242.0,14,14,9,5,0,26.928571428571427,167,27,22.178571428571427,15
Category_Wikipedia_sockpuppets_of_AnusMcAnusson.csv,20,5656087.0,7,13,5,2,0,63.35,201,35,18.5,6
Category_Wikipedia_sockpuppets_of_Maeveh.csv,87,439009.0,44,43,43,1,0,44.42528735632184,245,21,13.988505747126437,11
Category_Wikipedia_sockpuppets_of_Cypriot_Chauvinist.csv,2043,91818854.0,568,1475,191,377,0,55.858541360744006,498,54,22.00685266764562,3
Category_Wikipedia_sockpuppets_of_Shuchita.vyas.social.csv,23,8334905.0,11,12,8,3,0,33.95652173913044,135,33,19.782608695652176,7
Category_Wikipedia_sockpuppets_of_Xbvguugx.csv,338,15147636.0,116,222,24,92,0,41.751479289940825,332,77,26.047337278106507,12
Category_Wikipedia_sockpuppets_of_Yosh2006.csv,163,423085078.0,43,120,24,19,0,34.16564417177914,333,45,22.012269938650306,9
Category_Wikipedia_sockpuppets_of_D.H.110.csv,1450,19623734.0,488,962,145,343,0,54.068275862068965,255,86,20.58896551724138,4
Category_Wikipedia_sockpuppets_of_Prior400.csv,42,2480893.0,25,17,16,9,0,18.761904761904763,58,52,40.976190476190474,13
Category_Wikipedia_sockpuppets_of_Aamamun.csv,97,78783421.0,32,65,9,23,0,40.28865979381443,213,31,15.22680412371134,9
Category_Wikipedia_sockpuppets_of_P.V.Moyo.csv,133,70937825.0,34,99,33,1,0,46.83458646616541,225,27,10.548872180451127,3
Category_Wikipedia_sockpuppets_of_Hi-Blow.csv,12,72305.0,11,1,5,6,0,97.08333333333333,113,12,12.0,12
Category_Wikipedia_sockpuppets_of_Melody_Soldiers.csv,2,0.0,1,1,1,0,62,62.0,62,28,28.0,28
Category_Wikipedia_sockpuppets_of_Transport_2005.csv,814,4032876.0,195,619,186,9,0,45.21621621621622,384,43,16.05036855036855,3
Category_Wikipedia_sockpuppets_of_Abhay_Gupta_Varanasi.csv,1479,93929618.0,562,917,202,360,0,35.07910750507099,255,47,21.211629479377958,5
Category_Wikipedia_sockpuppets_of_Seal_Boxer.csv,340,24366739.0,115,225,105,10,0,45.07941176470588,236,66,26.397058823529413,8
Category_Wikipedia_sockpuppets_of_JoeStockImage.csv,14,70230.0,9,5,8,1,0,46.92857142857143,133,23,15.285714285714286,10
Category_Wikipedia_sockpuppets_of_Gungul_gungul.csv,17,22821009.0,5,12,3,2,0,57.8235294117647,170,29,22.529411764705884,6
Category_Wikipedia_sockpuppets_of_Wook-Wookie22.csv,231,6861169.0,75,156,41,34,0,46.913419913419915,237,44,18.896103896103895,6
Category_Wikipedia_sockpuppets_of_Andrew27112004.csv,1258,18404983.0,404,854,233,171,0,48.92209856915739,500,61,17.784578696343402,4
Category_Wikipedia_sockpuppets_of_Shalash3.csv,87,15053100.0,47,40,42,5,0,16.379310344827587,199,21,15.344827586206897,12
Category_Wikipedia_sockpuppets_of_AG9524.csv,334,7280262.0,113,221,60,53,0,48.137724550898206,496,46,22.00299401197605,9
Category_Wikipedia_sockpuppets_of_KillerGho$t.csv,8160,77172224.0,1818,6342,500,1318,0,49.237009803921566,500,77,19.448039215686276,3
Category_Wikipedia_sockpuppets_of_Adamstraw99.csv,1991,338245601.0,545,1446,500,45,0,50.545956805625316,410,65,17.53088900050226,4
Category_Wikipedia_sockpuppets_of_GeorgianJorjadze.csv,692,16501895.0,248,444,139,109,0,41.036127167630056,255,68,19.122832369942195,5
Category_Wikipedia_sockpuppets_of_Akbaralighazi.csv,503,158571603.0,139,364,58,81,0,46.77335984095428,232,63,16.174950298210735,5
Category_Wikipedia_sockpuppets_of_Phillip_Mandeville.csv,303,251847370.0,98,205,43,55,0,46.132013201320134,264,54,18.95049504950495,4
Category_Wikipedia_sockpuppets_of_Arifjwadder.csv,2761,114822603.0,1068,1693,500,568,0,41.0333212604129,254,89,22.632379572618618,3
Category_Wikipedia_sockpuppets_of_Hengamehf85.csv,11,1065947.0,8,3,8,0,0,28.727272727272727,79,25,21.727272727272727,21
Category_Wikipedia_sockpuppets_of_Lobster900.csv,17,258871.0,11,6,8,3,0,24.705882352941178,49,20,18.647058823529413,17
Category_Wikipedia_sockpuppets_of_Ft67.csv,162,1289373.0,69,93,34,35,0,59.648148148148145,196,55,25.19753086419753,9
Category_Wikipedia_sockpuppets_of_Anirbanmitra21.csv,21,85970995.0,5,16,3,2,0,75.61904761904762,302,53,26.523809523809526,5
Category_Wikipedia_sockpuppets_of_MrWriter245.csv,8139,100893160.0,3008,5131,500,2508,0,38.84740140066347,395,59,18.820985379039193,4
Category_Wikipedia_sockpuppets_of_Kashifkhan.csv,3,2448199.0,2,1,2,0,0,5.0,15,21,18.0,12
Category_Wikipedia_sockpuppets_of_Bossgamer69.csv,5,156988.0,3,2,2,1,13,35.2,121,15,9.0,5
Category_Wikipedia_sockpuppets_of_Jim_Wales'_Stubble.csv,19,19206.0,7,12,3,4,0,71.84210526315789,145,12,10.736842105263158,10
Category_Wikipedia_sockpuppets_of_Nascarman1.csv,339,11496780.0,152,187,68,84,0,36.8023598820059,255,55,21.40117994100295,8
Category_Wikipedia_sockpuppets_of_The_Real_American.csv,132,5147211.0,48,84,48,0,0,32.734848484848484,183,54,16.25,5
Category_Wikipedia_sockpuppets_of_Terrance1994.csv,556,199385.0,141,415,116,25,0,50.530575539568346,373,42,16.782374100719423,3
Category_Wikipedia_sockpuppets_of_Fishypizza.csv,202,27988452.0,75,127,46,29,0,36.336633663366335,250,57,30.074257425742573,4
Category_Wikipedia_sockpuppets_of_Kevoras.csv,622,662597.0,218,404,83,135,0,50.5096463022508,255,58,26.827974276527332,3
Category_Wikipedia_sockpuppets_of_Misternortob.csv,29,4056593.0,12,17,12,0,0,41.793103448275865,161,35,24.79310344827586,15
Category_Wikipedia_sockpuppets_of_S&SFan2005.csv,1279,17448249.0,374,905,291,83,0,39.92650508209539,395,61,28.04769351055512,8
Category_Wikipedia_sockpuppets_of_Sarah411.csv,10,104631.0,3,7,2,1,2,88.7,198,16,11.2,9
Category_Wikipedia_sockpuppets_of_Aquasteth.csv,52,7665555.0,30,22,8,22,0,36.57692307692308,157,25,15.76923076923077,10
Category_Wikipedia_sockpuppets_of_Gta234.csv,214,8749.0,72,142,50,22,0,46.47196261682243,208,32,19.05607476635514,12
Category_Wikipedia_sockpuppets_of_Iloveaustria87.csv,7,573.0,6,1,6,0,0,0.0,0,22,18.428571428571427,17
Category_Wikipedia_sockpuppets_of_Cameroon_Official.csv,25,496139.0,12,13,9,3,0,36.08,230,41,18.72,6
Category_Wikipedia_sockpuppets_of_Farsi15.csv,344,58999329.0,128,216,31,97,0,46.93604651162791,303,53,19.59011627906977,3
Category_Wikipedia_sockpuppets_of_Wrestlingfan2012.csv,2150,21021821.0,1132,1018,500,632,0,24.10325581395349,496,67,20.79906976744186,9
Category_Wikipedia_sockpuppets_of_Gdasfh847.csv,15,257037.0,10,5,5,5,0,40.86666666666667,161,24,24.0,24
Category_Wikipedia_sockpuppets_of_Pank_claw.csv,797,18433653.0,223,574,112,111,0,48.47678795483061,250,62,23.47427854454203,5
Category_Wikipedia_sockpuppets_of_Indextookviewsgoals.csv,421,12273438.0,154,267,86,68,0,56.75296912114014,250,45,21.026128266033254,9
Category_Wikipedia_sockpuppets_of_Kazinipu.csv,6,496741.0,3,3,3,0,0,41.833333333333336,187,12,11.5,11
Category_Wikipedia_sockpuppets_of_Incognitus_scriptor.csv,3131,415907653.0,632,2499,500,132,0,48.41935483870968,500,70,16.435643564356436,4
Category_Wikipedia_sockpuppets_of_Vyaiskaya.csv,881,6249382.0,274,607,216,58,0,64.86152099886493,500,55,18.340522133938705,6
Category_Wikipedia_sockpuppets_of_Bhupooja.csv,60,19865287.0,18,42,8,10,0,47.36666666666667,203,33,20.366666666666667,11
Category_Wikipedia_sockpuppets_of_Idalawar.csv,76,112999224.0,26,50,12,14,0,54.026315789473685,250,33,20.026315789473685,11
Category_Wikipedia_sockpuppets_of_Fapmaster2014.csv,21,1520.0,12,9,10,2,0,25.523809523809526,227,54,43.80952380952381,33
Category_Wikipedia_sockpuppets_of_Publican_Farmer.csv,174,51986738.0,44,130,21,23,0,58.241379310344826,255,52,23.408045977011493,14
Category_Wikipedia_sockpuppets_of_Sumanmarma.csv,116,520614.0,33,83,28,5,0,35.5,388,53,21.31896551724138,17
Category_Wikipedia_sockpuppets_of_Carmettu.csv,18,11694.0,14,4,5,9,0,31.166666666666668,122,18,13.88888888888889,10
Category_Wikipedia_sockpuppets_of_Chubbybunny3.csv,1007,18999322.0,281,726,229,52,0,36.88282025819265,439,38,15.069513406156902,4
Category_Wikipedia_sockpuppets_of_Expatbanker.csv,10,1575.0,6,4,5,1,29,71.6,135,14,14.0,14
Category_Wikipedia_sockpuppets_of_Link_Smurf.csv,1557,227834303.0,492,1065,133,359,0,48.129094412331405,322,54,20.758509955041745,2
Category_Wikipedia_sockpuppets_of_PE√ü√üLES.csv,28,6762455.0,13,15,7,6,0,53.035714285714285,199,29,26.214285714285715,3
Category_Wikipedia_sockpuppets_of_Lit2editor.csv,413,5436579.0,127,286,31,96,0,66.3365617433414,496,63,17.56900726392252,5
Category_Wikipedia_sockpuppets_of_EtymAesthete.csv,4744,18775941.0,1143,3601,500,643,0,49.97407251264755,255,59,15.902824620573355,3
Category_Wikipedia_sockpuppets_of_Tcs1208.csv,11,57063.0,5,6,4,1,0,29.818181818181817,84,33,29.818181818181817,13
Category_Wikipedia_sockpuppets_of_Lukejordan02.csv,1638,83879464.0,500,1138,500,0,0,46.595848595848594,499,62,24.81929181929182,8
Category_Wikipedia_sockpuppets_of_Patricia_CV.csv,2115,17449227.0,552,1563,500,52,0,40.47848699763593,648,52,20.556973995271868,4
Category_Wikipedia_sockpuppets_of_AmbroseGreypaw.csv,1218,15056177.0,389,829,204,185,0,47.12315270935961,357,87,17.363711001642034,4
Category_Wikipedia_sockpuppets_of_OneMadScientist.csv,2231,17528075.0,901,1330,500,401,0,45.409681757059616,255,47,19.675481846705512,3
Category_Wikipedia_sockpuppets_of_Faheemkintu.csv,547,28980922.0,185,362,162,23,0,48.14808043875686,381,60,16.96343692870201,4
Category_Wikipedia_sockpuppets_of_Kondavenkateshnetha.csv,140,74890022.0,37,103,35,2,0,37.93571428571428,229,26,12.057142857142857,8
Category_Wikipedia_sockpuppets_of_Peter_Ormond.csv,1704,105919246.0,529,1175,500,29,0,42.392605633802816,491,94,25.504107981220656,5
Category_Wikipedia_sockpuppets_of_Hotdaddy23.csv,119,9842525.0,33,86,13,20,0,44.05882352941177,241,40,25.100840336134453,8
Category_Wikipedia_sockpuppets_of_Michel_Sher.csv,221,2770354.0,74,147,23,51,0,55.34841628959276,243,46,16.687782805429865,5
Category_Wikipedia_sockpuppets_of_Rasputinfa.csv,477,258288449.0,99,378,27,72,0,48.18658280922432,242,52,17.949685534591193,5
Category_Wikipedia_sockpuppets_of_MRDU08.csv,2787,97734567.0,1286,1501,500,786,0,34.083602439899536,247,70,23.198062432723358,5
Category_Wikipedia_sockpuppets_of_Ashish_Narjinary.csv,1020,192278873.0,364,656,342,22,0,38.826470588235296,499,69,21.468627450980392,3
Category_Wikipedia_sockpuppets_of_Retro72.csv,2364,1881964.0,689,1675,463,226,0,53.645516074450086,255,47,16.609560067681894,2
Category_Wikipedia_sockpuppets_of_OGBranniff.csv,1560,17511456.0,585,975,490,95,0,43.26730769230769,250,94,25.425641025641024,4
Category_Wikipedia_sockpuppets_of_Mozambicano.csv,213,4143376.0,85,128,34,51,0,35.51643192488263,199,35,16.96713615023474,6
Category_Wikipedia_sockpuppets_of_Eajclark.csv,15,151073.0,8,7,6,2,0,30.2,136,38,24.333333333333332,12
Category_Wikipedia_sockpuppets_of_FreakBrainAtWork.csv,223,14828187.0,68,155,62,6,0,48.04932735426009,320,48,17.69506726457399,5
Category_Wikipedia_sockpuppets_of_Datarecovery21.csv,24,7723.0,11,13,6,5,2,84.25,198,31,16.041666666666668,6
Category_Wikipedia_sockpuppets_of_CC_King.csv,43,10555989.0,16,27,10,6,0,48.86046511627907,181,47,18.86046511627907,16
Category_Wikipedia_sockpuppets_of_Catholic-Truth-Advocate.csv,17,283463.0,8,9,3,5,31,117.88235294117646,306,24,20.176470588235293,19
Category_Wikipedia_sockpuppets_of_Pumpoviro.csv,5192,73758221.0,1295,3897,500,795,0,62.40851309707242,499,52,21.734591679506934,3
Category_Wikipedia_sockpuppets_of_Pewlosels.csv,177,1215952.0,37,140,35,2,0,40.559322033898304,200,70,40.9774011299435,4
Category_Wikipedia_sockpuppets_of_Shivansh_Hindustani.csv,83,455698.0,28,55,27,1,0,42.12048192771084,218,34,18.49397590361446,9
Category_Wikipedia_sockpuppets_of_Cuclamgo.csv,162,14693480.0,34,128,17,17,0,52.166666666666664,315,37,16.796296296296298,3
Category_Wikipedia_sockpuppets_of_Hychiang.csv,146,18985780.0,45,101,24,21,0,60.68493150684932,244,49,14.178082191780822,4
Category_Wikipedia_sockpuppets_of_Sathish1127.csv,1107,242799166.0,353,754,209,144,0,35.84643179765131,253,59,16.654923215898826,5
Category_Wikipedia_sockpuppets_of_Reuvengrish.csv,404,103161003.0,117,287,107,10,0,49.73514851485149,255,67,18.60148514851485,5
Category_Wikipedia_sockpuppets_of_Nursultan12.csv,1739,49246363.0,675,1064,500,175,0,32.922369177688324,503,59,23.53191489361702,6
Category_Wikipedia_sockpuppets_of_Santhini_R.csv,4,1184969.0,2,2,1,1,7,70.5,106,20,20.0,20
Category_Wikipedia_sockpuppets_of_Dwightjetnoga.csv,667,5637874.0,384,283,323,61,0,24.571214392803597,200,48,31.67766116941529,7
Category_Wikipedia_sockpuppets_of_Couponpitara.csv,6,362784.0,2,4,2,0,0,67.5,135,30,18.5,7
Category_Wikipedia_sockpuppets_of_DeltasAreCowards.csv,9,52529.0,4,5,3,1,16,53.77777777777778,138,14,12.0,11
Category_Wikipedia_sockpuppets_of_Xicko.csv,54,45568290.0,24,30,20,4,0,47.611111111111114,475,40,34.48148148148148,16
Category_Wikipedia_sockpuppets_of_Cal2323.csv,50,1996225.0,21,29,14,7,0,69.88,230,25,18.94,11
Category_Wikipedia_sockpuppets_of_Emersonlee.csv,21,145677166.0,6,15,5,1,0,34.095238095238095,177,42,16.952380952380953,14
Category_Wikipedia_sockpuppets_of_BoxRox.csv,460,27454398.0,148,312,68,80,0,53.780434782608694,255,54,16.965217391304346,5
Category_Wikipedia_sockpuppets_of_Mohamedrady2020.csv,1,0.0,1,0,1,0,53,53.0,53,25,25.0,25
Category_Wikipedia_sockpuppets_of_CheetaWolf.csv,366,5157749.0,159,207,106,53,0,42.849726775956285,255,97,31.469945355191257,10
Category_Wikipedia_sockpuppets_of_Nobita456.csv,3592,48161496.0,1346,2246,500,846,0,50.13947661469933,500,56,20.474109131403118,4
Category_Wikipedia_sockpuppets_of_Theman2121.csv,38,770.0,10,28,8,2,0,57.68421052631579,221,25,22.05263157894737,6
Category_Wikipedia_sockpuppets_of_Redandwhitead.csv,1,0.0,1,0,1,0,0,0.0,0,21,21.0,21
Category_Wikipedia_sockpuppets_of_Justshepu.csv,469,47860145.0,181,288,170,11,0,42.18123667377399,443,45,15.953091684434968,5
Category_Wikipedia_sockpuppets_of_Darmahjgari.csv,1376,19955277.0,430,946,115,315,0,36.88154069767442,255,52,11.841569767441861,3
Category_Wikipedia_sockpuppets_of_Darul_Ilm_Birmingham.csv,1,0.0,1,0,1,0,26,26.0,26,20,20.0,20
Category_Wikipedia_sockpuppets_of_Imacomp.csv,1027,2417750.0,522,505,500,22,0,38.20155793573515,187,51,19.701071080817915,7
Category_Wikipedia_sockpuppets_of_Sofakingwetoddit.csv,2,4154.0,2,0,2,0,41,58.5,76,24,24.0,24
Category_Wikipedia_sockpuppets_of_HooplaGuru.csv,81,2235221.0,67,14,32,35,0,18.049382716049383,168,25,21.22222222222222,10
Category_Wikipedia_sockpuppets_of_Minerfan.csv,133,6826009.0,61,72,53,8,0,28.60902255639098,199,37,22.05263157894737,18
Category_Wikipedia_sockpuppets_of_Inebranlable92.csv,914,28119273.0,544,370,500,44,0,32.401531728665205,475,45,27.578774617067833,4
Category_Wikipedia_sockpuppets_of_Naelsalvatore.csv,7,56528.0,4,3,2,2,0,67.85714285714286,156,11,11.0,11
Category_Wikipedia_sockpuppets_of_Globaldevelopmentinstitute.csv,2,0.0,1,1,1,0,24,24.0,24,24,24.0,24
Category_Wikipedia_sockpuppets_of_AdanXX.csv,2538,23430642.0,696,1842,500,196,0,42.015366430260045,423,51,18.37391646966115,3
Category_Wikipedia_sockpuppets_of_CO16.csv,2415,32152852.0,1000,1415,500,500,0,26.1175983436853,294,57,16.63064182194617,3
Category_Wikipedia_sockpuppets_of_Gjgtjhtkykhjhj.csv,449,4843117.0,126,323,91,35,0,61.56570155902004,495,31,11.955456570155903,3
Category_Wikipedia_sockpuppets_of_Rajithcalwis.csv,1258,362401415.0,477,781,441,36,0,43.13831478537361,255,72,18.13275039745628,4
Category_Wikipedia_sockpuppets_of_Sachinpandit.csv,188,244658951.0,50,138,13,37,0,55.97872340425532,247,58,19.414893617021278,4
Category_Wikipedia_sockpuppets_of_Ouuuudexterrr.csv,15,802.0,10,5,10,0,0,41.0,151,23,18.933333333333334,5
Category_Wikipedia_sockpuppets_of_WizetWiz.csv,36,2771370.0,15,21,14,1,0,34.77777777777778,196,20,14.88888888888889,5
Category_Wikipedia_sockpuppets_of_Mathewgeorgge.csv,58,60608182.0,21,37,18,3,0,74.1896551724138,250,34,15.46551724137931,9
Category_Wikipedia_sockpuppets_of_TheWizardof2017.csv,583,88782046.0,144,439,85,59,0,53.37221269296741,470,48,16.562607204116638,5
Category_Wikipedia_sockpuppets_of_Sf123456.csv,2058,22177805.0,740,1318,500,240,0,35.858114674441204,500,54,22.360544217687075,5
Category_Wikipedia_sockpuppets_of_Jaiwills.csv,4091,144941566.0,1391,2700,500,891,0,36.79662674162796,244,85,16.638719139574675,4
Category_Wikipedia_sockpuppets_of_Matt14451.csv,3217,43810998.0,1101,2116,500,601,0,54.7699720236245,500,67,26.07211687907989,4
Category_Wikipedia_sockpuppets_of_Ricky81682.csv,3142,250019996.0,1094,2048,500,594,0,58.83545512412476,382,213,24.95003182686187,3
Category_Wikipedia_sockpuppets_of_JBiskingg.csv,6,548.0,4,2,3,1,23,70.83333333333333,180,9,9.0,9
Category_Wikipedia_sockpuppets_of_Rita_El_Khouryy.csv,9,9530.0,5,4,4,1,10,42.22222222222222,101,28,27.666666666666668,25
Category_Wikipedia_sockpuppets_of_Bsems.csv,1206,146090192.0,517,689,500,17,0,51.556384742951906,419,53,30.54809286898839,13
Category_Wikipedia_sockpuppets_of_Kelownatopdog.csv,1294,288649826.0,375,919,51,324,0,52.820710973724886,345,62,20.90030911901082,5
Category_Wikipedia_sockpuppets_of_MUCHERS22.csv,1548,26781587.0,476,1072,267,209,0,49.20413436692507,237,68,22.996770025839794,5
Category_Wikipedia_sockpuppets_of_Mujahid1947.csv,125,877552.0,37,88,17,20,0,37.744,217,67,32.968,8
Category_Wikipedia_sockpuppets_of_Puppybone.csv,360,9766678.0,121,239,88,33,0,61.105555555555554,503,50,26.858333333333334,5
Category_Wikipedia_sockpuppets_of_Himanshipandey123.csv,71,5717450.0,26,45,19,7,0,62.014084507042256,268,18,11.633802816901408,8
Category_Wikipedia_sockpuppets_of_Mexican_Santa.csv,2,0.0,1,1,1,0,23,23.0,23,11,11.0,11
Category_Wikipedia_sockpuppets_of_Dileepvee.csv,1671,76675839.0,507,1164,500,7,0,37.12327947336924,255,63,20.666666666666668,7
Category_Wikipedia_sockpuppets_of_WeareXjaoan.csv,105,130829.0,41,64,30,11,0,41.34285714285714,192,37,15.152380952380952,7
Category_Wikipedia_sockpuppets_of_Altafalam.csv,33,18833526.0,17,16,11,6,0,63.24242424242424,241,44,33.36363636363637,19
Category_Wikipedia_sockpuppets_of_Yocreoenplazas.csv,66,158791.0,34,32,27,7,0,47.121212121212125,218,62,22.515151515151516,9
Category_Wikipedia_sockpuppets_of_ASHFAK_COYON.csv,1085,98148360.0,383,702,337,46,0,43.10414746543779,468,56,19.400921658986174,5
Category_Wikipedia_sockpuppets_of_Pierrevang3.csv,2050,16527049.0,663,1387,500,163,0,54.79414634146342,500,58,15.95170731707317,4
Category_Wikipedia_sockpuppets_of_AlisaJay.csv,402,5970301.0,125,277,68,57,0,43.18407960199005,255,49,17.524875621890548,5
Category_Wikipedia_sockpuppets_of_Daniel_Kobe_Ricks_Jr.csv,2855,149069231.0,1237,1618,289,948,0,37.28301225919439,500,64,17.24658493870403,4
Category_Wikipedia_sockpuppets_of_Aronanki.csv,2302,258424630.0,553,1749,500,53,0,53.869678540399654,500,60,20.776715899218072,4
Category_Wikipedia_sockpuppets_of_Sl63.csv,99,580471.0,27,72,27,0,0,52.515151515151516,219,18,6.838383838383838,5
Category_Wikipedia_sockpuppets_of_Streetmarketing.csv,75,11656121.0,44,31,27,17,0,31.72,255,20,17.493333333333332,16
Category_Wikipedia_sockpuppets_of_Latitude0116.csv,11193,523178382.0,3438,7755,500,2938,0,42.59349593495935,472,94,23.198070222460466,3
Category_Wikipedia_sockpuppets_of_Xiutwel.csv,1609,122884182.0,507,1102,500,7,0,49.966438781852084,250,90,28.330018645121193,7
Category_Wikipedia_sockpuppets_of_Staafros1.csv,6345,81103583.0,1608,4737,500,1108,0,32.04286840031521,255,66,20.18502758077226,4
Category_Wikipedia_sockpuppets_of_Arthur_Fonzarelli_MDCCXXXVIII.csv,118,1577690.0,47,71,43,4,0,91.86440677966101,500,39,24.38135593220339,14
Category_Wikipedia_sockpuppets_of_Bess289.csv,2,29.0,2,0,2,0,21,21.0,21,17,17.0,17
Category_Wikipedia_sockpuppets_of_DonnerParty2004.csv,11,895.0,6,5,5,1,0,78.36363636363636,197,12,12.0,12
Category_Wikipedia_sockpuppets_of_Pawangosavi36.csv,105,98636948.0,25,80,5,20,0,64.24761904761905,242,31,21.81904761904762,9
Category_Wikipedia_sockpuppets_of_Shabeehanswar.csv,259,205285561.0,119,140,108,11,0,33.13127413127413,330,54,15.656370656370656,7
Category_Wikipedia_sockpuppets_of_MLP_Princess_Luna.csv,194,1381858.0,152,42,117,35,0,30.010309278350515,196,53,24.438144329896907,10
Category_Wikipedia_sockpuppets_of_Chrism_12.csv,79,6386973.0,30,49,19,11,0,44.848101265822784,147,51,28.556962025316455,18
Category_Wikipedia_sockpuppets_of_Gargabook.csv,1283,50171633.0,292,991,193,99,0,47.46609508963367,248,71,20.738113795791115,3
Category_Wikipedia_sockpuppets_of_CENA_LUV.csv,1316,11895365.0,314,1002,165,149,0,24.319148936170212,200,35,15.105623100303951,4
Category_Wikipedia_sockpuppets_of_Little9man.csv,223,11321770.0,85,138,60,25,0,37.874439461883405,238,52,23.68609865470852,4
Category_Wikipedia_sockpuppets_of_Blaublaudaene.csv,91,53811554.0,43,48,22,21,0,34.59340659340659,196,28,17.34065934065934,8
Category_Wikipedia_sockpuppets_of_Garyleesmith3.csv,18,120505741.0,4,14,2,2,0,63.44444444444444,255,19,12.88888888888889,9
Category_Wikipedia_sockpuppets_of_Heraldrist.csv,1857,2494836.0,516,1341,500,16,0,43.53204092622509,298,47,15.495961227786752,3
Category_Wikipedia_sockpuppets_of_Internet_for_Learning.csv,14,328.0,5,9,5,0,0,32.785714285714285,91,47,41.285714285714285,15
Category_Wikipedia_sockpuppets_of_Mujhideen101.csv,16918,368349868.0,5882,11036,500,5382,0,41.20345194467431,503,71,21.38621586475943,4
Category_Wikipedia_sockpuppets_of_Bannedtruth.csv,387,5397656.0,118,269,48,70,0,44.229974160206716,191,74,21.064599483204134,6
Category_Wikipedia_sockpuppets_of_Salonikush12.csv,383,17525319.0,104,279,68,36,0,43.04960835509139,303,84,17.621409921671017,5
Category_Wikipedia_sockpuppets_of_Meh31.csv,36,1982853.0,14,22,13,1,0,40.416666666666664,199,28,16.97222222222222,7
Category_Wikipedia_sockpuppets_of_Sangwook090.csv,1,0.0,1,0,1,0,0,0.0,0,8,8.0,8
Category_Wikipedia_sockpuppets_of_Spoon11.csv,9,459.0,5,4,5,0,0,59.333333333333336,173,14,14.0,14
Category_Wikipedia_sockpuppets_of_Iknowallsecrets.csv,130,93522015.0,42,88,20,22,0,44.323076923076925,254,70,22.3,12
Category_Wikipedia_sockpuppets_of_BruinsLA$.csv,19,1527.0,13,6,13,0,0,119.52631578947368,493,51,23.63157894736842,13
Category_Wikipedia_sockpuppets_of_Strivingsoul.csv,2532,95336957.0,1000,1532,500,500,0,55.075434439178515,383,60,30.15916271721959,3
Category_Wikipedia_sockpuppets_of_Retired_user_78767.csv,221,377087291.0,69,152,37,32,0,52.76470588235294,296,47,25.235294117647058,6
Category_Wikipedia_sockpuppets_of_Simon_1996.csv,1530,18072115.0,618,912,500,118,0,35.83725490196078,383,67,30.470588235294116,6
Category_Wikipedia_sockpuppets_of_H.I.H_Shah_Jafar_I.csv,223,6848835.0,77,146,44,33,0,43.488789237668165,492,75,19.869955156950674,10
Category_Wikipedia_sockpuppets_of_HamzaSufyan.csv,64,37921409.0,26,38,23,3,0,41.1875,197,53,35.703125,21
Category_Wikipedia_sockpuppets_of_Pbasista1220.csv,171,7664293.0,57,114,20,37,0,42.619883040935676,248,20,11.701754385964913,4
Category_Wikipedia_sockpuppets_of_Anne_Barrington.csv,4930,450382512.0,1441,3489,204,1237,0,44.54421906693712,496,72,18.36004056795132,4
Category_Wikipedia_sockpuppets_of_Theofeliciano.csv,162,46652904.0,74,88,40,34,0,63.2037037037037,256,193,21.141975308641975,7
Category_Wikipedia_sockpuppets_of_Tim_Harris84.csv,36,935963.0,21,15,16,5,0,25.02777777777778,108,56,45.80555555555556,13
Category_Wikipedia_sockpuppets_of_Hendrix_Adi_Surya.csv,20,78831054.0,8,12,3,5,0,52.1,132,30,20.85,10
Category_Wikipedia_sockpuppets_of_Wasag.csv,75,9926278.0,38,37,20,18,0,58.54666666666667,223,20,8.213333333333333,3
Category_Wikipedia_sockpuppets_of_Charli_250.csv,3273,36732708.0,1850,1423,500,1350,0,21.799266727772686,369,85,35.19676138099603,10
Category_Wikipedia_sockpuppets_of_Alundahluk.csv,81,2212844.0,57,24,50,7,0,42.370370370370374,180,51,20.901234567901234,10
Category_Wikipedia_sockpuppets_of_Helleoos.csv,6,700285.0,3,3,1,2,0,41.833333333333336,109,41,29.333333333333332,7
Category_Wikipedia_sockpuppets_of_Srahmadi.csv,9936,349780430.0,4174,5762,500,3674,0,43.95209339774557,429,85,21.374798711755233,3
Category_Wikipedia_sockpuppets_of_Dk113040.csv,1532,31881205.0,508,1024,500,8,0,37.83942558746736,255,70,29.137728459530027,10
Category_Wikipedia_sockpuppets_of_Sarah_Easson.csv,123,15470308.0,48,75,24,24,0,42.886178861788615,199,22,12.528455284552846,5
Category_Wikipedia_sockpuppets_of_Afro-Eurasian.csv,4408,5931944.0,1279,3129,500,779,0,45.969600725952816,255,61,16.038793103448278,4
Category_Wikipedia_sockpuppets_of_Jason-Jimmy_Kent.csv,1463,211753155.0,539,924,446,93,0,38.799726589200276,496,35,15.943267259056732,6
Category_Wikipedia_sockpuppets_of_ÿπŸÖÿ±_ÿÆÿßŸÑÿØ_8888.csv,150,30912598.0,51,99,45,6,0,32.053333333333335,185,49,24.126666666666665,11
Category_Wikipedia_sockpuppets_of_WindyPegg.csv,1210,37457433.0,420,790,54,366,0,49.099173553719005,255,56,19.74628099173554,5
Category_Wikipedia_sockpuppets_of_GregBollom.csv,116,170473.0,46,70,26,20,0,57.293103448275865,218,52,17.93103448275862,5
Category_Wikipedia_sockpuppets_of_Followingfireworks.csv,10,898.0,9,1,9,0,0,0.0,0,17,17.0,17
Category_Wikipedia_sockpuppets_of_Lisheng1.csv,279,605490.0,89,190,33,56,0,41.215053763440864,255,28,10.172043010752688,3
Category_Wikipedia_sockpuppets_of_Pauljhickey.csv,70,1372549.0,44,26,25,19,0,32.128571428571426,186,32,13.4,10
Category_Wikipedia_sockpuppets_of_Lifeissosweet1991.csv,47,1243641.0,20,27,8,12,0,55.148936170212764,275,21,15.25531914893617,11
Category_Wikipedia_sockpuppets_of_SouL_Viper.csv,30,1702295.0,10,20,5,5,0,25.933333333333334,138,53,35.0,17
Category_Wikipedia_sockpuppets_of_Hjnav.csv,73,19717256.0,30,43,10,20,0,73.28767123287672,253,54,17.356164383561644,7
Category_Wikipedia_sockpuppets_of_Deplug1.csv,924,9205127.0,454,470,440,14,0,36.692640692640694,500,54,15.218614718614718,4
Category_Wikipedia_sockpuppets_of_Who_Loves_Thomas.csv,54,1391380.0,23,31,8,15,0,40.31481481481482,237,16,13.666666666666666,13
Category_Wikipedia_sockpuppets_of_BrendanJohn.csv,389,2618100.0,136,253,70,66,0,37.077120822622106,233,39,29.10796915167095,15
Category_Wikipedia_sockpuppets_of_EzinneAnwuri.csv,308,12364984.0,142,166,71,71,0,60.311688311688314,277,49,27.928571428571427,17
Category_Wikipedia_sockpuppets_of_Placidsux923.csv,1304,5356861.0,527,777,500,27,0,41.091257668711656,252,51,21.4079754601227,2
Category_Wikipedia_sockpuppets_of_FutuGo.csv,25,20631.0,12,13,11,1,0,30.68,75,71,49.04,12
Category_Wikipedia_sockpuppets_of_GaGu13.csv,1786,61470414.0,418,1368,207,211,0,39.994400895856664,255,50,19.12989921612542,7
Category_Wikipedia_sockpuppets_of_RockingGeo.csv,2854,1839419.0,959,1895,500,459,0,63.7312543798178,324,111,23.52908199018921,4
Category_Wikipedia_sockpuppets_of_Perculaclownfish.csv,1358,72865618.0,548,810,432,116,0,54.95213549337261,445,68,17.603092783505154,4
Category_Wikipedia_sockpuppets_of_TheLangmasGroupInc.csv,2,8097.0,2,0,1,1,45,120.5,196,28,25.5,23
Category_Wikipedia_sockpuppets_of_Hanna_Films.csv,8,10173.0,6,2,6,0,0,21.0,134,48,18.25,6
Category_Wikipedia_sockpuppets_of_Pkoaed.csv,81,2877.0,26,55,24,2,0,50.74074074074074,260,54,23.555555555555557,3
Category_Wikipedia_sockpuppets_of_AnotherRealOne.csv,19,4990.0,11,8,8,3,14,105.3157894736842,199,26,21.263157894736842,19
Category_Wikipedia_sockpuppets_of_REVOSMITTY.csv,168,1535575.0,62,106,35,27,0,63.32738095238095,285,35,18.577380952380953,5
Category_Wikipedia_sockpuppets_of_Blatantprivacyviolations.csv,11,3685517.0,8,3,6,2,2,67.45454545454545,198,34,24.454545454545453,19
Category_Wikipedia_sockpuppets_of_Ihateamos.csv,59,39303942.0,17,42,5,12,0,63.66101694915254,222,37,14.084745762711865,3
Category_Wikipedia_sockpuppets_of_Zhanghao1987.csv,955,13622671.0,298,657,178,120,0,52.001047120418846,254,52,19.027225130890052,4
Category_Wikipedia_sockpuppets_of_Anishluitel439.csv,5,2376.0,3,2,3,0,0,36.8,46,20,20.0,20
Category_Wikipedia_sockpuppets_of_John.sidhu.csv,17,195640.0,10,7,6,4,0,26.705882352941178,126,44,29.11764705882353,9
Category_Wikipedia_sockpuppets_of_Nopirosyadi.csv,52,3366342.0,25,27,19,6,0,40.23076923076923,253,54,24.826923076923077,13
Category_Wikipedia_sockpuppets_of_Kabiryazd.csv,592,207397075.0,246,346,94,152,0,33.95945945945946,496,64,17.58614864864865,9
Category_Wikipedia_sockpuppets_of_Legende_Legende_Legende.csv,5000,98923382.0,1428,3572,500,928,0,48.0874,500,71,17.0504,4
Category_Wikipedia_sockpuppets_of_Brya.csv,1504,487560667.0,500,1004,500,0,0,42.609042553191486,397,79,17.649601063829788,5
Category_Wikipedia_sockpuppets_of_Bob122122.csv,58,266912.0,38,20,17,21,0,45.01724137931034,181,29,16.775862068965516,8
Category_Wikipedia_sockpuppets_of_Deltagammaz.csv,2260,51494780.0,640,1620,477,163,0,58.236283185840705,391,68,17.038938053097347,5
Category_Wikipedia_sockpuppets_of_Cali11298.csv,10374,12061941.0,3356,7018,500,2856,0,58.88837478311162,255,80,22.28397917871602,3
Category_Wikipedia_sockpuppets_of_RAJIVVASUDEV.csv,2110,324099657.0,775,1335,500,275,0,48.695734597156395,429,68,19.567772511848343,2
Category_Wikipedia_sockpuppets_of_Factfanatic1.csv,2100,52926431.0,564,1536,500,64,0,67.71619047619048,500,60,18.844285714285714,3
Category_Wikipedia_sockpuppets_of_Chintu6.csv,758,253332180.0,255,503,201,54,0,51.37994722955145,307,69,19.3245382585752,3
Category_Wikipedia_sockpuppets_of_CalCon_Calculator.csv,54,445359.0,18,36,13,5,0,42.388888888888886,217,34,19.185185185185187,7
Category_Wikipedia_sockpuppets_of_Fahri_pes.csv,293,7746842.0,111,182,111,0,0,15.0,196,38,15.812286689419794,9
Category_Wikipedia_sockpuppets_of_GERARD_AIRLANGGA_T.csv,1508,31871276.0,354,1154,266,88,0,35.286472148541115,500,65,28.34681697612732,3
Category_Wikipedia_sockpuppets_of_Paleontologist99.csv,1749,108308407.0,500,1249,500,0,0,66.83704974271012,506,66,19.116066323613495,4
Category_Wikipedia_sockpuppets_of_Gregcloete.csv,1,0.0,1,0,1,0,18,18.0,18,15,15.0,15
Category_Wikipedia_sockpuppets_of_Wackslas.csv,1801,214657373.0,605,1196,500,105,0,36.85952248750694,255,72,21.079955580233204,4
Category_Wikipedia_sockpuppets_of_Rajanthegame.csv,32,1008186.0,11,21,11,0,0,45.34375,173,41,32.09375,22
Category_Wikipedia_sockpuppets_of_Baseerwar.csv,20,11681249.0,13,7,12,1,0,14.65,79,19,9.5,9
Category_Wikipedia_sockpuppets_of_Jugrajsingh7.csv,167,13932549.0,52,115,14,38,0,52.40718562874252,282,27,15.197604790419161,8
Category_Wikipedia_sockpuppets_of_Downholder40.csv,460,16116633.0,188,272,142,46,0,38.20652173913044,230,42,19.982608695652175,7
Category_Wikipedia_sockpuppets_of_ItalianConquest.csv,433,30839619.0,150,283,53,97,0,74.24942263279446,499,55,12.237875288683602,3
Category_Wikipedia_sockpuppets_of_Nair_Community.csv,167,2659022.0,73,94,31,42,0,39.50898203592814,227,40,19.682634730538922,8
Category_Wikipedia_sockpuppets_of_Nicknikio.csv,79,3187670.0,31,48,16,15,0,40.41772151898734,201,24,17.443037974683545,3
Category_Wikipedia_sockpuppets_of_GECollins.csv,349,315169370.0,152,197,87,65,0,53.561604584527224,486,48,9.478510028653295,8
Category_Wikipedia_sockpuppets_of_Wikipedian_Forevermore.csv,17,21475.0,9,8,3,6,0,52.23529411764706,194,51,33.88235294117647,10
Category_Wikipedia_sockpuppets_of_Rachele.b.csv,29,3892567.0,15,14,10,5,0,46.689655172413794,179,32,32.0,32
Category_Wikipedia_sockpuppets_of_Salinamalik302.csv,1,0.0,1,0,1,0,0,0.0,0,20,20.0,20
Category_Wikipedia_sockpuppets_of_Chamath237.csv,4897,129202724.0,1580,3317,500,1080,0,40.662242189095366,255,86,26.688993261180315,3
Category_Wikipedia_sockpuppets_of_FundiFisi.csv,15,7628773.0,8,7,5,3,0,59.733333333333334,259,19,14.4,13
Category_Wikipedia_sockpuppets_of_Tonybaldry.csv,26,7780612.0,14,12,11,3,0,43.34615384615385,136,11,11.0,11
Category_Wikipedia_sockpuppets_of_Pohjamadesse.csv,1702,60153623.0,514,1188,500,14,0,48.88601645123384,494,65,20.976498237367803,4
Category_Wikipedia_sockpuppets_of_DiggisMusic.csv,60,5519623.0,30,30,27,3,0,39.71666666666667,158,27,19.283333333333335,13
Category_Wikipedia_sockpuppets_of_Sirisecure.csv,621,12185242.0,188,433,67,121,0,50.227053140096615,376,56,17.13365539452496,4
Category_Wikipedia_sockpuppets_of_Lmurdock3.csv,1071,13081090.0,466,605,314,152,0,33.96638655462185,334,56,26.177404295051353,10
Category_Wikipedia_sockpuppets_of_Username3443.csv,16,1464.0,7,9,7,0,0,66.0,186,29,11.75,5
Category_Wikipedia_sockpuppets_of_Imothana.csv,1,0.0,1,0,1,0,29,29.0,29,55,55.0,55
Category_Wikipedia_sockpuppets_of_SithJarJar666.csv,4198,82345630.0,1510,2688,500,1010,0,57.01357789423535,500,84,23.1576941400667,4
Category_Wikipedia_sockpuppets_of_HP_Lovecraft_The_Second.csv,30,11010.0,13,17,12,1,0,36.766666666666666,224,37,18.033333333333335,13
Category_Wikipedia_sockpuppets_of_Crount.csv,3405,91779751.0,1289,2116,142,1147,0,48.884581497797356,508,66,17.809691629955946,4
Category_Wikipedia_sockpuppets_of_Wahyupkr110.csv,2,873.0,2,0,2,0,0,0.0,0,37,37.0,37
Category_Wikipedia_sockpuppets_of_Polgraf.csv,1084,38220920.0,348,736,294,54,0,47.15036900369004,260,54,16.583948339483396,4
Category_Wikipedia_sockpuppets_of_Rhp_26.csv,4092,54297304.0,1232,2860,500,732,0,34.74853372434018,250,59,21.227272727272727,3
Category_Wikipedia_sockpuppets_of_CCreate20142020.csv,189,609477.0,58,131,30,28,0,45.07936507936508,299,39,17.693121693121693,5
Category_Wikipedia_sockpuppets_of_Utbindas.csv,5123,256577415.0,1239,3884,409,830,0,50.06363458910794,255,64,14.918407183291041,3
Category_Wikipedia_sockpuppets_of_Anay_jain.csv,158,15634387.0,61,97,45,16,0,50.322784810126585,229,47,24.170886075949365,6
Category_Wikipedia_sockpuppets_of_CyberTechInc.csv,4,4252497.0,2,2,1,1,36,100.5,233,19,16.0,15
Category_Wikipedia_sockpuppets_of_TyrusThomas4lyf.csv,8334,282749451.0,2651,5683,500,2151,0,49.66162706983442,256,85,20.285337173026157,2
Category_Wikipedia_sockpuppets_of_Ronildarius.csv,63,22448088.0,25,38,24,1,0,57.07936507936508,232,37,21.047619047619047,5
Category_Wikipedia_sockpuppets_of_Dancey2.csv,2803,471910872.0,722,2081,500,222,0,45.68034249018908,384,52,17.753478415982876,2
Category_Wikipedia_sockpuppets_of_JonesJaguar.csv,1089,32898380.0,418,671,356,62,0,58.313131313131315,416,42,17.221303948576676,4
Category_Wikipedia_sockpuppets_of_Rosalinemartinez.csv,87,47290254.0,32,55,30,2,0,61.06896551724138,331,39,31.528735632183906,15
Category_Wikipedia_sockpuppets_of_Mdmosharofhossain.csv,60,605128.0,18,42,13,5,0,59.28333333333333,166,50,41.7,20
Category_Wikipedia_sockpuppets_of_Nilabh_Shivam_333.csv,1417,9890481.0,465,952,409,56,0,43.37755822159492,408,67,20.90331686661962,5
Category_Wikipedia_sockpuppets_of_Sudhavedanta.csv,728,180771642.0,212,516,206,6,0,50.440934065934066,418,45,16.960164835164836,4
Category_Wikipedia_sockpuppets_of_Folgertat.csv,1048,73223566.0,302,746,186,116,0,50.99809160305343,236,81,21.987595419847327,5
Category_Wikipedia_sockpuppets_of_Research0808.csv,30,2579576.0,15,15,9,6,0,42.06666666666667,142,12,8.066666666666666,6
Category_Wikipedia_sockpuppets_of_Slavemodsquad.csv,49,14956764.0,14,35,3,11,0,66.53061224489795,229,32,21.3265306122449,13
Category_Wikipedia_sockpuppets_of_Robinson_michael_junior.csv,3,2052.0,2,1,1,1,195,195.0,195,33,29.666666666666668,23
Category_Wikipedia_sockpuppets_of_Ryangamer32.csv,55,632757.0,20,35,14,6,0,47.61818181818182,224,42,22.2,8
Category_Wikipedia_sockpuppets_of_Cherylcosim32.csv,244,9004403.0,96,148,60,36,0,33.01229508196721,232,34,15.647540983606557,4
Category_Wikipedia_sockpuppets_of_Central_Midfielder.csv,4416,244861200.0,1183,3233,500,683,0,51.37794384057971,478,76,15.830842391304348,4
Category_Wikipedia_sockpuppets_of_WTKFan2.csv,621,7868421.0,528,93,366,162,0,36.16425120772947,496,62,22.58132045088567,7
Category_Wikipedia_sockpuppets_of_ÁñæÈ¢®„ÅÆÈ≥∂.csv,9,87266.0,3,6,2,1,0,100.33333333333333,220,28,20.0,15
Category_Wikipedia_sockpuppets_of_LondonerM&S.csv,55,2584609.0,27,28,16,11,0,57.56363636363636,234,22,12.672727272727272,4
Category_Wikipedia_sockpuppets_of_Pointlessweb.csv,133,29864218.0,47,86,31,16,0,39.41353383458647,182,27,17.924812030075188,5
Category_Wikipedia_sockpuppets_of_S√°nchezW.csv,5580,11761683.0,1643,3937,416,1227,0,48.78906810035842,519,64,14.061469534050179,2
Category_Wikipedia_sockpuppets_of_Me.vaishakh.csv,272,37715465.0,110,162,107,3,0,28.731617647058822,255,26,14.922794117647058,6
Category_Wikipedia_sockpuppets_of_ƒ¥Œπ…±Œ≤…∏_œâŒ±ŒôŒµ É.csv,3,623.0,2,1,1,1,0,23.333333333333332,35,11,11.0,11
Category_Wikipedia_sockpuppets_of_Alwayshere2.csv,6,986.0,3,3,2,1,34,71.66666666666667,109,23,22.0,21
Category_Wikipedia_sockpuppets_of_Engku1973.csv,2067,191797369.0,539,1528,409,130,0,39.52588292210934,499,48,17.98306724721819,4
Category_Wikipedia_sockpuppets_of_Gpcv77.csv,1719,72662689.0,480,1239,391,89,0,39.15125072716696,255,62,25.123327515997673,5
Category_Wikipedia_sockpuppets_of_Hurricane_Chandler.csv,1296,43717903.0,687,609,376,311,0,45.05632716049383,496,71,28.385802469135804,12
Category_Wikipedia_sockpuppets_of_Diegowakik.csv,1490,89596653.0,448,1042,426,22,0,36.185906040268456,499,47,17.66510067114094,2
Category_Wikipedia_sockpuppets_of_Runemaster24.csv,20,3833.0,6,14,6,0,0,47.75,167,18,14.1,10
Category_Wikipedia_sockpuppets_of_Zana_Dark.csv,1351,40896518.0,518,833,500,18,0,31.518874907475944,230,56,16.430051813471504,3
Category_Wikipedia_sockpuppets_of_NTDEV.csv,420,10211450.0,119,301,71,48,0,64.27619047619048,368,53,24.659523809523808,4
Category_Wikipedia_sockpuppets_of_Sayyed_Al_Kiram.csv,203,52224966.0,62,141,34,28,0,56.97536945812808,368,56,25.36945812807882,15
Category_Wikipedia_sockpuppets_of_PostcolonialLitNerd.csv,466,107021094.0,188,278,131,57,0,76.86051502145922,499,50,19.98283261802575,8
Category_Wikipedia_sockpuppets_of_Thousandoskt.csv,31,8461804.0,15,16,7,8,0,25.612903225806452,125,48,23.225806451612904,5
Category_Wikipedia_sockpuppets_of_Cannady212.csv,656,183019285.0,237,419,218,19,0,45.010670731707314,266,60,18.74390243902439,5
Category_Wikipedia_sockpuppets_of_Ausdiplomad.csv,72,704096.0,35,37,18,17,0,48.208333333333336,157,31,21.375,5
Category_Wikipedia_sockpuppets_of_NinaGreen.csv,2255,324160863.0,1002,1253,500,502,0,46.316186252771615,439,61,26.95609756097561,9
Category_Wikipedia_sockpuppets_of_Coolguy101011.csv,120,58595.0,58,62,32,26,0,36.541666666666664,220,25,20.45,14
Category_Wikipedia_sockpuppets_of_Superstar999.csv,608,4932604.0,178,430,48,130,0,59.06907894736842,306,59,22.039473684210527,7
Category_Wikipedia_sockpuppets_of_Itsfaridhasan.csv,1,0.0,1,0,1,0,0,0.0,0,24,24.0,24
Category_Wikipedia_sockpuppets_of_JordanL462.csv,243,6453415.0,83,160,62,21,0,59.11934156378601,250,47,16.839506172839506,4
Category_Wikipedia_sockpuppets_of_Sargonious.csv,1846,31259453.0,686,1160,500,186,0,34.75568797399783,255,43,15.912784398699891,3
Category_Wikipedia_sockpuppets_of_Quidster4040.csv,3873,338872212.0,1699,2174,500,1199,0,44.00258197779499,507,83,30.60237541957139,4
Category_Wikipedia_sockpuppets_of_Aventuraman.csv,19,157545931.0,9,10,5,4,4,60.526315789473685,206,11,11.0,11
Category_Wikipedia_sockpuppets_of_HamzaKhaliq12345.csv,271,18517009.0,83,188,30,53,0,50.17712177121771,255,52,15.642066420664207,10
Category_Wikipedia_sockpuppets_of_Spamtheppd1ck.csv,54,27509773.0,17,37,16,1,0,57.111111111111114,199,47,34.74074074074074,7
Category_Wikipedia_sockpuppets_of_Arifhidayat.csv,1504,388084517.0,379,1125,377,2,0,38.10438829787234,257,54,16.314494680851062,4
Category_Wikipedia_sockpuppets_of_Sabinbik.csv,1659,84017858.0,755,904,390,365,0,32.260397830018086,261,49,17.880048221820374,2
Category_Wikipedia_sockpuppets_of_Becashan.csv,45,1314007.0,25,20,25,0,0,49.71111111111111,218,77,20.4,5
Category_Wikipedia_sockpuppets_of_Musicales0212.csv,326,4402205.0,137,189,62,75,0,33.147239263803684,235,24,11.217791411042946,4
Category_Wikipedia_sockpuppets_of_Arizeuo.csv,226,49630224.0,66,160,64,2,0,49.39823008849557,487,70,26.438053097345133,11
Category_Wikipedia_sockpuppets_of_1V13NA5.csv,143,95127212.0,46,97,35,11,0,62.73426573426573,255,54,13.951048951048952,8
Category_Wikipedia_sockpuppets_of_Bpatel12.csv,1,0.0,1,0,1,0,102,102.0,102,24,24.0,24
Category_Wikipedia_sockpuppets_of_Guru78x.csv,295,247472.0,136,159,114,22,0,93.2135593220339,253,48,21.132203389830508,8
Category_Wikipedia_sockpuppets_of_Shima_Joel.csv,76,6050852.0,57,19,55,2,0,24.986842105263158,239,31,23.36842105263158,21
Category_Wikipedia_sockpuppets_of_WondrousMachine.csv,31,13659.0,19,12,17,2,0,30.870967741935484,179,53,41.516129032258064,19
Category_Wikipedia_sockpuppets_of_Ageofwars.csv,527,7422729.0,245,282,105,140,0,61.64326375711575,269,50,16.82732447817837,4
Category_Wikipedia_sockpuppets_of_Luxorandaswan.csv,44,2505331.0,16,28,6,10,0,47.88636363636363,233,28,13.545454545454545,5
Category_Wikipedia_sockpuppets_of_Marvinfos75.csv,9,6581379.0,4,5,3,1,10,55.55555555555556,159,25,17.666666666666668,14
Category_Wikipedia_sockpuppets_of_Mghghoffic.csv,7,12662941.0,5,2,4,1,0,109.0,495,37,29.285714285714285,28
Category_Wikipedia_sockpuppets_of_Gamechanger12345678.csv,14,754699.0,8,6,8,0,0,45.5,194,34,30.357142857142858,27
Category_Wikipedia_sockpuppets_of_Moosstore.csv,82,1815230.0,31,51,8,23,0,71.7560975609756,215,45,20.634146341463413,7
Category_Wikipedia_sockpuppets_of_Birmal_Hembram.csv,766,59045934.0,265,501,45,220,0,48.78981723237598,488,108,21.283289817232376,3
Category_Wikipedia_sockpuppets_of_Buttercupstriker12.csv,22,4510.0,9,13,7,2,0,71.4090909090909,188,19,16.227272727272727,13
Category_Wikipedia_sockpuppets_of_KDS4444.csv,2370,159329084.0,712,1658,500,212,0,52.22827004219409,255,98,18.69451476793249,4
Category_Wikipedia_sockpuppets_of_ÿ¥ÿ±ŸäŸÅ.csv,35,37239467.0,19,16,17,2,0,50.371428571428574,264,38,26.057142857142857,14
Category_Wikipedia_sockpuppets_of_Bonaparte.csv,29006,456460610.0,9598,19408,500,9098,0,42.93394470109632,500,104,20.28197614286699,3
Category_Wikipedia_sockpuppets_of_Bwmoll3.csv,2571,50944766.0,1000,1571,500,500,0,59.32827693504473,258,81,27.38234150136134,5
Category_Wikipedia_sockpuppets_of_USEE1776.csv,102,28568223.0,28,74,14,14,0,50.509803921568626,216,38,18.65686274509804,13
Category_Wikipedia_sockpuppets_of_Jimbopheel.csv,38,2470665.0,14,24,8,6,0,55.68421052631579,210,26,17.289473684210527,9
Category_Wikipedia_sockpuppets_of_RoadOFDoom.csv,66,30193.0,40,26,12,28,0,75.34848484848484,339,20,12.742424242424242,5
Category_Wikipedia_sockpuppets_of_Stag12man.csv,6,1529.0,5,1,5,0,0,35.333333333333336,102,14,12.666666666666666,12
Category_Wikipedia_sockpuppets_of_Gringoladomenega.csv,5607,29874714.0,1525,4082,500,1025,0,31.468699839486355,255,52,16.106474050294274,4
Category_Wikipedia_sockpuppets_of_K.Kapil77.csv,2275,17093079.0,504,1771,260,244,0,57.00659340659341,452,50,15.5410989010989,4
Category_Wikipedia_sockpuppets_of_Wgarly.csv,23,287510.0,15,8,8,7,0,48.391304347826086,153,23,18.08695652173913,16
Category_Wikipedia_sockpuppets_of_Jess6781.csv,3945,39121242.0,1000,2945,500,500,0,35.81444866920152,255,68,18.444106463878327,4
Category_Wikipedia_sockpuppets_of_Ericrico3.csv,1902,82017276.0,425,1477,274,151,0,44.12828601472135,397,67,23.912197686645637,3
Category_Wikipedia_sockpuppets_of_Totheairport.csv,833,49697981.0,295,538,178,117,0,55.63625450180072,496,49,18.605042016806724,3
Category_Wikipedia_sockpuppets_of_Burgas00.csv,1445,37655177.0,500,945,500,0,0,52.59307958477509,255,84,21.818685121107265,5
Category_Wikipedia_sockpuppets_of_HandsomeJerry.csv,63,33880968.0,13,50,10,3,0,49.42857142857143,199,39,22.063492063492063,3
Category_Wikipedia_sockpuppets_of_MariaJaydHicky.csv,39877,514255813.0,11671,28206,500,11171,0,43.33006494972039,500,68,19.499761767434862,2
Category_Wikipedia_sockpuppets_of_Paulkumar_Arikrishnan.N.csv,59,199073.0,33,26,33,0,0,44.220338983050844,196,68,40.83050847457627,33
Category_Wikipedia_sockpuppets_of_Ew0sdc.csv,386,7189176.0,132,254,116,16,0,46.78756476683938,255,67,29.76683937823834,11
Category_Wikipedia_sockpuppets_of_Dark_Moraes_Amorim.csv,67,24323933.0,22,45,8,14,0,52.791044776119406,230,30,13.985074626865671,8
Category_Wikipedia_sockpuppets_of_Fijiwahwah.csv,484,467667892.0,147,337,97,50,0,49.37396694214876,496,59,14.491735537190083,4
Category_Wikipedia_sockpuppets_of_PeterAmbrosia.csv,363,52437636.0,124,239,38,86,0,49.81267217630854,250,55,25.049586776859503,10
Category_Wikipedia_sockpuppets_of_Neptune's_Trident.csv,1851,49594623.0,592,1259,500,92,0,39.86547811993517,475,78,18.17071853052404,4
Category_Wikipedia_sockpuppets_of_Doratig.csv,926,136350232.0,255,671,163,92,0,48.240820734341256,500,79,19.181425485961125,5
Category_Wikipedia_sockpuppets_of_Ismael_Tarkan.csv,21,15777.0,11,10,6,5,0,22.238095238095237,77,26,16.80952380952381,9
Category_Wikipedia_sockpuppets_of_Harlow1937.csv,6107,74923441.0,2091,4016,500,1591,0,38.38676928115277,254,51,17.178974946782382,5
Category_Wikipedia_sockpuppets_of_Chaps94.csv,28,2052.0,12,16,5,7,0,51.535714285714285,215,25,13.857142857142858,1
Category_Wikipedia_sockpuppets_of_Asiddeamong.csv,7,187345.0,6,1,3,3,4,66.28571428571429,180,68,47.142857142857146,16
Category_Wikipedia_sockpuppets_of_Fishguy7.csv,1673,4049320.0,611,1062,424,187,0,49.09623430962343,255,63,21.479976090854752,3
Category_Wikipedia_sockpuppets_of_Newcrewforu.csv,3023,73722728.0,834,2189,129,705,0,53.24181276877274,231,62,15.01687065828647,2
Category_Wikipedia_sockpuppets_of_U_+_1F4AD.csv,1712,10656819.0,643,1069,350,293,0,39.37149532710281,500,68,27.95502336448598,6
Category_Wikipedia_sockpuppets_of_Catito14.csv,82,257260.0,47,35,34,13,0,45.73170731707317,233,67,37.71951219512195,31
Category_Wikipedia_sockpuppets_of_Sanjiv04.csv,84,57404613.0,29,55,29,0,0,42.55952380952381,139,33,24.226190476190474,14
Category_Wikipedia_sockpuppets_of_Chriskichau.csv,107,27832659.0,33,74,30,3,0,48.93457943925234,220,67,19.7196261682243,3
Category_Wikipedia_sockpuppets_of_Charanjeet_kaur.csv,25,2044486.0,8,17,5,3,0,62.44,254,49,22.68,18
Category_Wikipedia_sockpuppets_of_Borisnefedov.csv,4,63496.0,3,1,3,0,0,31.25,118,16,16.0,16
Category_Wikipedia_sockpuppets_of_Addeditor.csv,48,1984078.0,30,18,29,1,0,45.104166666666664,255,22,12.895833333333334,11
Category_Wikipedia_sockpuppets_of_33ABGirl.csv,2763,15138979.0,997,1766,500,497,0,50.51212450235251,347,79,20.417661961635904,3
Category_Wikipedia_sockpuppets_of_Jonah_Ayers.csv,1275,250031866.0,513,762,324,189,0,38.98117647058824,230,55,19.832156862745098,7
Category_Wikipedia_sockpuppets_of_Booboo_the_dog.csv,237,112315236.0,85,152,70,15,0,41.21097046413502,255,69,28.864978902953588,11
Category_Wikipedia_sockpuppets_of_Kurcyusz.csv,80,1025097.0,22,58,15,7,0,47.675,164,34,21.2625,14
Category_Wikipedia_sockpuppets_of_Hunterfk88.csv,136,14795945.0,47,89,23,24,0,44.86764705882353,204,69,26.294117647058822,8
Category_Wikipedia_sockpuppets_of_Boomslang.csv,1233,569854564.0,500,733,487,13,0,35.76966747769667,356,38,14.575831305758314,6
Category_Wikipedia_sockpuppets_of_Gejoroyce.csv,12,147408.0,7,5,7,0,0,37.25,87,22,14.916666666666666,10
Category_Wikipedia_sockpuppets_of_TRANSPARENT_BRAND.csv,16,105664.0,9,7,9,0,0,5.8125,78,27,27.0,27
Category_Wikipedia_sockpuppets_of_Kelephonestr.csv,251,4529359.0,99,152,58,41,0,45.61752988047809,231,66,18.888446215139442,5
Category_Wikipedia_sockpuppets_of_Samdavis25.csv,20,231730.0,16,4,10,6,28,102.85,259,40,30.65,29
Category_Wikipedia_sockpuppets_of_Pcsampreeth.csv,3,515061.0,3,0,2,1,18,30.0,42,22,15.333333333333334,12
Category_Wikipedia_sockpuppets_of_Gerryh7.csv,498,34345504.0,140,358,60,80,0,37.94979919678715,268,49,16.610441767068274,4
Category_Wikipedia_sockpuppets_of_Ortecmos.csv,25,6914470.0,22,3,15,7,0,51.08,199,31,25.92,13
Category_Wikipedia_sockpuppets_of_Cameliajohn.csv,4,5161258.0,4,0,4,0,28,52.5,85,16,16.0,16
Category_Wikipedia_sockpuppets_of_Ghgfcbhhfcbbh.csv,5,874272.0,3,2,1,2,0,71.6,195,15,15.0,15
Category_Wikipedia_sockpuppets_of_Romancatholickochi.csv,42,8746411.0,31,11,28,3,0,87.97619047619048,501,12,12.0,12
Category_Wikipedia_sockpuppets_of_2ne14ever.csv,1576,49570351.0,388,1188,132,256,0,35.34581218274111,248,45,14.985406091370558,3
Category_Wikipedia_sockpuppets_of_Stopid_bot_thing.csv,17,765.0,6,11,4,2,0,61.88235294117647,321,86,17.235294117647058,12
Category_Wikipedia_sockpuppets_of_MalcolmPrice82.csv,61,233095300.0,17,44,11,6,0,50.78688524590164,209,27,14.540983606557377,8
Category_Wikipedia_sockpuppets_of_Diane_Molly_Handerson.csv,1259,14378491.0,358,901,285,73,0,41.55996822875298,353,52,15.596505162827642,3
Category_Wikipedia_sockpuppets_of_Raikkonen.csv,1206,515896006.0,306,900,187,119,0,50.64593698175788,303,45,15.372305140961858,3
Category_Wikipedia_sockpuppets_of_ZyngFing.csv,11,3496.0,5,6,5,0,0,39.27272727272727,151,23,23.0,23
Category_Wikipedia_sockpuppets_of_Edifix.csv,1172,231838981.0,304,868,222,82,0,52.90955631399317,325,41,12.76023890784983,3
Category_Wikipedia_sockpuppets_of_Mr_strike_my_leg_stop_i_dont_like_fly.csv,2789,497971598.0,799,1990,500,299,0,48.72642524202223,481,62,20.048404446038006,1
Category_Wikipedia_sockpuppets_of_Kole_Drakula.csv,89,1646426.0,34,55,23,11,0,59.550561797752806,207,33,18.202247191011235,5
Category_Wikipedia_sockpuppets_of_Fakultyng.csv,23,32516569.0,12,11,5,7,0,34.91304347826087,149,53,29.304347826086957,11
Category_Wikipedia_sockpuppets_of_NaughtyNuggles.csv,162,32761210.0,54,108,31,23,0,54.46296296296296,500,41,19.339506172839506,7
Category_Wikipedia_sockpuppets_of_Giddyonyx.csv,965,11960109.0,236,729,78,158,0,46.37927461139896,255,73,27.118134715025906,3
Category_Wikipedia_sockpuppets_of_Absolutemetazero.csv,67,1647562.0,23,44,19,4,0,43.298507462686565,200,68,27.880597014925375,14
Category_Wikipedia_sockpuppets_of_Highstakes00.csv,2891,180899938.0,1044,1847,445,599,0,48.799723279142164,255,81,27.59218263576617,3
Category_Wikipedia_sockpuppets_of_Davidoeoples.csv,30,26355.0,16,14,15,1,0,42.56666666666667,210,50,24.8,14
Category_Wikipedia_sockpuppets_of_David.harcus.csv,1,0.0,1,0,1,0,37,37.0,37,22,22.0,22
Category_Wikipedia_sockpuppets_of_Ddxudjjdjd.csv,5,356.0,2,3,2,0,0,58.0,129,25,18.6,9
Category_Wikipedia_sockpuppets_of_LLTSU.csv,1838,79105731.0,612,1226,500,112,0,43.804134929270944,255,79,25.028835690968442,5
Category_Wikipedia_sockpuppets_of_Ourmineteam3.csv,48,426682.0,18,30,12,6,0,76.25,232,22,10.979166666666666,1
Category_Wikipedia_sockpuppets_of_Rosespare.csv,16,409115.0,9,7,8,1,0,60.3125,231,36,25.5,15
Category_Wikipedia_sockpuppets_of_Sveid.csv,6,6070.0,2,4,2,0,0,33.166666666666664,199,17,15.833333333333334,10
Category_Wikipedia_sockpuppets_of_Miracle_dream.csv,2532,146216432.0,614,1918,500,114,0,58.5019747235387,506,51,15.938388625592417,3
Category_Wikipedia_sockpuppets_of_Norbytherobot.csv,669,61658030.0,181,488,172,9,0,58.85052316890882,248,48,17.766816143497756,5
Category_Wikipedia_sockpuppets_of_Bhatdenali.csv,73,108267768.0,32,41,31,1,0,60.04109589041096,198,48,31.698630136986303,20
Category_Wikipedia_sockpuppets_of_Leo_of_Monterrey.csv,1814,12536700.0,513,1301,390,123,0,44.498897464167584,496,63,22.35005512679162,5
Category_Wikipedia_sockpuppets_of_DogHopper.csv,14,2547.0,11,3,8,3,0,38.857142857142854,139,19,12.0,11
Category_Wikipedia_sockpuppets_of_Tara_Eckersberg.csv,2892,366112777.0,934,1958,500,434,0,35.89764868603043,349,56,20.162517289073307,3
Category_Wikipedia_sockpuppets_of_Baywalker4.csv,81,65520775.0,29,52,14,15,0,53.851851851851855,252,46,21.074074074074073,5
Category_Wikipedia_sockpuppets_of_Motbag12.csv,1528,16380425.0,461,1067,319,142,0,62.681937172774866,255,52,20.452225130890053,5
Category_Wikipedia_sockpuppets_of_Singhpranjal00.csv,89,283457282.0,28,61,28,0,0,50.842696629213485,196,48,35.19101123595506,19
Category_Wikipedia_sockpuppets_of_Ramiericson.csv,623,297633362.0,193,430,175,18,0,62.791332263242374,495,41,19.513643659711075,4
Category_Wikipedia_sockpuppets_of_David_Eribe.csv,1003,17885864.0,324,679,134,190,0,45.467597208374876,349,62,19.834496510468593,3
Category_Wikipedia_sockpuppets_of_JeffCFreelance.csv,16,312087.0,8,8,4,4,0,71.75,161,24,20.8125,18
Category_Wikipedia_sockpuppets_of_MansonT.csv,181,47020913.0,50,131,31,19,0,53.790055248618785,211,26,14.988950276243093,9
Category_Wikipedia_sockpuppets_of_Mewtwowimmer.csv,2381,375758544.0,578,1803,500,78,0,34.44729105417892,309,61,20.474590508189838,3
Category_Wikipedia_sockpuppets_of_Sergeant_General_Ghostbuster.csv,696,7868202.0,207,489,150,57,0,40.76005747126437,490,50,20.879310344827587,4
Category_Wikipedia_sockpuppets_of_Panzyhunter79.csv,30,6059225.0,10,20,6,4,0,49.03333333333333,214,44,21.866666666666667,11
Category_Wikipedia_sockpuppets_of_Pope_Benjamin_Lister.csv,172,26932989.0,47,125,15,32,0,55.43023255813954,199,60,28.21511627906977,15
Category_Wikipedia_sockpuppets_of_4ecerbrooke.csv,32,2198386.0,10,22,10,0,0,61.03125,497,19,13.5,11
Category_Wikipedia_sockpuppets_of_Hamburger29.csv,7,1097965.0,5,2,4,1,30,67.28571428571429,173,21,15.571428571428571,12
Category_Wikipedia_sockpuppets_of_Chaedarling.csv,13,9022.0,11,2,5,6,13,37.0,247,8,8.0,8
Category_Wikipedia_sockpuppets_of_Einstein_the_afrodude.csv,179,48582828.0,38,141,38,0,0,33.69832402234637,199,54,23.28491620111732,9
Category_Wikipedia_sockpuppets_of_Torchsmarf.csv,22,365560.0,18,4,9,9,0,22.045454545454547,195,16,16.0,16
Category_Wikipedia_sockpuppets_of_SpicyBiryani.csv,1387,111099542.0,350,1037,158,192,0,57.237923576063444,496,72,25.541456380677722,1
Category_Wikipedia_sockpuppets_of_Hans_Franssen.csv,490,5777144.0,208,282,102,106,0,52.83265306122449,255,59,24.73061224489796,7
Category_Wikipedia_sockpuppets_of_KiwiMan.csv,45,105851.0,24,21,15,9,0,70.08888888888889,205,56,33.355555555555554,10
Category_Wikipedia_sockpuppets_of_Brutal_Brains.csv,32,355607.0,18,14,14,4,0,37.53125,318,24,18.46875,13
Category_Wikipedia_sockpuppets_of_XEUXL.csv,425,22814809.0,142,283,90,52,0,41.73882352941177,394,39,15.858823529411765,5
Category_Wikipedia_sockpuppets_of_Terahbytes.csv,1861,44487266.0,621,1240,500,121,0,42.04083825900054,344,66,25.13863514239656,4
Category_Wikipedia_sockpuppets_of_Hogeye.csv,3444,503378818.0,1041,2403,500,541,0,51.46341463414634,375,57,18.524680603948898,5
Category_Wikipedia_sockpuppets_of_Nutrition_&_health.csv,5,24006.0,2,3,1,1,12,68.2,148,16,14.2,13
Category_Wikipedia_sockpuppets_of_Denidacks.csv,29,10371230.0,6,23,3,3,0,33.96551724137931,173,19,12.931034482758621,5
Category_Wikipedia_sockpuppets_of_SaltandPepper2014.csv,3,17576.0,2,1,1,1,0,97.33333333333333,167,15,15.0,15
Category_Wikipedia_sockpuppets_of_Wonnydude.csv,21,95994361.0,5,16,2,3,0,62.714285714285715,233,63,34.285714285714285,13
Category_Wikipedia_sockpuppets_of_Aqzswxdecfrvgtb.csv,80,7674148.0,28,52,24,4,0,58.4375,405,54,29.5125,18
Category_Wikipedia_sockpuppets_of_RandomMinecraftMan.csv,185,9408.0,60,125,59,1,0,56.33513513513513,262,34,17.83783783783784,5
Category_Wikipedia_sockpuppets_of_Phendag.csv,4,510.0,3,1,3,0,7,62.75,230,70,67.75,61
Category_Wikipedia_sockpuppets_of_Gire_3pich2005.csv,5036,271985545.0,1421,3615,500,921,0,41.34531374106434,345,76,23.05321683876092,3
Category_Wikipedia_sockpuppets_of_Mike_willaims.csv,109,71805946.0,28,81,26,2,0,47.678899082568805,250,30,16.293577981651374,5
Category_Wikipedia_sockpuppets_of_Germudo_1.csv,1998,101343436.0,566,1432,500,66,0,97.41991991991992,514,74,18.51001001001001,4
Category_Wikipedia_sockpuppets_of_Tim.1944.Au.csv,173,34954298.0,62,111,52,10,0,36.63583815028902,296,41,19.716763005780347,8
Category_Wikipedia_sockpuppets_of_Jacobkoshy333.csv,101,14869889.0,40,61,30,10,0,44.46534653465346,215,43,16.871287128712872,5
Category_Wikipedia_sockpuppets_of_Jonathansamuel.csv,3993,52927307.0,1399,2594,500,899,0,43.97420485850238,255,56,18.125970448284498,5
Category_Wikipedia_sockpuppets_of_Sollewitt.csv,185,152843025.0,60,125,22,38,0,48.027027027027025,255,26,13.654054054054054,9
Category_Wikipedia_sockpuppets_of_Shabihabbas110.csv,102,56103879.0,36,66,25,11,0,49.549019607843135,228,25,9.27450980392157,6
Category_Wikipedia_sockpuppets_of_Tinpac.csv,17343,32576465.0,4257,13086,311,3946,0,47.586519056679926,255,87,19.160179899671338,3
Category_Wikipedia_sockpuppets_of_Ythewait.csv,2,2407568.0,2,0,1,1,14,53.5,93,21,18.5,16
Category_Wikipedia_sockpuppets_of_BiNA.csv,195,116757795.0,112,83,70,42,0,44.194871794871794,254,70,22.682051282051283,3
Category_Wikipedia_sockpuppets_of_Incogreader.csv,971,11588175.0,291,680,240,51,0,57.582904222451084,499,80,28.716786817713697,9
Category_Wikipedia_sockpuppets_of_TimSala.csv,3709,145064602.0,1613,2096,500,1113,0,41.90078188190887,255,44,22.44755998921542,8
Category_Wikipedia_sockpuppets_of_Ceauntay13.csv,245,1350903.0,77,168,73,4,0,28.179591836734694,204,47,20.816326530612244,7
Category_Wikipedia_sockpuppets_of_Henrytoxteth15.csv,77,5351374.0,24,53,18,6,0,50.22077922077922,284,46,15.766233766233766,6
Category_Wikipedia_sockpuppets_of_Jiggamafu.csv,382,54076704.0,156,226,118,38,0,44.90837696335078,255,65,16.426701570680628,7
Category_Wikipedia_sockpuppets_of_Optim.usprime.csv,143,5827031.0,55,88,37,18,0,49.78321678321678,211,50,21.06993006993007,13
Category_Wikipedia_sockpuppets_of_DrStrauss.csv,2623,3219296.0,828,1795,500,328,0,73.40259245139154,255,84,22.489897064430043,2
Category_Wikipedia_sockpuppets_of_Baseball_Fanatic.csv,2286,22847940.0,764,1522,486,278,0,36.231408573928256,250,70,22.092300962379703,3
Category_Wikipedia_sockpuppets_of_Musical_mosaic.csv,56,5491.0,16,40,16,0,0,37.857142857142854,232,59,24.5,6
Category_Wikipedia_sockpuppets_of_Zorouster.csv,5,316.0,3,2,3,0,0,45.4,82,19,18.2,17
Category_Wikipedia_sockpuppets_of_LastBreath64.csv,18047,136452566.0,6000,12047,500,5500,0,47.55222474649526,510,82,16.894830165678506,4
Category_Wikipedia_sockpuppets_of_BoxWriter.csv,412,16987243.0,122,290,113,9,0,40.70873786407767,350,60,19.881067961165048,3
Category_Wikipedia_sockpuppets_of_School_Cleeve.csv,20,5089.0,12,8,9,3,0,55.25,191,13,13.0,13
Category_Wikipedia_sockpuppets_of_Kevinasp.csv,1737,182021045.0,543,1194,500,43,0,40.90961427748992,417,67,18.99769717904433,6
Category_Wikipedia_sockpuppets_of_Pritampandey.csv,57,31947579.0,25,32,24,1,0,41.98245614035088,196,53,32.05263157894737,10
Category_Wikipedia_sockpuppets_of_Alirezakiarashi.csv,146,77579581.0,38,108,16,22,0,45.821917808219176,298,25,16.171232876712327,5
Category_Wikipedia_sockpuppets_of_Akshay_Reddy.csv,19,724189.0,7,12,5,2,0,52.78947368421053,226,60,50.68421052631579,11
Category_Wikipedia_sockpuppets_of_Megan_Parry.csv,13,140137.0,7,6,6,1,0,64.0,206,16,12.307692307692308,4
Category_Wikipedia_sockpuppets_of_RaiKashish.csv,206,39119297.0,48,158,36,12,0,57.44660194174757,376,53,13.674757281553399,4
Category_Wikipedia_sockpuppets_of_-Inanna-.csv,2743,36208099.0,1000,1743,500,500,0,23.320452059788554,230,52,16.591323368574553,3
Category_Wikipedia_sockpuppets_of_Souri_Sachin_Senapati_odisha.csv,13,75419694.0,5,8,3,2,0,36.0,82,33,27.46153846153846,23
Category_Wikipedia_sockpuppets_of_Powerline_And_Knife_Guy.csv,12,180.0,5,7,5,0,0,69.33333333333333,186,33,25.5,12
Category_Wikipedia_sockpuppets_of_Oldwindybear.csv,2966,19862417.0,1023,1943,500,523,0,36.339851652056645,209,102,23.02124072825354,7
Category_Wikipedia_sockpuppets_of_CarrotJuice101.csv,162,707379.0,70,92,46,24,0,60.5,500,37,17.932098765432098,9
Category_Wikipedia_sockpuppets_of_Dao2k.csv,1099,60060631.0,347,752,122,225,0,45.197452229299365,255,55,13.62147406733394,3
Category_Wikipedia_sockpuppets_of_The_Almighty_King.csv,2104,418360323.0,536,1568,500,36,0,48.672528517110266,436,90,27.02851711026616,5
Category_Wikipedia_sockpuppets_of_Blueberry_Aardvark.csv,9,152017.0,6,3,4,2,0,74.44444444444444,158,27,16.333333333333332,12
Category_Wikipedia_sockpuppets_of_Pulpfiction621.csv,3463,18389978.0,1000,2463,500,500,0,62.1741264799307,507,56,17.5258446433728,4
Category_Wikipedia_sockpuppets_of_Physo172.csv,3172,126595688.0,1096,2076,500,596,0,37.12232030264817,500,50,19.372635561160152,4
Category_Wikipedia_sockpuppets_of_Ratinator.csv,2340,11296484.0,791,1549,402,389,0,44.0491452991453,253,102,22.244871794871795,4
Category_Wikipedia_sockpuppets_of_Nrswanson.csv,2813,17838094.0,1155,1658,500,655,0,38.040881621045145,250,110,26.45183078563811,4
Category_Wikipedia_sockpuppets_of_Wiki_watchdog.csv,63,369930.0,26,37,6,20,0,29.22222222222222,196,56,25.095238095238095,7
Category_Wikipedia_sockpuppets_of_Smcgee19.csv,26,1042094.0,16,10,7,9,0,34.65384615384615,129,13,11.76923076923077,8
Category_Wikipedia_sockpuppets_of_Familyleave.csv,315,24136635.0,145,170,122,23,0,49.10793650793651,494,31,11.311111111111112,6
Category_Wikipedia_sockpuppets_of_NIM562.csv,60,1209967.0,23,37,17,6,0,47.38333333333333,196,45,20.2,9
Category_Wikipedia_sockpuppets_of_Andr√©sSnape.csv,232,2860679.0,92,140,45,47,0,35.01293103448276,237,47,22.564655172413794,3
Category_Wikipedia_sockpuppets_of_Adelebahmani.csv,94,10013778.0,42,52,26,16,0,46.638297872340424,193,42,19.78723404255319,13
Category_Wikipedia_sockpuppets_of_Atlantic_Ranter_9705.csv,797,40253315.0,218,579,197,21,0,50.60853199498118,495,55,21.43914680050188,3
Category_Wikipedia_sockpuppets_of_Thejailfallsday.csv,42,1484460.0,15,27,12,3,0,61.666666666666664,318,35,27.714285714285715,14
Category_Wikipedia_sockpuppets_of_Stringymail.csv,11,10108.0,10,1,10,0,0,7.181818181818182,28,18,18.0,18
Category_Wikipedia_sockpuppets_of_AccountNotMoved.csv,48,1394561.0,21,27,11,10,0,62.625,227,45,15.25,3
Category_Wikipedia_sockpuppets_of_Akash207.csv,160,230831831.0,46,114,41,5,0,46.175,205,47,19.925,5
Category_Wikipedia_sockpuppets_of_Httpvdm.csv,4,9345.0,4,0,1,3,79,79.0,79,25,24.75,24
Category_Wikipedia_sockpuppets_of_ViBODY.csv,87,10876737.0,48,39,37,11,0,49.11494252873563,255,44,18.919540229885058,14
Category_Wikipedia_sockpuppets_of_CORECAP.csv,49,27886761.0,45,4,32,13,0,13.306122448979592,199,20,17.93877551020408,17
Category_Wikipedia_sockpuppets_of_QayamHadi.csv,33,2004837.0,17,16,16,1,0,40.81818181818182,255,43,22.0,12
Category_Wikipedia_sockpuppets_of_Kavex98162.csv,2872,101150865.0,1036,1836,500,536,0,44.19742339832869,496,93,24.08008356545961,3
Category_Wikipedia_sockpuppets_of_Apeexterminator.csv,6419,224683844.0,2352,4067,333,2019,0,38.42452095341954,451,54,15.116061691852314,4
Category_Wikipedia_sockpuppets_of_BethA1.csv,9,176924.0,3,6,2,1,24,131.22222222222223,207,16,14.222222222222221,14
Category_Wikipedia_sockpuppets_of_Zonerocks.csv,1289,8147473.0,513,776,500,13,0,31.22265321955004,200,72,24.12567882079131,4
Category_Wikipedia_sockpuppets_of_PogiJmon.csv,2424,48698730.0,992,1432,500,492,0,37.632013201320134,249,69,18.918729372937293,4
Category_Wikipedia_sockpuppets_of_Loveandpeacemaker.csv,50,1830183.0,22,28,14,8,0,48.74,192,29,16.18,8
Category_Wikipedia_sockpuppets_of_Uthay6505.csv,232,17635364.0,98,134,61,37,0,45.689655172413794,216,45,18.353448275862068,8
Category_Wikipedia_sockpuppets_of_MrKingDomIdiot.csv,985,3016537.0,363,622,323,40,0,33.780710659898475,477,34,16.46802030456853,4
Category_Wikipedia_sockpuppets_of_SkyKingRSA.csv,57,4151907.0,22,35,13,9,0,96.10526315789474,377,38,22.017543859649123,9
Category_Wikipedia_sockpuppets_of_P√©_de_Chinelo.csv,2863,120513888.0,859,2004,226,633,0,47.63045756199791,250,57,20.5148445686343,4
Category_Wikipedia_sockpuppets_of_Karabakhazerbaycandir.csv,304,11648669.0,88,216,67,21,0,49.17763157894737,478,50,20.61842105263158,7
Category_Wikipedia_sockpuppets_of_Lauraface32.csv,964,61264627.0,301,663,146,155,0,46.22821576763486,255,51,20.202282157676347,4
Category_Wikipedia_sockpuppets_of_Sochima12.csv,49,9191979.0,21,28,11,10,0,53.63265306122449,204,24,15.918367346938776,9
Category_Wikipedia_sockpuppets_of_Md_editor.csv,40,30445417.0,17,23,13,4,0,35.775,193,33,20.975,5
Category_Wikipedia_sockpuppets_of_Solidem.csv,91,911503.0,29,62,26,3,0,44.18681318681319,302,41,20.0,7
Category_Wikipedia_sockpuppets_of_Tricarewest.csv,30,27702724.0,6,24,4,2,0,70.2,271,33,17.8,8
Category_Wikipedia_sockpuppets_of_Fixer88.csv,1390,266512556.0,601,789,500,101,0,38.08561151079137,498,66,23.542446043165466,4
Category_Wikipedia_sockpuppets_of_WrestlingManFan.csv,156,450847.0,59,97,23,36,0,30.30128205128205,228,30,18.0,9
Category_Wikipedia_sockpuppets_of_Nuttawat.csv,290,13207573.0,142,148,119,23,0,34.13103448275862,196,37,16.96206896551724,9
Category_Wikipedia_sockpuppets_of_Fenopy1.csv,231,2068529.0,61,170,16,45,0,45.935064935064936,238,27,15.93939393939394,2
Category_Wikipedia_sockpuppets_of_Jewelakhter.csv,573,182226529.0,153,420,34,119,0,43.539267015706805,254,61,16.465968586387433,4
Category_Wikipedia_sockpuppets_of_Mr._Blackout.csv,165,1067119.0,39,126,20,19,0,42.872727272727275,186,36,13.096969696969698,3
Category_Wikipedia_sockpuppets_of_Xaviertan.csv,240,38943453.0,87,153,40,47,0,39.02916666666667,212,27,15.079166666666667,7
Category_Wikipedia_sockpuppets_of_Jschauhan.csv,2872,156044296.0,1011,1861,500,511,0,39.396239554317546,255,64,15.319637883008356,4
Category_Wikipedia_sockpuppets_of_Iwanafish.csv,1230,62290330.0,500,730,500,0,0,30.3,243,74,14.765853658536585,4
Category_Wikipedia_sockpuppets_of_Maidenofirony.csv,28,97545.0,8,20,7,1,0,52.107142857142854,122,23,18.535714285714285,18
Category_Wikipedia_sockpuppets_of_ENT_70.csv,357,8629503.0,159,198,108,51,0,40.68347338935574,219,47,19.610644257703083,8
Category_Wikipedia_sockpuppets_of_DM1998.csv,1,0.0,1,0,1,0,26,26.0,26,16,16.0,16
Category_Wikipedia_sockpuppets_of_Kidknapping1234.csv,34,942.0,10,24,7,3,0,69.41176470588235,243,36,21.264705882352942,12
Category_Wikipedia_sockpuppets_of_YanT121.csv,604,80596634.0,160,444,55,105,0,56.69701986754967,481,50,17.948675496688743,4
Category_Wikipedia_sockpuppets_of_Stinging_P.csv,628,8521683.0,174,454,108,66,0,35.43789808917197,201,80,24.796178343949045,2
Category_Wikipedia_sockpuppets_of_Farhan_RR_Official.csv,297,4055806.0,77,220,44,33,0,61.31649831649832,255,57,22.22222222222222,4
Category_Wikipedia_sockpuppets_of_Akashpashine.csv,52,1379542.0,16,36,16,0,0,52.48076923076923,196,25,19.423076923076923,16
Category_Wikipedia_sockpuppets_of_Sachinbhat.csv,8,6909055.0,7,1,6,1,0,17.0,51,26,22.25,15
Category_Wikipedia_sockpuppets_of_FilipinoGuy0995.csv,664,32926519.0,308,356,247,61,0,95.80271084337349,496,61,17.81024096385542,3
Category_Wikipedia_sockpuppets_of_Taricksalmaci.csv,272,248152345.0,113,159,71,42,0,40.75367647058823,494,35,18.834558823529413,14
Category_Wikipedia_sockpuppets_of_Michaeldrayson.csv,566,24864136.0,134,432,107,27,0,36.706713780918726,209,34,14.360424028268552,3
Category_Wikipedia_sockpuppets_of_Doreamon1969.csv,32,4713791.0,21,11,13,8,0,56.1875,187,22,11.625,4
Category_Wikipedia_sockpuppets_of_Incorrigible_Troll.csv,3457,201807303.0,1703,1754,500,1203,0,38.174428695400636,392,102,27.146080416546138,6
Category_Wikipedia_sockpuppets_of_CalabazaF√©nix2.csv,772,31433458.0,294,478,63,231,0,37.95077720207254,279,53,18.22538860103627,7
Category_Wikipedia_sockpuppets_of_Congopro.csv,193,26312259.0,75,118,40,35,0,45.10880829015544,298,53,28.518134715025905,13
Category_Wikipedia_sockpuppets_of_Wwe90000000.csv,162,7514436.0,46,116,43,3,0,49.364197530864196,252,40,15.962962962962964,3
Category_Wikipedia_sockpuppets_of_Wicoso2345.csv,292,250009393.0,70,222,45,25,0,48.70205479452055,300,61,14.732876712328768,6
Category_Wikipedia_sockpuppets_of_Vamsiraj.csv,4716,26966713.0,2249,2467,500,1749,0,28.67663273960984,255,69,19.029686174724343,4
Category_Wikipedia_sockpuppets_of_Zhomron.csv,1968,7754561.0,539,1429,500,39,0,63.78150406504065,416,47,14.846544715447154,3
Category_Wikipedia_sockpuppets_of_Rtt11.csv,608,14327924.0,265,343,262,3,0,43.067434210526315,255,65,23.94407894736842,10
Category_Wikipedia_sockpuppets_of_Peter39c.csv,1340,6622993.0,573,767,500,73,0,35.46044776119403,500,70,22.576119402985075,5
Category_Wikipedia_sockpuppets_of_ThelemaSanskrit93.csv,106,38378658.0,29,77,24,5,0,37.54716981132076,178,72,20.62264150943396,4
Category_Wikipedia_sockpuppets_of_AzraFredericks.csv,115,53897669.0,51,64,32,19,0,65.73913043478261,238,38,17.88695652173913,8
Category_Wikipedia_sockpuppets_of_Jellydude7.csv,140,88573322.0,44,96,36,8,0,44.135714285714286,206,39,17.214285714285715,9
Category_Wikipedia_sockpuppets_of_EPIC_MASTER.csv,278,6739682.0,88,190,58,30,0,35.8705035971223,215,42,20.996402877697843,4
Category_Wikipedia_sockpuppets_of_Hsinchong.csv,1160,219676555.0,275,885,111,164,0,41.31551724137931,317,51,24.764655172413793,6
Category_Wikipedia_sockpuppets_of_Al_aman_kollam.csv,1125,9125758.0,355,770,267,88,0,48.65777777777778,438,67,21.150222222222222,5
Category_Wikipedia_sockpuppets_of_Trend7773.csv,294,2549761.0,100,194,34,66,0,50.89115646258504,255,46,18.20408163265306,6
Category_Wikipedia_sockpuppets_of_Kdetoi.csv,58,2442801.0,47,11,47,0,0,16.362068965517242,196,14,13.89655172413793,11
Category_Wikipedia_sockpuppets_of_VGNMarketing.csv,31,1299326.0,13,18,9,4,0,57.096774193548384,150,30,20.06451612903226,16
Category_Wikipedia_sockpuppets_of_Cmglitxh35.csv,37,116053.0,14,23,9,5,0,65.8108108108108,206,30,12.945945945945946,3
Category_Wikipedia_sockpuppets_of_Thesideliner2014.csv,95,108261655.0,30,65,15,15,0,54.37894736842105,211,64,23.126315789473683,13
Category_Wikipedia_sockpuppets_of_Culturalresearch.csv,1023,62718391.0,289,734,270,19,0,63.67350928641251,255,139,17.363636363636363,5
Category_Wikipedia_sockpuppets_of_Thegameshowlad.csv,2029,30326170.0,722,1307,300,422,0,47.98324297683588,426,74,24.754558896007886,4
Category_Wikipedia_sockpuppets_of_Doprowik.csv,94,5185707.0,49,45,10,39,0,61.755319148936174,422,52,35.797872340425535,19
Category_Wikipedia_sockpuppets_of_Poliacct0111.csv,32,3391160.0,17,15,11,6,0,50.75,226,48,27.25,3
Category_Wikipedia_sockpuppets_of_MagicKirin.csv,1834,513534305.0,462,1372,126,336,0,48.56979280261723,359,57,17.130861504907305,3
Category_Wikipedia_sockpuppets_of_Therazzors.csv,1166,27977549.0,390,776,183,207,0,59.00514579759863,453,54,16.019725557461406,7
Category_Wikipedia_sockpuppets_of_Zmaher.csv,2208,121482052.0,804,1404,500,304,0,34.796195652173914,255,48,22.274003623188406,4
Category_Wikipedia_sockpuppets_of_Askari_Haider_Haideri.csv,26,4588.0,6,20,4,2,8,90.11538461538461,311,17,11.76923076923077,7
Category_Wikipedia_sockpuppets_of_Mayfirstdenver.csv,3,3458.0,2,1,1,1,33,91.66666666666667,203,15,13.666666666666666,11
Category_Wikipedia_sockpuppets_of_Quinn20003.csv,39,90543.0,25,14,25,0,0,31.41025641025641,199,23,18.923076923076923,18
Category_Wikipedia_sockpuppets_of_Alpha_Monarch.csv,1946,42128906.0,580,1366,500,80,0,72.13206577595066,257,60,19.922918807810895,3
Category_Wikipedia_sockpuppets_of_Lilith2321.csv,16,95682.0,12,4,6,6,0,15.375,87,23,16.5,4
Category_Wikipedia_sockpuppets_of_AoG_The_One_Ture_Church.csv,100,137692.0,43,57,26,17,0,41.95,183,40,22.8,12
Category_Wikipedia_sockpuppets_of_Justin_The_Osmosis_Jones_Fan.csv,600,71751237.0,120,480,73,47,0,48.42333333333333,382,41,17.993333333333332,8
Category_Wikipedia_sockpuppets_of_Bazaira.csv,1578,58535333.0,776,802,500,276,0,34.93979721166033,253,87,29.076045627376427,6
Category_Wikipedia_sockpuppets_of_JulesElise.csv,174,22631422.0,63,111,32,31,0,55.0,230,46,17.5,14
Category_Wikipedia_sockpuppets_of_RossellaBlinded.csv,13,732222.0,7,6,2,5,0,55.0,123,48,48.0,48
Category_Wikipedia_sockpuppets_of_Cheralaathan.csv,279,2018516.0,116,163,92,24,0,37.32258064516129,300,45,41.59498207885304,6
Category_Wikipedia_sockpuppets_of_Snowycake.csv,701,31300601.0,250,451,131,119,0,49.646219686162624,496,74,31.38373751783167,5
Category_Wikipedia_sockpuppets_of_Shaiksuhana2.csv,3595,50131439.0,1200,2395,500,700,0,50.76550764951321,496,87,17.67538247566064,3
Category_Wikipedia_sockpuppets_of_SuhailShaji786.csv,209,35132387.0,71,138,28,43,0,57.110047846889955,496,37,15.110047846889952,6
Category_Wikipedia_sockpuppets_of_Tom_Sayle.csv,7143,505529823.0,2596,4547,500,2096,0,45.80386392272155,500,128,22.049839003219937,3
Category_Wikipedia_sockpuppets_of_Culverin.csv,1676,49134849.0,510,1166,500,10,0,32.451670644391406,242,82,22.350238663484486,3
Category_Wikipedia_sockpuppets_of_Bastista1.csv,1745,22174278.0,700,1045,500,200,0,35.17765042979943,252,56,21.373065902578798,3
Category_Wikipedia_sockpuppets_of_FWKTZS.csv,33,7049040.0,17,16,8,9,0,44.09090909090909,275,39,18.484848484848484,13
Category_Wikipedia_sockpuppets_of_Banana_Fingers.csv,3413,160114424.0,1060,2353,500,560,0,40.943158511573394,260,74,26.51274538529153,8
Category_Wikipedia_sockpuppets_of_Tahrz.csv,19,4560612.0,15,4,13,2,0,11.631578947368421,43,13,13.0,13
Category_Wikipedia_sockpuppets_of_Jeremy_Gilley.csv,34,647294.0,19,15,14,5,0,22.176470588235293,116,13,12.117647058823529,8
Category_Wikipedia_sockpuppets_of_Truthwillneverdie.csv,609,13168931.0,174,435,174,0,0,55.06568144499179,255,50,16.545155993431855,5
Category_Wikipedia_sockpuppets_of_Cal_505.csv,4859,21495800.0,1603,3256,500,1103,0,36.12842148590245,255,82,18.957810249022433,4
Category_Wikipedia_sockpuppets_of_SpencerCollins213447.csv,263,38789213.0,81,182,71,10,0,56.4828897338403,284,57,28.52851711026616,11
Category_Wikipedia_sockpuppets_of_Undertale_theme_song.csv,25,4147210.0,7,18,2,5,0,85.24,214,29,23.64,19
Category_Wikipedia_sockpuppets_of_Imogenashworth11.csv,5,17801.0,3,2,3,0,0,70.4,199,10,10.0,10
Category_Wikipedia_sockpuppets_of_Aquarius2.csv,279,18615622.0,97,182,34,63,0,34.086021505376344,233,44,27.42293906810036,10
Category_Wikipedia_sockpuppets_of_4ubusybodies.csv,48,2831546.0,33,15,7,26,0,70.20833333333333,183,37,27.4375,23
Category_Wikipedia_sockpuppets_of_RhodesAvenue.csv,3289,208096221.0,1226,2063,500,726,0,40.24901185770751,500,63,28.666463970811797,4
Category_Wikipedia_sockpuppets_of_Arnold_In_The_Shadows.csv,456,423706.0,135,321,39,96,0,83.68859649122807,255,61,20.032894736842106,4
Category_Wikipedia_sockpuppets_of_2stopwhispering.csv,363,2500858.0,103,260,95,8,0,42.14325068870524,247,63,17.977961432506888,5
Category_Wikipedia_sockpuppets_of_Ashutosh1010.csv,60,22235790.0,20,40,17,3,0,59.666666666666664,237,44,23.7,10
Category_Wikipedia_sockpuppets_of_GandalfdaWhite.csv,56,16467.0,24,32,7,17,0,37.535714285714285,184,35,14.428571428571429,7
Category_Wikipedia_sockpuppets_of_NegroBarney.csv,35,2975916.0,9,26,9,0,0,67.45714285714286,214,37,19.771428571428572,13
Category_Wikipedia_sockpuppets_of_Screwjack1981.csv,291,208376120.0,130,161,88,42,0,61.13058419243986,221,27,20.350515463917525,16
Category_Wikipedia_sockpuppets_of_Emilygreen2.csv,21,1124681.0,5,16,3,2,0,10.952380952380953,142,6,6.0,6
Category_Wikipedia_sockpuppets_of_Jonaldo_Smith.csv,174,16038748.0,38,136,29,9,0,42.52873563218391,254,36,17.04022988505747,3
Category_Wikipedia_sockpuppets_of_Johnali123.csv,571,20933020.0,174,397,137,37,0,53.49036777583187,250,39,26.373029772329247,9
Category_Wikipedia_sockpuppets_of_Smile_Lee.csv,1840,56826113.0,765,1075,500,265,0,43.055978260869566,255,67,23.20978260869565,3
Category_Wikipedia_sockpuppets_of_Lajanpour.csv,493,73097061.0,171,322,50,121,0,39.47464503042596,259,32,11.070993914807302,4
Category_Wikipedia_sockpuppets_of_MohammedEguyue25.csv,98,47466795.0,22,76,12,10,0,111.03061224489795,497,40,19.551020408163264,17
Category_Wikipedia_sockpuppets_of_Priyankamalhotra23.csv,17,1115522.0,6,11,4,2,10,94.52941176470588,215,52,22.470588235294116,7
Category_Wikipedia_sockpuppets_of_Dany_Hays.csv,84,2309121.0,35,49,14,21,0,25.952380952380953,166,39,26.357142857142858,19
Category_Wikipedia_sockpuppets_of_Virenderthind2019.csv,1039,22255961.0,500,539,500,0,0,37.750721847930706,385,63,18.411934552454284,4
Category_Wikipedia_sockpuppets_of_AustralianThreston.csv,121,1760753.0,47,74,19,28,0,43.3801652892562,194,47,27.59504132231405,13
Category_Wikipedia_sockpuppets_of_Lia_Palavandishvili.csv,105,198191180.0,43,62,33,10,0,76.26666666666667,470,84,30.066666666666666,14
Category_Wikipedia_sockpuppets_of_Mitrebox.csv,8947,18228222.0,2561,6386,500,2061,0,45.567005700234716,240,118,24.52419805521404,3
Category_Wikipedia_sockpuppets_of_Juantheman96.csv,4052,209527776.0,827,3225,486,341,0,50.436327739387956,491,69,20.70903257650543,3
Category_Wikipedia_sockpuppets_of_TylerKutschbach.csv,7567,90534274.0,1982,5585,500,1482,0,52.369763446544205,498,81,26.349147614642526,6
Category_Wikipedia_sockpuppets_of_Disneylandlover2006.csv,1398,2147331.0,515,883,500,15,0,40.71316165951359,253,53,23.929184549356222,8
Category_Wikipedia_sockpuppets_of_Dhidalgo.csv,2288,277600480.0,523,1765,500,23,0,45.82648601398601,434,64,19.66346153846154,2
Category_Wikipedia_sockpuppets_of_Great_Circassian.csv,154,703185.0,96,58,50,46,0,56.34415584415584,496,61,32.41558441558441,11
Category_Wikipedia_sockpuppets_of_Semlow.csv,313,2360302.0,110,203,29,81,0,32.18210862619808,196,45,14.258785942492013,6
Category_Wikipedia_sockpuppets_of_Patrick_L._Stephen.csv,317,16625887.0,95,222,50,45,0,52.457413249211356,325,39,24.19558359621451,7
Category_Wikipedia_sockpuppets_of_Rrtttq.csv,539,65800119.0,217,322,62,155,0,44.98886827458256,459,56,27.11873840445269,12
Category_Wikipedia_sockpuppets_of_Mar3ini.csv,690,519834934.0,204,486,155,49,0,44.58840579710145,496,49,18.372463768115942,4
Category_Wikipedia_sockpuppets_of_Rossdegenstein.csv,2024,451446784.0,510,1514,500,10,0,50.258399209486164,293,45,21.432312252964426,8
Category_Wikipedia_sockpuppets_of_Gillweed1995.csv,79,2333046.0,55,24,33,22,0,41.139240506329116,223,22,16.670886075949365,9
Category_Wikipedia_sockpuppets_of_Asgarinamdar.csv,52,26348402.0,26,26,22,4,0,36.17307692307692,196,22,16.307692307692307,8
Category_Wikipedia_sockpuppets_of_EnduranceRace.csv,332,41173442.0,119,213,100,19,0,58.26807228915663,200,24,17.551204819277107,5
Category_Wikipedia_sockpuppets_of_Adrianpaolobugarin.csv,891,20047183.0,293,598,285,8,0,38.38945005611672,234,53,26.306397306397308,4
Category_Wikipedia_sockpuppets_of_Lasha563.csv,128,30281043.0,51,77,51,0,0,45.09375,434,41,25.671875,15
Category_Wikipedia_sockpuppets_of_Xxishyxx.csv,7,8807.0,2,5,1,1,0,23.0,91,25,18.142857142857142,17
Category_Wikipedia_sockpuppets_of_Penyulap.csv,1523,278348492.0,537,986,500,37,0,49.26986211424819,485,89,27.312541037426133,12
Category_Wikipedia_sockpuppets_of_IamMNG.csv,101,245159.0,31,70,15,16,0,48.54455445544554,204,52,15.673267326732674,3
Category_Wikipedia_sockpuppets_of_HumphreyScottXavier.csv,7,91312.0,5,2,3,2,12,39.42857142857143,121,23,16.142857142857142,7
Category_Wikipedia_sockpuppets_of_NTHacked.csv,29,320004319.0,12,17,9,3,0,28.344827586206897,134,53,21.20689655172414,6
Category_Wikipedia_sockpuppets_of_AdamTayl.csv,1082,31453349.0,512,570,214,298,0,38.51940850277264,255,62,20.526802218114604,8
Category_Wikipedia_sockpuppets_of_Pray2win.csv,46,767779.0,33,13,26,7,0,19.91304347826087,121,19,14.891304347826088,13
Category_Wikipedia_sockpuppets_of_Nintendoman01.csv,2271,22788117.0,589,1682,500,89,0,39.128137384412156,249,59,20.007485689123733,4
Category_Wikipedia_sockpuppets_of_Cloudentry1992.csv,43,586492.0,16,27,13,3,0,46.48837209302326,191,56,37.04651162790697,11
Category_Wikipedia_sockpuppets_of_Moshej.csv,42,4089583.0,15,27,11,4,0,69.42857142857143,250,33,18.023809523809526,3
Category_Wikipedia_sockpuppets_of_Iamtrevorpaxton.csv,6,1224.0,3,3,2,1,19,45.666666666666664,149,39,39.0,39
Category_Wikipedia_sockpuppets_of_Applepineapple.csv,1941,51369157.0,777,1164,500,277,0,40.34724368882019,332,82,29.67078825347759,2
Category_Wikipedia_sockpuppets_of_Boombastic061.csv,3473,60762021.0,1225,2248,500,725,0,50.042326518859774,506,62,13.038583357327958,4
Category_Wikipedia_sockpuppets_of_AshiqurRahman7FEB.csv,378,340611457.0,141,237,126,15,0,36.198412698412696,491,47,23.664021164021165,7
Category_Wikipedia_sockpuppets_of_Jamilu_Abdussalam.csv,193,49194926.0,69,124,56,13,0,44.78238341968912,224,53,15.595854922279793,6
Category_Wikipedia_sockpuppets_of_Jfjfne.csv,92,857016.0,59,33,50,9,0,41.18478260869565,496,54,26.043478260869566,11
Category_Wikipedia_sockpuppets_of_Magic_Media.csv,197,625528.0,52,145,19,33,0,56.83248730964467,211,44,19.497461928934012,6
Category_Wikipedia_sockpuppets_of_Raeze_e1.csv,2,0.0,1,1,1,0,0,0.0,0,34,34.0,34
Category_Wikipedia_sockpuppets_of_Roadcrusher.csv,1638,6730533.0,573,1065,188,385,0,27.022588522588524,250,56,19.338217338217337,4
Category_Wikipedia_sockpuppets_of_Neptunekh.csv,4063,278733752.0,1156,2907,500,656,0,36.155796209697264,255,61,19.66773320206744,4
Category_Wikipedia_sockpuppets_of_Flammable_monky.csv,29,6238183.0,8,21,7,1,0,63.827586206896555,227,18,13.89655172413793,8
Category_Wikipedia_sockpuppets_of_Edward.Didier.csv,382,74386595.0,107,275,106,1,0,47.00261780104712,234,40,18.17801047120419,7
Category_Wikipedia_sockpuppets_of_Joe_sheph.csv,446,8771174.0,152,294,130,22,0,36.30269058295964,255,61,19.778026905829595,4
Category_Wikipedia_sockpuppets_of_Brixtonhall1508.csv,15,18284.0,8,7,5,3,14,68.2,154,16,11.0,4
Category_Wikipedia_sockpuppets_of_Peperonnie.csv,334,10317316.0,94,240,52,42,0,51.452095808383234,264,35,14.380239520958083,5
Category_Wikipedia_sockpuppets_of_Wookiewinnett.csv,70,4490.0,29,41,9,20,0,60.82857142857143,195,54,27.32857142857143,13
Category_Wikipedia_sockpuppets_of_Bouquey.csv,1652,28110923.0,598,1054,412,186,0,46.36682808716707,255,53,16.376513317191282,4
Category_Wikipedia_sockpuppets_of_Dr_Various.csv,334,143329826.0,150,184,108,42,0,40.32035928143713,255,50,20.688622754491018,11
Category_Wikipedia_sockpuppets_of_Samjohnbro.csv,1,0.0,1,0,1,0,29,29.0,29,20,20.0,20
Category_Wikipedia_sockpuppets_of_Macs15.csv,2399,321897458.0,1401,998,500,901,0,42.92997082117549,496,80,36.380992080033344,8
Category_Wikipedia_sockpuppets_of_K.D_Manikya_Tripuri.csv,407,19043730.0,140,267,132,8,0,41.00982800982801,360,48,16.565110565110565,4
Category_Wikipedia_sockpuppets_of_Lil_Pablo_2007.csv,5533,70711393.0,1341,4192,500,841,0,53.745707572745346,460,68,17.617928790891018,4
Category_Wikipedia_sockpuppets_of_Pflanzgarten.csv,104,17902587.0,37,67,32,5,0,30.759615384615383,160,11,9.134615384615385,9
Category_Wikipedia_sockpuppets_of_1abacada.csv,692,12516592.0,215,477,25,190,0,57.2485549132948,255,105,22.40173410404624,4
Category_Wikipedia_sockpuppets_of_Flowerman11.csv,390,3560277.0,142,248,59,83,0,39.48974358974359,218,47,16.607692307692307,4
Category_Wikipedia_sockpuppets_of_Akmak03.csv,238,15913620.0,65,173,45,20,0,33.331932773109244,168,34,15.634453781512605,3
Category_Wikipedia_sockpuppets_of_IECO_Voltage_Stabilizer.csv,37,245007.0,19,18,19,0,0,42.027027027027025,136,30,16.18918918918919,12
Category_Wikipedia_sockpuppets_of_Schami1989.csv,1038,24007886.0,610,428,500,110,0,30.57418111753372,499,74,30.57418111753372,13
Category_Wikipedia_sockpuppets_of_Reflexrobyou.csv,217,37531781.0,86,131,67,19,0,52.44700460829493,270,55,22.211981566820278,13
Category_Wikipedia_sockpuppets_of_Zhuli55.csv,46,6065863.0,17,29,13,4,0,50.47826086956522,211,31,11.934782608695652,3
Category_Wikipedia_sockpuppets_of_Voojima.csv,53,616285.0,32,21,18,14,0,41.943396226415096,208,17,9.867924528301886,5
Category_Wikipedia_sockpuppets_of_AurangzebMarwat.csv,353,16389080.0,149,204,149,0,0,32.46742209631728,256,40,27.356940509915013,6
Category_Wikipedia_sockpuppets_of_REDTMR.csv,1840,58144716.0,608,1232,382,226,0,60.65271739130435,254,54,24.144565217391303,1
Category_Wikipedia_sockpuppets_of_Makhamakhi.csv,2481,2020711.0,941,1540,500,441,0,40.06932688432084,255,78,22.095122934300687,4
Category_Wikipedia_sockpuppets_of_Letterwriter2021.csv,61,2553712.0,14,47,14,0,0,53.967213114754095,199,53,25.62295081967213,6
Category_Wikipedia_sockpuppets_of_Americanabroda.csv,126,3650047.0,93,33,86,7,0,40.73015873015873,255,34,14.055555555555555,9
Category_Wikipedia_sockpuppets_of_Jamesday57.csv,19,176280.0,13,6,5,8,0,57.421052631578945,243,15,11.105263157894736,9
Category_Wikipedia_sockpuppets_of_Henry_Mazzer.csv,2426,20478675.0,701,1725,202,499,0,48.95548227535037,255,57,19.58779884583677,4
Category_Wikipedia_sockpuppets_of_Leonsmither17.csv,15,26542105.0,5,10,5,0,0,41.2,240,17,16.4,16
Category_Wikipedia_sockpuppets_of_Dolyn.csv,33826,454555937.0,11251,22575,500,10751,0,49.514751965943354,500,96,22.293472476793,1
Category_Wikipedia_sockpuppets_of_Hainey92.csv,13,167895.0,7,6,4,3,0,62.0,168,25,20.0,12
Category_Wikipedia_sockpuppets_of_Rajan_raaz_pandey.csv,60,5316902.0,21,39,19,2,0,38.016666666666666,156,27,12.016666666666667,7
Category_Wikipedia_sockpuppets_of_Saltwaterperpetrator_VR.csv,94,5960847.0,57,37,37,20,0,30.361702127659573,262,7,7.0,7
Category_Wikipedia_sockpuppets_of_Rtally3.csv,694,113516341.0,280,414,280,0,0,46.09510086455332,204,51,32.90634005763689,11
Category_Wikipedia_sockpuppets_of_Mamaluigi2.csv,2019,17720296.0,796,1223,438,358,0,45.0455671124319,255,59,22.784546805349184,3
Category_Wikipedia_sockpuppets_of_IHopeYouDieSincerely.csv,22,690060.0,8,14,5,3,0,46.40909090909091,88,33,22.59090909090909,14
Category_Wikipedia_sockpuppets_of_Whynot179.csv,15,351344.0,11,4,10,1,0,41.93333333333333,196,28,15.866666666666667,14
Category_Wikipedia_sockpuppets_of_Iareallknowing.csv,1014,3524121.0,304,710,304,0,0,42.3560157790927,255,42,21.144970414201183,4
Category_Wikipedia_sockpuppets_of_NonStopMusic.csv,4,1491.0,4,0,4,0,0,48.75,195,21,21.0,21
Category_Wikipedia_sockpuppets_of_Jad_Krimeed.csv,259,17013460.0,96,163,90,6,0,47.91891891891892,491,38,14.528957528957529,6
Category_Wikipedia_sockpuppets_of_Nageswarao_Ghhsdiisiao.csv,330,5227408.0,124,206,58,66,0,50.86060606060606,304,59,21.14242424242424,6
Category_Wikipedia_sockpuppets_of_Efficiency576os.csv,4975,118890928.0,1270,3705,336,934,0,38.134070351758794,249,47,14.007638190954774,2
Category_Wikipedia_sockpuppets_of_HumpyNoRegard24.csv,99,1136220.0,42,57,25,17,0,40.54545454545455,204,35,16.393939393939394,7
Category_Wikipedia_sockpuppets_of_Jrut112.csv,91,2977841.0,56,35,19,37,0,50.879120879120876,250,24,14.043956043956044,13
Category_Wikipedia_sockpuppets_of_Venuanki.csv,60,206931761.0,19,41,16,3,0,54.05,493,51,23.083333333333332,13
Category_Wikipedia_sockpuppets_of_Jonawiki.csv,2071,77152862.0,747,1324,332,415,0,42.22646064703042,215,64,22.057460164171896,3
Category_Wikipedia_sockpuppets_of_Grammar_nazi_666.csv,3834,43144194.0,1000,2834,500,500,0,38.340114762649975,690,61,19.030255607720395,3
Category_Wikipedia_sockpuppets_of_Mulugheta_alula_roma.csv,1345,50701678.0,368,977,233,135,0,52.42007434944238,255,54,19.774721189591077,4
Category_Wikipedia_sockpuppets_of_ManaliJain88.csv,550,7890840.0,249,301,242,7,0,31.26181818181818,239,50,19.96,5
Category_Wikipedia_sockpuppets_of_Ghytu.csv,73,640837.0,60,13,48,12,0,70.98630136986301,232,30,22.36986301369863,15
Category_Wikipedia_sockpuppets_of_Fevrret.csv,687,1342386.0,301,386,267,34,0,46.63901018922853,255,70,26.901018922852984,5
Category_Wikipedia_sockpuppets_of_Bestcelebsnapchat.csv,100,6385880.0,64,36,47,17,0,31.64,247,53,24.85,12
Category_Wikipedia_sockpuppets_of_Ngray024.csv,4,1667.0,4,0,2,2,0,49.75,98,24,17.25,13
Category_Wikipedia_sockpuppets_of_MasonWikia.csv,751,39427309.0,227,524,170,57,0,39.74300932090546,260,41,17.77097203728362,5
Category_Wikipedia_sockpuppets_of_PBnJGuitarist23.csv,81,28632299.0,22,59,15,7,0,65.20987654320987,282,47,31.864197530864196,19
Category_Wikipedia_sockpuppets_of_778Showen778.csv,920,28200339.0,184,736,88,96,0,38.87717391304348,244,41,15.07391304347826,3
Category_Wikipedia_sockpuppets_of_Rafa_Figueiredo.csv,625,45676054.0,160,465,28,132,0,44.6928,246,42,17.1296,9
Category_Wikipedia_sockpuppets_of_Amithani.csv,109,71518723.0,37,72,25,12,0,32.74311926605505,146,55,25.94495412844037,7
Category_Wikipedia_sockpuppets_of_Alexcocopro.csv,34,20134764.0,11,23,8,3,0,60.73529411764706,243,28,17.441176470588236,13
Category_Wikipedia_sockpuppets_of_MatthewTardiff.csv,1953,12433695.0,636,1317,500,136,0,63.725038402457756,255,48,15.07731694828469,8
Category_Wikipedia_sockpuppets_of_KnoThanqs.csv,1,0.0,1,0,1,0,41,41.0,41,19,19.0,19
Category_Wikipedia_sockpuppets_of_Cilla1987.csv,379,97945035.0,148,231,142,6,0,44.422163588390504,250,47,21.49076517150396,10
Category_Wikipedia_sockpuppets_of_Undertakeranshu.csv,2021,28682040.0,674,1347,500,174,0,34.704106877783275,250,67,21.45818901533894,2
Category_Wikipedia_sockpuppets_of_Peppapig123456.csv,2308,53569802.0,672,1636,500,172,0,66.24436741767764,500,48,15.905979202772963,3
Category_Wikipedia_sockpuppets_of_Jeffman12345.csv,141,14783962.0,38,103,14,24,0,66.94326241134752,226,48,25.404255319148938,5
Category_Wikipedia_sockpuppets_of_CarlostheJackal01.csv,9220,34537916.0,2570,6650,500,2070,0,52.93318872017353,500,84,22.080368763557484,3
Category_Wikipedia_sockpuppets_of_LOCK177.csv,2569,40405340.0,692,1877,203,489,0,33.94589334371351,478,75,20.71739976644609,4
Category_Wikipedia_sockpuppets_of_Waqas.pakistan.csv,98,1896131.0,52,46,49,3,0,35.57142857142857,230,33,18.275510204081634,5
Category_Wikipedia_sockpuppets_of_Huggz.csv,1,0.0,1,0,1,0,15,15.0,15,13,13.0,13
Category_Wikipedia_sockpuppets_of_Stluciainformation.csv,735,151199306.0,285,450,195,90,0,54.029931972789115,500,91,24.09795918367347,6
Category_Wikipedia_sockpuppets_of_Mod12331.csv,16,180182.0,15,1,9,6,0,11.1875,146,25,21.25,21
Category_Wikipedia_sockpuppets_of_Wwilloughby.csv,1237,81592525.0,534,703,411,123,0,40.68229587712207,255,53,20.691996766370252,3
Category_Wikipedia_sockpuppets_of_SamCrawford1.csv,105,25667252.0,44,61,40,4,0,37.523809523809526,218,24,16.752380952380953,9
Category_Wikipedia_sockpuppets_of_Ace_Baker.csv,401,79230094.0,103,298,100,3,0,29.77556109725686,250,47,22.24937655860349,10
Category_Wikipedia_sockpuppets_of_Dash_Jr.csv,57,4685829.0,16,41,5,11,0,67.15789473684211,209,30,20.666666666666668,9
Category_Wikipedia_sockpuppets_of_Yashthepunisher.csv,1833,285881068.0,507,1326,500,7,0,53.38406983087834,496,101,20.77304964539007,6
Category_Wikipedia_sockpuppets_of_Lkerry37.csv,310,56621954.0,144,166,48,96,0,16.15483870967742,217,15,14.664516129032258,14
Category_Wikipedia_sockpuppets_of_Kkkev999.csv,175,5451530.0,64,111,28,36,0,46.605714285714285,372,45,24.388571428571428,3
Category_Wikipedia_sockpuppets_of_SummerWinter99.csv,24,2924782.0,13,11,10,3,7,106.875,498,27,15.458333333333334,14
Category_Wikipedia_sockpuppets_of_Hojjathassanpourvip.csv,7,66952.0,6,1,6,0,0,2.0,9,36,30.0,15
Category_Wikipedia_sockpuppets_of_Canpop.csv,499,34887870.0,156,343,156,0,0,36.012024048096194,208,50,15.697394789579159,7
Category_Wikipedia_sockpuppets_of_Chints247.csv,876,153563145.0,242,634,208,34,0,53.39954337899543,273,67,18.304794520547944,6
Category_Wikipedia_sockpuppets_of_NC-2018.csv,280,28323210.0,85,195,40,45,0,47.77142857142857,221,59,22.0,6
Category_Wikipedia_sockpuppets_of_JScott06.csv,1621,69452511.0,420,1201,294,126,0,38.60703269586675,250,60,19.921036397285626,4
Category_Wikipedia_sockpuppets_of_Nixon_Now.csv,9560,293519342.0,3485,6075,500,2985,0,42.00899581589958,496,106,26.318619246861925,3
Category_Wikipedia_sockpuppets_of_General_electric_p30ch.csv,1471,8149482.0,548,923,492,56,0,39.87695445275323,405,73,29.315431679129844,6
Category_Wikipedia_sockpuppets_of_Supervisor635.csv,310,16477301.0,137,173,81,56,0,78.45806451612903,254,56,21.73548387096774,4
Category_Wikipedia_sockpuppets_of_Proscience.csv,50,2556936.0,26,24,17,9,0,36.28,80,74,56.26,18
Category_Wikipedia_sockpuppets_of_Chamikara.92.csv,8,759863.0,4,4,2,2,0,26.0,120,22,18.0,11
Category_Wikipedia_sockpuppets_of_BAVISHA_T.csv,6,425704.0,3,3,3,0,9,58.0,92,25,22.0,19
Category_Wikipedia_sockpuppets_of_Dipslime.csv,40,7082604.0,19,21,7,12,0,47.725,170,23,17.675,17
Category_Wikipedia_sockpuppets_of_Adeoyetope.csv,2,0.0,1,1,1,0,0,0.0,0,53,53.0,53
Category_Wikipedia_sockpuppets_of_Hemppapemppa1234.csv,3,209.0,2,1,1,1,30,100.33333333333333,193,8,8.0,8
Category_Wikipedia_sockpuppets_of_Efc1878.csv,1040,9962183.0,529,511,500,29,0,72.05480769230769,255,42,17.35096153846154,11
Category_Wikipedia_sockpuppets_of_Trnhan1403.csv,155,4992315.0,48,107,25,23,0,38.774193548387096,240,44,22.393548387096775,9
Category_Wikipedia_sockpuppets_of_Thakur_Raj_Singh_Jat.csv,155,155494.0,58,97,29,29,0,62.57419354838709,502,32,13.6,8
Category_Wikipedia_sockpuppets_of_Thechroniclesofratman.csv,3701,141055563.0,1208,2493,465,743,0,41.18670629559578,246,65,19.17887057552013,4
Category_Wikipedia_sockpuppets_of_Islami.csv,1982,36273019.0,585,1397,500,85,0,31.419778002018163,200,74,16.266902119071645,4
Category_Wikipedia_sockpuppets_of_MartinPict.csv,2452,105707063.0,758,1694,500,258,0,52.06647634584013,407,75,20.072185970636216,3
Category_Wikipedia_sockpuppets_of_1989_Rosie.csv,5646,21627059.0,1500,4146,500,1000,0,46.54162238753099,263,70,26.037017357421185,5
Category_Wikipedia_sockpuppets_of_Donnie_Park.csv,2093,17151625.0,726,1367,500,226,0,41.87768752986144,254,95,27.887720974677496,3
Category_Wikipedia_sockpuppets_of_Battomi.csv,81,867511.0,39,42,21,18,0,34.79012345679013,210,45,20.246913580246915,7
Category_Wikipedia_sockpuppets_of_OhFive.csv,347,14277319.0,124,223,45,79,0,35.05763688760807,199,20,14.556195965417867,7
Category_Wikipedia_sockpuppets_of_Jmanjmanjman.csv,512,15275130.0,128,384,113,15,0,48.751953125,249,38,16.833984375,3
Category_Wikipedia_sockpuppets_of_Pro_Gamer_Dope.csv,7936,26531170.0,3040,4896,500,2540,0,33.940902217741936,499,83,18.845262096774192,6
Category_Wikipedia_sockpuppets_of_JohnPatrickKeefeII.csv,11,10279426.0,7,4,4,3,19,96.0,243,37,24.636363636363637,18
Category_Wikipedia_sockpuppets_of_CrypoManicanBiy81991.csv,78,8606355.0,24,54,3,21,0,23.71794871794872,212,39,17.846153846153847,8
Category_Wikipedia_sockpuppets_of_Sasha_Boudville.csv,2606,156499504.0,1000,1606,500,500,0,34.83576362240982,512,71,22.16462010744436,5
Category_Wikipedia_sockpuppets_of_Seelater234.csv,104,39741.0,38,66,4,34,0,33.17307692307692,152,40,12.759615384615385,5
Category_Wikipedia_sockpuppets_of_Kadadoc.csv,12,38770567.0,6,6,6,0,0,51.916666666666664,97,29,25.0,17
Category_Wikipedia_sockpuppets_of_Jasperna.csv,635,96531080.0,226,409,102,124,0,37.718110236220475,237,55,20.281889763779528,5
Category_Wikipedia_sockpuppets_of_King.godrat.csv,45,19103628.0,17,28,9,8,0,64.4,238,18,8.088888888888889,5
Category_Wikipedia_sockpuppets_of_Plead_Passepartout.csv,85,85305410.0,26,59,5,21,0,53.05882352941177,237,68,25.894117647058824,11
Category_Wikipedia_sockpuppets_of_KostyaMasterpiece.csv,82,35662564.0,23,59,11,12,0,65.35365853658537,299,40,21.451219512195124,7
Category_Wikipedia_sockpuppets_of_Nutash_Ali.csv,469,56668327.0,132,337,26,106,0,41.652452025586356,250,25,13.302771855010661,3
Category_Wikipedia_sockpuppets_of_Sander.v.Ginkel.csv,1631,171944121.0,706,925,500,206,0,48.87247087676272,255,169,31.160637645616188,7
Category_Wikipedia_sockpuppets_of_Julianpe.csv,348,1272424.0,128,220,58,70,0,43.99425287356322,253,62,26.517241379310345,6
Category_Wikipedia_sockpuppets_of_D10s_Maradona.csv,2695,78607544.0,1018,1677,500,518,0,54.50278293135436,496,66,28.36178107606679,9
Category_Wikipedia_sockpuppets_of_Drdanielchang.csv,1,0.0,1,0,1,0,25,25.0,25,10,10.0,10
Category_Wikipedia_sockpuppets_of_Kazi-Kamrul-Hasan.csv,325,5535514.0,126,199,68,58,0,43.12,275,59,23.41846153846154,6
Category_Wikipedia_sockpuppets_of_Jaucine_Ursa.csv,79,2671912.0,25,54,11,14,0,48.12658227848101,240,34,24.848101265822784,8
Category_Wikipedia_sockpuppets_of_WeRide2023.csv,63,34739816.0,48,15,21,27,0,58.492063492063494,281,21,8.047619047619047,6
Category_Wikipedia_sockpuppets_of_Andrei080610.csv,3575,25562772.0,768,2807,253,515,0,48.311328671328674,497,54,16.378741258741258,4
Category_Wikipedia_sockpuppets_of_KuhnstylePro.csv,7164,203742147.0,1940,5224,437,1503,0,39.041178112786156,255,62,21.902568397543273,4
Category_Wikipedia_sockpuppets_of_Aaroonie.csv,156,197334379.0,41,115,29,12,0,54.42307692307692,246,34,21.05128205128205,10
Category_Wikipedia_sockpuppets_of_Ahmed_Bachaka.csv,34,3179692.0,18,16,9,9,0,42.970588235294116,241,53,23.41176470588235,14
Category_Wikipedia_sockpuppets_of_Sarvabhaum.csv,3820,28779458.0,1221,2599,500,721,0,32.48926701570681,250,55,15.234816753926701,3
Category_Wikipedia_sockpuppets_of_Maboyzz2chain$$.csv,850,8290839.0,254,596,64,190,0,44.5,255,41,17.564705882352943,6
Category_Wikipedia_sockpuppets_of_Gabed123.csv,312,3071726.0,84,228,68,16,0,43.12179487179487,207,38,19.400641025641026,8
Category_Wikipedia_sockpuppets_of_Robert_Smith_A.csv,62,438670.0,26,36,19,7,0,37.88709677419355,310,15,9.919354838709678,7
Category_Wikipedia_sockpuppets_of_Jamminlive66.csv,233,137254636.0,84,149,68,16,0,42.69957081545064,431,16,8.944206008583691,4
Category_Wikipedia_sockpuppets_of_Leo_and_Alexander.csv,21,141490.0,13,8,9,4,0,43.38095238095238,195,16,16.0,16
Category_Wikipedia_sockpuppets_of_Lmoehle.csv,47,4488118.0,20,27,12,8,0,40.659574468085104,203,28,23.23404255319149,14
Category_Wikipedia_sockpuppets_of_ŸÖÿ≠ŸÖÿØ_ÿßŸÑÿÆŸàÿ®ÿ±Ÿä.csv,3365,27656895.0,1383,1982,500,883,0,30.67102526002972,245,81,22.221991084695393,5
Category_Wikipedia_sockpuppets_of_Russellml.csv,63,20233565.0,16,47,8,8,0,42.87301587301587,199,58,26.666666666666668,10
Category_Wikipedia_sockpuppets_of_The_Wisest_Expert.csv,25,3374065.0,11,14,7,4,0,72.84,305,28,17.68,10
Category_Wikipedia_sockpuppets_of_Ranjith001.csv,162,6236781.0,57,105,49,8,0,42.635802469135804,283,38,14.666666666666666,8
Category_Wikipedia_sockpuppets_of_Krchandler.csv,10,60140818.0,4,6,2,2,0,31.7,131,23,22.7,20
Category_Wikipedia_sockpuppets_of_Achidiac.csv,674,82887122.0,255,419,160,95,0,34.859050445103854,228,64,22.85311572700297,5
Category_Wikipedia_sockpuppets_of_Ryangossler1.csv,79,6938128.0,22,57,12,10,0,67.81012658227849,233,26,11.215189873417721,4
Category_Wikipedia_sockpuppets_of_CredEsTy.csv,111,4222632.0,25,86,14,11,0,43.549549549549546,221,38,18.45945945945946,4
Category_Wikipedia_sockpuppets_of_SassyFrassySRaaSsy.csv,21,3416.0,14,7,6,8,0,79.71428571428571,222,8,8.0,8
Category_Wikipedia_sockpuppets_of_Browniesandicecreamcake.csv,1914,68134155.0,646,1268,386,260,0,51.397596656217345,500,51,33.39864158829676,4
Category_Wikipedia_sockpuppets_of_Sleeping_is_fun.csv,7995,232409538.0,1925,6070,500,1425,0,48.352720450281424,394,83,15.192745465916198,2
Category_Wikipedia_sockpuppets_of_MyOperaCom.csv,849,2583282.0,249,600,125,124,0,55.02944640753828,251,58,17.86454652532391,3
Category_Wikipedia_sockpuppets_of_Vicky4567.csv,434,44406710.0,99,335,7,92,0,56.02073732718894,255,35,16.12442396313364,4
Category_Wikipedia_sockpuppets_of_Superfake800.csv,17,60333.0,12,5,10,2,0,32.8235294117647,191,45,39.0,11
Category_Wikipedia_sockpuppets_of_Nelson8708000.csv,41,574582.0,14,27,5,9,0,53.31707317073171,255,17,11.414634146341463,5
Category_Wikipedia_sockpuppets_of_Dr._Omnom.csv,10,4553.0,8,2,5,3,0,56.2,196,14,8.9,5
Category_Wikipedia_sockpuppets_of_Osmangani2019.csv,42,18958818.0,14,28,8,6,0,88.30952380952381,506,29,21.761904761904763,12
Category_Wikipedia_sockpuppets_of_WangFeiHung.csv,38,1222836.0,13,25,8,5,0,33.026315789473685,200,25,12.894736842105264,9
Category_Wikipedia_sockpuppets_of_WikiAddict81.csv,81,165190156.0,18,63,10,8,0,69.46913580246914,230,37,20.950617283950617,3
Category_Wikipedia_sockpuppets_of_BobEnyart.csv,2060,275621953.0,508,1552,500,8,0,62.447087378640774,446,61,18.116990291262137,4
Category_Wikipedia_sockpuppets_of_Dmits.csv,2,0.0,1,1,1,0,33,33.0,33,25,25.0,25
Category_Wikipedia_sockpuppets_of_Noble_banji.csv,381,16764337.0,160,221,114,46,0,51.123359580052494,496,57,24.448818897637796,6
Category_Wikipedia_sockpuppets_of_Her_Holy_Majesty_Social_Media.csv,11,66385.0,9,2,4,5,0,19.363636363636363,105,40,35.36363636363637,26
Category_Wikipedia_sockpuppets_of_Spoonkymonkey.csv,2816,222998740.0,756,2060,500,256,0,52.65553977272727,329,56,21.719105113636363,5
Category_Wikipedia_sockpuppets_of_Rpv2.csv,13,993855.0,7,6,5,2,0,29.076923076923077,172,25,16.692307692307693,13
Category_Wikipedia_sockpuppets_of_Shrek3TheRoadChip.csv,15,9406.0,7,8,4,3,0,51.86666666666667,140,25,23.133333333333333,17
Category_Wikipedia_sockpuppets_of_Sukh2019.csv,132,18584414.0,47,85,29,18,0,50.77272727272727,239,53,19.59090909090909,8
Category_Wikipedia_sockpuppets_of_Ottoniel_Blanco.csv,5533,109484379.0,1360,4173,500,860,0,57.36905837701066,255,65,15.790891017531177,3
Category_Wikipedia_sockpuppets_of_Banana_Republic.csv,6163,484302972.0,2049,4114,500,1549,0,60.95894856401103,496,99,24.448482881713453,3
Category_Wikipedia_sockpuppets_of_Seltzer_Shank.csv,252,208393889.0,82,170,54,28,0,43.55952380952381,495,48,18.349206349206348,5
Category_Wikipedia_sockpuppets_of_Chaosname.csv,10987,340918132.0,3277,7710,500,2777,0,47.48038591062164,255,75,18.388914171293347,3
Category_Wikipedia_sockpuppets_of_Draganparis.csv,1396,59573380.0,523,873,500,23,0,44.51146131805157,231,47,23.308022922636102,6
Category_Wikipedia_sockpuppets_of_Shshshakagzknaumsbs.csv,75,7980135.0,25,50,21,4,0,46.72,261,39,21.84,16
Category_Wikipedia_sockpuppets_of_Saguamundi.csv,5356,106700781.0,1528,3828,500,1028,0,55.15011202389843,255,89,22.17363704256908,3
Category_Wikipedia_sockpuppets_of_Cbelli92.csv,36,115859155.0,29,7,19,10,0,58.02777777777778,313,65,18.555555555555557,17
Category_Wikipedia_sockpuppets_of_DKJIAJNEIF.csv,3,77.0,2,1,2,0,0,9.666666666666666,29,22,21.666666666666668,21
Category_Wikipedia_sockpuppets_of_Ana_Su≈°ac.csv,1436,5257201.0,623,813,461,162,0,27.66225626740947,241,63,15.473537604456824,6
Category_Wikipedia_sockpuppets_of_D-Dog-16.csv,690,203474624.0,248,442,185,63,0,44.971014492753625,250,50,29.69710144927536,8
Category_Wikipedia_sockpuppets_of_Tonystark877.csv,1,0.0,1,0,1,0,5,5.0,5,22,22.0,22
Category_Wikipedia_sockpuppets_of_ShortJason.csv,1099,29728464.0,371,728,229,142,0,26.67606915377616,199,75,20.741583257506825,4
Category_Wikipedia_sockpuppets_of_Stevence_SA.csv,1504,106320230.0,546,958,235,311,0,45.642287234042556,398,62,17.954787234042552,4
Category_Wikipedia_sockpuppets_of_Chandelshashank.csv,19,676670.0,6,13,6,0,0,46.94736842105263,111,33,26.105263157894736,18
Category_Wikipedia_sockpuppets_of_Wiki-drapers.csv,113,5463890.0,48,65,48,0,0,45.80530973451327,227,48,20.008849557522122,6
Category_Wikipedia_sockpuppets_of_Fabrifago.csv,51,334762.0,37,14,34,3,0,19.333333333333332,199,39,25.294117647058822,16
Category_Wikipedia_sockpuppets_of_Lesbianadvocate.csv,6672,152511438.0,2552,4120,500,2052,0,46.8904376498801,255,51,15.61121103117506,3
Category_Wikipedia_sockpuppets_of_Dylanschneider1912.csv,165,878797.0,62,103,33,29,0,37.018181818181816,261,42,14.666666666666666,8
Category_Wikipedia_sockpuppets_of_Kubura.csv,3582,382601792.0,1000,2582,500,500,0,41.73422668900056,430,75,18.794249022892238,3
Category_Wikipedia_sockpuppets_of_Pallavi.p.g28.csv,1449,93596623.0,508,941,297,211,0,22.601794340924776,363,45,12.578329882677709,5
Category_Wikipedia_sockpuppets_of_Uck-Albaner.csv,1397,99919666.0,441,956,425,16,0,36.22118826055834,249,57,18.964924838940586,4
Category_Wikipedia_sockpuppets_of_David_Justin.csv,1900,54679672.0,675,1225,500,175,0,27.59578947368421,200,60,24.913684210526316,4
Category_Wikipedia_sockpuppets_of_WassimDoureihi.csv,390,447078043.0,109,281,67,42,0,44.60769230769231,300,25,14.176923076923076,14
Category_Wikipedia_sockpuppets_of_Bcactscoresarelow.csv,47,12520823.0,13,34,10,3,0,49.297872340425535,191,42,25.48936170212766,17
Category_Wikipedia_sockpuppets_of_Real_Life_Redneck.csv,3,229471.0,2,1,1,1,10,63.666666666666664,170,14,14.0,14
Category_Wikipedia_sockpuppets_of_Jackthompson1885.csv,59,2208467.0,28,31,20,8,0,84.15254237288136,344,32,24.779661016949152,11
Category_Wikipedia_sockpuppets_of_Aly.a.akers.csv,3,3874.0,2,1,2,0,29,88.0,196,37,22.333333333333332,15
Category_Wikipedia_sockpuppets_of_Jamesrohrecker.csv,43,1751.0,25,18,13,12,0,17.906976744186046,203,17,14.720930232558139,10
Category_Wikipedia_sockpuppets_of_Nukeh.csv,1980,9579699.0,649,1331,500,149,0,48.34040404040404,211,75,21.986363636363638,5
Category_Wikipedia_sockpuppets_of_Epistemphilic7.csv,205,29335938.0,72,133,37,35,0,71.41951219512195,247,50,24.117073170731707,4
Category_Wikipedia_sockpuppets_of_Patches1998.csv,1215,112005359.0,399,816,328,71,0,46.51522633744856,247,80,22.90864197530864,3
Category_Wikipedia_sockpuppets_of_Damiannabot.csv,62,3369732.0,35,27,27,8,0,44.17741935483871,199,22,13.629032258064516,11
Category_Wikipedia_sockpuppets_of_Mohammad_adil.csv,1752,111854921.0,525,1227,500,25,0,51.519406392694066,254,94,17.041666666666668,3
Category_Wikipedia_sockpuppets_of_Tempest-GoA.csv,3,353.0,2,1,2,0,20,87.0,215,9,9.0,9
Category_Wikipedia_sockpuppets_of_≈†ƒÅhzƒÅd√©.csv,191,22325984.0,50,141,44,6,0,47.01570680628272,221,35,15.099476439790577,6
Category_Wikipedia_sockpuppets_of_Lemaroto.csv,19521,188784219.0,5224,14297,500,4724,0,41.264740535833205,500,83,22.197735771733004,4
Category_Wikipedia_sockpuppets_of_MusicLover650.csv,17607,371615240.0,4803,12804,500,4303,0,44.244334639631965,414,85,14.608621570966093,2
Category_Wikipedia_sockpuppets_of_cdswalkthrough.csv,527,34804585.0,198,329,163,35,0,47.874762808349146,253,28,13.366223908918407,6
Category_Wikipedia_sockpuppets_of_Jakeyjenk.csv,2,272.0,2,0,1,1,0,6.5,13,28,28.0,28
Category_Wikipedia_sockpuppets_of_Balakashyap.csv,343,133859150.0,109,234,49,60,0,49.4868804664723,460,38,14.276967930029155,4
Category_Wikipedia_sockpuppets_of_Tonio11111.csv,365,99510093.0,141,224,92,49,0,31.676712328767124,205,42,17.284931506849315,10
Category_Wikipedia_sockpuppets_of_Newsandfacts.csv,105,277422942.0,65,40,47,18,0,35.180952380952384,234,34,27.01904761904762,22
Category_Wikipedia_sockpuppets_of_C.Kent87.csv,4273,95269810.0,1000,3273,500,500,0,46.788205008190964,250,50,17.310320617832904,4
Category_Wikipedia_sockpuppets_of_Jasurisfat.csv,4,185.0,3,1,2,1,0,37.25,149,20,20.0,20
Category_Wikipedia_sockpuppets_of_Davaha.csv,143,1455915.0,45,98,40,5,0,49.75524475524475,238,53,22.664335664335663,4
Category_Wikipedia_sockpuppets_of_Sllewellyn7.csv,4339,6145260.0,904,3435,500,404,0,32.709380041484216,249,62,20.22332334639318,3
Category_Wikipedia_sockpuppets_of_Bhagyakshirsagar.csv,15,4192.0,5,10,4,1,0,64.6,232,15,14.333333333333334,10
Category_Wikipedia_sockpuppets_of_Afroludi.csv,4,4193.0,2,2,2,0,0,36.0,60,18,18.0,18
Category_Wikipedia_sockpuppets_of_Donnyfl.csv,9,922.0,5,4,4,1,12,59.22222222222222,119,11,11.0,11
Category_Wikipedia_sockpuppets_of_Faizan.csv,4124,67833563.0,1539,2585,500,1039,0,56.73666343355965,259,64,18.66949563530553,5
Category_Wikipedia_sockpuppets_of_Wikindia24x7.csv,3576,84944486.0,1279,2297,500,779,0,40.47846756152125,241,58,18.963646532438478,3
Category_Wikipedia_sockpuppets_of_Beepoppab.csv,400,36971587.0,121,279,110,11,0,38.1975,225,45,18.035,6
Category_Wikipedia_sockpuppets_of_Dailywebblog.csv,9,4152.0,5,4,3,2,16,107.33333333333333,208,13,9.0,7
Category_Wikipedia_sockpuppets_of_Tyson453.csv,2,0.0,1,1,1,0,29,29.0,29,16,16.0,16
Category_Wikipedia_sockpuppets_of_Iduz.csv,17,1789599.0,14,3,6,8,0,26.58823529411765,90,22,15.411764705882353,9
Category_Wikipedia_sockpuppets_of_Mistyolper.csv,143,6073422.0,34,109,29,5,0,44.7972027972028,257,38,25.405594405594407,6
Category_Wikipedia_sockpuppets_of_The_Floka.csv,2256,48016571.0,1017,1239,500,517,0,36.57225177304964,496,59,29.18040780141844,6
Category_Wikipedia_sockpuppets_of_MessiniaGreece.csv,276,27526247.0,116,160,109,7,0,46.68115942028985,250,27,13.66304347826087,6
Category_Wikipedia_sockpuppets_of_SlideAndSlip.csv,2703,488153535.0,1039,1664,482,557,0,45.048834628190896,494,93,25.309655937846838,4
Category_Wikipedia_sockpuppets_of_The_Holocaust_Never_Happened.csv,68,2248699.0,16,52,7,9,0,72.04411764705883,200,54,16.764705882352942,3
Category_Wikipedia_sockpuppets_of_Johnbannan.csv,153,19592516.0,42,111,27,15,0,69.81699346405229,473,47,16.980392156862745,9
Category_Wikipedia_sockpuppets_of_Mrugeshsingh.csv,601,31471854.0,214,387,214,0,0,32.98668885191348,364,64,17.575707154742098,6
Category_Wikipedia_sockpuppets_of_Sanjeetbond.csv,7072,82198348.0,2484,4588,500,1984,0,38.734869909502265,255,67,19.054298642533936,3
Category_Wikipedia_sockpuppets_of_PiboManitoba.csv,418,26434040.0,152,266,20,132,0,43.995215311004785,199,51,21.251196172248804,8
Category_Wikipedia_sockpuppets_of_Lolawin.csv,1,0.0,1,0,1,0,16,16.0,16,5,5.0,5
Category_Wikipedia_sockpuppets_of_Israelite1.csv,105,347023.0,41,64,37,4,0,77.83809523809524,217,35,25.80952380952381,8
Category_Wikipedia_sockpuppets_of_Ssunique100.csv,145,2333825.0,57,88,55,2,0,40.206896551724135,255,41,16.786206896551725,6
Category_Wikipedia_sockpuppets_of_Duebstep.csv,30,10965939.0,10,20,7,3,0,62.0,496,51,32.266666666666666,14
Category_Wikipedia_sockpuppets_of_Specialwood.csv,1114,12156834.0,359,755,290,69,0,39.418312387791744,299,51,24.77737881508079,4
Category_Wikipedia_sockpuppets_of_Wlaw23357567658.csv,27,165787.0,16,11,11,5,0,53.22222222222222,183,32,15.62962962962963,15
Category_Wikipedia_sockpuppets_of_IDZeroNo.csv,968,345346945.0,324,644,284,40,0,42.93904958677686,496,55,17.378099173553718,6
Category_Wikipedia_sockpuppets_of_Theuyhjasji.csv,7,437068.0,4,3,1,3,6,59.57142857142857,123,19,19.0,19
Category_Wikipedia_sockpuppets_of_Maromania.csv,5,8474519.0,2,3,2,0,7,54.6,132,21,20.6,20
Category_Wikipedia_sockpuppets_of_Hexenjagd.csv,783,19319861.0,303,480,295,8,0,34.158365261813536,247,48,15.468710089399744,7
Category_Wikipedia_sockpuppets_of__Christian_fablicker_.csv,30,665609.0,9,21,9,0,0,52.8,238,23,16.033333333333335,14
Category_Wikipedia_sockpuppets_of_RandomGuy2018.csv,2451,104804176.0,728,1723,500,228,0,47.40677274581803,497,44,13.890248878008975,4
Category_Wikipedia_sockpuppets_of_BDKSH.csv,299,3880267.0,147,152,122,25,0,36.30434782608695,192,48,37.22742474916388,3
Category_Wikipedia_sockpuppets_of_Dikshasoni23.csv,9,204477.0,6,3,3,3,0,29.88888888888889,144,25,24.11111111111111,23
Category_Wikipedia_sockpuppets_of_Milech.csv,31,464330.0,12,19,7,5,0,62.774193548387096,232,22,10.548387096774194,4
Category_Wikipedia_sockpuppets_of_Zaka_Weezy.csv,211,78312780.0,69,142,55,14,0,48.61611374407583,214,36,17.597156398104264,4
Category_Wikipedia_sockpuppets_of_Viran.csv,763,210048201.0,225,538,72,153,0,57.58584534731324,255,54,22.06422018348624,5
Category_Wikipedia_sockpuppets_of_Ludivine.csv,60375,169658304.0,23347,37028,500,22847,0,34.45961076604555,271,109,17.18487784679089,3
Category_Wikipedia_sockpuppets_of_Jahnavi_vutukuri.csv,10,1292386.0,6,4,5,1,0,18.2,123,15,14.1,12
Category_Wikipedia_sockpuppets_of_Jay_Jay_Marcus_Keize13.csv,1989,19008749.0,679,1310,500,179,0,39.115133232780295,255,59,19.44695827048768,3
Category_Wikipedia_sockpuppets_of_Jojojomamama.csv,49,864897.0,17,32,9,8,0,66.85714285714286,241,18,15.204081632653061,13
Category_Wikipedia_sockpuppets_of_Supriyya.csv,2578,218978408.0,834,1744,500,334,0,45.2788983708301,255,60,14.149340574088441,4
Category_Wikipedia_sockpuppets_of_Ivan_Dembicki.csv,1613,43201401.0,567,1046,411,156,0,38.138251704897705,255,44,16.150650960942343,5
Category_Wikipedia_sockpuppets_of_Messenger2010.csv,688,11585536.0,282,406,124,158,0,44.68895348837209,200,54,21.594476744186046,7
Category_Wikipedia_sockpuppets_of_Flipityfloohaa.csv,6,457.0,4,2,4,0,0,62.666666666666664,189,14,14.0,14
Category_Wikipedia_sockpuppets_of_Sebu13.csv,103,30678503.0,51,52,42,9,0,38.650485436893206,196,44,27.699029126213592,16
Category_Wikipedia_sockpuppets_of_Freakshownerd.csv,2981,11045749.0,1031,1950,500,531,0,42.755786648775576,250,87,19.25360617242536,4
Category_Wikipedia_sockpuppets_of_Futhark1988.csv,107,127966755.0,33,74,30,3,0,38.299065420560744,163,47,29.757009345794394,19
Category_Wikipedia_sockpuppets_of_Razahazara911.csv,144,9021178.0,49,95,41,8,0,46.979166666666664,260,49,18.20138888888889,5
Category_Wikipedia_sockpuppets_of_Kumarsunils.csv,117,76647587.0,40,77,14,26,0,31.41025641025641,193,47,25.05982905982906,8
Category_Wikipedia_sockpuppets_of_Stephanie_ackles.csv,48,36121524.0,11,37,8,3,0,68.625,232,14,13.3125,13
Category_Wikipedia_sockpuppets_of_Zen-master.csv,2368,51968879.0,742,1626,500,242,0,42.0772804054054,200,72,27.508445945945947,3
Category_Wikipedia_sockpuppets_of_Shahzthottan.csv,3,20260.0,3,0,2,1,0,70.66666666666667,196,20,17.0,13
Category_Wikipedia_sockpuppets_of_Lambakarna.csv,1541,353490704.0,568,973,500,68,0,55.91174561972745,495,100,17.98896820246593,6
Category_Wikipedia_sockpuppets_of_Smokey2022.csv,1559,109982221.0,580,979,368,212,0,45.133418858242464,254,76,19.602950609364978,3
Category_Wikipedia_sockpuppets_of_Beaneater00.csv,3119,176539466.0,862,2257,500,362,0,58.93235011221545,497,85,21.98461045206797,3
Category_Wikipedia_sockpuppets_of_Tripodero.csv,1599,66515142.0,698,901,500,198,0,48.57661038148843,496,76,22.53345841150719,5
Category_Wikipedia_sockpuppets_of_Venomous_Sniper.csv,6690,10096719.0,1875,4815,500,1375,0,60.96352765321375,464,86,18.069207772795217,3
Category_Wikipedia_sockpuppets_of_Figbiscuits.csv,838,6428920.0,280,558,123,157,0,54.00954653937948,440,83,25.286396181384248,6
Category_Wikipedia_sockpuppets_of_Douwang.csv,4,751.0,2,2,1,1,0,53.25,93,23,23.0,23
Category_Wikipedia_sockpuppets_of_Truckeckhart2009.csv,3347,14790965.0,1156,2191,500,656,0,34.77173588288019,500,52,20.632207947415598,4
Category_Wikipedia_sockpuppets_of_Grazon.csv,5017,58084528.0,1197,3820,500,697,0,38.4480765397648,229,99,17.878214072154673,4
Category_Wikipedia_sockpuppets_of_Patiencebako.csv,227,55335919.0,88,139,87,1,0,50.6431718061674,275,52,14.779735682819384,7
Category_Wikipedia_sockpuppets_of_YinYangJihad.csv,213,58470220.0,65,148,12,53,0,48.00469483568075,227,46,17.431924882629108,6
Category_Wikipedia_sockpuppets_of_VTomi.csv,579,38781804.0,160,419,145,15,0,41.5993091537133,221,54,20.272884283246977,5
Category_Wikipedia_sockpuppets_of_Stensrim.csv,2090,85625031.0,865,1225,262,603,0,51.93684210526316,500,74,22.813875598086124,5
Category_Wikipedia_sockpuppets_of_Floating_philosopher.csv,246,2460336.0,91,155,85,6,0,60.09756097560975,230,50,24.215447154471544,6
Category_Wikipedia_sockpuppets_of_Mhecky.csv,587,69118041.0,128,459,61,67,0,62.47359454855196,500,55,19.27427597955707,4
Category_Wikipedia_sockpuppets_of_Wikieditor1399.csv,1,0.0,1,0,1,0,0,0.0,0,23,23.0,23
Category_Wikipedia_sockpuppets_of_Rane43.csv,988,79005598.0,434,554,386,48,0,49.82995951417004,500,44,20.271255060728745,6
Category_Wikipedia_sockpuppets_of_Romesh67.csv,1010,7200995.0,648,362,380,268,0,29.474257425742575,328,40,21.37821782178218,9
Category_Wikipedia_sockpuppets_of_SJMccarthy.csv,259,7657720.0,107,152,51,56,0,54.092664092664094,268,31,20.27027027027027,10
Category_Wikipedia_sockpuppets_of_Yunoselect3.csv,65,714406.0,22,43,12,10,0,51.4,218,26,18.138461538461538,14
Category_Wikipedia_sockpuppets_of_GOLDINI1.csv,84,1809549.0,41,43,38,3,0,46.607142857142854,495,53,35.5,18
Category_Wikipedia_sockpuppets_of_Olafrozen.csv,1375,2617920.0,500,875,500,0,0,38.58836363636364,496,60,16.544,4
Category_Wikipedia_sockpuppets_of_Priyankasai94.csv,7,101380.0,4,3,2,2,0,17.142857142857142,42,25,24.142857142857142,23
Category_Wikipedia_sockpuppets_of_Sharmauiuc.csv,221,24364877.0,95,126,79,16,0,44.76018099547511,203,48,32.040723981900456,15
Category_Wikipedia_sockpuppets_of_Azhar_sulfikar.csv,119,24644704.0,41,78,33,8,0,43.747899159663866,207,53,15.495798319327731,6
Category_Wikipedia_sockpuppets_of_Marut840.csv,132,207943986.0,30,102,29,1,0,44.39393939393939,255,18,11.795454545454545,5
Category_Wikipedia_sockpuppets_of_Coruptia.csv,620,14850515.0,270,350,111,159,0,42.346774193548384,255,38,22.891935483870967,8
Category_Wikipedia_sockpuppets_of_WikiHogan654.csv,3620,171879893.0,1006,2614,500,506,0,43.87375690607735,301,62,18.311878453038673,1
Category_Wikipedia_sockpuppets_of_Schlafly.csv,2169,506569876.0,527,1642,500,27,0,71.04702627939143,427,65,23.407561088059012,5
Category_Wikipedia_sockpuppets_of_Michael_Paul_Heart.csv,3714,115315380.0,1509,2205,500,1009,0,70.06596661281637,255,64,18.736133548734518,4
Category_Wikipedia_sockpuppets_of_Party54321.csv,456,67487006.0,108,348,62,46,0,58.0328947368421,240,93,13.967105263157896,3
Category_Wikipedia_sockpuppets_of_New_pillager.csv,717,16514994.0,294,423,179,115,0,45.02649930264993,500,56,17.640167364016737,1
Category_Wikipedia_sockpuppets_of_Kevinado10.csv,44,2655095.0,33,11,32,1,0,28.886363636363637,197,25,17.818181818181817,4
Category_Wikipedia_sockpuppets_of_Povertypop.csv,354,2081648.0,77,277,19,58,0,45.95762711864407,206,50,10.790960451977401,4
Category_Wikipedia_sockpuppets_of_EuropeanHistory2011.csv,189,78263165.0,72,117,16,56,0,60.53968253968254,253,50,20.25925925925926,8
Category_Wikipedia_sockpuppets_of_Here_to_sway.csv,1313,990552.0,513,800,500,13,0,48.81416603198782,243,50,18.05864432597106,9
Category_Wikipedia_sockpuppets_of_Maxforwind.csv,1390,157186822.0,357,1033,260,97,0,57.89424460431655,500,54,15.624460431654676,3
Category_Wikipedia_sockpuppets_of_Kaleodu.csv,3231,147823608.0,1054,2177,500,554,0,48.25595790776849,479,60,19.393995666976167,5
Category_Wikipedia_sockpuppets_of_Purple_contribution.csv,233,35076643.0,110,123,78,32,0,22.103004291845494,204,34,22.11587982832618,3
Category_Wikipedia_sockpuppets_of_Captain_scarlet.csv,1524,549411080.0,504,1020,500,4,0,70.21981627296589,478,66,23.463254593175854,4
Category_Wikipedia_sockpuppets_of_Morbenmoshe.csv,48,934580.0,16,32,16,0,0,54.875,253,35,16.166666666666668,5
Category_Wikipedia_sockpuppets_of_Hisham_5ZX.csv,2052,22660689.0,814,1238,500,314,0,33.39863547758284,224,39,13.769980506822613,3
Category_Wikipedia_sockpuppets_of_Nostalgicperson03218.csv,400,5371351.0,90,310,77,13,0,52.5925,305,44,20.3075,5
Category_Wikipedia_sockpuppets_of_Katrina_Villegas.csv,127,4808848.0,42,85,11,31,0,49.07086614173228,239,27,16.212598425196852,8
Category_Wikipedia_sockpuppets_of_Valerius_Tygart.csv,3668,482732172.0,1159,2509,500,659,0,42.92720828789531,477,129,20.47328244274809,3
Category_Wikipedia_sockpuppets_of_Bat_Man2507.csv,71,25129365.0,28,43,11,17,0,59.436619718309856,255,41,18.169014084507044,5
Category_Wikipedia_sockpuppets_of_Suckafree420.csv,397,6750026.0,129,268,56,73,0,60.085642317380355,250,47,19.506297229219143,4
Category_Wikipedia_sockpuppets_of_JoJo_Rabbit11.csv,712,12866345.0,254,458,216,38,0,54.57022471910113,499,56,21.700842696629213,4
Category_Wikipedia_sockpuppets_of_Connor.lunn.csv,75,2425994.0,48,27,27,21,0,50.88,195,34,23.52,9
Category_Wikipedia_sockpuppets_of_Aaajit22700.csv,1020,24370102.0,364,656,237,127,0,40.84313725490196,345,76,17.113725490196078,5
Category_Wikipedia_sockpuppets_of_Geoffrey100.csv,2141,93067615.0,725,1416,459,266,0,32.72209248014946,241,57,14.99112564222326,4
Category_Wikipedia_sockpuppets_of_Parrotman.csv,214,43965453.0,58,156,38,20,0,40.981308411214954,226,30,16.009345794392523,4
Category_Wikipedia_sockpuppets_of_Tolibonboni.csv,105,4053064.0,31,74,28,3,0,59.78095238095238,255,24,7.714285714285714,4
Category_Wikipedia_sockpuppets_of_Increaseproduction.csv,24,937515.0,6,18,4,2,0,45.708333333333336,164,37,29.875,28
Category_Wikipedia_sockpuppets_of_Rowingasia.csv,46195,257560410.0,19740,26455,500,19240,0,35.44803550167767,500,86,29.321138651369196,3
Category_Wikipedia_sockpuppets_of_Tmotofga.csv,14,238113.0,8,6,7,1,0,23.357142857142858,85,49,43.714285714285715,16
Category_Wikipedia_sockpuppets_of_Washapplk.csv,5,53276.0,2,3,2,0,0,49.4,198,13,10.6,7
Category_Wikipedia_sockpuppets_of_Milind_devpurkar.csv,16,16093514.0,4,12,1,3,0,62.3125,196,44,38.0,18
Category_Wikipedia_sockpuppets_of_Henry_Cohen.csv,1,0.0,1,0,1,0,0,0.0,0,19,19.0,19
Category_Wikipedia_sockpuppets_of_Agusdominguez.csv,76,16385467.0,31,45,5,26,0,28.473684210526315,169,16,13.052631578947368,9
Category_Wikipedia_sockpuppets_of_Shadowthedog.csv,937,302329442.0,287,650,157,130,0,44.749199573105656,248,48,18.858057630736393,8
Category_Wikipedia_sockpuppets_of_Nortingi.csv,79,196613154.0,24,55,14,10,0,36.392405063291136,231,28,18.0126582278481,3
Category_Wikipedia_sockpuppets_of_JimSmith123.csv,326,57472170.0,155,171,84,71,0,51.82208588957055,253,77,29.16871165644172,15
Category_Wikipedia_sockpuppets_of_Styy4fvtd.csv,1312,34186026.0,341,971,324,17,0,48.09146341463415,451,46,13.330792682926829,3
Category_Wikipedia_sockpuppets_of_Arunmb630.csv,1,0.0,1,0,1,0,0,0.0,0,17,17.0,17
Category_Wikipedia_sockpuppets_of_Aranciodimassimo.csv,19,3457321.0,10,9,10,0,0,36.63157894736842,263,14,12.526315789473685,7
Category_Wikipedia_sockpuppets_of_Ghermanovirtual2012.csv,73,28796214.0,17,56,13,4,0,38.6986301369863,231,42,30.027397260273972,10
Category_Wikipedia_sockpuppets_of_Phoenix_man.csv,5706,83009693.0,2098,3608,493,1605,0,56.07746232036453,500,99,27.604626708727654,3
Category_Wikipedia_sockpuppets_of_A&RBoss.csv,515,279569422.0,130,385,86,44,0,49.06019417475728,254,43,20.415533980582524,9
Category_Wikipedia_sockpuppets_of_Minyanalex.csv,364,24541108.0,169,195,149,20,0,29.75,220,45,14.491758241758241,6
Category_Wikipedia_sockpuppets_of_Endingsesame.csv,1172,329244323.0,399,773,160,239,0,48.38993174061434,313,68,21.488054607508534,4
Category_Wikipedia_sockpuppets_of_Roger_Metric.csv,105,107636879.0,21,84,14,7,0,56.25714285714286,248,38,11.904761904761905,4
Category_Wikipedia_sockpuppets_of_Handrem.csv,4908,135624052.0,1126,3782,255,871,0,39.775061124694375,250,77,17.747758761206192,3
Category_Wikipedia_sockpuppets_of_WarriorYt43.csv,199,47048240.0,65,134,60,5,0,57.28140703517588,286,53,29.115577889447238,11
Category_Wikipedia_sockpuppets_of_JamalYahiu.csv,120,35880324.0,49,71,49,0,0,43.425,496,48,26.216666666666665,14
Category_Wikipedia_sockpuppets_of_ReadingGossips.csv,256,23143635.0,63,193,36,27,0,41.54296875,261,57,16.7421875,4
Category_Wikipedia_sockpuppets_of_Jethwarp.csv,2659,431498976.0,1000,1659,500,500,0,46.971041745016926,496,87,16.07220759684092,3
Category_Wikipedia_sockpuppets_of_Csacademy123.csv,66,7534125.0,26,40,7,19,0,50.696969696969695,196,53,27.545454545454547,13
Category_Wikipedia_sockpuppets_of_Annakoppad.csv,686,54782288.0,260,426,191,69,0,43.66618075801749,227,65,22.249271137026238,6
Category_Wikipedia_sockpuppets_of_Keveb.csv,1,0.0,1,0,1,0,39,39.0,39,10,10.0,10
Category_Wikipedia_sockpuppets_of_Makgeeky.csv,121,188120.0,42,79,19,23,0,60.3801652892562,252,53,21.99173553719008,13
Category_Wikipedia_sockpuppets_of_Pippoosh.csv,17,2856393.0,7,10,4,3,0,84.0,180,25,12.470588235294118,1
Category_Wikipedia_sockpuppets_of_Stokerbean.csv,334,140946621.0,100,234,78,22,0,44.55688622754491,255,58,28.610778443113773,7
Category_Wikipedia_sockpuppets_of_AsafZalmanov.csv,848,29563490.0,504,344,500,4,0,32.068396226415096,242,25,17.32075471698113,8
Category_Wikipedia_sockpuppets_of_Altenmann.csv,12310,505375434.0,3535,8775,500,3035,0,49.28635255889521,495,99,19.136149471974004,2
Category_Wikipedia_sockpuppets_of_Nuttynittany.csv,30,2683383.0,21,9,5,16,0,90.7,203,11,11.0,11
Category_Wikipedia_sockpuppets_of_Spilled_Galaxy.csv,7,2316.0,3,4,2,1,4,101.71428571428571,243,17,12.857142857142858,8
Category_Wikipedia_sockpuppets_of_Quincywhite2009.csv,280,28432875.0,95,185,21,74,0,52.36071428571429,331,37,19.178571428571427,4
Category_Wikipedia_sockpuppets_of_Burhanhakim99.csv,8,4287405.0,3,5,3,0,0,40.875,88,24,20.875,15
Category_Wikipedia_sockpuppets_of_Benhx.csv,49,274523.0,20,29,10,10,0,47.40816326530612,250,37,18.73469387755102,10
Category_Wikipedia_sockpuppets_of_Sargon_dankha.csv,4,1165.0,3,1,2,1,0,34.5,110,26,22.0,18
Category_Wikipedia_sockpuppets_of_Meredithw2008.csv,219,64233984.0,75,144,42,33,0,57.945205479452056,387,43,16.84474885844749,11
Category_Wikipedia_sockpuppets_of_Iamronit.csv,29,21697011.0,16,13,8,8,0,53.172413793103445,446,21,16.24137931034483,13
Category_Wikipedia_sockpuppets_of_Thrillmecd.csv,132,3391364.0,66,66,63,3,0,29.416666666666668,227,40,15.590909090909092,9
Category_Wikipedia_sockpuppets_of_Shafi674838393939.csv,762,23401131.0,275,487,253,22,0,29.75984251968504,563,41,16.669291338582678,6
Category_Wikipedia_sockpuppets_of_Vee8Njinn.csv,32,62313.0,23,9,9,14,0,56.53125,199,50,18.5625,10
Category_Wikipedia_sockpuppets_of_Damanpreet_Singh_Kamboj.csv,116,2917787.0,59,57,32,27,0,32.974137931034484,357,13,8.155172413793103,5
Category_Wikipedia_sockpuppets_of_Eyeeguy.csv,7,2513.0,5,2,2,3,9,44.714285714285715,121,15,15.0,15
Category_Wikipedia_sockpuppets_of_AuroraOllie.csv,125,4808744.0,35,90,2,33,0,58.44,359,38,18.184,4
Category_Wikipedia_sockpuppets_of_WiseWik.csv,219,13053698.0,117,102,110,7,0,50.853881278538815,251,19,16.315068493150687,12
Category_Wikipedia_sockpuppets_of_Sravan7.csv,35,453452.0,25,10,21,4,0,16.0,196,15,11.771428571428572,8
Category_Wikipedia_sockpuppets_of_Murrayflynn.csv,845,68333224.0,280,565,111,169,0,39.440236686390534,232,45,16.276923076923076,3
Category_Wikipedia_sockpuppets_of_Nitinjmyers.csv,2,43.0,2,0,2,0,0,0.0,0,19,19.0,19
Category_Wikipedia_sockpuppets_of_Alyssahassan.csv,363,378338715.0,102,261,73,29,0,54.955922865013775,286,45,16.702479338842974,10
Category_Wikipedia_sockpuppets_of_Martini_Lewis_X.csv,1561,44670268.0,648,913,500,148,0,29.43882126841768,296,63,6.7584881486226775,4
Category_Wikipedia_sockpuppets_of_Luaza1313.csv,2246,32316138.0,1069,1177,500,569,0,37.51780943900267,255,61,24.55164737310775,3
Category_Wikipedia_sockpuppets_of_Rahfatsalman.csv,171,27984763.0,60,111,30,30,0,50.590643274853804,255,42,21.0,9
Category_Wikipedia_sockpuppets_of_Momina01.csv,22,600275.0,11,11,6,5,0,30.954545454545453,100,50,43.5,18
Category_Wikipedia_sockpuppets_of_BGMNYC.csv,150,1354402.0,53,97,53,0,0,37.9,200,46,19.12,11
Category_Wikipedia_sockpuppets_of_IamTheLegend.csv,23,3001.0,17,6,9,8,0,29.434782608695652,182,19,19.0,19
Category_Wikipedia_sockpuppets_of_Pixfinderstudio.csv,1,0.0,1,0,1,0,22,22.0,22,21,21.0,21
Category_Wikipedia_sockpuppets_of_ShantaethePirate.csv,631,79336034.0,244,387,18,226,0,53.17274167987322,255,48,21.589540412044375,11
Category_Wikipedia_sockpuppets_of_KunoxTxa.csv,1083,159663388.0,308,775,81,227,0,36.93813481071099,253,52,16.168051708217913,7
Category_Wikipedia_sockpuppets_of_Elie_Abouaoun.csv,70,256878.0,66,4,64,2,0,12.357142857142858,196,24,23.02857142857143,23
Category_Wikipedia_sockpuppets_of_Hitwe.csv,29,170458433.0,11,18,8,3,0,55.206896551724135,326,21,17.06896551724138,15
Category_Wikipedia_sockpuppets_of_Yonmei.csv,1612,521038391.0,526,1086,500,26,0,54.16315136476427,492,72,20.456575682382134,7
Category_Wikipedia_sockpuppets_of_Steve15893.csv,11,761074.0,7,4,7,0,15,37.36363636363637,122,49,32.27272727272727,3
Category_Wikipedia_sockpuppets_of_Trippleact.csv,357,5780079.0,219,138,180,39,0,30.829131652661065,213,65,16.7703081232493,4
Category_Wikipedia_sockpuppets_of_Naegurnaegur.csv,6,169200.0,5,1,2,3,0,44.5,123,29,29.0,29
Category_Wikipedia_sockpuppets_of_Antivandbot_ng.csv,16,618.0,7,9,4,3,0,33.375,134,28,21.875,19
Category_Wikipedia_sockpuppets_of_Martinevans123.csv,1954,260265958.0,548,1406,500,48,0,56.75793244626407,496,54,17.880245649948822,4
Category_Wikipedia_sockpuppets_of_Sattriyacritic.csv,25,737402.0,12,13,8,4,3,45.44,202,40,16.4,8
Category_Wikipedia_sockpuppets_of_Faizanhb2.csv,544,60037297.0,166,378,123,43,0,50.1672794117647,255,65,18.040441176470587,6
Category_Wikipedia_sockpuppets_of_Tamsin_Kendra.csv,6,1037090.0,3,3,3,0,28,92.66666666666667,196,23,21.333333333333332,18
Category_Wikipedia_sockpuppets_of_Drug15243.csv,17,2723759.0,9,8,5,4,0,103.88235294117646,496,52,19.294117647058822,11
Category_Wikipedia_sockpuppets_of_Wikidawg11.csv,991,33869584.0,335,656,38,297,0,48.52472250252271,255,60,20.300706357214935,6
Category_Wikipedia_sockpuppets_of_De_la_lombertie.csv,32,81030492.0,10,22,7,3,0,53.8125,179,27,17.15625,11
Category_Wikipedia_sockpuppets_of_Brunodam.csv,12911,511903372.0,4526,8385,500,4026,0,38.09960498799473,494,76,20.635736968476493,3
Category_Wikipedia_sockpuppets_of_Alex_Olaru.csv,494,4290256.0,145,349,113,32,0,43.81578947368421,254,56,20.795546558704455,4
Category_Wikipedia_sockpuppets_of_A29298.csv,114,474289.0,45,69,42,3,0,44.35964912280702,264,34,14.587719298245615,6
Category_Wikipedia_sockpuppets_of_Contentwriter.FJDC.csv,49,1283898.0,29,20,28,1,0,42.857142857142854,305,54,26.040816326530614,9
Category_Wikipedia_sockpuppets_of_Chinatravelexpert.csv,562,23081965.0,120,442,23,97,0,38.944839857651246,221,42,11.848754448398576,5
Category_Wikipedia_sockpuppets_of_Nyc2354.csv,368,21600761.0,131,237,26,105,0,39.932065217391305,244,30,15.483695652173912,5
Category_Wikipedia_sockpuppets_of_Satyam7252.csv,180,100999051.0,36,144,10,26,0,62.522222222222226,255,32,15.872222222222222,6
Category_Wikipedia_sockpuppets_of_Gregagentx.csv,95,92947847.0,25,70,17,8,0,38.63157894736842,177,41,19.178947368421053,6
Category_Wikipedia_sockpuppets_of_Kingsman3.csv,2990,15340223.0,1012,1978,500,512,0,38.927424749163876,496,59,17.934782608695652,2
Category_Wikipedia_sockpuppets_of_Editor2433986.csv,718,38012015.0,225,493,198,27,0,45.061281337047355,496,56,17.050139275766018,6
Category_Wikipedia_sockpuppets_of_Doctor987654.csv,342,6878856.0,121,221,66,55,0,49.8187134502924,424,53,23.64327485380117,5
Category_Wikipedia_sockpuppets_of_Juliofcruz0902.csv,50,17638.0,20,30,15,5,0,40.22,183,28,10.9,4
Category_Wikipedia_sockpuppets_of_Hananmuzaffar123.csv,335,28273694.0,116,219,43,73,0,39.25373134328358,247,42,18.18507462686567,8
Category_Wikipedia_sockpuppets_of_Senah20.csv,3,33691.0,3,0,2,1,0,0.0,0,9,9.0,9
Category_Wikipedia_sockpuppets_of_Bryanf222.csv,348,62892024.0,112,236,51,61,0,53.67816091954023,254,29,16.770114942528735,4
Category_Wikipedia_sockpuppets_of_Television_Radio.csv,891,11035420.0,326,565,215,111,0,51.87317620650954,255,90,17.937149270482603,5
Category_Wikipedia_sockpuppets_of_Risav1994.csv,15,947505.0,11,4,11,0,0,11.8,70,19,18.333333333333332,14
Category_Wikipedia_sockpuppets_of_Ethanjesse.csv,414,40851674.0,135,279,114,21,0,44.94444444444444,255,63,29.756038647342994,4
Category_Wikipedia_sockpuppets_of_Inhwiki.csv,83,1036007.0,48,35,19,29,0,31.91566265060241,197,43,27.650602409638555,3
Category_Wikipedia_sockpuppets_of_UnknownlabLA.csv,1,0.0,1,0,1,0,18,18.0,18,22,22.0,22
Category_Wikipedia_sockpuppets_of_RamKaran_Parjapati.csv,367,41418949.0,121,246,104,17,0,42.16348773841962,239,47,19.267029972752045,7
Category_Wikipedia_sockpuppets_of_Alak_Kumar_Buragohain.csv,2,0.0,1,1,1,0,92,92.0,92,14,14.0,14
Category_Wikipedia_sockpuppets_of_Jeffrey_Vernon_Merkey.csv,2153,102598325.0,833,1320,500,333,0,41.331630283325595,250,93,24.715281003251278,3
Category_Wikipedia_sockpuppets_of_Axjuo.csv,2067,2931038.0,1000,1067,500,500,0,22.74600870827286,495,69,29.18577648766328,8
Category_Wikipedia_sockpuppets_of_Kesha495.csv,1522,1659932.0,562,960,335,227,0,33.084756898817346,233,60,24.134034165571617,8
Category_Wikipedia_sockpuppets_of_Ewok_Slayer.csv,1632,96385529.0,507,1125,500,7,0,36.72610294117647,213,79,22.207720588235293,1
Category_Wikipedia_sockpuppets_of_Hodder_Consumer.csv,207,10209029.0,69,138,45,24,0,40.43961352657005,243,44,18.73913043478261,10
Category_Wikipedia_sockpuppets_of_Kaepertank.csv,799,31996465.0,314,485,116,198,0,53.51814768460576,395,54,20.207759699624532,4
Category_Wikipedia_sockpuppets_of_Rupturestriker.csv,1514,4654769.0,526,988,500,26,0,38.14200792602378,338,62,22.097093791281374,3
Category_Wikipedia_sockpuppets_of_Macer75.csv,172,8859527.0,58,114,52,6,0,58.68604651162791,254,51,15.738372093023257,5
Category_Wikipedia_sockpuppets_of_Infosyshof.csv,2,0.0,1,1,1,0,28,28.0,28,48,48.0,48
Category_Wikipedia_sockpuppets_of_MultiMrWeb.csv,456,172547108.0,134,322,69,65,0,53.82017543859649,252,89,22.844298245614034,4
Category_Wikipedia_sockpuppets_of_Gaya_pinddaan.csv,2,0.0,1,1,1,0,27,27.0,27,19,19.0,19
Category_Wikipedia_sockpuppets_of_Joezone23.csv,657,8509381.0,209,448,104,105,0,31.80365296803653,217,55,19.26027397260274,3
Category_Wikipedia_sockpuppets_of_Dr._Seaweed.csv,588,2592626.0,233,355,91,142,0,51.14965986394558,199,47,21.918367346938776,4
Category_Wikipedia_sockpuppets_of_Username1234567891011.csv,725,4066803.0,190,535,100,90,0,50.744827586206895,240,70,23.297931034482758,3
Category_Wikipedia_sockpuppets_of_Lordship888.csv,907,65046783.0,371,536,369,2,0,82.95259095920618,519,56,25.971334068357223,7
Category_Wikipedia_sockpuppets_of_Gun_Lover.csv,3936,224768700.0,1209,2727,500,709,0,52.46697154471545,500,51,14.558689024390244,3
Category_Wikipedia_sockpuppets_of_Ghost_of_the_haunted_restaurant.csv,96,1911141.0,32,64,9,23,0,61.854166666666664,356,47,36.458333333333336,14
Category_Wikipedia_sockpuppets_of_Fizikanauk.csv,2588,361860805.0,682,1906,500,182,0,46.36360123647604,479,77,30.583848531684698,5
Category_Wikipedia_sockpuppets_of_Guipuscoa.csv,375,2102572.0,107,268,23,84,0,48.304,250,33,18.450666666666667,6
Category_Wikipedia_sockpuppets_of_Legendraid.csv,432,9853493.0,146,286,79,67,0,49.38194444444444,255,41,14.032407407407407,4
Category_Wikipedia_sockpuppets_of_Inversiveskills2021.csv,237,4492334.0,76,161,46,30,0,41.88607594936709,294,43,19.11392405063291,6
Category_Wikipedia_sockpuppets_of_Angelone7749.csv,512,388881904.0,196,316,187,9,0,65.1015625,343,68,27.154296875,3
Category_Wikipedia_sockpuppets_of_Arisedrew.csv,3826,419851320.0,1146,2680,500,646,0,43.81625718766335,323,91,21.284108729743856,1
Category_Wikipedia_sockpuppets_of_Mansourramis.csv,1698,11131983.0,876,822,500,376,0,30.62073027090695,234,53,25.111896348645466,10
Category_Wikipedia_sockpuppets_of_Tranhaidang1993.csv,725,33801698.0,329,396,181,148,0,25.888275862068966,491,60,34.29931034482759,7
Category_Wikipedia_sockpuppets_of_DSearle63.csv,30,668852.0,16,14,4,12,20,38.8,112,47,43.7,43
Category_Wikipedia_sockpuppets_of_Mastermind_of_jigsaw_puzzles.csv,27,3064.0,15,12,11,4,0,34.629629629629626,147,54,33.96296296296296,21
Category_Wikipedia_sockpuppets_of_Kurdiyate352.csv,5099,192437793.0,1509,3590,500,1009,0,51.18591880760933,500,48,14.115316728770347,4
Category_Wikipedia_sockpuppets_of_Abhaybeniwalreengus.csv,3041,29169263.0,967,2074,500,467,0,47.33969089115423,500,62,16.60933903321276,4
Category_Wikipedia_sockpuppets_of_Smithsonutivich.csv,7,966436.0,4,3,3,1,0,66.0,229,25,19.428571428571427,12
Category_Wikipedia_sockpuppets_of_KendallandLogan.csv,53,907634.0,28,25,26,2,0,38.471698113207545,222,26,15.20754716981132,9
Category_Wikipedia_sockpuppets_of_Tunoapeggy.csv,54,20313526.0,20,34,10,10,0,51.2962962962963,213,40,16.537037037037038,11
Category_Wikipedia_sockpuppets_of_Ndtv11.csv,33,539096.0,14,19,9,5,0,39.81818181818182,91,33,20.0,5
Category_Wikipedia_sockpuppets_of_Holmes0.csv,95,133996149.0,78,17,78,0,0,22.821052631578947,221,17,14.189473684210526,14
Category_Wikipedia_sockpuppets_of_Camdens4eva.csv,13,16227970.0,5,8,1,4,14,37.15384615384615,151,29,29.0,29
Category_Wikipedia_sockpuppets_of_Alinob77.csv,128,425200.0,52,76,34,18,0,27.53125,182,44,28.3125,11
Category_Wikipedia_sockpuppets_of_S√°nchezgiallorrossi99.csv,369,1179705.0,194,175,192,2,0,32.59620596205962,245,31,14.257452574525745,5
Category_Wikipedia_sockpuppets_of_AzUrArInG.csv,638,67157778.0,219,419,183,36,0,45.52194357366771,355,49,20.891849529780565,4
Category_Wikipedia_sockpuppets_of_Shyguy1991.csv,1917,8027786.0,754,1163,500,254,0,24.639019300991134,240,58,18.327595200834637,6
Category_Wikipedia_sockpuppets_of_Ratherbe2000.csv,1452,17334063.0,539,913,500,39,0,51.39325068870524,353,58,22.356060606060606,4
Category_Wikipedia_sockpuppets_of_Sangiinyam.csv,25,54816450.0,9,16,9,0,0,48.52,243,26,20.6,13
Category_Wikipedia_sockpuppets_of_Italways.csv,44,182526.0,21,23,11,10,0,56.22727272727273,199,21,11.386363636363637,4
Category_Wikipedia_sockpuppets_of_Bosnie1991.csv,414,7436926.0,129,285,40,89,0,52.94202898550725,343,38,15.028985507246377,6
Category_Wikipedia_sockpuppets_of_Donthreatenme.csv,29,524496.0,12,17,11,1,0,41.06896551724138,205,23,18.24137931034483,17
Category_Wikipedia_sockpuppets_of_User_28062F033EOF457DC93EEFAABBET2C3.csv,130,8781195.0,59,71,24,35,0,52.50769230769231,496,53,33.38461538461539,11
Category_Wikipedia_sockpuppets_of_Firety16.csv,642,2941209.0,269,373,242,27,0,40.79595015576324,262,47,21.327102803738317,4
Category_Wikipedia_sockpuppets_of_Ramin_farvahar.csv,117,1289411.0,46,71,39,7,0,46.401709401709404,191,52,21.128205128205128,7
Category_Wikipedia_sockpuppets_of_Xgmx.csv,2316,111355752.0,659,1657,346,313,0,37.06649395509499,248,71,20.65414507772021,3
Category_Wikipedia_sockpuppets_of_Rcardiffcity27.csv,1945,21954237.0,560,1385,467,93,0,28.79331619537275,234,40,18.62776349614396,7
Category_Wikipedia_sockpuppets_of_Theactingeeker.csv,2022,49510677.0,733,1289,469,264,0,35.75173095944609,255,78,18.8135509396637,5
Category_Wikipedia_sockpuppets_of_Geebage2012.csv,9,1940.0,7,2,3,4,0,41.0,164,29,26.333333333333332,17
Category_Wikipedia_sockpuppets_of_Anamariaaa211.csv,49,1541939.0,25,24,15,10,0,33.51020408163265,131,63,28.93877551020408,17
Category_Wikipedia_sockpuppets_of_Eranrabl.csv,1324,211265312.0,537,787,500,37,0,41.44259818731118,438,71,20.736404833836858,3
Category_Wikipedia_sockpuppets_of_A._Roderick-Grove.csv,543,156878973.0,197,346,140,57,0,63.255985267034994,498,51,22.92817679558011,10
Category_Wikipedia_sockpuppets_of_Diva166.csv,3272,32718533.0,1345,1927,427,918,0,26.26619804400978,396,39,21.167176039119806,6
Category_Wikipedia_sockpuppets_of_Harsh7agl.csv,546,98767763.0,169,377,103,66,0,45.52564102564103,316,70,20.485347985347985,5
Category_Wikipedia_sockpuppets_of_Hsn11988.csv,435,1656607.0,221,214,201,20,0,28.944827586206898,196,40,16.163218390804598,8
Category_Wikipedia_sockpuppets_of_Hskaup.csv,12,91390.0,10,2,10,0,0,59.916666666666664,103,57,21.333333333333332,6
Category_Wikipedia_sockpuppets_of_Deepcruze.csv,2302,226269996.0,706,1596,500,206,0,47.870112945264985,367,56,21.70330147697654,3
Category_Wikipedia_sockpuppets_of_Zeumic.csv,195,9149215.0,82,113,70,12,0,47.37435897435898,193,51,32.47179487179487,16
Category_Wikipedia_sockpuppets_of_Wilomina.csv,31,288675.0,17,14,7,10,0,23.322580645161292,199,64,41.38709677419355,13
Category_Wikipedia_sockpuppets_of_Guy47268473648.csv,1,0.0,1,0,1,0,0,0.0,0,19,19.0,19
Category_Wikipedia_sockpuppets_of_ÿ≠ÿßÿ±ÿ´_ÿ≥€åŸÜ_ÿÆ€åŸÑ_ÿ®ŸÑ⁄Ü.csv,58,18141236.0,21,37,16,5,0,33.327586206896555,135,53,22.25862068965517,7
Category_Wikipedia_sockpuppets_of_Brandywine589.csv,199,70251308.0,92,107,89,3,0,54.84924623115578,251,27,21.507537688442213,15
Category_Wikipedia_sockpuppets_of_Arsan_Faris.csv,5684,29736234.0,1921,3763,500,1421,0,32.344123856439126,499,53,16.93103448275862,4
Category_Wikipedia_sockpuppets_of_Whlrradio.csv,299,153609751.0,90,209,90,0,0,49.23076923076923,238,37,20.665551839464882,11
Category_Wikipedia_sockpuppets_of_Jeet_Chandan.csv,9,20679.0,6,3,6,0,0,55.111111111111114,496,18,18.0,18
Category_Wikipedia_sockpuppets_of_Brandon_Smith121.csv,255,32275349.0,81,174,29,52,0,69.45098039215686,317,26,12.301960784313726,3
Category_Wikipedia_sockpuppets_of_Polyoxy.csv,145,33442966.0,49,96,25,24,0,68.78620689655172,445,25,13.744827586206897,8
Category_Wikipedia_sockpuppets_of_Anarayan.csv,175,233869096.0,35,140,34,1,0,66.93714285714286,255,31,16.268571428571427,10
Category_Wikipedia_sockpuppets_of_YouNeedToCalm.csv,1962,29311023.0,640,1322,500,140,0,41.49796126401631,500,75,24.56269113149847,3
Category_Wikipedia_sockpuppets_of_Rajarano100.csv,79,12016508.0,27,52,12,15,0,36.22784810126582,215,33,20.253164556962027,4
Category_Wikipedia_sockpuppets_of_Timothy_Sheridan.csv,327,67053309.0,113,214,57,56,0,46.825688073394495,227,50,22.960244648318042,5
Category_Wikipedia_sockpuppets_of_CharlesFinnegan.csv,38,10293.0,15,23,15,0,0,49.18421052631579,162,50,44.5,16
Category_Wikipedia_sockpuppets_of_Acunli_45.csv,788,197952461.0,164,624,109,55,0,41.642131979695435,255,50,12.365482233502538,4
Category_Wikipedia_sockpuppets_of_Highkeyflair.csv,237,96327889.0,69,168,15,54,0,39.029535864978904,200,48,22.063291139240505,11
Category_Wikipedia_sockpuppets_of_Saakaryadav.csv,90,3154653.0,51,39,45,6,0,26.266666666666666,245,39,26.122222222222224,13
Category_Wikipedia_sockpuppets_of_Sans-editor-swap.csv,41,36646040.0,10,31,8,2,0,64.09756097560975,226,29,13.951219512195122,5
Category_Wikipedia_sockpuppets_of_Melonsofas.csv,494,3853683.0,164,330,109,55,0,37.558704453441294,255,48,22.663967611336034,7
Category_Wikipedia_sockpuppets_of_CorinaN.csv,7,87063.0,5,2,5,0,19,25.571428571428573,29,43,35.857142857142854,18
Category_Wikipedia_sockpuppets_of_SurvivorFanHH.csv,85,599668.0,33,52,19,14,0,39.470588235294116,194,68,45.35294117647059,14
Category_Wikipedia_sockpuppets_of_InScaneYT.csv,19,30396843.0,7,12,2,5,0,64.47368421052632,200,20,18.105263157894736,12
Category_Wikipedia_sockpuppets_of_Hellowrd.csv,218,51932729.0,60,158,40,20,0,41.21559633027523,275,42,14.73394495412844,4
Category_Wikipedia_sockpuppets_of_Kaldari.csv,1873,316834797.0,504,1369,500,4,0,62.051788574479446,480,62,20.22851041110518,3
Category_Wikipedia_sockpuppets_of_Nanorlb.csv,1418,70833352.0,606,812,497,109,0,43.29055007052186,233,58,19.582510578279265,5
Category_Wikipedia_sockpuppets_of_The_Rusty_Trombone.csv,86,12858996.0,26,60,6,20,0,52.0,173,65,29.13953488372093,16
Category_Wikipedia_sockpuppets_of_Sinbad_Barron.csv,9472,139543764.0,2243,7229,500,1743,0,41.561866554054056,250,62,16.28684543918919,3
Category_Wikipedia_sockpuppets_of_Mjabran2012.csv,1332,799585.0,488,844,218,270,0,39.716966966966964,255,39,15.75075075075075,5
Category_Wikipedia_sockpuppets_of_KBBY2019.csv,322,98128812.0,209,113,192,17,0,63.0527950310559,496,33,15.816770186335404,7
Category_Wikipedia_sockpuppets_of_Sharmila_ValueLicensing.csv,4,424108.0,3,1,2,1,0,8.75,35,33,27.5,22
Category_Wikipedia_sockpuppets_of_Grayrocks.csv,10,1142.0,6,4,3,3,8,28.0,145,43,21.4,4
Category_Wikipedia_sockpuppets_of_Gotica.csv,399,3109974.0,174,225,174,0,0,50.01754385964912,196,29,18.68421052631579,9
Category_Wikipedia_sockpuppets_of_SmoothieFacePvP.csv,8,104177.0,7,1,5,2,0,20.0,160,12,12.0,12
Category_Wikipedia_sockpuppets_of_IaiIa123.csv,362,5438451.0,144,218,53,91,0,51.5939226519337,267,53,21.116022099447513,11
Category_Wikipedia_sockpuppets_of_PerfectEditor.csv,200,59394838.0,73,127,51,22,0,40.15,234,63,23.83,8
Category_Wikipedia_sockpuppets_of_L3l4l5926.csv,170,65492908.0,90,80,90,0,0,45.07058823529412,519,48,17.694117647058825,2
Category_Wikipedia_sockpuppets_of_Bonejack.csv,10,20578.0,8,2,4,4,0,54.9,200,19,17.6,13
Category_Wikipedia_sockpuppets_of_KanaKaNn.csv,64,667575.0,21,43,11,10,0,45.90625,271,46,23.78125,18
Category_Wikipedia_sockpuppets_of_Mon29dec.csv,41,1003118.0,17,24,12,5,0,75.34146341463415,200,20,15.292682926829269,10
Category_Wikipedia_sockpuppets_of_Mmathan.actor.csv,135,1021874.0,56,79,25,31,0,47.54814814814815,201,53,20.42962962962963,6
Category_Wikipedia_sockpuppets_of_Andiar.rohnds.csv,1263,41316675.0,483,780,401,82,0,46.99604117181315,253,58,24.209817893903406,4
Category_Wikipedia_sockpuppets_of_DonaldDuck.csv,1368,87522356.0,500,868,500,0,0,40.978070175438596,247,74,19.885964912280702,5
Category_Wikipedia_sockpuppets_of_Arunkapadia.csv,165,36347107.0,67,98,30,37,0,42.18787878787879,233,49,19.575757575757574,10
Category_Wikipedia_sockpuppets_of_Hollathag.csv,264,160864721.0,89,175,81,8,0,35.81060606060606,250,67,18.200757575757574,7
Category_Wikipedia_sockpuppets_of_Thedarkman.csv,490,89427081.0,134,356,120,14,0,42.648979591836735,200,69,17.616326530612245,7
Category_Wikipedia_sockpuppets_of_John_Freestone.csv,158,700026.0,73,85,73,0,0,58.74683544303797,200,52,21.575949367088608,12
Category_Wikipedia_sockpuppets_of_OnceaMetro.csv,6054,260935358.0,1507,4547,475,1032,0,44.32672613148332,255,80,15.06425503799141,4
Category_Wikipedia_sockpuppets_of_GodblesstheUSA.csv,6,75386.0,4,2,2,2,0,45.166666666666664,152,28,28.0,28
Category_Wikipedia_sockpuppets_of_Keyboard_of_list.csv,102,11752403.0,49,53,36,13,0,40.294117647058826,303,35,21.784313725490197,3
Category_Wikipedia_sockpuppets_of_Shadow_grunt.csv,55,2687826.0,12,43,9,3,0,56.38181818181818,220,22,10.654545454545454,3
Category_Wikipedia_sockpuppets_of_LIGerasimova.csv,333,2856158.0,135,198,47,88,0,30.585585585585587,200,61,21.984984984984983,9
Category_Wikipedia_sockpuppets_of_Esptest.csv,34,11909807.0,12,22,2,10,0,54.470588235294116,165,23,17.41176470588235,13
Category_Wikipedia_sockpuppets_of_Ashdeepx.csv,82,191808.0,60,22,47,13,0,27.951219512195124,234,24,11.817073170731707,10
Category_Wikipedia_sockpuppets_of_Sprinyuokko.csv,114,5097359.0,55,59,11,44,0,54.08771929824562,210,59,15.903508771929825,4
Category_Wikipedia_sockpuppets_of_Joreyan.csv,5123,12791633.0,1540,3583,135,1405,0,38.70525082959204,414,60,14.142299433925434,3
Category_Wikipedia_sockpuppets_of_Eyoab.csv,526,12075527.0,195,331,94,101,0,53.465779467680605,354,64,17.568441064638783,5
Category_Wikipedia_sockpuppets_of_Dove's_talk.csv,3444,6444949.0,1000,2444,500,500,0,75.05632984901277,494,59,23.64576074332172,3
Category_Wikipedia_sockpuppets_of_Tintinthereporter226.csv,1205,17858155.0,416,789,359,57,0,48.97925311203319,500,78,24.665560165975105,5
Category_Wikipedia_sockpuppets_of_Yingyangyingyang.csv,18,30850.0,9,9,4,5,0,75.66666666666667,194,17,17.0,17
Category_Wikipedia_sockpuppets_of_Sandipan1997.csv,92,1047920.0,25,67,22,3,0,63.26086956521739,302,53,23.641304347826086,5
Category_Wikipedia_sockpuppets_of_SSS108.csv,1316,90168449.0,503,813,500,3,0,47.64209726443769,219,66,27.780395136778115,11
Category_Wikipedia_sockpuppets_of_Nutritiondept.csv,8,11072435.0,8,0,6,2,11,46.875,153,70,57.375,17
Category_Wikipedia_sockpuppets_of_Kido56.csv,71,17839017.0,31,40,29,2,0,47.267605633802816,205,29,15.633802816901408,11
Category_Wikipedia_sockpuppets_of_Sebanfernu.csv,149,87713695.0,48,101,38,10,0,29.268456375838927,209,27,16.812080536912752,7
Category_Wikipedia_sockpuppets_of_JoyceRachelVarghese.csv,72,1731940.0,20,52,13,7,0,74.43055555555556,249,25,13.51388888888889,4
Category_Wikipedia_sockpuppets_of_Qmart007.csv,98,22278501.0,29,69,16,13,0,51.39795918367347,302,54,26.806122448979593,12
Category_Wikipedia_sockpuppets_of_Samuel_So.csv,298,244779620.0,123,175,106,17,0,48.7248322147651,218,58,21.26510067114094,8
Category_Wikipedia_sockpuppets_of_Slaylordaniel13.csv,648,12242160.0,216,432,185,31,0,41.46913580246913,247,55,18.51388888888889,9
Category_Wikipedia_sockpuppets_of_Monterrosa.csv,3475,25052583.0,926,2549,500,426,0,42.68115107913669,255,85,17.81928057553957,5
Category_Wikipedia_sockpuppets_of_Msclockwatcher.csv,389,173148121.0,105,284,28,77,0,50.2185089974293,255,48,19.866323907455012,6
Category_Wikipedia_sockpuppets_of_Fact-China.csv,177,7215930.0,166,11,134,32,0,3.8926553672316384,168,13,13.0,13
Category_Wikipedia_sockpuppets_of_ReturnEpicLegendz.csv,36,7856945.0,8,28,5,3,0,68.33333333333333,233,19,12.055555555555555,8
Category_Wikipedia_sockpuppets_of_Poppystyles11.csv,5,170.0,2,3,1,1,0,53.6,127,14,9.2,6
Category_Wikipedia_sockpuppets_of_Hackshorrorshow.csv,7,7497.0,5,2,3,2,0,39.857142857142854,136,29,13.571428571428571,11
Category_Wikipedia_sockpuppets_of_Ashiyura.csv,3482,94012733.0,1000,2482,500,500,0,64.04853532452613,500,56,18.41815048822516,5
Category_Wikipedia_sockpuppets_of_Snyderisgod.csv,14,211927.0,9,5,9,0,8,73.28571428571429,194,16,16.0,16
Category_Wikipedia_sockpuppets_of_Richardmoore1.csv,83,42004914.0,34,49,7,27,0,45.51807228915663,243,29,15.783132530120483,7
Category_Wikipedia_sockpuppets_of_Lucio_Scatola.csv,105,105752199.0,50,55,39,11,0,73.82857142857142,431,26,15.019047619047619,12
Category_Wikipedia_sockpuppets_of_Levelaunt.csv,1970,20633403.0,582,1388,25,557,0,39.12030456852792,452,69,21.620304568527917,4
Category_Wikipedia_sockpuppets_of_JonathanMarkOfVirginia.csv,147,4437152.0,64,83,54,10,0,72.66666666666667,471,35,21.01360544217687,10
Category_Wikipedia_sockpuppets_of_Poopmaster2006.csv,14,6216852.0,7,7,5,2,0,46.57142857142857,134,22,21.142857142857142,20
Category_Wikipedia_sockpuppets_of_Aravindhan_Mangaashery.csv,5,1874.0,3,2,3,0,19,59.0,82,34,34.0,34
Category_Wikipedia_sockpuppets_of_Lelouch_Di_Britannia.csv,919,341826889.0,320,599,217,103,0,53.330794341675734,415,51,23.837867247007615,6
Category_Wikipedia_sockpuppets_of_StopEdJohnston2016.csv,21,2607.0,10,11,7,3,0,57.666666666666664,151,47,33.904761904761905,19
Category_Wikipedia_sockpuppets_of_Miraclelyricalrappinglyricalmiracle.csv,9,864.0,4,5,4,0,0,98.77777777777777,230,19,8.88888888888889,6
Category_Wikipedia_sockpuppets_of_Repairman745.csv,80,40071698.0,24,56,15,9,0,45.3125,193,71,33.8125,14
Category_Wikipedia_sockpuppets_of_AmMasters.csv,523,37400914.0,128,395,55,73,0,49.82791586998088,249,22,13.638623326959847,9
Category_Wikipedia_sockpuppets_of_Riiiiiraa.csv,539,6580866.0,227,312,204,23,0,35.968460111317256,496,26,10.443413729128014,6
Category_Wikipedia_sockpuppets_of_Anselmo00.csv,210,2666986.0,76,134,48,28,0,44.41904761904762,360,42,23.590476190476192,6
Category_Wikipedia_sockpuppets_of_Randhir234.csv,9,199314.0,5,4,4,1,2,19.0,39,45,35.0,15
Category_Wikipedia_sockpuppets_of_Abhishek_shannu.csv,1642,29127569.0,602,1040,304,298,0,42.36784409257004,336,52,16.94640682095006,2
Category_Wikipedia_sockpuppets_of_Kansascitt1225.csv,4506,159409375.0,1164,3342,500,664,0,53.24056813138038,531,50,17.28184642698624,4
Category_Wikipedia_sockpuppets_of_Turkesani.csv,33,689775.0,18,15,8,10,0,24.393939393939394,192,52,30.181818181818183,11
Category_Wikipedia_sockpuppets_of_Yoshi525.csv,438,49859630.0,103,335,29,74,0,28.139269406392692,243,59,19.19634703196347,4
Category_Wikipedia_sockpuppets_of_Tratra22395768.csv,3174,76527120.0,1665,1509,500,1165,0,72.54284814114682,253,73,24.525519848771268,2
Category_Wikipedia_sockpuppets_of_Ccoste.csv,5,125.0,3,2,3,0,0,85.2,199,21,19.0,16
Category_Wikipedia_sockpuppets_of_Anoraker.csv,495,62006056.0,145,350,85,60,0,42.028282828282826,228,45,17.711111111111112,5
Category_Wikipedia_sockpuppets_of_BobH63.csv,11,190545.0,9,2,6,3,0,62.18181818181818,168,9,9.0,9
Category_Wikipedia_sockpuppets_of_Dawgsnlocust.csv,14,812951.0,5,9,4,1,0,74.92857142857143,245,33,21.642857142857142,14
Category_Wikipedia_sockpuppets_of_Abhinavpoonia.csv,39,191200894.0,14,25,14,0,0,51.17948717948718,179,56,27.641025641025642,17
Category_Wikipedia_sockpuppets_of_Saudi_arabia_123456.csv,9,178156.0,6,3,3,3,0,52.666666666666664,173,22,13.444444444444445,11
Category_Wikipedia_sockpuppets_of_Flegelpuss.csv,731,18691260.0,240,491,199,41,0,55.80027359781122,246,51,29.44733242134063,5
Category_Wikipedia_sockpuppets_of_Euclidthalis.csv,1809,118897628.0,552,1257,500,52,0,43.110558319513544,255,70,21.377003869541184,4
Category_Wikipedia_sockpuppets_of_Betty262728.csv,398,1976740.0,144,254,79,65,0,30.34170854271357,279,45,26.12562814070352,6
Category_Wikipedia_sockpuppets_of_Tusiplatinum.csv,41,324258.0,33,8,24,9,0,76.09756097560975,441,23,16.0,5
Category_Wikipedia_sockpuppets_of_Daremedareyou.csv,32,451973.0,14,18,14,0,0,46.34375,173,23,13.53125,8
Category_Wikipedia_sockpuppets_of_Chris_M_Pattinson.csv,785,58917905.0,307,478,202,105,0,38.045859872611466,255,58,20.337579617834393,8
Category_Wikipedia_sockpuppets_of_Clyide_Harice.csv,7,6334.0,4,3,3,1,0,22.571428571428573,158,6,6.0,6
Category_Wikipedia_sockpuppets_of_PakisOne.csv,903,25304438.0,254,649,149,105,0,42.7641196013289,399,61,18.24141749723145,4
Category_Wikipedia_sockpuppets_of_Jojogungun.csv,333,32463099.0,149,184,126,23,0,67.82882882882883,255,26,13.522522522522523,10
Category_Wikipedia_sockpuppets_of_Etfcanadian.csv,1250,17428293.0,469,781,200,269,0,44.1456,254,57,20.9888,5
Category_Wikipedia_sockpuppets_of_Victor_Salvini.csv,1383,28018608.0,450,933,257,193,0,54.09833694866233,500,59,22.199566160520607,6
Category_Wikipedia_sockpuppets_of_William_Hembrom.csv,11,458746.0,5,6,5,0,0,31.0,62,31,20.636363636363637,17
Category_Wikipedia_sockpuppets_of_PerfectlyIrrational.csv,8146,74226715.0,2760,5386,500,2260,0,48.31389639086668,500,76,23.535354775349866,5
Category_Wikipedia_sockpuppets_of_Jacob_Hnri_6.csv,1197,96102025.0,392,805,200,192,0,31.80952380952381,255,67,17.483709273182956,3
Category_Wikipedia_sockpuppets_of_MiamiMath.csv,19,259419.0,10,9,9,1,0,43.26315789473684,198,14,10.052631578947368,8
Category_Wikipedia_sockpuppets_of_Georgemachinegun.csv,13,4336481.0,8,5,3,5,0,74.6923076923077,192,5,5.0,5
Category_Wikipedia_sockpuppets_of_Helper3490.csv,65,7768746.0,30,35,16,14,0,38.44615384615385,217,39,16.53846153846154,4
Category_Wikipedia_sockpuppets_of_Mirfishe.csv,1860,191544630.0,627,1233,304,323,0,36.94462365591398,250,53,20.768817204301076,4
Category_Wikipedia_sockpuppets_of_Alexandrababelove.csv,233,1227132.0,118,115,30,88,0,33.892703862660944,227,27,19.7725321888412,10
Category_Wikipedia_sockpuppets_of_Manojvalluri.csv,146,62300752.0,60,86,49,11,0,44.25342465753425,245,35,20.472602739726028,10
Category_Wikipedia_sockpuppets_of_Mrdragon2022.csv,48,4778926.0,27,21,24,3,0,75.54166666666667,311,35,24.270833333333332,9
Category_Wikipedia_sockpuppets_of_0000001Ghost.csv,80,26409298.0,24,56,21,3,0,45.7875,248,24,9.9375,9
Category_Wikipedia_sockpuppets_of_JeezMan9000.csv,131,45008128.0,36,95,24,12,0,63.954198473282446,499,31,12.587786259541986,3
Category_Wikipedia_sockpuppets_of_Pdineen03.csv,1264,25152093.0,441,823,435,6,0,34.475474683544306,239,43,17.871835443037973,7
Category_Wikipedia_sockpuppets_of_A_proud_Tel_Aviver.csv,269,8617290.0,78,191,19,59,0,56.36802973977695,229,66,21.936802973977695,6
Category_Wikipedia_sockpuppets_of_Brandonmlorenz.csv,1,0.0,1,0,1,0,20,20.0,20,25,25.0,25
Category_Wikipedia_sockpuppets_of_Richardbackster.csv,69,2319952.0,25,44,6,19,0,61.6231884057971,223,25,13.304347826086957,6
Category_Wikipedia_sockpuppets_of_Truthdevanga.csv,38,1395018.0,18,20,17,1,0,52.94736842105263,276,21,11.078947368421053,7
Category_Wikipedia_sockpuppets_of_Marvellousugorji.csv,9,4499261.0,3,6,3,0,0,22.22222222222222,94,25,19.666666666666668,9
Category_Wikipedia_sockpuppets_of_UmairYokaimon.csv,773,63449193.0,183,590,154,29,0,40.05433376455369,389,48,15.972833117723157,7
Category_Wikipedia_sockpuppets_of_HoveringTurtle.csv,83,798989.0,37,46,27,10,0,55.0722891566265,237,34,17.53012048192771,4
Category_Wikipedia_sockpuppets_of_King_Sunpiper.csv,95,2401373.0,52,43,13,39,0,33.83157894736842,270,21,13.010526315789473,9
Category_Wikipedia_sockpuppets_of_Royan_journals.csv,14,4999990.0,6,8,4,2,0,66.28571428571429,195,50,35.214285714285715,27
Category_Wikipedia_sockpuppets_of_Darla_Payne.csv,32,602166.0,21,11,6,15,0,42.0,205,18,17.125,14
Category_Wikipedia_sockpuppets_of_Pedro_Silva_Loy.csv,152,7572441.0,73,79,19,54,0,54.88815789473684,255,51,18.967105263157894,6
Category_Wikipedia_sockpuppets_of_Lenny_Kaufman.csv,2318,81413325.0,664,1654,500,164,0,50.63071613459879,255,53,24.98274374460742,3
Category_Wikipedia_sockpuppets_of_Shohagraname.csv,5,2709.0,2,3,1,1,0,80.0,169,18,17.4,17
Category_Wikipedia_sockpuppets_of_Bizovne.csv,519,46236445.0,143,376,82,61,0,50.23506743737958,248,44,16.31791907514451,4
Category_Wikipedia_sockpuppets_of_Wikiuser999120.csv,283,2251279.0,103,180,26,77,0,48.540636042402824,247,50,21.992932862190813,3
Category_Wikipedia_sockpuppets_of_DLM_92.csv,3494,9237848.0,1085,2409,500,585,0,17.09559244419004,217,56,13.670005724098454,2
Category_Wikipedia_sockpuppets_of_Mirrortoamermaid.csv,976,6133972.0,572,404,500,72,0,33.84426229508197,255,68,24.703893442622952,8
Category_Wikipedia_sockpuppets_of_LaughingOutLoud.csv,10,2588.0,6,4,5,1,12,78.8,199,30,21.0,4
Category_Wikipedia_sockpuppets_of_Shylocksboy.csv,1797,26847031.0,522,1275,500,22,0,44.688369504730105,250,67,18.649415692821368,5
Category_Wikipedia_sockpuppets_of_Drodedsweard.csv,89,1006145.0,35,54,25,10,0,60.764044943820224,230,45,28.786516853932586,11
Category_Wikipedia_sockpuppets_of_Tooblatoo.csv,43,21014590.0,15,28,13,2,0,39.02325581395349,385,40,15.86046511627907,6
Category_Wikipedia_sockpuppets_of_Tokarro666.csv,580,4879101.0,240,340,177,63,0,38.68103448275862,235,35,16.18103448275862,4
Category_Wikipedia_sockpuppets_of_Judge1234.csv,585,76136266.0,411,174,318,93,0,24.353846153846153,449,44,15.970940170940171,5
Category_Wikipedia_sockpuppets_of_Enoch22.csv,45,323250728.0,14,31,14,0,0,39.77777777777778,205,21,11.733333333333333,7
Category_Wikipedia_sockpuppets_of_Albanianhistorian123.csv,176,24979738.0,46,130,32,14,0,52.17613636363637,337,41,21.363636363636363,8
Category_Wikipedia_sockpuppets_of_Emcochoclab.csv,1706,357859461.0,715,991,500,215,0,40.15181711606096,318,53,22.033997655334115,11
Category_Wikipedia_sockpuppets_of_Rubykane.csv,298,142953148.0,73,225,66,7,0,55.03020134228188,259,37,13.026845637583893,4
Category_Wikipedia_sockpuppets_of_ResearchEditor.csv,3418,96338712.0,1190,2228,500,690,0,47.79666471620831,249,68,20.482153306026916,4
Category_Wikipedia_sockpuppets_of_Chrisadank13.csv,105,130391061.0,21,84,21,0,0,63.06666666666667,245,30,14.314285714285715,5
Category_Wikipedia_sockpuppets_of_Nightmare991.csv,1,0.0,1,0,1,0,0,0.0,0,40,40.0,40
Category_Wikipedia_sockpuppets_of_Shihan_883.csv,449,4689502.0,196,253,87,109,0,42.632516703786195,200,32,13.347438752783964,4
Category_Wikipedia_sockpuppets_of_Mrr_Fortune.csv,12,4159959.0,7,5,4,3,0,52.833333333333336,196,43,21.333333333333332,13
Category_Wikipedia_sockpuppets_of_Wierzba.csv,3338,280976854.0,1282,2056,500,782,0,54.23996405032954,496,79,19.10485320551228,5
Category_Wikipedia_sockpuppets_of_BX395.csv,4073,28327031.0,1440,2633,500,940,0,49.51166216547999,500,85,15.399705376872085,3
Category_Wikipedia_sockpuppets_of_Jogoblin.csv,557,22655364.0,181,376,74,107,0,39.95511669658887,257,59,22.409335727109514,5
Category_Wikipedia_sockpuppets_of_EHowe.csv,163,33782438.0,47,116,33,14,0,42.59509202453988,244,46,16.337423312883434,7
Category_Wikipedia_sockpuppets_of_Royalty90.csv,459,233206946.0,142,317,72,70,0,38.42483660130719,246,66,23.60566448801743,5
Category_Wikipedia_sockpuppets_of_Cowboy_Rocco.csv,1439,31348799.0,515,924,254,261,0,31.70326615705351,213,45,17.237665045170257,7
Category_Wikipedia_sockpuppets_of_Toriqul_islam_Tusher.csv,66,176113878.0,20,46,12,8,0,50.515151515151516,224,37,24.166666666666668,12
Category_Wikipedia_sockpuppets_of_MegaMan1988.csv,1611,6796068.0,503,1108,500,3,0,56.79329608938548,255,87,21.38175046554935,5
Category_Wikipedia_sockpuppets_of_Patelhera.csv,202,95793842.0,63,139,19,44,0,48.54455445544554,283,49,15.128712871287128,5
Category_Wikipedia_sockpuppets_of_Brich627.csv,498,35453361.0,119,379,49,70,0,44.38353413654618,246,70,21.44578313253012,6
Category_Wikipedia_sockpuppets_of_Itzat94118.csv,547,58675683.0,250,297,213,37,0,52.62522851919561,255,51,17.486288848263253,8
Category_Wikipedia_sockpuppets_of_Paulgorbulski.csv,11,142176.0,8,3,4,4,22,41.54545454545455,113,21,11.727272727272727,9
Category_Wikipedia_sockpuppets_of_Hunterthomassen.csv,17,234741.0,10,7,9,1,0,41.8235294117647,230,24,18.941176470588236,14
Category_Wikipedia_sockpuppets_of_General_kohn1136.csv,21,258596.0,8,13,8,0,2,17.857142857142858,77,24,17.714285714285715,13
Category_Wikipedia_sockpuppets_of_HerbLightman.csv,6023,105637962.0,2358,3665,500,1858,0,40.91549061929271,481,50,18.141291715092148,4
Category_Wikipedia_sockpuppets_of_Tallonator.csv,1046,172507620.0,522,524,500,22,0,47.45411089866157,497,42,22.235181644359464,7
Category_Wikipedia_sockpuppets_of_CenterWatch94.csv,252,33265555.0,89,163,33,56,0,41.67857142857143,228,45,20.599206349206348,7
Category_Wikipedia_sockpuppets_of_Locallegend61999.csv,12,44357.0,7,5,4,3,0,34.333333333333336,169,18,16.666666666666668,16
Category_Wikipedia_sockpuppets_of_Dr_Roots.csv,632,56866521.0,142,490,99,43,0,42.53481012658228,234,50,17.794303797468356,5
Category_Wikipedia_sockpuppets_of_PajamaParty1980.csv,506,31417198.0,166,340,42,124,0,54.56719367588933,255,47,20.565217391304348,7
Category_Wikipedia_sockpuppets_of_Yaneleksklus.csv,2119,6690027.0,693,1426,500,193,0,33.53327041057102,255,62,11.098159509202453,3
Category_Wikipedia_sockpuppets_of_BNParibasguy.csv,627,56227942.0,240,387,136,104,0,56.143540669856456,496,54,19.228070175438596,5
Category_Wikipedia_sockpuppets_of_Memer6000.csv,122,4260895.0,25,97,17,8,0,37.83606557377049,196,27,16.75409836065574,4
Category_Wikipedia_sockpuppets_of_Etiennebaheza.csv,167,63356700.0,62,105,22,40,0,44.946107784431135,226,65,24.32934131736527,6
Category_Wikipedia_sockpuppets_of_Codyfinke.csv,13419,193413289.0,3486,9933,500,2986,0,33.56665921454654,254,70,16.940979208584842,2
Category_Wikipedia_sockpuppets_of_AprilFashion.csv,13,1991.0,6,7,3,3,0,73.6923076923077,159,33,15.615384615384615,6
Category_Wikipedia_sockpuppets_of_Forguese.csv,154,5618795.0,61,93,25,36,0,48.72077922077922,312,26,14.688311688311689,5
Category_Wikipedia_sockpuppets_of_Josh.172.csv,3057,9699797.0,1232,1825,341,891,0,52.583578671900554,397,80,26.007850834151128,1
Category_Wikipedia_sockpuppets_of_Jjmalone.csv,20,9169959.0,17,3,7,10,0,19.1,151,10,10.0,10
Category_Wikipedia_sockpuppets_of_Nadirali.csv,2135,11256140.0,600,1535,500,100,0,33.59953161592506,200,51,19.534426229508195,4
Category_Wikipedia_sockpuppets_of_Viperaz.csv,19,306374.0,13,6,8,5,0,60.526315789473685,160,17,15.105263157894736,15
Category_Wikipedia_sockpuppets_of_LouisRedfern.csv,20,3239651.0,19,1,16,3,0,22.5,189,27,26.2,22
Category_Wikipedia_sockpuppets_of_Dragonfly009.csv,274,70106133.0,104,170,51,53,0,48.697080291970806,255,56,27.35036496350365,4
Category_Wikipedia_sockpuppets_of_Sceptre.csv,2046,554878523.0,756,1290,500,256,0,55.143695014662754,454,76,22.413000977517108,3
Category_Wikipedia_sockpuppets_of_MarquinhosWikipediano.csv,1681,65324777.0,607,1074,500,107,0,61.03926234384295,500,80,28.64069006543724,11
Category_Wikipedia_sockpuppets_of_I_ate_the_cookie.csv,981,32637916.0,290,691,265,25,0,44.33231396534149,226,62,21.28644240570846,5
Category_Wikipedia_sockpuppets_of_NPTruth.csv,160,97084731.0,64,96,57,7,0,66.575,489,43,20.84375,17
Category_Wikipedia_sockpuppets_of_Averybenedictxezonaki.csv,124,3193544.0,80,44,46,34,0,33.36290322580645,204,31,23.508064516129032,11
Category_Wikipedia_sockpuppets_of_ANigg.csv,1497,69375317.0,586,911,500,86,0,35.77955911823647,230,78,27.561122244488978,8
Category_Wikipedia_sockpuppets_of_NickJr_Fanon2021.csv,539,69627126.0,159,380,72,87,0,53.183673469387756,407,47,14.2987012987013,3
Category_Wikipedia_sockpuppets_of_Zaaraalsabihkhan.csv,50,101525824.0,14,36,9,5,0,65.06,255,21,14.88,5
Category_Wikipedia_sockpuppets_of_Neosurfer.csv,59,606596.0,26,33,13,13,0,52.59322033898305,194,26,16.8135593220339,7
Category_Wikipedia_sockpuppets_of_Salman_Ul_Mouzam_Abbasi.csv,3,100.0,3,0,3,0,0,0.0,0,45,45.0,45
Category_Wikipedia_sockpuppets_of_Norprobr.csv,2314,70683048.0,828,1486,500,328,0,51.63094209161625,497,62,20.77009507346586,4
Category_Wikipedia_sockpuppets_of_Gordon24fan.csv,2326,33202041.0,755,1571,388,367,0,33.2914875322442,250,54,16.734307824591575,8
Category_Wikipedia_sockpuppets_of_Jesuboy.csv,115,229419863.0,33,82,29,4,0,75.54782608695652,500,22,14.347826086956522,12
Category_Wikipedia_sockpuppets_of_SajidMir2.csv,3067,12267878.0,867,2200,373,494,0,56.17378545810238,494,72,17.205086403651777,1
Category_Wikipedia_sockpuppets_of_Angogaru.csv,98,122157617.0,27,71,27,0,0,60.39795918367347,278,52,19.23469387755102,6
Category_Wikipedia_sockpuppets_of_Adilswati.csv,2543,65965184.0,845,1698,500,345,0,38.36767597325993,255,65,15.189539913488007,4
Category_Wikipedia_sockpuppets_of_Figure8state.csv,69,2981242.0,18,51,12,6,0,42.14492753623188,251,50,33.68115942028985,14
Category_Wikipedia_sockpuppets_of_Checkorder2.csv,97,591937.0,33,64,17,16,0,46.123711340206185,191,28,21.030927835051546,10
Category_Wikipedia_sockpuppets_of_Bubblegumparade.csv,13,4501741.0,4,9,2,2,0,56.53846153846154,195,28,26.153846153846153,24
Category_Wikipedia_sockpuppets_of_ASHMAN2341.csv,178,18133233.0,55,123,25,30,0,40.949438202247194,220,31,17.589887640449437,10
Category_Wikipedia_sockpuppets_of_Lando247.csv,98,2356823.0,57,41,17,40,0,27.989795918367346,168,43,17.56122448979592,11
Category_Wikipedia_sockpuppets_of_Xetra80.csv,230,5088524.0,83,147,60,23,0,55.16086956521739,211,47,16.769565217391303,7
Category_Wikipedia_sockpuppets_of_Ting_ting12.csv,20,153311931.0,6,14,3,3,0,30.35,191,13,11.8,10
Category_Wikipedia_sockpuppets_of_Xtinadbest.csv,6477,146637154.0,2280,4197,500,1780,0,32.26509186351706,255,58,22.499922803767177,3
Category_Wikipedia_sockpuppets_of_Zestee.csv,1321,155156309.0,673,648,411,262,0,27.85465556396669,247,53,23.26192278576836,9
Category_Wikipedia_sockpuppets_of_Massaromatteo.csv,19,1303286.0,13,6,13,0,0,56.8421052631579,194,26,24.894736842105264,23
Category_Wikipedia_sockpuppets_of_Maxmotives81.csv,509,34293644.0,277,232,222,55,0,29.6188605108055,231,58,25.271119842829076,11
Category_Wikipedia_sockpuppets_of_I_alive.csv,12,492.0,6,6,6,0,0,41.5,202,54,30.666666666666668,19
Category_Wikipedia_sockpuppets_of_Abhinavbpi.csv,4,1631324.0,3,1,2,1,0,29.0,51,20,20.0,20
Category_Wikipedia_sockpuppets_of_Inovannnn.csv,1085,30909315.0,441,644,107,334,0,45.9815668202765,356,52,27.213824884792626,4
Category_Wikipedia_sockpuppets_of_Kiro_Bassem.csv,1617,38007272.0,554,1063,500,54,0,49.02040816326531,384,64,22.92022263450835,4
Category_Wikipedia_sockpuppets_of_RobertRosen.csv,2518,55711030.0,869,1649,500,369,0,49.567116759332805,250,51,24.795869737887212,6
Category_Wikipedia_sockpuppets_of_Henrypenn1.csv,236,269945906.0,54,182,47,7,0,53.36440677966102,255,46,14.584745762711865,6
Category_Wikipedia_sockpuppets_of_Billycohn129.csv,163,31879005.0,49,114,17,32,0,38.74233128834356,254,45,18.2760736196319,6
Category_Wikipedia_sockpuppets_of_RandomManna106.csv,4230,50387108.0,1577,2653,500,1077,0,51.17565011820331,496,79,27.53096926713948,4
Category_Wikipedia_sockpuppets_of_Fathiyimah.csv,358,517997.0,121,237,86,35,0,51.013966480446925,305,37,22.30167597765363,7
Category_Wikipedia_sockpuppets_of_Tricornglish_trikornggriSHwikiY.csv,88,21067862.0,70,18,39,31,0,42.19318181818182,496,44,22.443181818181817,13
Category_Wikipedia_sockpuppets_of_Shubhamshevade.csv,3,71.0,2,1,2,0,30,65.0,135,24,24.0,24
Category_Wikipedia_sockpuppets_of_Cherryy23.csv,216,182405450.0,75,141,51,24,0,43.5787037037037,272,36,17.62962962962963,5
Category_Wikipedia_sockpuppets_of_BCuzwhynot.csv,12599,85066628.0,3188,9411,500,2688,0,50.2449400746091,525,70,17.900309548376857,3
Category_Wikipedia_sockpuppets_of_Revertorium.csv,131,97025.0,43,88,41,2,0,47.43511450381679,228,33,18.46564885496183,6
Category_Wikipedia_sockpuppets_of_Robert599.csv,410,3408567.0,221,189,175,46,0,21.234146341463415,185,50,18.846341463414635,6
Category_Wikipedia_sockpuppets_of_World_wide_wobby.csv,3,208.0,2,1,1,1,16,106.0,194,12,12.0,12
Category_Wikipedia_sockpuppets_of_Umair_Aj.csv,5595,239769575.0,1591,4004,500,1091,0,55.0840035746202,277,59,16.859696157283288,3
Category_Wikipedia_sockpuppets_of_Scarpro.csv,23,2154839.0,16,7,11,5,4,36.43478260869565,101,57,40.21739130434783,6
Category_Wikipedia_sockpuppets_of_Johnyajohn.csv,283,106130095.0,88,195,62,26,0,37.41342756183746,211,49,18.20141342756184,7
Category_Wikipedia_sockpuppets_of_Kikkoman01.csv,233,16325849.0,69,164,51,18,0,44.33476394849785,254,52,16.673819742489272,5
Category_Wikipedia_sockpuppets_of_Iwajidshaikh.csv,77,165232385.0,25,52,16,9,0,50.66233766233766,222,45,21.506493506493506,6
Category_Wikipedia_sockpuppets_of_Daughter_of_Zion.csv,8,154490.0,6,2,4,2,0,37.75,166,26,23.75,23
Category_Wikipedia_sockpuppets_of_Xbox_ltitltitli.csv,16,10973.0,10,6,10,0,0,88.875,199,50,32.625,13
Category_Wikipedia_sockpuppets_of_Trevorconaz.csv,496,11472564.0,120,376,3,117,0,45.935483870967744,254,75,19.518145161290324,3
Category_Wikipedia_sockpuppets_of_Caradoc29105.csv,2454,255081671.0,1008,1446,98,910,0,37.98166259168704,295,56,19.406682966585166,4
Category_Wikipedia_sockpuppets_of_Leed110.csv,757,183180849.0,230,527,128,102,0,46.5442536327609,406,58,24.30118890356671,3
Category_Wikipedia_sockpuppets_of_MontyIsInnocent.csv,17,414338.0,10,7,5,5,0,56.64705882352941,166,20,18.705882352941178,12
Category_Wikipedia_sockpuppets_of_FF_toho.csv,402,60391758.0,111,291,110,1,0,54.08457711442786,393,62,25.181592039800996,2
Category_Wikipedia_sockpuppets_of_LMDsl.csv,2,0.0,1,1,1,0,32,32.0,32,28,28.0,28
Category_Wikipedia_sockpuppets_of_Prince-au-L√©og√¢ne.csv,626,152219019.0,189,437,79,110,0,40.638977635782744,254,49,15.840255591054314,4
Category_Wikipedia_sockpuppets_of_TheStarMiner.csv,6,97641248.0,2,4,2,0,29,53.5,85,19,17.5,16
Category_Wikipedia_sockpuppets_of_Ibrahim_imran_worrior.csv,97,66337273.0,37,60,36,1,0,45.30927835051546,206,34,17.144329896907216,6
Category_Wikipedia_sockpuppets_of_Realmanbyt.csv,58,6560361.0,15,43,9,6,0,49.724137931034484,192,31,16.913793103448278,10
Category_Wikipedia_sockpuppets_of_SwediePie.csv,206,40727450.0,48,158,46,2,0,55.58252427184466,255,35,11.179611650485437,5
Category_Wikipedia_sockpuppets_of_Kelseykukui.csv,112,34482684.0,38,74,33,5,0,44.6875,231,62,19.125,4
Category_Wikipedia_sockpuppets_of_Majeedkhan0210.csv,3,79733.0,2,1,2,0,18,47.333333333333336,93,22,22.0,22
Category_Wikipedia_sockpuppets_of_Chuckdisi.csv,972,140029394.0,512,460,500,12,0,29.945473251028808,291,47,39.2798353909465,17
Category_Wikipedia_sockpuppets_of_Frankfurtge.csv,187,234949664.0,111,76,97,14,0,46.64705882352941,255,20,15.481283422459892,15
Category_Wikipedia_sockpuppets_of_Faruz.Aviad.csv,72,67120780.0,17,55,10,7,0,61.416666666666664,330,18,9.319444444444445,5
Category_Wikipedia_sockpuppets_of_Charlesmaslen.csv,1420,17213036.0,739,681,201,538,0,32.56056338028169,255,49,16.590845070422535,5
Category_Wikipedia_sockpuppets_of_Alaasadik.csv,115,138027892.0,34,81,20,14,0,42.77391304347826,222,36,19.94782608695652,4
Category_Wikipedia_sockpuppets_of_Mquarshie.csv,16,9836.0,9,7,5,4,0,21.4375,117,20,17.625,10
Category_Wikipedia_sockpuppets_of_Artyom1968_myartm123.csv,714,11764869.0,362,352,312,50,0,46.51960784313726,496,56,37.65546218487395,17
Category_Wikipedia_sockpuppets_of_Nashproto.csv,94,53251705.0,40,54,30,10,0,39.308510638297875,221,27,13.042553191489361,9
Category_Wikipedia_sockpuppets_of_WOW.csv,150,189367508.0,31,119,31,0,0,44.76,199,65,22.993333333333332,4
Category_Wikipedia_sockpuppets_of_Nick_at_Delta_Police.csv,23,267332.0,13,10,8,5,6,30.347826086956523,123,30,26.043478260869566,23
Category_Wikipedia_sockpuppets_of_Salad_Days.csv,1211,8007810.0,506,705,500,6,0,32.02559867877787,226,83,23.59454995871181,3
Category_Wikipedia_sockpuppets_of_Lu_tawa.csv,193,4609711.0,89,104,35,54,0,38.92746113989637,200,34,20.21761658031088,12
Category_Wikipedia_sockpuppets_of_Lucifer0016.csv,176,46162272.0,57,119,24,33,0,49.82386363636363,303,33,15.028409090909092,6
Category_Wikipedia_sockpuppets_of_Hastag_gumbii.csv,2050,26607515.0,666,1384,296,370,0,42.940975609756094,326,78,20.249268292682927,3
Category_Wikipedia_sockpuppets_of_DMB112.csv,1314,17177353.0,500,814,500,0,0,53.919330289193304,255,77,23.88812785388128,9
Category_Wikipedia_sockpuppets_of_Victorjames123.csv,35,5585601.0,20,15,11,9,0,54.68571428571428,155,22,13.857142857142858,9
Category_Wikipedia_sockpuppets_of_AviNewRad.csv,38,35843940.0,25,13,24,1,0,28.894736842105264,293,9,9.0,9
Category_Wikipedia_sockpuppets_of_Hhhhhhhhggg.csv,8,751.0,4,4,4,0,0,58.75,123,13,10.75,10
Category_Wikipedia_sockpuppets_of_PPdd.csv,1203,33692995.0,519,684,500,19,0,57.11221945137157,248,57,26.397339983374895,9
Category_Wikipedia_sockpuppets_of_Besos_Con_Mucha_Saliva.csv,55,5599059.0,21,34,18,3,0,55.0,159,60,24.01818181818182,8
Category_Wikipedia_sockpuppets_of_Andy1993.csv,158,50275943.0,55,103,32,23,0,35.075949367088604,243,37,20.39240506329114,7
Category_Wikipedia_sockpuppets_of_Wiki_Facts_fixer.csv,1343,72709554.0,405,938,377,28,0,40.5174981384959,361,52,24.499627699180937,7
Category_Wikipedia_sockpuppets_of_Bellhavenbest.csv,154,245906828.0,40,114,26,14,0,54.25974025974026,396,66,20.363636363636363,5
Category_Wikipedia_sockpuppets_of_NPOV-Fixer.csv,6,53019.0,5,1,4,1,50,120.33333333333333,306,10,10.0,10
Category_Wikipedia_sockpuppets_of_Techno_Kryon.csv,3,212.0,2,1,1,1,0,0.0,0,12,12.0,12
Category_Wikipedia_sockpuppets_of_Nerlo123.csv,141,1135830.0,41,100,18,23,0,47.53900709219858,215,58,17.645390070921987,4
Category_Wikipedia_sockpuppets_of_Angdl.csv,445,115912263.0,156,289,127,29,0,44.757303370786516,199,79,29.096629213483148,4
Category_Wikipedia_sockpuppets_of_Ershadtehrani.csv,235,256596849.0,47,188,14,33,0,49.53617021276596,242,29,11.842553191489362,4
Category_Wikipedia_sockpuppets_of_Agt2008fan.csv,6195,341793657.0,2539,3656,120,2419,0,47.58773204196933,500,55,24.756577885391444,4
Category_Wikipedia_sockpuppets_of_Chrisprattrules.csv,683,66316165.0,171,512,120,51,0,33.610541727672036,253,52,14.805270863836018,8
Category_Wikipedia_sockpuppets_of_B_Lynn33.csv,17,942471.0,10,7,9,1,9,72.11764705882354,179,19,19.0,19
Category_Wikipedia_sockpuppets_of_Arf√¶st_Ealdwr√≠tere.csv,672,335713329.0,173,499,143,30,0,49.726190476190474,362,82,25.941964285714285,4
Category_Wikipedia_sockpuppets_of_Weathertrustchannel.csv,260,91383383.0,79,181,23,56,0,54.776923076923076,474,50,11.11923076923077,4
Category_Wikipedia_sockpuppets_of_Apple_Products_Are_Krap.csv,18,92822.0,13,5,8,5,0,70.77777777777777,180,34,23.166666666666668,16
Category_Wikipedia_sockpuppets_of_BackpackerOZ.csv,17,11599062.0,11,6,4,7,0,48.294117647058826,178,23,13.588235294117647,13
Category_Wikipedia_sockpuppets_of_Sdesilva99.csv,137,2762058.0,54,83,54,0,0,48.75182481751825,326,21,15.065693430656934,11
Category_Wikipedia_sockpuppets_of_Aevensen.csv,115,7217116.0,37,78,27,10,0,50.6,249,39,17.078260869565216,4
Category_Wikipedia_sockpuppets_of_GMA_Fan.csv,3227,102769206.0,1156,2071,500,656,0,31.990083669042455,240,82,24.36690424542919,5
Category_Wikipedia_sockpuppets_of_Mudaliar.csv,1963,24276989.0,664,1299,500,164,0,34.96434029546612,250,66,19.57106469689251,3
Category_Wikipedia_sockpuppets_of_Xsyner.csv,611,72281482.0,160,451,150,10,0,47.32896890343699,218,54,15.039279869067103,9
Category_Wikipedia_sockpuppets_of_Thiyagasothy.csv,174,13121234.0,68,106,66,2,0,51.304597701149426,245,52,14.528735632183908,4
Category_Wikipedia_sockpuppets_of_Grant.Alpaugh.csv,2438,96907124.0,851,1587,500,351,0,47.783018867924525,248,65,30.550861361771943,4
Category_Wikipedia_sockpuppets_of_Dkatzenstein.csv,3,8942.0,3,0,3,0,0,17.666666666666668,37,19,16.333333333333332,11
Category_Wikipedia_sockpuppets_of_Amandazz100.csv,174,51216025.0,59,115,50,9,0,45.701149425287355,253,53,18.051724137931036,8
Category_Wikipedia_sockpuppets_of_Hussainjaffar316.csv,39,61280894.0,15,24,13,2,0,54.743589743589745,499,36,21.82051282051282,17
Category_Wikipedia_sockpuppets_of_Qamar645.csv,179,18242776.0,127,52,121,6,0,35.022346368715084,204,65,26.22905027932961,14
Category_Wikipedia_sockpuppets_of_Miguel_04012010.csv,1049,27818533.0,411,638,338,73,0,44.589132507149664,470,47,25.887511916110583,11
Category_Wikipedia_sockpuppets_of_Zealking.csv,472,16712809.0,118,354,40,78,0,49.41525423728814,220,68,19.43220338983051,4
Category_Wikipedia_sockpuppets_of_Setareh_Malek.csv,139,86756012.0,52,87,23,29,0,36.68345323741007,219,62,23.43884892086331,12
Category_Wikipedia_sockpuppets_of_Leyasu.csv,2732,33265528.0,765,1967,500,265,0,32.2203513909224,200,80,19.251098096632504,3
Category_Wikipedia_sockpuppets_of_Calculus113t.csv,41,34184151.0,12,29,7,5,0,45.53658536585366,244,18,15.024390243902438,13
Category_Wikipedia_sockpuppets_of_Knordo_Fnefwezzle.csv,47,848207.0,24,23,4,20,0,50.61702127659574,162,41,26.638297872340427,15
Category_Wikipedia_sockpuppets_of_Welcome_team.csv,7,116918.0,5,2,2,3,0,73.71428571428571,143,25,21.142857142857142,17
Category_Wikipedia_sockpuppets_of_Tristan.andrade.136.csv,225,22729796.0,74,151,26,48,0,40.44888888888889,240,61,21.964444444444446,10
Category_Wikipedia_sockpuppets_of_Mukieb236.csv,112,11684027.0,41,71,19,22,0,45.67857142857143,163,53,20.276785714285715,12
Category_Wikipedia_sockpuppets_of_Todd25.csv,431,150138489.0,171,260,132,39,0,33.559164733178655,228,48,16.779582366589327,10
Category_Wikipedia_sockpuppets_of_Mrpf_plus.csv,394,10830095.0,152,242,112,40,0,43.12690355329949,496,54,24.771573604060915,13
Category_Wikipedia_sockpuppets_of_Poetlister.csv,425,19787096.0,134,291,134,0,0,43.849411764705884,251,99,19.611764705882354,7
Category_Wikipedia_sockpuppets_of_Saksihw.csv,54,13649368.0,25,29,8,17,0,47.22222222222222,198,47,24.64814814814815,12
Category_Wikipedia_sockpuppets_of_Ayselonline.csv,274,307205866.0,94,180,46,48,0,45.04014598540146,247,53,21.412408759124087,9
Category_Wikipedia_sockpuppets_of_Frank_Anchor.csv,1841,520047695.0,588,1253,500,88,0,48.068984247691475,327,100,25.729494839761,6
Category_Wikipedia_sockpuppets_of_James_Lindberg.csv,1034,146778100.0,399,635,366,33,0,36.71856866537718,255,46,23.29110251450677,9
Category_Wikipedia_sockpuppets_of_Zlatko580.csv,70,21703583.0,22,48,19,3,0,49.48571428571429,255,47,21.15714285714286,11
Category_Wikipedia_sockpuppets_of_Pipeperez01.csv,144,1399017.0,43,101,19,24,0,41.63194444444444,229,51,17.40277777777778,7
Category_Wikipedia_sockpuppets_of_Fox53.csv,2844,198377411.0,1060,1784,500,560,0,42.61884669479606,247,54,15.904008438818565,6
Category_Wikipedia_sockpuppets_of_Dance-pop.csv,4454,134632147.0,1495,2959,500,995,0,45.27166591827571,250,78,18.120565783565336,6
Category_Wikipedia_sockpuppets_of_Otheruser1264.csv,37,598476.0,21,16,11,10,0,47.108108108108105,254,54,32.4054054054054,16
Category_Wikipedia_sockpuppets_of_Cameron2007.csv,783,186635172.0,344,439,205,139,0,35.56704980842912,244,52,21.666666666666668,6
Category_Wikipedia_sockpuppets_of_Roami_khan.csv,147,7134389.0,75,72,40,35,0,30.41496598639456,445,31,15.986394557823129,6
Category_Wikipedia_sockpuppets_of_KingJack21.csv,442,81479149.0,106,336,23,83,0,49.47285067873303,343,66,31.64027149321267,10
Category_Wikipedia_sockpuppets_of_Editr147.csv,31,76889.0,14,17,8,6,0,63.193548387096776,210,44,19.838709677419356,13
Category_Wikipedia_sockpuppets_of_EatAnAss.csv,12,196509.0,7,5,7,0,0,25.25,132,16,16.0,16
Category_Wikipedia_sockpuppets_of_Jeremy112233.csv,6741,191347979.0,2318,4423,500,1818,0,48.570093457943926,330,90,18.32517430648272,4
Category_Wikipedia_sockpuppets_of_Rv1717.csv,32,225150079.0,7,25,6,1,0,43.5625,235,16,15.1875,11
Category_Wikipedia_sockpuppets_of_BrookeCook.csv,524,185329798.0,142,382,24,118,0,51.62022900763359,496,67,17.811068702290076,5
Category_Wikipedia_sockpuppets_of_Piedpiperofwiki.csv,27,443.0,8,19,3,5,0,52.51851851851852,141,30,14.666666666666666,9
Category_Wikipedia_sockpuppets_of_Mahi_Choudhary_falka.csv,273,19524432.0,91,182,41,50,0,45.58974358974359,258,44,15.985347985347985,5
Category_Wikipedia_sockpuppets_of_Dancmaster.csv,266,144703248.0,95,171,95,0,0,42.421052631578945,333,44,26.718045112781954,10
Category_Wikipedia_sockpuppets_of_AJ_Mclean_1978.csv,33,13028877.0,15,18,7,8,0,48.81818181818182,255,44,21.181818181818183,9
Category_Wikipedia_sockpuppets_of_Surenderdas7.csv,2740,18336543.0,1000,1740,500,500,0,29.476642335766424,395,37,17.290875912408758,5
Category_Wikipedia_sockpuppets_of_The_great_Deleter.csv,166,369995.0,51,115,16,35,0,53.096385542168676,228,71,18.96987951807229,3
Category_Wikipedia_sockpuppets_of_StandAtlanticFans.csv,87,255492863.0,29,58,14,15,0,42.4367816091954,234,79,21.2183908045977,11
Category_Wikipedia_sockpuppets_of_Prateek1536.csv,77,776276.0,33,44,33,0,0,40.12987012987013,223,41,39.79220779220779,38
Category_Wikipedia_sockpuppets_of_Bl4ckSireen.csv,63,74330336.0,22,41,17,5,0,45.317460317460316,276,50,19.77777777777778,8
Category_Wikipedia_sockpuppets_of_Capogeezy75.csv,31,79797.0,25,6,14,11,0,30.774193548387096,155,43,37.516129032258064,23
Category_Wikipedia_sockpuppets_of_Avenail.csv,15,73318.0,6,9,4,2,0,33.46666666666667,142,22,16.0,8
Category_Wikipedia_sockpuppets_of_Davkal.csv,2643,87520406.0,1024,1619,500,524,0,42.675747256905034,243,66,28.153234960272417,4
Category_Wikipedia_sockpuppets_of_Etugrulghazi.csv,262,5438746.0,145,117,139,6,0,44.82442748091603,486,37,17.400763358778626,7
Category_Wikipedia_sockpuppets_of_S4hour.csv,912,166565254.0,260,652,102,158,0,42.73026315789474,298,69,24.37719298245614,7
Category_Wikipedia_sockpuppets_of_Haffy881.csv,1794,102531779.0,500,1294,377,123,0,41.958751393534,255,55,21.732998885172798,5
Category_Wikipedia_sockpuppets_of_JohnnyBananas17.csv,944,13056735.0,886,58,500,386,0,15.701271186440678,196,33,24.263771186440678,17
Category_Wikipedia_sockpuppets_of_Lillyshang.csv,276,85486774.0,102,174,79,23,0,45.34057971014493,494,45,22.916666666666668,9
Category_Wikipedia_sockpuppets_of_Atlantaknights1996.csv,1338,212305020.0,520,818,500,20,0,39.586696562032884,376,69,21.8609865470852,4
Category_Wikipedia_sockpuppets_of_OptimusView.csv,2789,87227002.0,1008,1781,500,508,0,41.31050555754751,255,59,20.07637145930441,4
Category_Wikipedia_sockpuppets_of_Pjesnik21.csv,5763,38067450.0,1852,3911,500,1352,0,40.670310602116956,500,64,18.528370640291516,3
Category_Wikipedia_sockpuppets_of_SteKelBry.csv,2417,71078193.0,677,1740,169,508,0,53.35208936698386,495,67,17.705419942076954,3
Category_Wikipedia_sockpuppets_of_Pompommars.csv,137,1548360.0,42,95,18,24,0,41.09489051094891,236,28,8.255474452554745,3
Category_Wikipedia_sockpuppets_of_Piledriver91.csv,1542,186120487.0,372,1170,247,125,0,43.02464332036317,270,57,14.70817120622568,5
Category_Wikipedia_sockpuppets_of_Fulongtaiwan_Official.csv,298,84911474.0,128,170,34,94,0,41.01677852348993,419,57,14.395973154362416,8
Category_Wikipedia_sockpuppets_of_Nalandil.csv,20,77539.0,9,11,9,0,0,51.3,234,29,23.15,17
Category_Wikipedia_sockpuppets_of_Giornorosso.csv,1932,65056639.0,436,1496,156,280,0,48.905797101449274,250,78,17.156832298136646,4
Category_Wikipedia_sockpuppets_of_Lifeline_Ophelia.csv,2282,198945415.0,536,1746,147,389,0,49.41542506573182,255,87,19.98597721297108,3
Category_Wikipedia_sockpuppets_of_Hendri325.csv,62,1401021.0,49,13,21,28,0,18.29032258064516,146,31,18.612903225806452,8
Category_Wikipedia_sockpuppets_of_MapleBark.csv,81,576836.0,65,16,35,30,8,130.60493827160494,399,27,24.22222222222222,22
Category_Wikipedia_sockpuppets_of_Sabiahmedabad.csv,89,1088951.0,29,60,7,22,0,58.943820224719104,240,24,13.685393258426966,7
Category_Wikipedia_sockpuppets_of_Salby.csv,102,28376502.0,27,75,14,13,0,33.049019607843135,148,58,24.980392156862745,8
Category_Wikipedia_sockpuppets_of_Chuckalkazian.csv,22,49856550.0,7,15,4,3,0,42.45454545454545,141,34,22.863636363636363,17
Category_Wikipedia_sockpuppets_of_S612628.csv,530,3877753.0,243,287,46,197,0,30.27358490566038,241,59,22.941509433962263,4
Category_Wikipedia_sockpuppets_of_MindSlayer13.csv,1445,38327192.0,504,941,500,4,0,38.292733564013844,438,40,16.74325259515571,7
Category_Wikipedia_sockpuppets_of_EndoExo.csv,2383,8294465.0,762,1621,427,335,0,47.224926563155684,234,59,21.014687368862777,3
Category_Wikipedia_sockpuppets_of_Jamesinc14.csv,85,44539415.0,17,68,10,7,0,33.35294117647059,197,54,24.576470588235296,6
Category_Wikipedia_sockpuppets_of_Albert_einstein2010.csv,44,3796711.0,17,27,13,4,0,51.52272727272727,189,48,22.363636363636363,16
Category_Wikipedia_sockpuppets_of_Tombah.csv,3252,21422691.0,1162,2090,500,662,0,52.55258302583026,496,71,17.116543665436655,4
Category_Wikipedia_sockpuppets_of_PurelyAtomic.csv,230,103736427.0,63,167,42,21,0,43.40869565217391,257,51,18.83478260869565,5
Category_Wikipedia_sockpuppets_of_Dr_Samkiv_Kumar.csv,1810,24202731.0,678,1132,220,458,0,35.180662983425414,424,63,18.29281767955801,3
Category_Wikipedia_sockpuppets_of_Unavailable.undisclosed.csv,284,10532381.0,85,199,10,75,0,59.09507042253521,240,72,17.281690140845072,8
Category_Wikipedia_sockpuppets_of_Tedmike.csv,1400,18378992.0,520,880,401,119,0,36.63785714285714,255,52,25.486428571428572,5
Category_Wikipedia_sockpuppets_of_RepordRider.csv,1745,44312519.0,587,1158,252,335,0,47.70487106017192,255,59,21.150143266475645,5
Category_Wikipedia_sockpuppets_of_LadyDuck06.csv,569,198454500.0,237,332,233,4,0,31.768014059753956,255,42,15.625659050966608,4
Category_Wikipedia_sockpuppets_of_Samweithe4.csv,2390,77106479.0,738,1652,313,425,0,43.22133891213389,378,53,21.889121338912133,3
Category_Wikipedia_sockpuppets_of_Alliasalmon.csv,1,0.0,1,0,1,0,196,196.0,196,16,16.0,16
Category_Wikipedia_sockpuppets_of_Jsteel7.csv,267,32421404.0,70,197,25,45,0,48.7752808988764,255,41,19.640449438202246,10
Category_Wikipedia_sockpuppets_of_Douglas_bond_of_doom.csv,493,16405214.0,161,332,30,131,0,40.83975659229209,249,52,29.746450304259636,14
Category_Wikipedia_sockpuppets_of_Mosha_Dibanisa.csv,25,13455538.0,13,12,10,3,0,36.88,165,35,24.88,12
Category_Wikipedia_sockpuppets_of_Chinmav_edits.csv,136,7004325.0,43,93,22,21,0,53.5514705882353,232,50,25.205882352941178,7
Category_Wikipedia_sockpuppets_of_Julie_Dancer.csv,4703,59374033.0,1379,3324,500,879,0,35.965341271528814,237,66,32.97639804380183,6
Category_Wikipedia_sockpuppets_of_R√∂chling-Gruppe.csv,56,85641207.0,20,36,18,2,0,73.41071428571429,280,27,16.946428571428573,8
Category_Wikipedia_sockpuppets_of_Jennifer_Chang.csv,210,13789765.0,93,117,26,67,0,25.50952380952381,238,51,31.123809523809523,11
Category_Wikipedia_sockpuppets_of_Ultrabomb.csv,425,59075820.0,139,286,107,32,0,50.85411764705882,255,54,18.021176470588234,4
Category_Wikipedia_sockpuppets_of_Harun_Zaria.csv,1067,16230778.0,397,670,367,30,0,41.223992502343016,412,64,19.375820056232428,3
Category_Wikipedia_sockpuppets_of_Aaron106.csv,2082,29142393.0,716,1366,500,216,0,46.21902017291066,496,54,19.756003842459172,5
Category_Wikipedia_sockpuppets_of_PANJABI21.csv,61,147874.0,28,33,13,15,0,57.91803278688525,219,29,17.81967213114754,12
Category_Wikipedia_sockpuppets_of_Pederjo99.csv,2261,35133950.0,512,1749,500,12,0,45.857585139318886,371,71,26.111455108359134,3
Category_Wikipedia_sockpuppets_of_Stormcloak_EthnoNationalist.csv,411,19940176.0,122,289,40,82,0,61.32116788321168,488,68,20.97323600973236,5
Category_Wikipedia_sockpuppets_of_Gimme2ofthose.csv,189,33190048.0,56,133,56,0,0,56.33862433862434,346,53,15.476190476190476,7
Category_Wikipedia_sockpuppets_of_Ancientsteppe.csv,8453,45614000.0,3033,5420,500,2533,0,36.20821010292204,255,60,17.537915532946883,3
Category_Wikipedia_sockpuppets_of_OscarJuan.csv,521,525035795.0,133,388,131,2,0,60.85988483685221,330,47,14.155470249520153,3
Category_Wikipedia_sockpuppets_of_ScholarlyScribe.csv,1360,21048121.0,568,792,500,68,0,40.99191176470588,496,64,22.361029411764704,5
Category_Wikipedia_sockpuppets_of_I_a_m_Iu_k_e_1_6.csv,68,82082.0,31,37,22,9,0,24.544117647058822,196,13,6.705882352941177,6
Category_Wikipedia_sockpuppets_of_Dinesh_Meena92.csv,108,20856242.0,34,74,27,7,0,42.80555555555556,227,21,8.61111111111111,4
Category_Wikipedia_sockpuppets_of_Neckhumbucker.csv,238,289025998.0,82,156,56,26,0,49.86974789915966,252,57,18.827731092436974,8
Category_Wikipedia_sockpuppets_of_Rogerfgay.csv,1474,531443631.0,505,969,500,5,0,50.06377204884667,357,61,27.192672998643147,8
Category_Wikipedia_sockpuppets_of_Samantha.rusconi.csv,106,67574208.0,39,67,12,27,0,39.62264150943396,225,53,24.08490566037736,14
Category_Wikipedia_sockpuppets_of_Muhammeddhalifjr.csv,2065,97978930.0,592,1473,179,413,0,47.51041162227603,363,53,20.093462469733655,4
Category_Wikipedia_sockpuppets_of_MrsPhinch.csv,656,154507858.0,313,343,278,35,0,50.9375,265,46,30.335365853658537,4
Category_Wikipedia_sockpuppets_of_V-Dash.csv,1978,17736913.0,748,1230,500,248,0,42.21435793731042,246,54,28.743680485338725,10
Category_Wikipedia_sockpuppets_of_Ginia_kohler.csv,9,42439.0,6,3,6,0,0,25.22222222222222,104,66,29.333333333333332,11
Category_Wikipedia_sockpuppets_of_Matthew05(ginger).csv,14,120656.0,10,4,6,4,0,28.428571428571427,164,30,28.928571428571427,27
Category_Wikipedia_sockpuppets_of_Arguecat4.csv,113,103028.0,45,68,34,11,0,45.11504424778761,195,37,19.27433628318584,7
Category_Wikipedia_sockpuppets_of_Imeghana17.csv,691,12434460.0,222,469,91,131,0,35.62662807525326,255,53,15.82344428364689,9
Category_Wikipedia_sockpuppets_of_Mosquera.csv,1204,5499252.0,527,677,500,27,0,28.31312292358804,258,78,23.789036544850497,8
Category_Wikipedia_sockpuppets_of_The_Three_Cousins.csv,458,10365802.0,151,307,113,38,0,37.57860262008734,496,62,31.224890829694324,5
Category_Wikipedia_sockpuppets_of_TikTokJournalist.csv,52,292675.0,18,34,11,7,0,45.15384615384615,183,53,29.134615384615383,6
Category_Wikipedia_sockpuppets_of_EFT69.csv,46,176004.0,36,10,25,11,0,8.543478260869565,130,17,15.043478260869565,12
Category_Wikipedia_sockpuppets_of_Dylan_Florida.csv,4592,274124029.0,1145,3447,47,1098,0,40.44642857142857,496,58,19.76698606271777,3
Category_Wikipedia_sockpuppets_of_Playdoh1845.csv,33,2626598.0,18,15,14,4,15,43.121212121212125,169,21,17.21212121212121,16
Category_Wikipedia_sockpuppets_of_Jonjonalvarez.csv,276,25591844.0,78,198,53,25,0,44.36231884057971,258,53,19.568840579710145,4
Category_Wikipedia_sockpuppets_of_SamBo198.csv,80,22667575.0,35,45,18,17,0,40.9875,258,57,29.5,13
Category_Wikipedia_sockpuppets_of_POZNAN77.csv,42,153211.0,34,8,26,8,0,22.761904761904763,496,69,25.19047619047619,5
Category_Wikipedia_sockpuppets_of_Daviesben24.csv,676,35611323.0,192,484,100,92,0,41.49556213017752,255,45,17.097633136094675,3
Category_Wikipedia_sockpuppets_of_Howard__Dib__Montjio.csv,48,449934.0,16,32,16,0,0,37.166666666666664,153,30,16.020833333333332,5
Category_Wikipedia_sockpuppets_of_BigGabriel555.csv,1718,60499958.0,550,1168,500,50,0,47.79802095459837,226,72,19.67636786961583,5
Category_Wikipedia_sockpuppets_of_Chase_Pancake.csv,1715,23076249.0,573,1142,500,73,0,38.90728862973761,500,43,17.590087463556852,5
Category_Wikipedia_sockpuppets_of_Jaed_Ali.csv,301,41207142.0,87,214,69,18,0,41.1063122923588,242,28,16.35548172757475,8
Category_Wikipedia_sockpuppets_of_Sihanahmed08576.csv,22,2071981.0,8,14,6,2,0,59.09090909090909,231,36,27.045454545454547,10
Category_Wikipedia_sockpuppets_of_Honestyinmass.csv,110,2075622.0,50,60,49,1,0,59.1,388,42,22.954545454545453,16
Category_Wikipedia_sockpuppets_of_Dhubbard2500.csv,92,208478120.0,32,60,30,2,0,50.78260869565217,220,33,20.293478260869566,16
Category_Wikipedia_sockpuppets_of_Charliestalnaker.csv,1876,40619450.0,615,1261,500,115,0,53.502132196162044,500,67,22.62579957356077,4
Category_Wikipedia_sockpuppets_of_Rangasn.csv,58,22373824.0,33,25,18,15,0,56.741379310344826,196,43,13.155172413793103,10
Category_Wikipedia_sockpuppets_of_Europebound2007.csv,384,3689615.0,106,278,38,68,0,32.299479166666664,200,42,19.1015625,6
Category_Wikipedia_sockpuppets_of_Bengoman1993.csv,394,23597671.0,132,262,66,66,0,54.93654822335025,252,60,26.274111675126903,10
Category_Wikipedia_sockpuppets_of_Cor_le_ven.csv,522,5567318.0,143,379,68,75,0,36.99233716475096,254,64,16.844827586206897,4
Category_Wikipedia_sockpuppets_of_BloodRunsCold1996.csv,193,4150048.0,47,146,45,2,0,38.72020725388601,200,21,12.150259067357513,9
Category_Wikipedia_sockpuppets_of_SANTO_GOLD.csv,67,22297221.0,25,42,13,12,0,63.298507462686565,199,47,19.17910447761194,9
Category_Wikipedia_sockpuppets_of_Vickey_Singh_Jha.csv,92,514345.0,41,51,24,17,0,38.75,206,29,14.532608695652174,9
Category_Wikipedia_sockpuppets_of_Bethsheba_Ashe.csv,1948,93771426.0,637,1311,303,334,0,60.1694045174538,496,74,21.51334702258727,3
Category_Wikipedia_sockpuppets_of_Ktthatme.csv,48,114757411.0,17,31,17,0,0,48.916666666666664,196,65,32.3125,12
Category_Wikipedia_sockpuppets_of_Bold7755.csv,70,329304.0,31,39,31,0,0,77.31428571428572,183,67,23.814285714285713,12
Category_Wikipedia_sockpuppets_of_MM_Ahluwalia.csv,443,49913909.0,154,289,144,10,0,36.15349887133183,254,67,19.37020316027088,6
Category_Wikipedia_sockpuppets_of_Free_State_Division.csv,130,173673.0,44,86,13,31,0,48.146153846153844,196,36,20.892307692307693,12
Category_Wikipedia_sockpuppets_of_Sheepman2099.csv,38,1353843.0,21,17,12,9,0,103.34210526315789,500,19,15.5,12
Category_Wikipedia_sockpuppets_of_Asdasxzczx23.csv,59,16947024.0,32,27,30,2,0,46.13559322033898,304,22,12.94915254237288,6
Category_Wikipedia_sockpuppets_of_Lancombz.csv,601,16357178.0,170,431,74,96,0,46.77703826955075,200,50,15.389351081530782,3
Category_Wikipedia_sockpuppets_of_Adityasaxena.corp.csv,1165,18473735.0,368,797,265,103,0,49.48240343347639,255,78,17.616309012875536,4
Category_Wikipedia_sockpuppets_of_MDnews2u.csv,108,1032679.0,44,64,32,12,0,32.638888888888886,200,51,23.40740740740741,9
Category_Wikipedia_sockpuppets_of_SpartacusXXX.csv,40,1336065.0,19,21,13,6,0,46.725,203,45,23.45,13
Category_Wikipedia_sockpuppets_of_Samit_Kumar_Ray.csv,4,10798047.0,3,1,2,1,14,71.5,120,25,23.75,20
Category_Wikipedia_sockpuppets_of_Skipperboy25080.csv,240,25686363.0,71,169,27,44,0,49.670833333333334,320,42,18.2,7
Category_Wikipedia_sockpuppets_of_Borovv.csv,1188,41090369.0,579,609,500,79,0,57.76010101010101,255,54,25.810606060606062,6
Category_Wikipedia_sockpuppets_of_Landnama.csv,1046,3529947.0,572,474,500,72,0,57.88623326959847,473,68,26.078393881453156,6
Category_Wikipedia_sockpuppets_of_◊®◊ï◊†123.csv,361,270363740.0,115,246,27,88,0,52.88919667590028,429,53,15.368421052631579,6
Category_Wikipedia_sockpuppets_of_Simon.mangel.csv,66,1223613.0,28,38,16,12,0,51.84848484848485,227,18,12.318181818181818,7
Category_Wikipedia_sockpuppets_of_Kerev_HaEmet.csv,36,1219999.0,13,23,12,1,0,21.77777777777778,113,80,44.833333333333336,7
Category_Wikipedia_sockpuppets_of_Rohit_tripathi60.csv,120,125688856.0,24,96,18,6,0,48.24166666666667,196,65,21.308333333333334,5
Category_Wikipedia_sockpuppets_of_Dalajuju.csv,64,7521439.0,40,24,20,20,0,66.78125,291,32,17.65625,14
Category_Wikipedia_sockpuppets_of_Azizulhakim.ashik.csv,75,12265717.0,27,48,16,11,0,57.53333333333333,276,38,14.946666666666667,7
Category_Wikipedia_sockpuppets_of_MaryBrownsCAN.csv,15,215025.0,9,6,8,1,0,28.4,122,23,16.4,12
Category_Wikipedia_sockpuppets_of_NfpaMan.csv,110,729446.0,32,78,22,10,0,65.50909090909092,217,36,18.972727272727273,7
Category_Wikipedia_sockpuppets_of_Johnsonjack123.csv,356,12880055.0,110,246,67,43,0,53.11516853932584,255,65,21.839887640449437,6
Category_Wikipedia_sockpuppets_of_SharifulIslamNaikBD.csv,30,19892338.0,9,21,7,2,0,63.1,261,15,9.5,7
Category_Wikipedia_sockpuppets_of_Stormisstar.csv,625,16350723.0,197,428,84,113,0,49.7648,235,50,25.8368,7
Category_Wikipedia_sockpuppets_of_Ramil.csv,304,4592785.0,122,182,65,57,0,31.20394736842105,199,31,20.480263157894736,10
Category_Wikipedia_sockpuppets_of_Ldingley.csv,1428,5009374.0,527,901,500,27,0,31.03921568627451,200,55,20.30672268907563,5
Category_Wikipedia_sockpuppets_of_111818b.csv,585,39479674.0,146,439,96,50,0,65.42393162393162,470,68,19.04957264957265,5
Category_Wikipedia_sockpuppets_of_AquilaXIII.csv,3358,52253426.0,895,2463,500,395,0,49.390708755211435,500,51,15.922275163787969,2
Category_Wikipedia_sockpuppets_of_Miccoliband.csv,6,578035.0,5,1,4,1,0,24.666666666666668,44,14,14.0,14
Category_Wikipedia_sockpuppets_of_Mazandaran_Sea.csv,108,5783431.0,50,58,42,8,0,56.842592592592595,410,54,21.666666666666668,11
Category_Wikipedia_sockpuppets_of_Bonnar212.csv,283,148078009.0,102,181,65,37,0,55.830388692579504,258,51,22.60070671378092,11
Category_Wikipedia_sockpuppets_of_Tejalkalbate.csv,79,2962889.0,70,9,47,23,0,8.645569620253164,132,10,10.0,10
Category_Wikipedia_sockpuppets_of_Bigshowandkane64.csv,9334,280154418.0,2392,6942,500,1892,0,41.54660381401329,500,60,17.366402399828583,3
Category_Wikipedia_sockpuppets_of_Stephanie_Bowman.csv,2445,78847930.0,663,1782,314,349,0,48.47361963190184,255,60,23.558691206543966,4
Category_Wikipedia_sockpuppets_of_MidnightSilver.csv,1016,32313700.0,508,508,500,8,0,40.23129921259842,237,72,37.65255905511811,10
Category_Wikipedia_sockpuppets_of_Oppulence76.csv,219,12044799.0,63,156,12,51,0,78.42922374429224,255,47,18.95433789954338,9
Category_Wikipedia_sockpuppets_of_Lustralaustral.csv,696,57966783.0,197,499,98,99,0,52.72270114942529,250,67,19.152298850574713,1
Category_Wikipedia_sockpuppets_of_Mariellaclark.csv,279,30310362.0,62,217,50,12,0,31.989247311827956,215,33,14.770609318996415,7
Category_Wikipedia_sockpuppets_of_Dosooo001.csv,39,786934.0,27,12,12,15,0,70.87179487179488,496,19,13.128205128205128,8
Category_Wikipedia_sockpuppets_of_Requiem_II.csv,1707,159472506.0,625,1082,500,125,0,54.43585237258348,306,54,15.411833626244874,3
Category_Wikipedia_sockpuppets_of_Moralepimpstar.csv,319,20207867.0,90,229,45,45,0,49.54858934169279,255,58,21.36677115987461,5
Category_Wikipedia_sockpuppets_of_RDLX15.csv,521,2883427.0,173,348,103,70,0,57.34932821497121,255,36,17.001919385796544,4
Category_Wikipedia_sockpuppets_of_Luke18_2-8.csv,3,128.0,2,1,2,0,0,25.333333333333332,39,38,33.333333333333336,24
Category_Wikipedia_sockpuppets_of_Msmuc.csv,125,46738871.0,51,74,36,15,0,38.832,205,42,18.872,3
Category_Wikipedia_sockpuppets_of_Rawr33.csv,2,83.0,2,0,2,0,0,0.0,0,16,16.0,16
Category_Wikipedia_sockpuppets_of_Mathieu_Vouillamoz.csv,2985,64119466.0,1074,1911,500,574,0,45.39061976549414,500,99,20.189949748743718,4
Category_Wikipedia_sockpuppets_of_Brettandelle.csv,5751,118105722.0,1338,4413,71,1267,0,43.59224482698661,500,49,16.00869414014954,2
Category_Wikipedia_sockpuppets_of_Dontforfme.csv,44,168295.0,13,31,9,4,0,47.5,150,41,19.568181818181817,5
Category_Wikipedia_sockpuppets_of_DuckeggAlex.csv,1702,39672278.0,508,1194,500,8,0,57.14159811985899,458,52,17.834900117508813,5
Category_Wikipedia_sockpuppets_of_PIPony22.csv,493,87406551.0,198,295,192,6,0,40.65922920892495,222,54,24.738336713995942,9
Category_Wikipedia_sockpuppets_of_Letitgo215.csv,257,3617197.0,93,164,88,5,0,51.62645914396887,255,59,19.50194552529183,4
Category_Wikipedia_sockpuppets_of_NewSubwayLove.csv,266,7179651.0,93,173,41,52,0,48.19924812030075,231,55,25.99624060150376,8
Category_Wikipedia_sockpuppets_of_Eva_Thamson.csv,25,3664.0,13,12,8,5,0,48.4,144,32,30.72,16
Category_Wikipedia_sockpuppets_of_Jingleheimer.schmidt.johnjacob.csv,26,2469.0,15,11,8,7,0,92.84615384615384,348,26,22.923076923076923,22
Category_Wikipedia_sockpuppets_of_Thevikingovikingo.csv,290,364662.0,84,206,66,18,0,52.60689655172414,227,53,29.358620689655172,8
Category_Wikipedia_sockpuppets_of_MrKaramu.csv,5,441.0,3,2,2,1,5,66.2,198,41,41.0,41
Category_Wikipedia_sockpuppets_of_Marketing_umbrella.csv,2,55.0,2,0,2,0,0,17.5,35,19,19.0,19
Category_Wikipedia_sockpuppets_of_Abdo_Mitwally.csv,69,43022665.0,29,40,17,12,0,51.01449275362319,267,58,17.463768115942027,10
Category_Wikipedia_sockpuppets_of_Assmaster24.csv,19,9034710.0,13,6,11,2,0,60.0,494,17,16.68421052631579,14
Category_Wikipedia_sockpuppets_of_Kazamimariaelena.csv,100,8925441.0,34,66,10,24,0,42.28,262,26,15.87,5
Category_Wikipedia_sockpuppets_of_Mr_Taz.csv,1767,92261444.0,530,1237,500,30,0,46.08998302207131,248,60,23.40633842671194,2
Category_Wikipedia_sockpuppets_of_Event.Horizon.000.csv,216,13327520.0,77,139,64,13,0,46.84722222222222,231,39,16.60648148148148,5
Category_Wikipedia_sockpuppets_of_Edits201.csv,524,10558320.0,163,361,67,96,0,51.64312977099237,255,54,26.931297709923665,10
Category_Wikipedia_sockpuppets_of_Simi_at_BrightCHAMPS.csv,96,3652945.0,28,68,16,12,0,58.322916666666664,215,30,16.229166666666668,4
Category_Wikipedia_sockpuppets_of_Zati_Minecraft.csv,30,526280.0,16,14,9,7,0,55.4,209,14,11.033333333333333,10
Category_Wikipedia_sockpuppets_of_Laxfan96.csv,29,105133.0,13,16,10,3,0,58.310344827586206,222,26,20.17241379310345,10
Category_Wikipedia_sockpuppets_of_Hisilly.csv,34,7917.0,13,21,6,7,0,66.38235294117646,227,17,12.088235294117647,10
Category_Wikipedia_sockpuppets_of_AugustusAudax.csv,3329,16372129.0,954,2375,500,454,0,53.4448783418444,496,93,21.78492039651547,2
Category_Wikipedia_sockpuppets_of_Kazimmohammad.csv,107,24704143.0,37,70,36,1,0,35.308411214953274,278,32,17.757009345794394,10
Category_Wikipedia_sockpuppets_of_Sarahlovesemo.csv,30,2366392.0,12,18,9,3,0,52.46666666666667,175,19,10.866666666666667,4
Category_Wikipedia_sockpuppets_of_Josephlalrinhlua786.csv,2543,9958750.0,985,1558,500,485,0,28.300825796303577,257,51,24.588281557215886,9
Category_Wikipedia_sockpuppets_of_Players777.csv,33,3469427.0,11,22,5,6,0,67.12121212121212,268,26,13.606060606060606,10
Category_Wikipedia_sockpuppets_of_Cam_Bout.csv,235,16428565.0,68,167,45,23,0,39.136170212765954,312,48,27.46808510638298,6
Category_Wikipedia_sockpuppets_of_Sarrena.csv,523,30515386.0,128,395,122,6,0,46.76099426386233,243,63,16.11281070745698,4
Category_Wikipedia_sockpuppets_of_CharlesAntoine72.csv,3,2185209.0,3,0,3,0,0,9.333333333333334,28,26,26.0,26
Category_Wikipedia_sockpuppets_of_Wombles7.csv,61,81183086.0,13,48,13,0,0,59.36065573770492,383,36,24.704918032786885,7
Category_Wikipedia_sockpuppets_of_SgtAvestrand1956.csv,2539,48037031.0,1063,1476,171,892,0,37.845608507286336,255,83,17.40882237101221,4
Category_Wikipedia_sockpuppets_of_Greentechmedia.csv,27,862300.0,20,7,14,6,0,49.55555555555556,171,19,17.22222222222222,15
Category_Wikipedia_sockpuppets_of_Waterspaces.csv,719,137150565.0,209,510,194,15,0,41.403337969401946,248,44,16.068150208623088,5
Category_Wikipedia_sockpuppets_of_Biaswatchdog.csv,41,2276353.0,23,18,18,5,0,69.09756097560975,200,42,26.341463414634145,18
Category_Wikipedia_sockpuppets_of_32alpha4tango.csv,487,18331038.0,161,326,160,1,0,45.59342915811088,250,48,27.579055441478438,4
Category_Wikipedia_sockpuppets_of_Aiden_34.csv,270,58427915.0,72,198,34,38,0,45.05925925925926,333,36,20.82962962962963,13
Category_Wikipedia_sockpuppets_of_Journal_of_Creating_Value.csv,7,358727.0,4,3,4,0,0,71.57142857142857,195,22,20.571428571428573,17
Category_Wikipedia_sockpuppets_of_Magadhkingdom.csv,537,11834406.0,211,326,184,27,0,43.11173184357542,236,33,12.843575418994414,5
Category_Wikipedia_sockpuppets_of_SpaceEye360.csv,19,530.0,5,14,5,0,0,47.05263157894737,235,17,14.578947368421053,13
Category_Wikipedia_sockpuppets_of_Hyadeuluxe.csv,1019,7617437.0,254,765,16,238,0,43.502453385672226,254,53,17.191364082433758,4
Category_Wikipedia_sockpuppets_of_Kolya121896.csv,2,42.0,2,0,2,0,0,0.0,0,47,47.0,47
Category_Wikipedia_sockpuppets_of_PatCheng.csv,4175,453347539.0,1111,3064,500,611,0,47.05005988023952,363,84,24.141077844311376,4
Category_Wikipedia_sockpuppets_of_Atac2.csv,4068,474956585.0,1594,2474,500,1094,0,53.825958702064895,325,94,21.44395280235988,3
Category_Wikipedia_sockpuppets_of_Doveye71.csv,270,58068279.0,126,144,119,7,0,42.407407407407405,255,87,29.696296296296296,13
Category_Wikipedia_sockpuppets_of_Lelosejean.csv,3028,54380435.0,1213,1815,470,743,0,24.830250990752972,250,60,21.43659180977543,9
Category_Wikipedia_sockpuppets_of_Giolol.csv,218,8886665.0,59,159,26,33,0,46.41743119266055,269,54,15.715596330275229,4
Category_Wikipedia_sockpuppets_of_TopTvtamil.csv,70,16782689.0,19,51,14,5,0,33.3,222,18,16.428571428571427,13
Category_Wikipedia_sockpuppets_of_Steadyonplease.csv,488,18669190.0,152,336,94,58,0,55.307377049180324,251,39,21.309426229508198,3
Category_Wikipedia_sockpuppets_of_Ahmedfarhat.csv,1977,150332678.0,708,1269,500,208,0,35.97521497218007,272,69,20.45776428932726,2
Category_Wikipedia_sockpuppets_of_Yaplipa.csv,21,5369770.0,10,11,4,6,0,63.23809523809524,196,24,16.857142857142858,12
Category_Wikipedia_sockpuppets_of_Sl16.csv,59,11492457.0,45,14,43,2,0,42.71186440677966,197,23,22.661016949152543,22
Category_Wikipedia_sockpuppets_of_Your_faces_name.csv,57,2567461.0,13,44,13,0,0,31.31578947368421,168,35,20.596491228070175,9
Category_Wikipedia_sockpuppets_of_CMCreator900.csv,939,69707811.0,354,585,335,19,0,42.84558040468583,244,63,20.254526091586794,5
Category_Wikipedia_sockpuppets_of_Utraqueunum.csv,262,256474723.0,87,175,82,5,0,60.61450381679389,255,63,19.129770992366414,7
Category_Wikipedia_sockpuppets_of_Justine_Seavey_II.csv,249,39269782.0,92,157,31,61,0,33.5863453815261,255,46,17.27309236947791,7
Category_Wikipedia_sockpuppets_of_TheRedPenOfDooom.csv,17,192543.0,10,7,9,1,0,50.35294117647059,196,30,24.823529411764707,6
Category_Wikipedia_sockpuppets_of_Elliedm.csv,32,680258.0,17,15,7,10,0,50.5625,184,18,13.5,8
Category_Wikipedia_sockpuppets_of_Etanemuway.csv,44,6152.0,19,25,13,6,0,53.18181818181818,182,21,13.954545454545455,8
Category_Wikipedia_sockpuppets_of_Nathanbobby.csv,1480,4539317.0,296,1184,145,151,0,38.21418918918919,255,43,19.004054054054055,7
Category_Wikipedia_sockpuppets_of_Demarchi58.csv,52,18176879.0,25,27,15,10,0,36.19230769230769,199,20,16.153846153846153,14
Category_Wikipedia_sockpuppets_of_Brianalaflair.csv,17,311262.0,5,12,1,4,0,42.64705882352941,139,33,32.0,26
Category_Wikipedia_sockpuppets_of_ProgressiveRight.csv,260,191197690.0,129,131,122,7,0,29.603846153846153,287,22,15.38076923076923,11
Category_Wikipedia_sockpuppets_of_E.G..csv,7297,174030160.0,2093,5204,500,1593,0,37.18021104563519,247,72,19.62573660408387,2
Category_Wikipedia_sockpuppets_of_Guruupdesh.csv,177,86426648.0,71,106,40,31,0,48.23163841807909,307,53,22.37853107344633,6
Category_Wikipedia_sockpuppets_of_Oganthony1.csv,9,875.0,4,5,3,1,0,50.111111111111114,148,11,10.11111111111111,7
Category_Wikipedia_sockpuppets_of_NathanHollister.csv,495,192771011.0,122,373,99,23,0,61.593939393939394,368,64,24.953535353535354,7
Category_Wikipedia_sockpuppets_of_Michael.csv,1125,1553878.0,578,547,500,78,0,9.24088888888889,179,65,13.326222222222222,2
Category_Wikipedia_sockpuppets_of_EditShakib2024.csv,41,1027210.0,15,26,14,1,0,55.707317073170735,234,53,21.170731707317074,5
Category_Wikipedia_sockpuppets_of_Fona2000.csv,1413,85861459.0,511,902,500,11,0,43.53998584571833,248,47,17.362349610757253,5
Category_Wikipedia_sockpuppets_of_Hidden_Tempo.csv,3519,334208694.0,1251,2268,500,751,0,52.09462915601023,435,69,23.396419437340153,7
Category_Wikipedia_sockpuppets_of_Haham_hanuka.csv,3104,37345328.0,710,2394,500,210,0,37.89271907216495,246,81,14.836984536082474,3
Category_Wikipedia_sockpuppets_of_Srinu523.csv,1147,3233458.0,530,617,500,30,0,38.82824760244115,255,60,30.979075850043593,7
Category_Wikipedia_sockpuppets_of_Grace_Saunders.csv,1934,428477396.0,618,1316,500,118,0,41.90847983453981,255,64,17.470010341261634,4
Category_Wikipedia_sockpuppets_of_Kamickalo.csv,30,86698439.0,6,24,4,2,0,42.733333333333334,162,35,16.4,5
Category_Wikipedia_sockpuppets_of_Starrion1.csv,15,784398.0,6,9,4,2,0,45.6,150,66,38.266666666666666,13
Category_Wikipedia_sockpuppets_of_Northds.csv,182,251257712.0,63,119,45,18,0,51.010989010989015,260,66,16.082417582417584,4
Category_Wikipedia_sockpuppets_of_1mm1.csv,8,10591.0,5,3,4,1,0,25.25,97,42,42.0,42
Category_Wikipedia_sockpuppets_of_Serijvip.csv,3518,359589829.0,1000,2518,500,500,0,38.887436043206364,480,61,18.241614553723707,5
Category_Wikipedia_sockpuppets_of_Mrmia29.csv,443,89210810.0,107,336,94,13,0,41.214446952595935,288,44,15.539503386004515,6
Category_Wikipedia_sockpuppets_of_Cottona.csv,3,760694.0,2,1,2,0,0,29.0,80,20,20.0,20
Category_Wikipedia_sockpuppets_of_Siphomukoshaphiri.csv,6,432.0,5,1,5,0,7,33.0,75,27,27.0,27
Category_Wikipedia_sockpuppets_of_Macheads101.csv,61,11473908.0,21,40,20,1,0,54.21311475409836,263,37,17.557377049180328,9
Category_Wikipedia_sockpuppets_of_FadedOrange.csv,790,68522635.0,330,460,100,230,0,41.53164556962025,300,64,20.196202531645568,7
Category_Wikipedia_sockpuppets_of_Wikiman1717.csv,332,1210403.0,120,212,94,26,0,43.28915662650602,235,51,20.349397590361445,7
Category_Wikipedia_sockpuppets_of_Keep_It_Real.csv,525,35247805.0,105,420,85,20,0,42.21142857142857,226,36,18.268571428571427,10
Category_Wikipedia_sockpuppets_of_Tamjidahmedali.csv,341,6110305.0,102,239,59,43,0,53.557184750733136,496,44,14.80058651026393,4
Category_Wikipedia_sockpuppets_of_Axolotl_is_a_Pokemon.csv,1239,17542368.0,317,922,302,15,0,54.93301049233253,499,66,15.659402744148506,1
Category_Wikipedia_sockpuppets_of_DENDEN123.csv,11,10690.0,10,1,6,4,0,0.0,0,14,14.0,14
Category_Wikipedia_sockpuppets_of_Artoriusfadianus.csv,423,120981260.0,213,210,108,105,0,56.63120567375886,462,52,24.224586288416077,12
Category_Wikipedia_sockpuppets_of_Unicurse.csv,357,455126093.0,139,218,136,3,0,41.92717086834734,253,35,17.016806722689076,11
Category_Wikipedia_sockpuppets_of_Astropolice.csv,91,6021084.0,39,52,11,28,0,57.2967032967033,267,33,15.0,5
Category_Wikipedia_sockpuppets_of_Equine-man.csv,1616,162555394.0,516,1100,500,16,0,67.18564356435644,476,83,22.769801980198018,3
Category_Wikipedia_sockpuppets_of_Huricane2005dora.csv,138,3458875.0,73,65,32,41,0,49.427536231884055,199,69,28.630434782608695,12
Category_Wikipedia_sockpuppets_of_TIAOWiki.csv,7,2407624.0,5,2,3,2,0,83.85714285714286,189,18,17.0,13
Category_Wikipedia_sockpuppets_of_JP8077.csv,10886,242092785.0,2594,8292,500,2094,0,41.55823994120889,255,57,14.839610508910527,4
Category_Wikipedia_sockpuppets_of_Googgoollman7777.csv,4450,205732009.0,949,3501,500,449,0,49.748988764044945,505,69,10.833033707865168,2
Category_Wikipedia_sockpuppets_of_Kenny_Atkinson.csv,1306,6219701.0,507,799,500,7,0,32.6937212863706,298,47,25.432618683001532,5
Category_Wikipedia_sockpuppets_of_Janagewen.csv,1646,239815918.0,647,999,378,269,0,50.00850546780073,255,62,21.98359659781288,3
Category_Wikipedia_sockpuppets_of_Partyrocker7711.csv,1158,56271075.0,455,703,434,21,0,34.19084628670121,272,34,21.89896373056995,5
Category_Wikipedia_sockpuppets_of_Nirelan.csv,855,190128353.0,330,525,176,154,0,41.705263157894734,219,51,16.77777777777778,3
Category_Wikipedia_sockpuppets_of_Cheeseisgross.csv,1,0.0,1,0,1,0,0,0.0,0,44,44.0,44
Category_Wikipedia_sockpuppets_of_Alexander_the_great1.csv,1072,2329351.0,388,684,383,5,0,43.138992537313435,212,67,23.44776119402985,5
Category_Wikipedia_sockpuppets_of_Ravi22oct.csv,469,2468234.0,172,297,51,121,0,38.857142857142854,200,45,17.550106609808104,5
Category_Wikipedia_sockpuppets_of_Œ°ŒØœÑŒ±_Œ≤ŒµœÅŒπœÜŒ±ŒπŒΩœÑ.csv,50,211889.0,21,29,12,9,0,54.64,206,41,22.98,10
Category_Wikipedia_sockpuppets_of_Solntsa90.csv,1712,29342691.0,512,1200,500,12,0,58.50584112149533,255,60,24.35338785046729,2
Category_Wikipedia_sockpuppets_of_Sripsb.csv,65,972512.0,25,40,20,5,0,72.47692307692307,250,27,12.646153846153846,9
Category_Wikipedia_sockpuppets_of_Wissen975.csv,321,6358590.0,119,202,53,66,0,45.14018691588785,253,54,21.626168224299064,6
Category_Wikipedia_sockpuppets_of_‡¶ú‡¶ô‡ßç‡¶ó‡¶≤‡¶¨‡¶æ‡¶∏‡ßÄ.csv,7003,264073401.0,2114,4889,500,1614,0,40.81864915036413,500,67,21.24532343281451,3
Category_Wikipedia_sockpuppets_of_Mrepoulis.csv,110,23645074.0,36,74,30,6,0,33.27272727272727,248,42,30.618181818181817,18
Category_Wikipedia_sockpuppets_of_Ramesh_Heart.csv,318,8635014.0,144,174,73,71,0,32.67610062893082,237,43,17.09119496855346,5
Category_Wikipedia_sockpuppets_of_CaiKenat.csv,25,168262.0,12,13,6,6,0,65.56,195,22,13.44,12
Category_Wikipedia_sockpuppets_of_ShwE_TV_Myanmar.csv,66,94884.0,27,39,17,10,0,44.25757575757576,237,28,12.424242424242424,5
Category_Wikipedia_sockpuppets_of_Darcel2268.csv,43,354976.0,17,26,13,4,0,42.69767441860465,156,43,25.53488372093023,19
Category_Wikipedia_sockpuppets_of_Francis_ngokumu.csv,80,15215549.0,53,27,33,20,0,65.7,199,32,20.9125,12
Category_Wikipedia_sockpuppets_of_Marykember.csv,486,232262515.0,100,386,27,73,0,46.44444444444444,268,40,16.532921810699587,7
Category_Wikipedia_sockpuppets_of_Golyanovskii.csv,4,42682.0,4,0,4,0,0,51.5,111,11,11.0,11
Category_Wikipedia_sockpuppets_of_Jaden_cassely.csv,296,7068035.0,123,173,60,63,0,43.601351351351354,245,31,11.300675675675675,5
Category_Wikipedia_sockpuppets_of_EFEM_its.csv,226,3381718.0,124,102,42,82,0,37.35840707964602,494,36,21.902654867256636,7
Category_Wikipedia_sockpuppets_of_Patni.Aditya.csv,22,100388.0,7,15,4,3,0,40.72727272727273,231,25,16.636363636363637,13
Category_Wikipedia_sockpuppets_of_Nabil_Yousef_Yousef.csv,20,85727827.0,5,15,5,0,0,52.25,125,29,20.0,17
Category_Wikipedia_sockpuppets_of_Lloydbaltazar.csv,7434,345162665.0,2249,5185,500,1749,0,43.91619585687382,259,60,19.14420231369384,4
Category_Wikipedia_sockpuppets_of_A19470822.csv,251,4032896.0,116,135,92,24,0,67.56175298804781,354,71,18.99203187250996,8
Category_Wikipedia_sockpuppets_of_Aspenheitz.csv,2739,29462868.0,760,1979,385,375,0,43.19386637458927,339,78,16.72690763052209,3
Category_Wikipedia_sockpuppets_of_Cvlwr.csv,1685,20878491.0,627,1058,357,270,0,34.02670623145401,243,69,16.054005934718102,6
Category_Wikipedia_sockpuppets_of_Bobi02052014.csv,75,597661.0,28,47,15,13,0,58.266666666666666,433,45,22.866666666666667,10
Category_Wikipedia_sockpuppets_of_Christine_Kato.csv,65,173253.0,24,41,13,11,0,40.47692307692308,148,53,23.2,13
Category_Wikipedia_sockpuppets_of_Utkalabarta.csv,39,259893679.0,14,25,8,6,0,59.30769230769231,214,26,18.692307692307693,11
Category_Wikipedia_sockpuppets_of_Hein_Moet_Moet.csv,2,0.0,1,1,1,0,134,134.0,134,23,23.0,23
Category_Wikipedia_sockpuppets_of_Miaminsurance.csv,397,188378397.0,135,262,121,14,0,52.2896725440806,496,81,25.292191435768263,9
Category_Wikipedia_sockpuppets_of_Sonic_Wave_XII.csv,11,504.0,4,7,4,0,0,66.63636363636364,188,48,22.0,10
Category_Wikipedia_sockpuppets_of_Indianath.csv,5,15297.0,4,1,3,1,0,24.0,50,48,48.0,48
Category_Wikipedia_sockpuppets_of_David.Tomanek.csv,253,910342.0,124,129,100,24,0,32.00790513833992,269,26,16.363636363636363,8
Category_Wikipedia_sockpuppets_of_Lmmnhn.csv,2101,43814932.0,1000,1101,500,500,0,43.45168967158496,500,75,29.97810566396954,8
Category_Wikipedia_sockpuppets_of_Sumitmpsd.csv,1755,11405690.0,557,1198,482,75,0,44.194301994301995,255,64,15.656980056980057,4
Category_Wikipedia_sockpuppets_of_Gdohgsd.csv,82,142723649.0,40,42,34,6,0,39.0,218,68,26.890243902439025,6
Category_Wikipedia_sockpuppets_of_Johnasonlily.csv,111,8104274.0,32,79,20,12,0,95.08108108108108,500,45,21.26126126126126,5
Category_Wikipedia_sockpuppets_of_Tdv123.csv,1359,108720593.0,511,848,500,11,0,41.70640176600441,388,67,27.922737306843267,8
Category_Wikipedia_sockpuppets_of_Rita_Moritan.csv,1802,130813365.0,487,1315,313,174,0,38.38956714761376,255,113,20.667591564927857,1
Category_Wikipedia_sockpuppets_of_CodyCruickshank.csv,848,28837376.0,502,346,500,2,0,25.64858490566038,255,60,23.5813679245283,9
Category_Wikipedia_sockpuppets_of_Alsvp.csv,1,0.0,1,0,1,0,42,42.0,42,47,47.0,47
Category_Wikipedia_sockpuppets_of_Hymnodist.2004.csv,2444,23080696.0,731,1713,500,231,0,57.25327332242226,440,49,14.24836333878887,3
Category_Wikipedia_sockpuppets_of_Khadim_ahlesunnah_waljamaah.csv,8252,77703480.0,3256,4996,500,2756,0,52.62300048473097,405,105,21.102278235579252,3
Category_Wikipedia_sockpuppets_of_Mrs.T.csv,54,16815.0,21,33,12,9,0,37.77777777777778,138,36,22.72222222222222,14
Category_Wikipedia_sockpuppets_of_Niteshchhetribhai.csv,239,1457720.0,83,156,21,62,0,47.49790794979079,249,36,16.832635983263597,5
Category_Wikipedia_sockpuppets_of_Kahn_and_Averill.csv,262,640143.0,83,179,71,12,0,55.23664122137404,249,28,14.706106870229007,5
Category_Wikipedia_sockpuppets_of_Alphaonekannan.csv,5309,64165946.0,2089,3220,500,1589,0,47.92635147862121,500,88,23.862497645507627,3
Category_Wikipedia_sockpuppets_of_Langotangocoo.csv,18,1370372.0,11,7,8,3,0,183.66666666666666,472,21,20.333333333333332,9
Category_Wikipedia_sockpuppets_of_LabeeqAfzal.csv,3,1460302.0,2,1,2,0,12,22.0,39,17,17.0,17
Category_Wikipedia_sockpuppets_of_Valaleilo.csv,208,201377585.0,63,145,22,41,0,53.03846153846154,230,53,24.783653846153847,7
Category_Wikipedia_sockpuppets_of_MarcoAt18.csv,740,71963733.0,316,424,299,17,0,27.332432432432434,438,70,36.25,18
Category_Wikipedia_sockpuppets_of_Flapkushagra.csv,25,146142.0,19,6,19,0,0,18.36,133,23,18.56,4
Category_Wikipedia_sockpuppets_of_GreekWarrior.csv,548,117728061.0,136,412,106,30,0,33.6478102189781,207,56,20.963503649635037,5
Category_Wikipedia_sockpuppets_of_Gautham_Krishna_007.csv,3912,35399407.0,1299,2613,500,799,0,33.239263803680984,276,70,16.646216768916155,4
Category_Wikipedia_sockpuppets_of_Stripped-xtina.csv,405,2119654.0,126,279,97,29,0,27.91111111111111,199,58,23.609876543209875,5
Category_Wikipedia_sockpuppets_of_ÿ≥ŸÑŸÖÿßŸÜ999.csv,528,16280900.0,173,355,87,86,0,45.28598484848485,255,44,14.846590909090908,4
Category_Wikipedia_sockpuppets_of_StylesClash18.csv,2014,8155552.0,721,1293,500,221,0,48.55114200595829,255,49,18.221449851042703,6
Category_Wikipedia_sockpuppets_of_C.dunkin.csv,393,8624799.0,182,211,173,9,0,35.31806615776082,209,68,24.295165394402037,9
Category_Wikipedia_sockpuppets_of_TougHHead.csv,2955,58479275.0,893,2062,448,445,0,40.75093062605753,250,68,21.389509306260575,4
Category_Wikipedia_sockpuppets_of_Lulz.csv,1,0.0,1,0,1,0,21,21.0,21,17,17.0,17
Category_Wikipedia_sockpuppets_of_Shookallen88.csv,2416,181606617.0,647,1769,222,425,0,40.946605960264904,275,52,16.534354304635762,6
Category_Wikipedia_sockpuppets_of_Mike_Mike.csv,157,76263721.0,41,116,31,10,0,60.3312101910828,254,46,14.764331210191083,6
Category_Wikipedia_sockpuppets_of_Itsvaibhavpopli.csv,1,0.0,1,0,1,0,127,127.0,127,20,20.0,20
Category_Wikipedia_sockpuppets_of_Smettems.csv,2764,299354817.0,653,2111,345,308,0,47.506512301013025,399,52,16.125542691751086,1
Category_Wikipedia_sockpuppets_of_Roger13Zimmerman.csv,263,204522902.0,98,165,80,18,0,60.20532319391635,236,55,20.346007604562736,9
Category_Wikipedia_sockpuppets_of_Larvatus.csv,1522,131241806.0,509,1013,500,9,0,34.78449408672799,250,65,17.773981603153747,1
Category_Wikipedia_sockpuppets_of_DeadSend4.csv,2611,210508774.0,939,1672,500,439,0,52.22481807736499,255,61,17.746840291076214,8
Category_Wikipedia_sockpuppets_of_Call_me_xyz.csv,145,21902847.0,94,51,65,29,0,71.48275862068965,237,21,12.517241379310345,11
Category_Wikipedia_sockpuppets_of_Jerry_Duarte.csv,2470,27562435.0,512,1958,500,12,0,38.9161943319838,496,63,23.6748987854251,4
Category_Wikipedia_sockpuppets_of_Spoopy_SCVNDL.csv,85,816001.0,25,60,14,11,0,59.43529411764706,259,54,21.294117647058822,7
Category_Wikipedia_sockpuppets_of_Leythi.csv,46,4811428.0,33,13,28,5,0,34.630434782608695,169,17,12.76086956521739,11
Category_Wikipedia_sockpuppets_of_The_Hut.csv,2282,349730878.0,522,1760,500,22,0,48.89307624890447,262,83,26.91980718667835,7
Category_Wikipedia_sockpuppets_of_Ethel_D.csv,436,60708300.0,121,315,74,47,0,75.27522935779817,491,50,17.474770642201836,6
Category_Wikipedia_sockpuppets_of_Franchise1218.csv,43,30187048.0,17,26,12,5,0,42.06976744186046,184,33,19.813953488372093,14
Category_Wikipedia_sockpuppets_of_Kunero.csv,21,526413.0,7,14,3,4,15,56.95238095238095,183,5,5.0,5
Category_Wikipedia_sockpuppets_of_ROXELANA22.csv,6048,359962723.0,2285,3763,500,1785,0,30.962632275132275,376,88,16.891699735449734,4
Category_Wikipedia_sockpuppets_of_Mostafa_Elsherbini.csv,532,6554704.0,168,364,138,30,0,36.48872180451128,259,41,21.14097744360902,3
Category_Wikipedia_sockpuppets_of_Kanakaggarawal29.csv,159,9324670.0,70,89,63,7,0,31.547169811320753,240,57,21.433962264150942,11
Category_Wikipedia_sockpuppets_of_Merasian_Luineaz.csv,104,43285372.0,54,50,32,22,0,39.72115384615385,196,29,13.846153846153847,6
Category_Wikipedia_sockpuppets_of_Rabinrahim.csv,131,2224595.0,31,100,15,16,0,33.541984732824424,395,64,15.01526717557252,8
Category_Wikipedia_sockpuppets_of_SINPariah.csv,156,1128228.0,71,85,71,0,0,49.69871794871795,199,90,35.44871794871795,7
Category_Wikipedia_sockpuppets_of_Caedite_eos.csv,523,119374012.0,129,394,112,17,0,45.80688336520077,247,53,22.302103250478012,7
Category_Wikipedia_sockpuppets_of_Sancalls.csv,23,437846127.0,7,16,6,1,0,47.73913043478261,168,19,11.043478260869565,8
Category_Wikipedia_sockpuppets_of_Erebees.csv,26,634658.0,20,6,18,2,0,38.96153846153846,222,21,21.0,21
Category_Wikipedia_sockpuppets_of_Hivas0107.csv,260,21982138.0,140,120,139,1,0,41.073076923076925,301,47,16.015384615384615,3
Category_Wikipedia_sockpuppets_of_ÿ¨ÿßŸä.csv,294,16440061.0,84,210,69,15,0,45.67687074829932,259,48,16.064625850340136,4
Category_Wikipedia_sockpuppets_of_CIS.csv,9230,211680929.0,2461,6769,500,1961,0,46.863488624052,261,74,18.161971830985916,2
Category_Wikipedia_sockpuppets_of_Kpowar.csv,263,18327223.0,137,126,96,41,0,51.26235741444867,416,29,15.247148288973383,5
Category_Wikipedia_sockpuppets_of_Khedive101.csv,474,62896394.0,165,309,163,2,0,40.516877637130804,494,51,17.175105485232066,4
Category_Wikipedia_sockpuppets_of_South_Nashua.csv,2486,20324982.0,1056,1430,500,556,0,36.24416733708769,255,76,21.901448109412712,4
Category_Wikipedia_sockpuppets_of_CenaFUAA.csv,415,3048451.0,96,319,90,6,0,42.86265060240964,428,41,15.966265060240964,6
Category_Wikipedia_sockpuppets_of_KnownFactsChecker.csv,481,49941667.0,153,328,129,24,0,57.84407484407485,442,47,16.972972972972972,5
Category_Wikipedia_sockpuppets_of_Mudcrab69.csv,220,17616941.0,72,148,23,49,0,64.30909090909091,241,51,15.768181818181818,4
Category_Wikipedia_sockpuppets_of_ColackentCreations101.csv,126,28581498.0,38,88,35,3,0,61.46031746031746,392,37,29.126984126984127,16
Category_Wikipedia_sockpuppets_of_Kingcherry2020.csv,260,101099191.0,71,189,65,6,0,60.823076923076925,464,53,23.642307692307693,5
Category_Wikipedia_sockpuppets_of_Farzanfa007.csv,280,126984451.0,103,177,77,26,0,39.55357142857143,290,53,25.414285714285715,10
Category_Wikipedia_sockpuppets_of_The1uncle.csv,19,608062.0,12,7,6,6,0,96.42105263157895,199,18,10.578947368421053,6
Category_Wikipedia_sockpuppets_of_Asaidmanar.csv,553,47489230.0,192,361,125,67,0,54.85352622061483,306,58,20.066907775768534,8
Category_Wikipedia_sockpuppets_of_Slayer_of_corrupt.csv,827,272259111.0,206,621,104,102,0,49.97218863361548,262,75,19.418379685610642,3
Category_Wikipedia_sockpuppets_of_DDEVIL52.csv,24,2334554.0,9,15,9,0,0,33.333333333333336,133,74,35.833333333333336,13
Category_Wikipedia_sockpuppets_of_EeveIndia.csv,33,2566092.0,10,23,8,2,0,50.84848484848485,200,53,33.27272727272727,19
Category_Wikipedia_sockpuppets_of_Funcity55.csv,79,1196135.0,52,27,38,14,0,37.75949367088607,196,55,21.518987341772153,7
Category_Wikipedia_sockpuppets_of_Ucstudentc.csv,54,244125.0,27,27,13,14,0,39.925925925925924,138,46,21.64814814814815,13
Category_Wikipedia_sockpuppets_of_‡¶Ü‡¶∞‡¶æ‡¶´‡¶æ‡¶§_‡¶π‡ßã‡¶∏‡ßá‡¶®_‡¶∂‡¶ø‡¶´‡¶æ‡¶§.csv,2,187.0,2,0,2,0,10,10.0,10,47,47.0,47
Category_Wikipedia_sockpuppets_of_The_Abbasid_Alsayeid_Al_Abbasi.csv,24,759919.0,12,12,11,1,2,55.375,196,40,28.333333333333332,4
Category_Wikipedia_sockpuppets_of_MissLindsayAnn.csv,7,1812.0,6,1,3,3,0,24.0,144,12,12.0,12
Category_Wikipedia_sockpuppets_of_Alfwin_Fernando.csv,465,4847418.0,141,324,138,3,0,45.76129032258064,251,46,15.591397849462366,4
Category_Wikipedia_sockpuppets_of_Iamsujoydey.csv,1,0.0,1,0,1,0,0,0.0,0,27,27.0,27
Category_Wikipedia_sockpuppets_of_Andersonenvy.csv,863,393582383.0,228,635,203,25,0,46.149478563151796,376,66,17.30127462340672,4
Category_Wikipedia_sockpuppets_of_Stephkapfunde.csv,230,190361120.0,116,114,116,0,0,56.61304347826087,325,60,23.339130434782607,10
Category_Wikipedia_sockpuppets_of_Putinscrane.csv,20,1084.0,7,13,7,0,0,95.65,224,27,15.0,11
Category_Wikipedia_sockpuppets_of_Slooppouts34.csv,531,14364181.0,201,330,165,36,0,57.709981167608284,255,50,16.173258003766477,5
Category_Wikipedia_sockpuppets_of_Masgharkhan.csv,12,270630.0,4,8,2,2,0,51.833333333333336,142,16,12.25,11
Category_Wikipedia_sockpuppets_of_GADFLY46.csv,2169,372066933.0,625,1544,315,310,0,42.75749193176579,255,72,20.22913785154449,4
Category_Wikipedia_sockpuppets_of_Georgiano.csv,2258,73588423.0,871,1387,500,371,0,38.98981399468556,330,78,19.95704162976085,4
Category_Wikipedia_sockpuppets_of_Solyishim.csv,6,1060.0,2,4,1,1,0,73.5,183,12,12.0,12
Category_Wikipedia_sockpuppets_of_Obarefoot.csv,28,147051648.0,9,19,9,0,0,23.892857142857142,136,19,15.285714285714286,15
Category_Wikipedia_sockpuppets_of_Rogeiphone.csv,77,3320567.0,29,48,20,9,0,56.98701298701299,204,30,14.753246753246753,11
Category_Wikipedia_sockpuppets_of_Eugenespeed.csv,2520,176269621.0,508,2012,500,8,0,44.047222222222224,247,61,18.16626984126984,3
Category_Wikipedia_sockpuppets_of_Kiranrajkg186.csv,32,72666.0,14,18,10,4,0,48.5625,232,34,17.21875,12
Category_Wikipedia_sockpuppets_of_Anyones_Else_For_Nutley.csv,48,177173.0,20,28,7,13,0,53.479166666666664,199,73,40.791666666666664,11
Category_Wikipedia_sockpuppets_of_Targatron.csv,1022,245639934.0,273,749,165,108,0,55.4187866927593,454,43,19.510763209393346,3
Category_Wikipedia_sockpuppets_of_109.151.65.218.csv,200,260124827.0,50,150,21,29,0,48.465,228,38,24.535,4
Category_Wikipedia_sockpuppets_of_Doremon9087.csv,1740,148065237.0,453,1287,136,317,0,55.95862068965517,496,64,16.09367816091954,4
Category_Wikipedia_sockpuppets_of_Rajchelleonefamily.csv,16,2621902.0,10,6,5,5,0,48.625,182,25,25.0,25
Category_Wikipedia_sockpuppets_of_PoliticianTexas.csv,12411,209450314.0,5076,7335,500,4576,0,35.435581339134636,265,84,23.49625332366449,3
Category_Wikipedia_sockpuppets_of_Aaron7008.csv,3,1483.0,2,1,1,1,21,66.66666666666667,158,16,16.0,16
Category_Wikipedia_sockpuppets_of_Nenetarun.csv,6681,84949094.0,1915,4766,500,1415,0,55.33063912587936,500,84,18.592276605298608,3
Category_Wikipedia_sockpuppets_of_Owie123.csv,39,8634686.0,12,27,12,0,0,40.282051282051285,239,40,19.128205128205128,5
Category_Wikipedia_sockpuppets_of_Keyonta_21.csv,214,40677001.0,83,131,27,56,0,47.88317757009346,246,30,20.911214953271028,7
Category_Wikipedia_sockpuppets_of_Mentalist_karan.csv,520,5092540.0,180,340,154,26,0,52.45961538461538,235,56,24.79423076923077,6
Category_Wikipedia_sockpuppets_of_ÿ≥ŸÜÿ¥ÿ¥ŸÖÿ¥ŸÖÿ¥.csv,10,910.0,5,5,2,3,0,52.5,128,25,19.8,15
Category_Wikipedia_sockpuppets_of_Willy_wonka_and_the_dikipedia_factory.csv,104,64696802.0,27,77,12,15,0,43.23076923076923,156,42,18.125,6
Category_Wikipedia_sockpuppets_of_Ddd1600.csv,1561,513869788.0,389,1172,377,12,0,54.021140294682894,432,52,16.53683536194747,4
Category_Wikipedia_sockpuppets_of_Doctorlaw.csv,1290,213919468.0,420,870,300,120,0,46.26201550387597,255,73,24.136434108527133,3
Category_Wikipedia_sockpuppets_of_Dylaneft.csv,386,7573413.0,95,291,40,55,0,52.64766839378238,260,35,11.878238341968911,4
Category_Wikipedia_sockpuppets_of_Aalaan.csv,3199,278712293.0,1014,2185,500,514,0,45.351984995311035,255,54,15.972491403563614,5
Category_Wikipedia_sockpuppets_of_Shanker_Pur.csv,1055,37004152.0,362,693,360,2,0,51.28625592417062,237,58,18.603791469194313,4
Category_Wikipedia_sockpuppets_of_Politobzor.csv,95,40454106.0,24,71,19,5,0,54.73684210526316,259,41,18.905263157894737,10
Category_Wikipedia_sockpuppets_of_Eurokiwi.csv,2742,55055072.0,1000,1742,500,500,0,40.41101385849745,249,102,21.25309992706054,3
Category_Wikipedia_sockpuppets_of_Stevenspiegel.csv,130,50812705.0,33,97,32,1,0,33.13846153846154,193,45,22.953846153846154,11
Category_Wikipedia_sockpuppets_of_Hahahihihoho.csv,2623,28511674.0,832,1791,380,452,0,30.732367518109037,203,65,18.008387342737322,1
Category_Wikipedia_sockpuppets_of_Ekajati.csv,24162,97671095.0,7915,16247,500,7415,0,41.830022349143285,254,96,16.975043456667496,2
Category_Wikipedia_sockpuppets_of_SpryLiving.csv,15,2124.0,5,10,4,1,0,30.533333333333335,159,16,14.333333333333334,11
Category_Wikipedia_sockpuppets_of_Runningcupcake03.csv,776,20475255.0,380,396,378,2,0,34.63788659793814,222,46,21.2770618556701,6
Category_Wikipedia_sockpuppets_of_CantBeatEmJoinEm.csv,87,545309.0,36,51,19,17,0,56.48275862068966,220,29,17.60919540229885,8
Category_Wikipedia_sockpuppets_of_Ekurume8.csv,46,2461235.0,22,24,12,10,0,52.52173913043478,206,28,12.91304347826087,5
Category_Wikipedia_sockpuppets_of_Hawner;g.csv,8,51063.0,3,5,3,0,22,84.875,204,23,14.25,3
Category_Wikipedia_sockpuppets_of_Sevcohaha.csv,2415,108787006.0,999,1416,500,499,0,49.68447204968944,261,80,22.732091097308487,8
Category_Wikipedia_sockpuppets_of_Koyokilolz.csv,130,8130003.0,61,69,12,49,0,38.715384615384615,232,26,18.1,8
Category_Wikipedia_sockpuppets_of_‡¶Æ‡ßÉ‡¶ó‡¶æ‡¶Ç‡¶ï.csv,288,3203777.0,160,128,101,59,0,21.243055555555557,238,53,27.25,7
Category_Wikipedia_sockpuppets_of_Yeonyeon1230.csv,1078,27038729.0,451,627,239,212,0,31.100185528756956,255,55,17.82838589981447,5
Category_Wikipedia_sockpuppets_of_Wesley644.csv,1,0.0,1,0,1,0,16,16.0,16,12,12.0,12
Category_Wikipedia_sockpuppets_of_Jimmy_McDaniels.csv,484,63752374.0,181,303,128,53,0,52.65289256198347,250,51,25.867768595041323,8
Category_Wikipedia_sockpuppets_of_Rawatg1602.csv,32,1424161.0,11,21,10,1,0,47.84375,139,35,22.21875,11
Category_Wikipedia_sockpuppets_of_Ncbipindra.csv,12,125828134.0,11,1,9,2,0,27.416666666666668,177,44,34.666666666666664,16
Category_Wikipedia_sockpuppets_of_BenYaamin.csv,75,6377636.0,32,43,27,5,0,48.22666666666667,214,62,28.44,13
Category_Wikipedia_sockpuppets_of_Holland_Tok.csv,2062,1546616.0,598,1464,500,98,0,48.405916585838995,392,47,16.24878758486906,5
Category_Wikipedia_sockpuppets_of_Naktipanchal.csv,46,107163091.0,14,32,11,3,0,46.41304347826087,207,16,11.934782608695652,5
Category_Wikipedia_sockpuppets_of_Speakoutfreely.csv,415,88398214.0,99,316,70,29,0,53.53012048192771,237,24,14.142168674698794,5
Category_Wikipedia_sockpuppets_of_Saskia_lou.csv,390,23070535.0,149,241,126,23,0,38.45641025641026,436,42,15.297435897435898,7
Category_Wikipedia_sockpuppets_of_Zac_hyams.csv,2,0.0,1,1,1,0,0,0.0,0,25,25.0,25
Category_Wikipedia_sockpuppets_of_P0CF1B.csv,23,4769045.0,13,10,8,5,0,33.82608695652174,136,50,37.391304347826086,13
Category_Wikipedia_sockpuppets_of_‡¶∏‡¶¨‡¶ú‡¶æ‡¶®‡ßç‡¶§‡¶æ.csv,1138,96242842.0,291,847,189,102,0,48.1871704745167,496,62,14.112478031634446,5
Category_Wikipedia_sockpuppets_of_Stradiot.csv,7,167306.0,5,2,3,2,0,40.714285714285715,164,5,5.0,5
Category_Wikipedia_sockpuppets_of_Dazoutti.csv,3403,51974408.0,1193,2210,154,1039,0,43.53188363208933,500,54,18.356156332647664,5
Category_Wikipedia_sockpuppets_of_Danthemanlok.csv,96,6732252.0,36,60,31,5,0,48.333333333333336,210,53,22.270833333333332,4
Category_Wikipedia_sockpuppets_of_Jainsuchita7.csv,115,9243221.0,43,72,40,3,0,38.243478260869566,224,36,17.330434782608695,7
Category_Wikipedia_sockpuppets_of_HNS_Counselors_for_Bitcoin_Suisse_capo.csv,22,2390254.0,9,13,9,0,0,25.227272727272727,98,48,46.09090909090909,43
Category_Wikipedia_sockpuppets_of_Wconnell201.csv,72,238885478.0,23,49,21,2,0,42.0,196,52,21.125,11
Category_Wikipedia_sockpuppets_of_Vonderjohn.csv,203,245067584.0,55,148,47,8,0,50.81773399014779,266,38,22.23152709359606,8
Category_Wikipedia_sockpuppets_of_Alfred_Legrand.csv,2883,65828935.0,966,1917,401,565,0,31.158168574401664,216,56,17.99445022545959,1
Category_Wikipedia_sockpuppets_of_Neanbie.csv,17,643443.0,12,5,8,4,0,22.764705882352942,150,21,15.352941176470589,11
Category_Wikipedia_sockpuppets_of_Rashtooiy.csv,12,161030.0,4,8,3,1,0,74.91666666666667,206,17,16.25,12
Category_Wikipedia_sockpuppets_of_Legendado.csv,33,8479646.0,23,10,17,6,0,50.303030303030305,202,74,30.78787878787879,11
Category_Wikipedia_sockpuppets_of_Thescholarlyinsight.csv,200,111922443.0,65,135,54,11,0,41.395,249,78,31.15,8
Category_Wikipedia_sockpuppets_of_JesusLuna19.csv,404,59674327.0,146,258,128,18,0,42.289603960396036,376,38,18.762376237623762,6
Category_Wikipedia_sockpuppets_of_Sivalesnar.csv,129,8494942.0,34,95,29,5,0,42.24031007751938,255,29,14.945736434108527,6
Category_Wikipedia_sockpuppets_of_Emmakylie75.csv,115,33078438.0,27,88,24,3,0,54.8,252,36,19.339130434782607,10
Category_Wikipedia_sockpuppets_of_Brian002100.csv,70,87825.0,41,29,41,0,0,31.042857142857144,141,42,25.97142857142857,5
Category_Wikipedia_sockpuppets_of_ECW500.csv,4384,183925221.0,1347,3037,461,886,0,43.784671532846716,255,73,22.652600364963504,3
Category_Wikipedia_sockpuppets_of_BrunoMed.csv,1321,43635848.0,525,796,500,25,0,63.03860711582135,255,65,19.96971990915973,4
Category_Wikipedia_sockpuppets_of_John_Torn.csv,247,5522406.0,94,153,39,55,0,53.23481781376518,250,54,21.55060728744939,3
Category_Wikipedia_sockpuppets_of_Mariannan.csv,577,8398769.0,289,288,289,0,0,33.10918544194107,237,50,22.547660311958406,9
Category_Wikipedia_sockpuppets_of_Cesare_Barbone.csv,539,233613696.0,217,322,146,71,0,36.43413729128015,236,61,16.0278293135436,3
Category_Wikipedia_sockpuppets_of_Skeptic25.csv,31,1599.0,12,19,11,1,0,51.935483870967744,229,23,16.677419354838708,10
Category_Wikipedia_sockpuppets_of_HardstyleViking.csv,200,1949777.0,78,122,48,30,0,34.535,199,27,12.18,4
Category_Wikipedia_sockpuppets_of_Maheshkumaryadav.csv,1265,2476291.0,506,759,500,6,0,46.0403162055336,243,93,31.273517786561264,6
Category_Wikipedia_sockpuppets_of_Abdullah7922.csv,378,11171071.0,124,254,82,42,0,50.65873015873016,485,67,20.566137566137566,5
Category_Wikipedia_sockpuppets_of_Jdfielder.csv,94,58250769.0,24,70,20,4,0,63.691489361702125,207,22,14.627659574468085,8
Category_Wikipedia_sockpuppets_of_Guilherme_Gava_Bergami.csv,386,30744220.0,102,284,33,69,0,39.52849740932643,407,46,19.70984455958549,6
Category_Wikipedia_sockpuppets_of_Artincider.csv,6,8227.0,5,1,3,2,30,40.666666666666664,94,50,50.0,50
Category_Wikipedia_sockpuppets_of_MonkeyKingdom.csv,1020,149132368.0,570,450,500,70,0,43.61078431372549,259,53,18.999019607843138,5
Category_Wikipedia_sockpuppets_of_Pinktulip.csv,2383,110843045.0,677,1706,500,177,0,45.64330675618967,235,74,22.251363827108687,5
Category_Wikipedia_sockpuppets_of_Marquis_de_la_Eirron.csv,42273,431330981.0,13197,29076,500,12697,0,45.15522910604878,525,102,26.681262271426206,3
Category_Wikipedia_sockpuppets_of_BasedHistorian_PHD.csv,666,15846158.0,199,467,107,92,0,47.133633633633636,500,53,15.567567567567568,5
Category_Wikipedia_sockpuppets_of_Haiwan_Talukder.csv,143,13968901.0,46,97,37,9,0,28.783216783216783,159,40,16.51048951048951,5
Category_Wikipedia_sockpuppets_of_FrameWave20.csv,1822,76651777.0,626,1196,332,294,0,35.01042810098792,250,60,17.964324917672887,3
Category_Wikipedia_sockpuppets_of_Andrewho22.csv,44,510359.0,26,18,19,7,0,48.04545454545455,229,18,13.227272727272727,13
Category_Wikipedia_sockpuppets_of_BEAR_GORILLA.csv,63,352045.0,34,29,24,10,0,51.53968253968254,219,45,19.6984126984127,5
Category_Wikipedia_sockpuppets_of_Pariapornouri.csv,24,105675002.0,12,12,10,2,0,33.333333333333336,196,23,13.375,12
Category_Wikipedia_sockpuppets_of_Radio_Retropolis.csv,33,494943.0,16,17,12,4,0,58.666666666666664,237,41,27.454545454545453,10
Category_Wikipedia_sockpuppets_of_Superheroprashast.csv,728,18332572.0,260,468,230,30,0,36.017857142857146,255,55,15.862637362637363,5
Category_Wikipedia_sockpuppets_of_QayidHakim1129.csv,18,86025557.0,12,6,5,7,0,49.27777777777778,155,28,13.88888888888889,11
Category_Wikipedia_sockpuppets_of_LineofWisdom.csv,906,6349834.0,305,601,241,64,0,40.152317880794705,247,73,30.314569536423843,3
Category_Wikipedia_sockpuppets_of_Robsteadman.csv,1976,25011008.0,775,1201,500,275,0,30.910931174089068,196,72,17.012145748987855,3
Category_Wikipedia_sockpuppets_of_Johncoracing48.csv,803,47783315.0,364,439,344,20,0,35.82689912826899,260,57,20.315068493150687,8
Category_Wikipedia_sockpuppets_of_Galantoe000.csv,229,1785271.0,68,161,26,42,0,43.63755458515284,270,62,20.222707423580786,5
Category_Wikipedia_sockpuppets_of_Sleonard1.csv,2,136.0,2,0,2,0,0,0.0,0,19,19.0,19
Category_Wikipedia_sockpuppets_of_Crosario1976.csv,2,7645.0,2,0,1,1,22,133.0,244,36,26.5,17
Category_Wikipedia_sockpuppets_of_PupƒÉzoiul.csv,2,18.0,2,0,2,0,26,30.5,35,22,17.5,13
Category_Wikipedia_sockpuppets_of_KFIRE12341234.csv,50,354800.0,50,0,49,1,0,8.98,194,29,18.22,18
Category_Wikipedia_sockpuppets_of_Evelynkwapong539.csv,1972,36044566.0,789,1183,500,289,0,45.838235294117645,480,54,22.90212981744422,6
Category_Wikipedia_sockpuppets_of_Albot1997.csv,203,24359904.0,48,155,18,30,0,42.21182266009852,215,30,18.99014778325123,3
Category_Wikipedia_sockpuppets_of_Mechstudent.csv,422,2682985.0,151,271,96,55,0,33.68009478672986,243,37,16.026066350710902,7
Category_Wikipedia_sockpuppets_of_Mediolanum.csv,2031,43177445.0,615,1416,273,342,0,45.05416051206302,255,53,20.454455933037913,2
Category_Wikipedia_sockpuppets_of_GAGFSHEDGMN.csv,615,1659836.0,352,263,189,163,0,31.985365853658536,232,55,25.276422764227643,3
Category_Wikipedia_sockpuppets_of_Ron_Robey.csv,45,15606094.0,17,28,13,4,7,71.31111111111112,212,41,21.622222222222224,14
Category_Wikipedia_sockpuppets_of_Vgleer.csv,1603,96762959.0,383,1220,40,343,0,57.96568933250156,255,65,15.228945726762321,3
Category_Wikipedia_sockpuppets_of_Xiaoyang_Yu.csv,47,266903.0,24,23,19,5,0,66.61702127659575,268,16,13.02127659574468,11
Category_Wikipedia_sockpuppets_of_Sabby20.csv,17,3580530.0,11,6,7,4,0,30.941176470588236,126,26,23.11764705882353,19
Category_Wikipedia_sockpuppets_of_Anglofasce.csv,254,3053742.0,100,154,78,22,0,34.69291338582677,251,34,24.114173228346456,15
Category_Wikipedia_sockpuppets_of_Jamesflare.csv,52,15429740.0,21,31,18,3,0,34.44230769230769,196,64,21.865384615384617,9
Category_Wikipedia_sockpuppets_of_Gallipoli1915.csv,41,50025.0,13,28,10,3,0,56.65853658536585,307,29,19.29268292682927,11
Category_Wikipedia_sockpuppets_of_Nagihuin.csv,785,150257155.0,194,591,193,1,0,59.83949044585987,255,48,18.727388535031846,5
Category_Wikipedia_sockpuppets_of_Qiwi.csv,48,192210532.0,17,31,13,4,0,40.229166666666664,198,20,14.145833333333334,9
Category_Wikipedia_sockpuppets_of_Notfrompedro.csv,3387,34457611.0,1000,2387,500,500,0,75.64127546501328,499,64,20.65160909359315,1
Category_Wikipedia_sockpuppets_of_Meowcat1236.csv,21,5633017.0,11,10,8,3,0,54.23809523809524,221,21,14.19047619047619,9
Category_Wikipedia_sockpuppets_of_SolomonisShlomo.csv,7,1207902.0,3,4,1,2,10,136.28571428571428,248,8,7.285714285714286,7
Category_Wikipedia_sockpuppets_of_Atespon.csv,307,26747449.0,68,239,36,32,0,55.42671009771987,329,41,17.68729641693811,6
Category_Wikipedia_sockpuppets_of_The_Deadly_TV_series.csv,284,24291731.0,95,189,22,73,0,51.566901408450704,251,50,20.58450704225352,3
Category_Wikipedia_sockpuppets_of_Puxunito.csv,86,9680506.0,26,60,12,14,0,57.80232558139535,255,33,15.546511627906977,5
Category_Wikipedia_sockpuppets_of_Mrmeatboy123.csv,58,38555154.0,16,42,10,6,0,65.75862068965517,249,27,16.913793103448278,10
Category_Wikipedia_sockpuppets_of_Tabstis.csv,45,35609074.0,12,33,12,0,0,55.15555555555556,205,19,12.577777777777778,9
Category_Wikipedia_sockpuppets_of_Join_Instagram_at_Under_13.csv,397,55628543.0,119,278,56,63,0,53.576826196473554,500,45,22.09823677581864,4
Category_Wikipedia_sockpuppets_of_Dtt1.csv,1183,17195187.0,503,680,500,3,0,61.72020287404903,420,66,24.770921386306,5
Category_Wikipedia_sockpuppets_of_Simran1993.csv,20,3276265.0,11,9,5,6,0,35.65,160,22,16.5,4
Category_Wikipedia_sockpuppets_of_Itrules.csv,75,16434914.0,40,35,37,3,0,48.346666666666664,186,24,16.44,3
Category_Wikipedia_sockpuppets_of_LilLoadedDickRider.csv,5,951.0,3,2,2,1,0,65.0,144,10,10.0,10
Category_Wikipedia_sockpuppets_of_Sleepydre.csv,2228,71707669.0,1087,1141,500,587,0,46.680430879712745,255,57,15.71229802513465,4
Category_Wikipedia_sockpuppets_of_Vyxrxeexeht6g.csv,103,2173503.0,35,68,24,11,0,43.95145631067961,227,28,12.572815533980583,6
Category_Wikipedia_sockpuppets_of_RJR3333.csv,4688,276098928.0,1391,3297,500,891,0,48.866254266211605,255,56,19.602815699658702,3
Category_Wikipedia_sockpuppets_of_Kellyrichter.csv,23,1040571.0,12,11,9,3,0,34.0,148,41,31.391304347826086,20
Category_Wikipedia_sockpuppets_of_Dust429.csv,703,109191744.0,206,497,126,80,0,43.28876244665718,250,54,21.099573257467995,4
Category_Wikipedia_sockpuppets_of_AKADEMIYA2063.csv,21,9312426.0,11,10,7,4,0,63.285714285714285,451,33,25.38095238095238,23
Category_Wikipedia_sockpuppets_of_Mwalla.csv,1224,84239287.0,331,893,233,98,0,40.87908496732026,250,73,20.772875816993466,7
Category_Wikipedia_sockpuppets_of_Nick_UK_took_a_falldown_in_2005.csv,41,3298.0,13,28,10,3,0,65.5609756097561,210,46,27.51219512195122,6
Category_Wikipedia_sockpuppets_of_45managementinc.csv,4,15586.0,4,0,4,0,0,23.75,39,23,23.0,23
Category_Wikipedia_sockpuppets_of_Jump2225.csv,13,600.0,4,9,4,0,0,34.53846153846154,172,14,13.384615384615385,12
Category_Wikipedia_sockpuppets_of_Mielhoney.csv,375,247321892.0,135,240,135,0,0,65.90933333333334,493,54,17.026666666666667,5
Category_Wikipedia_sockpuppets_of_Sussyman11.csv,95,27563310.0,32,63,19,13,0,41.88421052631579,262,41,20.6,7
Category_Wikipedia_sockpuppets_of_MapleviewLounge.csv,89,6531878.0,47,42,26,21,0,48.79775280898876,202,48,23.53932584269663,11
Category_Wikipedia_sockpuppets_of_Artsandopinion.csv,472,140371491.0,122,350,120,2,0,44.30084745762712,232,36,15.042372881355933,4
Category_Wikipedia_sockpuppets_of_RabidWombatJR.csv,119,4842300.0,34,85,18,16,0,37.78151260504202,232,55,30.218487394957982,12
Category_Wikipedia_sockpuppets_of_MyBleedingHeart.csv,1501,40470705.0,506,995,500,6,0,35.188540972684876,425,54,15.8927381745503,5
Category_Wikipedia_sockpuppets_of_Self_made_theory.csv,807,20838767.0,242,565,93,149,0,43.80545229244114,354,68,19.83271375464684,5
Category_Wikipedia_sockpuppets_of_JJimbo3.csv,106,384711.0,37,69,20,17,0,42.62264150943396,220,36,27.556603773584907,12
Category_Wikipedia_sockpuppets_of_Michaelpkk.csv,633,4429203.0,186,447,123,63,0,41.494470774091624,241,90,23.541864139020536,4
Category_Wikipedia_sockpuppets_of_Spiros4m.csv,199,287383435.0,60,139,57,3,0,40.778894472361806,235,44,18.92964824120603,2
Category_Wikipedia_sockpuppets_of_Hasankhan96.csv,55,19842.0,16,39,16,0,0,57.85454545454545,236,39,19.436363636363637,6
Category_Wikipedia_sockpuppets_of_SirEpicBob.csv,552,5266837.0,220,332,63,157,0,37.766304347826086,222,63,21.505434782608695,3
Category_Wikipedia_sockpuppets_of_BluesFan1930.csv,790,41984735.0,322,468,277,45,0,35.30253164556962,255,57,19.72025316455696,5
Category_Wikipedia_sockpuppets_of_Dragoon17cc.csv,198,284571055.0,46,152,42,4,0,40.75252525252525,237,47,20.166666666666668,10
Category_Wikipedia_sockpuppets_of_Yanela.s_zulu.csv,789,119667635.0,282,507,51,231,0,50.50063371356147,351,57,14.948035487959443,4
Category_Wikipedia_sockpuppets_of_DraKyry.csv,744,260672149.0,214,530,169,45,0,61.04032258064516,255,58,22.469086021505376,4
Category_Wikipedia_sockpuppets_of_VMORO.csv,1631,493838312.0,513,1118,500,13,0,54.91416309012875,500,61,18.803801348865726,3
Category_Wikipedia_sockpuppets_of_Marvixo.csv,302,6141476.0,102,200,66,36,0,49.705298013245034,255,54,19.60927152317881,6
Category_Wikipedia_sockpuppets_of_Newton.sg1.csv,4,13100.0,3,1,2,1,0,29.25,71,22,18.25,17
Category_Wikipedia_sockpuppets_of_bunzyfunzy.csv,194,169052474.0,70,124,67,3,0,42.654639175257735,224,54,25.211340206185568,9
Category_Wikipedia_sockpuppets_of_JEBahrain.csv,88,4115328.0,57,31,45,12,0,42.25,283,25,19.09090909090909,10
Category_Wikipedia_sockpuppets_of_Bags_of_atoms.csv,1,0.0,1,0,1,0,60,60.0,60,11,11.0,11
Category_Wikipedia_sockpuppets_of_Hoes_over_Bros.csv,15,518862.0,3,12,2,1,0,37.8,94,29,20.666666666666668,18
Category_Wikipedia_sockpuppets_of_Telangapatha.csv,218,2946643.0,135,83,83,52,0,43.11009174311926,253,52,26.472477064220183,10
Category_Wikipedia_sockpuppets_of_Simmerdon3448.csv,5477,17688100.0,1500,3977,500,1000,0,47.7566185868176,429,67,18.86963666240643,5
Category_Wikipedia_sockpuppets_of_Msc008.csv,78,186841947.0,22,56,21,1,0,45.17948717948718,221,64,30.384615384615383,11
Category_Wikipedia_sockpuppets_of_Dr90s.csv,3700,77156731.0,1032,2668,205,827,0,43.71054054054054,245,82,25.76054054054054,5
Category_Wikipedia_sockpuppets_of_ImRomeoHarris.csv,7,10310.0,2,5,2,0,0,12.285714285714286,46,20,17.857142857142858,17
Category_Wikipedia_sockpuppets_of_Ddwilli2.csv,1,0.0,1,0,1,0,0,0.0,0,10,10.0,10
Category_Wikipedia_sockpuppets_of_Kiaxar.csv,369,5637281.0,105,264,70,35,0,46.27642276422764,248,50,17.119241192411923,5
Category_Wikipedia_sockpuppets_of_RahulChawla2907.csv,308,3933490.0,145,163,83,62,0,87.13311688311688,496,51,16.996753246753247,8
Category_Wikipedia_sockpuppets_of_Iamfiveee.csv,3,4625.0,3,0,3,0,28,140.0,196,19,15.666666666666666,14
Category_Wikipedia_sockpuppets_of_Ansathas.csv,280,419227698.0,88,192,66,22,0,58.46785714285714,255,34,19.135714285714286,7
Category_Wikipedia_sockpuppets_of_RebeccaMcdonald.csv,61,108587.0,26,35,24,2,0,49.39344262295082,225,25,19.491803278688526,13
Category_Wikipedia_sockpuppets_of_Priyansh_Jadhav.csv,20,21295807.0,7,13,4,3,0,44.1,255,53,40.35,20
Category_Wikipedia_sockpuppets_of_Robloxsid.csv,369,49217709.0,149,220,29,120,0,35.18970189701897,249,60,20.466124661246614,9
Category_Wikipedia_sockpuppets_of_THENEWYORKER.csv,437,397769897.0,184,253,46,138,0,41.139588100686495,496,38,22.643020594965677,11
Category_Wikipedia_sockpuppets_of_Jaxoncat13.csv,1457,26341536.0,443,1014,229,214,0,43.15374056280027,306,69,22.504461221688402,2
Category_Wikipedia_sockpuppets_of_GoShow.csv,2935,27012343.0,781,2154,500,281,0,65.26678023850086,255,59,17.624872231686542,3
Category_Wikipedia_sockpuppets_of_TJ_Terry.csv,1079,31693946.0,242,837,228,14,0,40.42817423540315,241,44,14.11955514365153,4
Category_Wikipedia_sockpuppets_of_SwedenAviator.csv,461,168635171.0,130,331,57,73,0,47.56182212581345,381,62,20.071583514099782,6
Category_Wikipedia_sockpuppets_of_Marvzi.csv,648,53346126.0,219,429,172,47,0,49.21604938271605,255,54,32.875,5
Category_Wikipedia_sockpuppets_of_Bestguyhi.csv,48,6431202.0,17,31,13,4,0,101.4375,365,34,24.708333333333332,15
Category_Wikipedia_sockpuppets_of_Nimisha_Pramod.csv,298,5946929.0,77,221,27,50,0,43.38590604026846,312,38,14.486577181208053,5
Category_Wikipedia_sockpuppets_of_OtterStewLou.csv,82,11886676.0,49,33,39,10,0,30.634146341463413,265,25,13.195121951219512,11
Category_Wikipedia_sockpuppets_of_Marlon.sahetapy.csv,1133,42562702.0,326,807,185,141,0,29.9567519858782,223,48,14.837599293909973,4
Category_Wikipedia_sockpuppets_of_Jacobjakielaszek.csv,17,9042.0,5,12,3,2,0,57.05882352941177,196,26,18.647058823529413,14
Category_Wikipedia_sockpuppets_of_StewieGriffin1998.csv,4240,16763951.0,1042,3198,500,542,0,40.032311320754715,463,58,19.287028301886792,4
Category_Wikipedia_sockpuppets_of_Satrawi_rebel.csv,202,249657.0,80,122,45,35,0,28.004950495049506,169,65,24.331683168316832,7
Category_Wikipedia_sockpuppets_of_Wikidemon9.csv,25,21321.0,13,12,9,4,0,60.28,199,36,18.8,10
Category_Wikipedia_sockpuppets_of_ShadowKILIKILI123.csv,266,14667309.0,124,142,65,59,0,33.62406015037594,225,50,30.01127819548872,8
Category_Wikipedia_sockpuppets_of_Fyillovawwrfgg.csv,5,129.0,3,2,3,0,0,58.6,131,7,7.0,7
Category_Wikipedia_sockpuppets_of_Hyrijesaliu.csv,4218,52533331.0,1558,2660,500,1058,0,28.183736367946896,255,42,17.990753911806543,4
Category_Wikipedia_sockpuppets_of_Atulsalgar.csv,25,47662317.0,8,17,4,4,0,26.08,196,28,19.04,15
Category_Wikipedia_sockpuppets_of_Rajpubhatti.csv,24,2917766.0,6,18,3,3,0,49.166666666666664,147,27,16.125,4
Category_Wikipedia_sockpuppets_of_ColourWolf.csv,2791,96246530.0,1079,1712,129,950,0,35.29487638839126,220,60,18.639555714797563,4
Category_Wikipedia_sockpuppets_of_Dalai_lama_ding_dong.csv,3215,30106507.0,962,2253,500,462,0,61.32130637636081,255,62,22.981959564541214,4
Category_Wikipedia_sockpuppets_of_LsnIg334.csv,2431,92736328.0,749,1682,500,249,0,50.81900452488688,360,75,21.525298231180585,2
Category_Wikipedia_sockpuppets_of_Franklin_Singh_Oyet.csv,130,73018837.0,39,91,17,22,0,53.30769230769231,245,29,14.692307692307692,4
Category_Wikipedia_sockpuppets_of_Macking3004.csv,28,1470100.0,25,3,22,3,0,47.857142857142854,214,17,17.0,17
Category_Wikipedia_sockpuppets_of_Quantum_Particles.csv,2006,4503008.0,604,1402,372,232,0,55.899302093718845,256,65,18.991026919242273,2
Category_Wikipedia_sockpuppets_of_Flygongengar.csv,1624,204069914.0,520,1104,500,20,0,49.33497536945813,256,64,22.22536945812808,3
Category_Wikipedia_sockpuppets_of_Dsklw.csv,46,54142.0,19,27,15,4,0,57.41304347826087,208,23,17.52173913043478,7
Category_Wikipedia_sockpuppets_of_Transformers2000.csv,343,6692336.0,184,159,172,12,0,30.38483965014577,310,48,36.23615160349854,14
Category_Wikipedia_sockpuppets_of_The_HMS_Sans_Pareil.csv,310,6827322.0,110,200,37,73,0,30.061290322580646,288,37,24.51290322580645,7
Category_Wikipedia_sockpuppets_of_ByaAkai.csv,3228,110065884.0,853,2375,500,353,0,33.83426270136307,255,71,24.552354399008674,3
Category_Wikipedia_sockpuppets_of_Creditrepaircloud.csv,27,74500561.0,18,9,17,1,0,18.925925925925927,89,27,13.666666666666666,12
Category_Wikipedia_sockpuppets_of_Piaarhipiaar.csv,163,5827867.0,103,60,100,3,0,57.423312883435585,413,45,33.32515337423313,21
Category_Wikipedia_sockpuppets_of_Vijay166.csv,1,0.0,1,0,1,0,0,0.0,0,22,22.0,22
Category_Wikipedia_sockpuppets_of_ANURAG4652.csv,238,11145959.0,119,119,42,77,0,34.54621848739496,213,41,15.121848739495798,6
Category_Wikipedia_sockpuppets_of_Denosio.csv,6253,13226111.0,2166,4087,500,1666,0,43.9585798816568,501,69,29.152566767951384,6
Category_Wikipedia_sockpuppets_of_Zaman_Ali_01.csv,17,361686.0,6,11,4,2,0,38.294117647058826,82,41,22.764705882352942,18
Category_Wikipedia_sockpuppets_of_Amir.Hossein.7055.csv,12310,68504339.0,3911,8399,500,3411,0,30.89220146222583,265,73,21.060357432981316,3
Category_Wikipedia_sockpuppets_of_Contributions_to_gbr.csv,169,123606812.0,59,110,38,21,0,39.69230769230769,255,45,17.4792899408284,9
Category_Wikipedia_sockpuppets_of_Grote_gerarad.csv,50,1273.0,17,33,15,2,0,31.34,209,24,16.18,9
Category_Wikipedia_sockpuppets_of_MoonMetropolis.csv,1291,1295733.0,505,786,500,5,0,50.23625096824167,255,62,24.990704879938033,5
Category_Wikipedia_sockpuppets_of_Prehistoricplanes.csv,1047,77450559.0,367,680,327,40,0,55.70773638968481,500,36,15.89111747851003,4
Category_Wikipedia_sockpuppets_of_Rajabasu.csv,345,465352599.0,69,276,65,4,0,48.4,312,44,16.605797101449276,7
Category_Wikipedia_sockpuppets_of_LegrisKe.csv,518,29222566.0,157,361,91,66,0,50.91891891891892,249,67,20.41891891891892,4
Category_Wikipedia_sockpuppets_of_TyHaliburtn.csv,974,8950997.0,400,574,173,227,0,51.063655030800824,500,71,36.70225872689939,9
Category_Wikipedia_sockpuppets_of_Frenchcafe.csv,1381,189051926.0,573,808,500,73,0,28.357711803041273,254,54,19.099203475742215,3
Category_Wikipedia_sockpuppets_of_Lord12349876.csv,29,732687.0,28,1,26,2,0,15.03448275862069,21,30,10.689655172413794,10
Category_Wikipedia_sockpuppets_of_Faisalkhankkc.csv,2,38.0,2,0,2,0,0,0.0,0,41,41.0,41
Category_Wikipedia_sockpuppets_of_Takiva.csv,182,40482013.0,51,131,17,34,0,55.67032967032967,484,30,13.104395604395604,7
Category_Wikipedia_sockpuppets_of_Youlittlehandsomeguy.csv,160,20736168.0,32,128,31,1,0,44.61875,250,25,12.2875,2
Category_Wikipedia_sockpuppets_of_Ravi1962.csv,5,343563226.0,4,1,4,0,0,18.6,37,20,20.0,20
Category_Wikipedia_sockpuppets_of_Alexia_thomas15.csv,398,9323848.0,188,210,56,132,0,50.324120603015075,250,88,24.236180904522612,5
Category_Wikipedia_sockpuppets_of_Slic_Ric_Flair.csv,56,36519.0,22,34,15,7,0,73.125,249,47,22.625,9
Category_Wikipedia_sockpuppets_of_Bayat_hessam.csv,27,4399872.0,13,14,8,5,0,63.55555555555556,240,27,15.0,7
Category_Wikipedia_sockpuppets_of_AnEditorNameA.csv,53,521163.0,39,14,38,1,0,32.905660377358494,240,47,16.62264150943396,7
Category_Wikipedia_sockpuppets_of_Zeeshanshafiq988.csv,1,0.0,1,0,1,0,196,196.0,196,29,29.0,29
Category_Wikipedia_sockpuppets_of_Republic_of_India.csv,130,3958526.0,90,40,80,10,0,18.00769230769231,191,37,23.03846153846154,15
Category_Wikipedia_sockpuppets_of_Reverend_Colman_Trembley.csv,1333,18499597.0,461,872,275,186,0,47.79594898724681,500,94,18.06151537884471,4
Category_Wikipedia_sockpuppets_of_Carlo_Galanti.csv,953,60315752.0,245,708,102,143,0,44.20881427072403,381,57,31.322140608604407,9
Category_Wikipedia_sockpuppets_of_Wonderfulwikinerd.csv,4,3513.0,3,1,2,1,0,49.5,196,23,14.0,11
Category_Wikipedia_sockpuppets_of_In_the_congress_of_you.csv,64,4802894.0,20,44,5,15,0,50.546875,337,32,14.15625,7
Category_Wikipedia_sockpuppets_of_Sawm12786.csv,1,0.0,1,0,1,0,62,62.0,62,3,3.0,3
Category_Wikipedia_sockpuppets_of_MomanizerABCD!.csv,331,17743566.0,111,220,95,16,0,48.32628398791541,378,55,15.223564954682779,7
Category_Wikipedia_sockpuppets_of_LLCruncher.csv,6126,532291275.0,1864,4262,500,1364,0,43.790564805746,362,140,17.884427032321252,3
Category_Wikipedia_sockpuppets_of_Costco_nostra.csv,1725,17120387.0,526,1199,500,26,0,41.05913043478261,325,37,24.477101449275363,9
Category_Wikipedia_sockpuppets_of_Hiphopstarz.csv,95,1896006.0,26,69,10,16,0,47.01052631578948,222,28,13.905263157894737,8
Category_Wikipedia_sockpuppets_of_Xakiahmed.csv,228,49249237.0,140,88,101,39,0,39.55263157894737,224,28,16.600877192982455,6
Category_Wikipedia_sockpuppets_of_Superbrightidea.csv,8,1045.0,5,3,4,1,0,31.625,124,36,18.375,11
Category_Wikipedia_sockpuppets_of_The_Secret_Agent.csv,198,20308587.0,72,126,43,29,0,43.55050505050505,255,47,19.727272727272727,7
Category_Wikipedia_sockpuppets_of_PhoenixMIX.csv,44,6569851.0,28,16,14,14,0,47.61363636363637,218,21,12.704545454545455,10
Category_Wikipedia_sockpuppets_of_Shalivahan2.csv,2061,102357589.0,737,1324,500,237,0,58.54633672974284,494,61,19.94759825327511,4
Category_Wikipedia_sockpuppets_of_Y.A.M.L.A_(sophina_at_hello_kitty).csv,36,101577.0,12,24,10,2,0,39.25,253,28,17.13888888888889,5
Category_Wikipedia_sockpuppets_of_TheBeast837593.csv,85,2095508.0,32,53,15,17,0,33.8235294117647,215,50,19.63529411764706,14
Category_Wikipedia_sockpuppets_of_Camoq.csv,86,83988807.0,22,64,18,4,0,32.348837209302324,209,44,26.27906976744186,12
Category_Wikipedia_sockpuppets_of_Abdullah_bahajri.csv,141,2170315.0,50,91,37,13,0,37.148936170212764,212,32,13.23404255319149,6
Category_Wikipedia_sockpuppets_of_Islamatefaly.csv,13,13234.0,12,1,11,1,11,31.53846153846154,89,23,16.53846153846154,11
Category_Wikipedia_sockpuppets_of_BaluSingh_Official.csv,14,3804862.0,7,7,7,0,0,50.357142857142854,157,23,22.0,21
Category_Wikipedia_sockpuppets_of_Badri_Vishal_and_Mansi_Krishna.csv,51,2994319.0,16,35,13,3,0,58.98039215686274,234,40,22.568627450980394,15
Category_Wikipedia_sockpuppets_of_RMS52.csv,1603,3624174.0,541,1062,500,41,0,47.379912663755455,255,59,23.080474111041795,3
Category_Wikipedia_sockpuppets_of_Barbarajohnson1.csv,76,69399447.0,29,47,18,11,0,35.96052631578947,112,58,20.80263157894737,6
Category_Wikipedia_sockpuppets_of_Kaiser_von_Europa.csv,2764,343204984.0,1000,1764,500,500,0,46.61722141823444,494,93,19.683791606367585,3
Category_Wikipedia_sockpuppets_of_Mitrale89.csv,1256,4631105.0,563,693,379,184,0,39.056528662420384,255,55,18.180732484076433,5
Category_Wikipedia_sockpuppets_of_Moda_Three.csv,57,32654579.0,29,28,28,1,0,48.421052631578945,196,19,18.82456140350877,14
Category_Wikipedia_sockpuppets_of_Stmarksmissionary.csv,576,55543095.0,238,338,46,192,0,61.30902777777778,343,79,28.09375,9
Category_Wikipedia_sockpuppets_of_Marcovel.csv,278,24015107.0,98,180,50,48,0,45.94604316546763,234,54,16.798561151079138,6
Category_Wikipedia_sockpuppets_of_Hayashihouyi.csv,778,7532741.0,228,550,178,50,0,54.55526992287918,495,41,13.466580976863753,3
Category_Wikipedia_sockpuppets_of_Gugi2001.csv,8691,54535893.0,3076,5615,500,2576,0,38.63007709124381,468,74,21.898630767460592,3
Category_Wikipedia_sockpuppets_of_Subhayan_Mukherjee.csv,1787,33461927.0,633,1154,230,403,0,37.96698377168439,255,64,15.459429210968104,4
Category_Wikipedia_sockpuppets_of_Jp.roq.csv,29,513359.0,18,11,18,0,0,55.58620689655172,159,26,16.448275862068964,6
Category_Wikipedia_sockpuppets_of_Emptyvee.csv,78,4302284.0,16,62,3,13,0,68.62820512820512,230,31,15.435897435897436,10
Category_Wikipedia_sockpuppets_of_Shwetajuneja.csv,2,0.0,1,1,1,0,66,66.0,66,19,19.0,19
Category_Wikipedia_sockpuppets_of_Hkstrategies.csv,8,790604.0,5,3,3,2,0,22.25,38,26,24.75,24
Category_Wikipedia_sockpuppets_of_8lpboston.csv,196,1245580.0,68,128,24,44,0,42.21938775510204,255,53,24.3265306122449,10
Category_Wikipedia_sockpuppets_of_Rajan_Jasrotia.csv,136,7881403.0,116,20,109,7,0,18.022058823529413,254,27,14.985294117647058,14
Category_Wikipedia_sockpuppets_of_Zombiedude101.csv,353,414837685.0,107,246,85,22,0,48.478753541076486,346,45,20.144475920679888,8
Category_Wikipedia_sockpuppets_of_MiddleMan2127.csv,192,3718781.0,127,65,73,54,0,53.322916666666664,233,46,17.588541666666668,11
Category_Wikipedia_sockpuppets_of_Tariq_afflaq.csv,4086,24673013.0,1222,2864,500,722,0,57.558981889378366,500,55,15.774596182085169,3
Category_Wikipedia_sockpuppets_of_CDTPP.csv,248,25798264.0,93,155,87,6,0,39.21370967741935,253,58,24.891129032258064,9
Category_Wikipedia_sockpuppets_of_IreneTandry.csv,857,6148866.0,301,556,301,0,0,28.700116686114352,252,58,28.74679113185531,9
Category_Wikipedia_sockpuppets_of_Pankaj1506.csv,430,86310310.0,155,275,142,13,0,40.63953488372093,227,36,17.369767441860464,7
Category_Wikipedia_sockpuppets_of_Werieth.csv,2908,165353733.0,672,2236,500,172,0,46.09456671251719,254,63,19.876891334250345,3
Category_Wikipedia_sockpuppets_of_Das_Ansehnlisch.csv,1976,17231408.0,508,1468,500,8,0,38.574392712550605,250,56,20.17763157894737,5
Category_Wikipedia_sockpuppets_of_Matreeks.csv,379,212165075.0,114,265,107,7,0,45.02110817941953,364,53,20.939313984168866,5
Category_Wikipedia_sockpuppets_of_Milleniux90210.csv,2389,18041573.0,884,1505,500,384,0,32.59564671410632,484,72,30.380912515696945,4
Category_Wikipedia_sockpuppets_of_90tillinfinitydue.csv,457,10002584.0,161,296,127,34,0,63.27789934354486,494,50,23.14660831509847,3
Category_Wikipedia_sockpuppets_of_Chakapada.csv,37,4396856.0,16,21,14,2,0,36.810810810810814,190,34,27.054054054054053,6
Category_Wikipedia_sockpuppets_of_Omkrishnajena.csv,143,37061603.0,70,73,29,41,0,42.33566433566433,285,51,20.972027972027973,6
Category_Wikipedia_sockpuppets_of_BigzMMA.csv,1374,13021315.0,512,862,500,12,0,34.49417758369724,241,62,21.92066957787482,3
Category_Wikipedia_sockpuppets_of_Kordon_Bleu.csv,45,518756.0,15,30,11,4,0,60.86666666666667,173,49,19.822222222222223,16
Category_Wikipedia_sockpuppets_of_Planetary_Chaos.csv,1749,7503746.0,500,1249,500,0,0,46.0926243567753,250,54,21.87364208118925,2
Category_Wikipedia_sockpuppets_of_Some_religion_scholar.csv,655,18042156.0,245,410,54,191,0,50.396946564885496,255,47,15.473282442748092,6
Category_Wikipedia_sockpuppets_of_AlexGerrard77.csv,1493,13940667.0,687,806,500,187,0,27.78432685867381,255,71,20.8801071667783,4
Category_Wikipedia_sockpuppets_of_Poopiestpants.csv,4,1518.0,3,1,2,1,0,37.5,150,13,13.0,13
Category_Wikipedia_sockpuppets_of_Ziggymaster.csv,4800,17576939.0,1530,3270,500,1030,0,42.483125,242,58,17.17125,2
Category_Wikipedia_sockpuppets_of_DrexMafia.csv,32,868486.0,15,17,15,0,0,35.15625,101,56,42.3125,19
Category_Wikipedia_sockpuppets_of_Straatmeester.csv,5538,360398006.0,1936,3602,500,1436,0,38.00794510653665,404,58,16.157638136511377,3
Category_Wikipedia_sockpuppets_of_Paul_Oh.csv,42,7411566.0,29,13,10,19,0,54.45238095238095,255,20,16.047619047619047,8
Category_Wikipedia_sockpuppets_of_Hornetzilla78.csv,3393,83139723.0,1134,2259,466,668,0,55.023577954612435,269,72,29.728558797524315,2
Category_Wikipedia_sockpuppets_of_ToonBoyDan.csv,1114,98027868.0,263,851,88,175,0,49.8016157989228,247,60,24.618491921005386,5
Category_Wikipedia_sockpuppets_of_Hazaraboyz.csv,1624,37673390.0,714,910,500,214,0,32.554802955665025,245,57,19.726600985221676,6
Category_Wikipedia_sockpuppets_of_Ethanwolf.csv,4,519.0,3,1,3,0,11,26.75,43,33,25.25,15
Category_Wikipedia_sockpuppets_of_Jebli18.csv,65,1075555.0,23,42,11,12,0,72.75384615384615,494,54,21.23076923076923,11
Category_Wikipedia_sockpuppets_of_NorbertArthur.csv,2607,71543625.0,738,1869,500,238,0,32.10203298810894,254,68,17.50326045262754,3
Category_Wikipedia_sockpuppets_of_Mussa_Bin_Bique.csv,302,1320014.0,113,189,70,43,0,42.182119205298015,348,38,13.741721854304636,5
Category_Wikipedia_sockpuppets_of_Threelittlebirdswoop.csv,9,682328.0,7,2,4,3,15,41.333333333333336,106,28,16.333333333333332,4
Category_Wikipedia_sockpuppets_of_Rithiml.csv,706,3034087.0,329,377,236,93,0,28.39801699716714,331,41,28.872521246458923,12
Category_Wikipedia_sockpuppets_of_AustinRichardson29.csv,183,21160645.0,56,127,53,3,0,59.349726775956285,244,35,16.459016393442624,5
Category_Wikipedia_sockpuppets_of_Haldersudipta.csv,25,642837.0,13,12,11,2,0,40.88,167,21,18.52,16
Category_Wikipedia_sockpuppets_of_0LYMP1C^$$3^T3R.csv,34,33737445.0,11,23,8,3,0,93.47058823529412,497,40,27.91176470588235,23
Category_Wikipedia_sockpuppets_of_Beth_Parry22.csv,136,37493955.0,36,100,32,4,0,46.338235294117645,267,41,14.463235294117647,5
Category_Wikipedia_sockpuppets_of_OceanManTakeMeByTheHandLeadMeToTheLand.csv,176,7238115.0,68,108,22,46,0,55.01704545454545,255,48,14.659090909090908,5
Category_Wikipedia_sockpuppets_of_Pampelonne.csv,1889,141817935.0,433,1456,17,416,0,58.52302805717311,337,54,17.3928004235045,3
Category_Wikipedia_sockpuppets_of_Thorpfilms.csv,13,645668.0,5,8,3,2,0,19.615384615384617,75,17,13.846153846153847,10
Category_Wikipedia_sockpuppets_of_France79.csv,44,1547265.0,16,28,6,10,0,39.22727272727273,158,53,16.113636363636363,5
Category_Wikipedia_sockpuppets_of_HardSunBadMoon.csv,488,8386609.0,166,322,158,8,0,46.63934426229508,340,58,19.354508196721312,8
Category_Wikipedia_sockpuppets_of_AnwinNovaTrichy.csv,200,137588431.0,44,156,35,9,0,50.36,225,51,24.105,9
Category_Wikipedia_sockpuppets_of_Sever_Silaghi.csv,3,23.0,2,1,2,0,19,27.666666666666668,32,50,50.0,50
Category_Wikipedia_sockpuppets_of_UniBrill.csv,1177,72287477.0,441,736,209,232,0,47.42905692438403,500,73,21.282073067119796,6
Category_Wikipedia_sockpuppets_of_Sitaray.csv,241,194738960.0,79,162,58,21,0,35.78423236514523,233,55,31.983402489626556,10
Category_Wikipedia_sockpuppets_of_Padamraj.joshi.csv,86,27516921.0,25,61,11,14,0,48.0,226,53,23.011627906976745,5
Category_Wikipedia_sockpuppets_of_Kalebfloyd075370.csv,796,96642161.0,272,524,160,112,0,32.734924623115575,255,57,30.185929648241206,10
Category_Wikipedia_sockpuppets_of_Ichemmanur.csv,8,142939736.0,7,1,7,0,0,25.375,50,24,24.0,24
Category_Wikipedia_sockpuppets_of_Talley_Dunn_Gallery.csv,11,8889.0,6,5,6,0,0,43.09090909090909,164,34,30.818181818181817,29
Category_Wikipedia_sockpuppets_of_Allinone365.csv,60,672261.0,17,43,4,13,0,81.66666666666667,255,33,16.933333333333334,6
Category_Wikipedia_sockpuppets_of_Rt665j4.csv,261,11205472.0,167,94,105,62,0,52.651340996168585,253,42,14.019157088122606,10
Category_Wikipedia_sockpuppets_of_Sshreshtha.csv,25,863570.0,21,4,19,2,0,42.56,269,24,23.2,20
Category_Wikipedia_sockpuppets_of_Mirrored_Love.csv,1428,110061613.0,524,904,381,143,0,35.87675070028011,271,68,24.47829131652661,5
Category_Wikipedia_sockpuppets_of_Katya_Foster.csv,263,6638438.0,124,139,113,11,0,46.00760456273764,255,62,32.90874524714829,18
Category_Wikipedia_sockpuppets_of_Er.Naresh_Chaudhary.csv,354,51406243.0,263,91,260,3,0,19.166666666666668,254,29,8.971751412429379,7
Category_Wikipedia_sockpuppets_of_TonySpraks.csv,65,988581.0,17,48,14,3,0,57.06153846153846,232,29,16.276923076923076,13
Category_Wikipedia_sockpuppets_of_Nameless00000.csv,39,13765283.0,12,27,8,4,0,83.66666666666667,243,33,24.76923076923077,9
Category_Wikipedia_sockpuppets_of_Scots_gael.csv,23,471986.0,15,8,10,5,0,27.347826086956523,169,17,15.73913043478261,15
Category_Wikipedia_sockpuppets_of_Nguyen0409.csv,1790,18404530.0,508,1282,189,319,0,59.68659217877095,500,69,19.056983240223463,3
Category_Wikipedia_sockpuppets_of_Theaghan.csv,79,6411332.0,31,48,25,6,0,44.949367088607595,253,47,22.455696202531644,12
Category_Wikipedia_sockpuppets_of_Vitorreid.csv,281,1492379.0,88,193,21,67,0,50.27402135231317,228,37,19.558718861209965,7
Category_Wikipedia_sockpuppets_of_AETEST.csv,100,7770105.0,37,63,18,19,0,41.44,231,51,22.19,11
Category_Wikipedia_sockpuppets_of_Ethiopique.csv,5489,87986184.0,1601,3888,500,1101,0,47.34505374385134,500,48,16.077609764984516,3
Category_Wikipedia_sockpuppets_of_Ajdebre.csv,4618,293446978.0,1501,3117,500,1001,0,47.22390645300996,434,62,20.088999566912083,3
Category_Wikipedia_sockpuppets_of_Borden234.csv,22,419900.0,7,15,7,0,0,26.454545454545453,139,64,34.09090909090909,17
Category_Wikipedia_sockpuppets_of_Jacob_Peters.csv,6817,207878885.0,1821,4996,330,1491,0,41.84964060437142,255,54,17.91990611706029,5
Category_Wikipedia_sockpuppets_of_Voodoo_Bus.csv,32,301962.0,12,20,8,4,0,87.28125,230,24,14.9375,12
Category_Wikipedia_sockpuppets_of_Sambhil32.csv,859,56164005.0,365,494,332,33,0,47.810244470314316,338,75,18.594877764842842,7
Category_Wikipedia_sockpuppets_of_Chrisfoster12.csv,161,1222624.0,57,104,34,23,0,24.63975155279503,175,38,21.229813664596275,9
Category_Wikipedia_sockpuppets_of_Thelbbn.csv,2,16641.0,2,0,2,0,0,0.0,0,32,27.0,22
Category_Wikipedia_sockpuppets_of_Quadirsaab.csv,695,137499185.0,265,430,175,90,0,54.52517985611511,252,33,17.185611510791368,7
Category_Wikipedia_sockpuppets_of_Ministryofdew.csv,1075,227434688.0,324,751,300,24,0,56.40372093023256,500,48,13.52186046511628,4
Category_Wikipedia_sockpuppets_of_Lagoo_sab.csv,22030,313076415.0,7066,14964,500,6566,0,46.125510667271904,255,70,19.716432137993646,3
Category_Wikipedia_sockpuppets_of_CPHL.csv,2207,60583680.0,487,1720,482,5,0,51.041685545990035,478,36,11.180788400543724,2
Category_Wikipedia_sockpuppets_of_Samuel_Khuspov.csv,367,17683615.0,127,240,53,74,0,47.49863760217983,496,41,20.5149863760218,8
Category_Wikipedia_sockpuppets_of_Superspy57.csv,4,1800.0,2,2,2,0,12,33.5,74,21,19.75,16
Category_Wikipedia_sockpuppets_of_Hotelpool.csv,164,285181.0,70,94,53,17,0,54.298780487804876,254,54,28.884146341463413,10
Category_Wikipedia_sockpuppets_of_IvanBertolla.csv,9,33147.0,6,3,6,0,0,8.0,18,22,22.0,22
Category_Wikipedia_sockpuppets_of_William_AAAAA.csv,3070,57795444.0,1209,1861,212,997,0,35.6671009771987,232,49,14.29771986970684,8
Category_Wikipedia_sockpuppets_of_Jhayron2620.csv,157,1802634.0,81,76,69,12,0,28.910828025477706,240,32,11.394904458598726,6
Category_Wikipedia_sockpuppets_of_LFOlsnes-Lea.csv,1232,9066929.0,477,755,476,1,0,48.03327922077922,241,62,21.601461038961038,7
Category_Wikipedia_sockpuppets_of_LisaLambe01.csv,31,2249019.0,17,14,12,5,0,47.58064516129032,245,21,12.483870967741936,10
Category_Wikipedia_sockpuppets_of_Spamden_Dunce.csv,172,38726199.0,40,132,27,13,0,59.06395348837209,288,25,13.970930232558139,3
Category_Wikipedia_sockpuppets_of_AHHHHHHHAHAHAHAHA.csv,64,1128782.0,19,45,11,8,0,43.265625,179,54,25.03125,7
Category_Wikipedia_sockpuppets_of_Weaselsinc.csv,268,287876673.0,86,182,80,6,0,52.973880597014926,252,33,19.936567164179106,11
Category_Wikipedia_sockpuppets_of_MrBOXHOCKEY.csv,24,1398181.0,15,9,13,2,0,80.70833333333333,203,24,16.125,10
Category_Wikipedia_sockpuppets_of_Treywrighteous.csv,28,1299055.0,14,14,11,3,0,41.142857142857146,209,29,21.107142857142858,11
Category_Wikipedia_sockpuppets_of_Adduserbot.csv,206,22124235.0,89,117,68,21,0,33.36407766990291,238,28,13.737864077669903,11
Category_Wikipedia_sockpuppets_of_Drennleberrn.csv,506,19410245.0,125,381,116,9,0,20.547430830039527,197,67,26.150197628458496,8
Category_Wikipedia_sockpuppets_of_Eimukas22.csv,7416,235365891.0,1901,5515,500,1401,0,42.70860302049623,498,72,19.91235167206041,4
Category_Wikipedia_sockpuppets_of_Pareeg83.csv,21,1756778.0,12,9,6,6,0,33.666666666666664,88,41,33.095238095238095,18
Category_Wikipedia_sockpuppets_of_Nationals01.csv,373,32219153.0,82,291,21,61,0,70.22252010723861,500,83,27.865951742627345,4
Category_Wikipedia_sockpuppets_of_Nicoli342.csv,36,17363.0,19,17,18,1,0,86.72222222222223,391,44,27.055555555555557,19
Category_Wikipedia_sockpuppets_of_Typewwen.csv,103,7656672.0,80,23,19,61,0,30.78640776699029,171,28,24.233009708737864,24
Category_Wikipedia_sockpuppets_of_Sarojbisht11.csv,675,15451302.0,328,347,312,16,0,41.71259259259259,490,63,18.955555555555556,5
Category_Wikipedia_sockpuppets_of_Arav_Sri_Agarwal.csv,25,11575163.0,7,18,7,0,0,43.16,369,27,14.8,9
Category_Wikipedia_sockpuppets_of_Renuthekitchen.csv,73,89584.0,20,53,10,10,0,62.75342465753425,267,24,10.068493150684931,4
Category_Wikipedia_sockpuppets_of_ShaveBoyShave.csv,3,105.0,2,1,2,0,0,64.0,192,24,24.0,24
Category_Wikipedia_sockpuppets_of_Jacktime34.csv,1176,55607111.0,384,792,335,49,0,52.25,417,59,19.918367346938776,3
Category_Wikipedia_sockpuppets_of_Sir_Jack_Hopkins.csv,2589,32737902.0,1027,1562,500,527,0,39.415990730011586,380,56,18.833526458091928,4
Category_Wikipedia_sockpuppets_of_Wikidragonrider.csv,60,1253025.0,19,41,11,8,3,61.083333333333336,217,53,37.85,17
Category_Wikipedia_sockpuppets_of_Dareblock.csv,58,222987.0,19,39,15,4,0,61.39655172413793,234,49,36.310344827586206,19
Category_Wikipedia_sockpuppets_of_Wikipedia_is_Communism.csv,305,123727400.0,61,244,26,35,0,48.79672131147541,210,44,17.455737704918032,4
Category_Wikipedia_sockpuppets_of_BobVillars.csv,1342,21917261.0,505,837,500,5,0,58.20640834575261,496,129,22.73397913561848,3
Category_Wikipedia_sockpuppets_of_Ethan_Talon.csv,693,5737312.0,171,522,73,98,0,45.40981240981241,255,46,11.088023088023087,4
Category_Wikipedia_sockpuppets_of_Fattypattybigmac.csv,40,39684142.0,8,32,8,0,0,60.4,227,41,26.85,11
Category_Wikipedia_sockpuppets_of_Fuhrer_Trump.csv,28,1322057.0,8,20,4,4,0,77.53571428571429,244,60,48.0,20
Category_Wikipedia_sockpuppets_of_PapaTakaro.csv,3250,76363335.0,1037,2213,500,537,0,63.25753846153846,474,71,21.31876923076923,1
Category_Wikipedia_sockpuppets_of_DiabloSE30.csv,658,482994663.0,174,484,168,6,0,53.212765957446805,326,61,21.02887537993921,6
Category_Wikipedia_sockpuppets_of_Schmimat001.csv,19,157226.0,12,7,11,1,0,73.36842105263158,337,26,21.736842105263158,7
Category_Wikipedia_sockpuppets_of_Alizehennessy.csv,5,879.0,3,2,3,0,0,84.0,199,19,18.2,17
Category_Wikipedia_sockpuppets_of_Aliawalsh22.csv,43,11733709.0,22,21,21,1,0,35.76744186046512,180,21,15.44186046511628,13
Category_Wikipedia_sockpuppets_of_HughD.csv,7473,213592746.0,2695,4778,500,2195,0,55.1973772246755,496,93,22.63963602301619,4
Category_Wikipedia_sockpuppets_of_Sheep_nuts.csv,35,3439251.0,7,28,3,4,0,48.42857142857143,179,17,12.82857142857143,7
Category_Wikipedia_sockpuppets_of_Annecurtisloveelijahmateo173.csv,22,2234071.0,11,11,9,2,0,44.31818181818182,197,37,34.63636363636363,24
Category_Wikipedia_sockpuppets_of_Biff714.csv,2345,74378819.0,849,1496,500,349,0,32.62899786780384,250,61,17.043923240938167,4
Category_Wikipedia_sockpuppets_of_Superbrickbro.csv,4769,13837496.0,2386,2383,500,1886,0,40.43153700985532,417,46,16.820088068777522,5
Category_Wikipedia_sockpuppets_of_Biciklista10.csv,431,17567010.0,149,282,128,21,0,51.25058004640371,245,46,17.96751740139211,3
Category_Wikipedia_sockpuppets_of_ELFFORUM2022.csv,188,3532144.0,77,111,30,47,0,53.23936170212766,498,36,17.26595744680851,10
Category_Wikipedia_sockpuppets_of_Vdhillon.csv,2724,52455733.0,1000,1724,500,500,0,45.33810572687225,255,71,20.269456681350956,4
Category_Wikipedia_sockpuppets_of_Anshuman_Tiwari_Official.csv,529,71632285.0,158,371,46,112,0,53.43478260869565,496,53,21.468809073724007,8
Category_Wikipedia_sockpuppets_of_Safinazuyuyor.csv,747,13589529.0,242,505,116,126,0,55.25435073627845,500,53,16.958500669344044,4
Category_Wikipedia_sockpuppets_of_Atif_kakar2013.csv,15,6396633.0,9,6,9,0,0,28.0,78,24,22.0,19
Category_Wikipedia_sockpuppets_of_Rohitdav97.csv,121,113096544.0,31,90,23,8,0,51.21487603305785,230,52,11.363636363636363,5
Category_Wikipedia_sockpuppets_of_Chriscon31.csv,13,3169.0,8,5,6,2,0,67.53846153846153,216,18,15.846153846153847,11
Category_Wikipedia_sockpuppets_of_Jamey_Gch.csv,24,6284497.0,8,16,8,0,0,31.875,161,32,14.666666666666666,10
Category_Wikipedia_sockpuppets_of_N1234567.csv,3236,12213776.0,925,2311,500,425,0,51.49412855377009,376,62,15.534919653893695,2
Category_Wikipedia_sockpuppets_of_Spindoctor69.csv,530,14807218.0,201,329,122,79,0,38.1188679245283,201,61,20.19056603773585,4
Category_Wikipedia_sockpuppets_of_DarknessShines2.csv,6021,181769395.0,1652,4369,500,1152,0,51.78359076565354,262,103,27.922604218568345,5
Category_Wikipedia_sockpuppets_of_Arrekasnothing20.csv,288,1373862.0,113,175,89,24,0,47.85069444444444,500,50,17.833333333333332,4
Category_Wikipedia_sockpuppets_of_The_abominable_Wiki_troll.csv,48859,392091165.0,14147,34712,500,13647,0,43.13538959045417,500,88,17.346486829448004,3
Category_Wikipedia_sockpuppets_of_Awikivisitor20122018.csv,1062,50941068.0,375,687,360,15,0,41.97551789077213,496,54,19.828625235404896,3
Category_Wikipedia_sockpuppets_of_Hindu108.csv,974,1140252.0,309,665,163,146,0,48.299794661190965,395,57,27.395277207392198,4
Category_Wikipedia_sockpuppets_of_Indiandept.Of_history&politics.csv,86,1124485.0,33,53,13,20,0,41.08139534883721,274,38,23.86046511627907,7
Category_Wikipedia_sockpuppets_of_Thenameismahendra.csv,45,464034.0,16,29,11,5,0,42.333333333333336,169,42,24.57777777777778,16
Category_Wikipedia_sockpuppets_of_Antony1821.csv,13069,437749348.0,3825,9244,500,3325,0,28.02877037263754,506,53,16.329022878567603,3
Category_Wikipedia_sockpuppets_of_Marija_W_Marinkovic.csv,96,16347912.0,31,65,27,4,0,40.8125,500,53,21.15625,14
Category_Wikipedia_sockpuppets_of_Rizky_Iconia.csv,4096,39509609.0,1155,2941,500,655,0,32.23388671875,255,60,23.2197265625,4
Category_Wikipedia_sockpuppets_of_Sahas16.csv,86,14305045.0,24,62,8,16,0,66.13953488372093,200,36,17.023255813953487,4
Category_Wikipedia_sockpuppets_of_Itaykaufman12.csv,319,556074.0,91,228,34,57,0,65.7962382445141,255,37,18.905956112852664,3
Category_Wikipedia_sockpuppets_of_KiGavin.csv,53,21102648.0,14,39,14,0,0,64.13207547169812,251,65,24.962264150943398,3
Category_Wikipedia_sockpuppets_of_Kyosharo.csv,212,1678962.0,92,120,52,40,0,52.91509433962264,477,44,21.641509433962263,7
Category_Wikipedia_sockpuppets_of_Shah_Md_Bahadur_Alam.csv,9,26334.0,5,4,3,2,13,25.88888888888889,68,30,28.666666666666668,24
"Category_Wikipedia_sockpuppets_of_Retract,_lest_you_regress.csv",43,96911.0,19,24,11,8,0,70.27906976744185,255,35,16.674418604651162,4
Category_Wikipedia_sockpuppets_of_Web_Reader_3.csv,300,5447847.0,117,183,59,58,0,45.37,255,62,21.54,4
Category_Wikipedia_sockpuppets_of_Cindy10000.csv,320,76027269.0,112,208,95,17,0,32.24375,200,46,20.5125,12
Category_Wikipedia_sockpuppets_of_Wormy1011.csv,1266,68349825.0,506,760,500,6,0,40.46919431279621,230,54,22.057661927330173,6
Category_Wikipedia_sockpuppets_of_Johnathan57Joyceefyt.csv,128,5770957.0,56,72,13,43,0,57.59375,389,67,32.5390625,11
Category_Wikipedia_sockpuppets_of_S2K-Lynx.csv,3706,16776256.0,1222,2484,500,722,0,45.838100377765784,462,80,21.131408526713436,3
Category_Wikipedia_sockpuppets_of_CMSRJPM1.csv,25,693800.0,17,8,15,2,0,53.04,177,45,33.08,11
Category_Wikipedia_sockpuppets_of_Salmoria.csv,1111,5261280.0,453,658,449,4,0,27.254725472547253,201,39,18.13231323132313,7
Category_Wikipedia_sockpuppets_of_MaikelRoy.csv,46,2400321.0,18,28,12,6,0,62.15217391304348,254,27,11.934782608695652,5
Category_Wikipedia_sockpuppets_of_Everybuckwheat.csv,285,353986345.0,114,171,58,56,0,50.771929824561404,489,48,21.61754385964912,9
Category_Wikipedia_sockpuppets_of_Cold_revenge.csv,386,13826425.0,119,267,58,61,0,42.89119170984456,232,58,20.531088082901555,6
Category_Wikipedia_sockpuppets_of_Jazzerino.csv,2637,12271467.0,948,1689,500,448,0,46.86841107318923,255,64,21.16647705726204,4
Category_Wikipedia_sockpuppets_of_Shwethahc.csv,90,21086483.0,18,72,14,4,0,38.58888888888889,230,33,25.844444444444445,9
Category_Wikipedia_sockpuppets_of_Jibajabba.csv,1486,224444987.0,507,979,500,7,0,33.755047106325705,250,57,23.4650067294751,3
Category_Wikipedia_sockpuppets_of_Vili.falenius.csv,172,20131824.0,64,108,53,11,0,80.61627906976744,345,31,19.27906976744186,6
Category_Wikipedia_sockpuppets_of_KraMuc.csv,1,0.0,1,0,1,0,0,0.0,0,23,23.0,23
Category_Wikipedia_sockpuppets_of_Buffaloxoldiar.csv,1355,18677483.0,457,898,236,221,0,47.2,210,59,21.692250922509224,5
Category_Wikipedia_sockpuppets_of_Chansep2009.csv,174,23933978.0,55,119,52,3,0,38.54022988505747,245,41,22.385057471264368,11
Category_Wikipedia_sockpuppets_of_Ichika_Kasuga.csv,1937,10984798.0,792,1145,500,292,0,49.883324728962315,500,70,38.3164687661332,9
Category_Wikipedia_sockpuppets_of_Saiph121.csv,4921,35210023.0,1586,3335,500,1086,0,39.28632391790286,499,85,25.843121316805526,6
Category_Wikipedia_sockpuppets_of_HemantDas34.csv,1095,7609453.0,415,680,94,321,0,44.87671232876713,254,54,16.915981735159818,6
Category_Wikipedia_sockpuppets_of_Burnsjamie86.csv,4,2820.0,3,1,2,1,0,15.75,63,33,22.0,11
Category_Wikipedia_sockpuppets_of_Asphonixm.csv,2513,53079272.0,872,1641,500,372,0,36.78074015121369,496,75,17.12932749701552,4
Category_Wikipedia_sockpuppets_of_SaraV.csv,156,109288.0,65,91,31,34,0,74.8525641025641,249,46,22.44871794871795,9
Category_Wikipedia_sockpuppets_of_Katie_Short.csv,53,13123572.0,15,38,7,8,0,62.16981132075472,266,21,12.754716981132075,8
Category_Wikipedia_sockpuppets_of_Durr-e-shehwar.csv,1554,11824514.0,712,842,500,212,0,44.05534105534105,258,50,19.42084942084942,7
Category_Wikipedia_sockpuppets_of_Syedfalak.csv,30,30164088.0,23,7,10,13,0,30.166666666666668,190,26,17.866666666666667,15
Category_Wikipedia_sockpuppets_of_DrParkes.csv,223,863884.0,107,116,28,79,0,28.829596412556054,213,41,24.90134529147982,6
Category_Wikipedia_sockpuppets_of_Ehsanfarzadnia.csv,77,72333.0,37,40,19,18,0,48.246753246753244,282,42,33.311688311688314,19
Category_Wikipedia_sockpuppets_of_Kfjisee.csv,264,46237494.0,93,171,27,66,0,52.27272727272727,261,70,18.382575757575758,5
Category_Wikipedia_sockpuppets_of_Landtank.csv,38,17665394.0,13,25,5,8,0,72.5,253,37,18.57894736842105,12
Category_Wikipedia_sockpuppets_of_Russellfl5.csv,5,1833.0,3,2,2,1,39,47.4,75,82,74.8,46
Category_Wikipedia_sockpuppets_of_H_M_Shah_Poran.csv,23,1435.0,11,12,11,0,0,22.130434782608695,157,45,19.217391304347824,4
Category_Wikipedia_sockpuppets_of_QuestFour.csv,3105,124629498.0,1000,2105,500,500,0,49.76876006441224,488,64,18.726570048309178,4
Category_Wikipedia_sockpuppets_of_Clem32.csv,20,109011.0,10,10,6,4,0,45.85,125,69,59.0,19
Category_Wikipedia_sockpuppets_of_Z4590_gever.csv,7,10967459.0,4,3,2,2,0,43.57142857142857,135,39,24.857142857142858,15
Category_Wikipedia_sockpuppets_of_Mimiyoon.csv,141,200845072.0,45,96,42,3,0,40.234042553191486,199,42,19.78723404255319,14
Category_Wikipedia_sockpuppets_of_Xaskithe.csv,237,44386398.0,83,154,79,4,0,65.66244725738396,500,36,22.223628691983123,5
Category_Wikipedia_sockpuppets_of_Bstewart330.csv,23,5209959.0,8,15,6,2,0,79.95652173913044,256,47,19.652173913043477,18
Category_Wikipedia_sockpuppets_of_MusicLogger.csv,39,8235314.0,19,20,19,0,0,24.564102564102566,138,27,23.025641025641026,16
Category_Wikipedia_sockpuppets_of_Abhyud.csv,290,35607800.0,94,196,65,29,0,43.94827586206897,231,56,16.76896551724138,5
Category_Wikipedia_sockpuppets_of_Shaunak_Chakraborty.csv,273,34099757.0,98,175,44,54,0,41.205128205128204,210,51,20.355311355311354,8
Category_Wikipedia_sockpuppets_of_Dmitri89.csv,67,36776.0,33,34,19,14,0,66.58208955223881,192,17,12.35820895522388,7
Category_Wikipedia_sockpuppets_of_Chicagobears94.csv,1911,25852294.0,629,1282,228,401,0,32.165358451072734,250,63,17.25117739403454,3
Category_Wikipedia_sockpuppets_of_Dacodava.csv,2271,72269099.0,866,1405,500,366,0,35.33289299867899,250,55,16.415675913694407,4
Category_Wikipedia_sockpuppets_of_Edgar1990Kh.csv,46,7520739.0,32,14,17,15,0,31.891304347826086,178,24,18.369565217391305,17
Category_Wikipedia_sockpuppets_of_DinoP5568135.csv,604,59690350.0,153,451,46,107,0,48.49503311258278,375,39,17.59271523178808,9
Category_Wikipedia_sockpuppets_of_TGETruth.csv,4,648.0,2,2,2,0,0,33.25,57,18,15.5,13
Category_Wikipedia_sockpuppets_of_Mcepeci.csv,772,127622792.0,255,517,236,19,0,49.7720207253886,255,48,16.993523316062177,9
Category_Wikipedia_sockpuppets_of_Aralia_Fresia.csv,10,56076083.0,3,7,3,0,22,76.6,162,31,16.3,10
Category_Wikipedia_sockpuppets_of_Aslishiva.csv,1468,8474195.0,522,946,500,22,0,29.482970027247955,255,37,17.23024523160763,6
Category_Wikipedia_sockpuppets_of_Doenrtecz.csv,2,0.0,1,1,1,0,61,61.0,61,21,21.0,21
Category_Wikipedia_sockpuppets_of_TK_FoOC.csv,495,87008798.0,148,347,69,79,0,46.53333333333333,260,48,17.345454545454544,4
Category_Wikipedia_sockpuppets_of_Infodealer2008.csv,160,97911310.0,67,93,13,54,0,64.1875,220,23,10.3875,8
Category_Wikipedia_sockpuppets_of_Randyreporter.csv,101,11582606.0,39,62,35,4,0,34.84158415841584,197,28,20.683168316831683,5
Category_Wikipedia_sockpuppets_of_KaderMir2002.csv,96,821612.0,57,39,16,41,0,50.25,413,27,20.458333333333332,16
Category_Wikipedia_sockpuppets_of_Wanurikahiu.csv,381,108856125.0,95,286,56,39,0,33.45406824146982,231,52,24.238845144356954,5
Category_Wikipedia_sockpuppets_of_Dom_hunter.csv,57,613012.0,49,8,47,2,0,19.05263157894737,187,46,20.736842105263158,16
Category_Wikipedia_sockpuppets_of_Jjusa123.csv,9,11162.0,5,4,3,2,0,97.0,141,33,19.88888888888889,13
Category_Wikipedia_sockpuppets_of_S.R.G.G_Spinster.csv,308,23072388.0,90,218,65,25,0,28.76948051948052,247,32,21.474025974025974,7
Category_Wikipedia_sockpuppets_of_Reer_Woqooyi.csv,253,4981986.0,128,125,108,20,0,35.21739130434783,244,27,12.422924901185771,3
Category_Wikipedia_sockpuppets_of_Car_plunk.csv,267,23586687.0,115,152,84,31,0,36.22846441947566,252,32,21.808988764044944,11
Category_Wikipedia_sockpuppets_of_Truong_Gia_Bao112.csv,262,24603965.0,84,178,55,29,0,51.267175572519086,319,37,22.31297709923664,6
Category_Wikipedia_sockpuppets_of_Nationalpb.csv,152,1972757.0,45,107,24,21,0,27.210526315789473,196,43,18.092105263157894,4
Category_Wikipedia_sockpuppets_of_Nayanhalder57.csv,1387,105954019.0,537,850,500,37,0,39.11535688536409,263,54,20.85291997116078,3
Category_Wikipedia_sockpuppets_of_Excelse.csv,1993,214663863.0,505,1488,500,5,0,55.00501756146513,374,188,29.26041144004014,4
Category_Wikipedia_sockpuppets_of_Fructosia.csv,7,446.0,3,4,1,2,38,52.0,72,24,20.142857142857142,15
Category_Wikipedia_sockpuppets_of_BBJZ.csv,91,6916940.0,53,38,13,40,0,31.53846153846154,236,43,16.45054945054945,9
Category_Wikipedia_sockpuppets_of_Usoejw9.csv,535,29866047.0,172,363,166,6,0,50.18130841121496,430,60,16.014953271028038,6
Category_Wikipedia_sockpuppets_of_Iris_Medallion.csv,407,1800160.0,170,237,117,53,0,31.63144963144963,232,65,27.034398034398034,13
Category_Wikipedia_sockpuppets_of_DXanda.csv,499,43582354.0,205,294,175,30,0,57.74949899799599,495,95,24.589178356713425,3
Category_Wikipedia_sockpuppets_of_Bet1973.csv,93,39556191.0,36,57,27,9,0,33.204301075268816,199,22,14.13978494623656,4
Category_Wikipedia_sockpuppets_of_Internalb.csv,342,604362.0,165,177,125,40,0,30.269005847953217,226,49,25.423976608187136,6
Category_Wikipedia_sockpuppets_of_Viruswitch.csv,446,291590333.0,166,280,89,77,0,44.437219730941706,255,47,19.977578475336323,8
Category_Wikipedia_sockpuppets_of_Snocrates.csv,2949,54857564.0,1000,1949,500,500,0,42.299762631400476,250,78,23.015937605968126,4
Category_Wikipedia_sockpuppets_of_ADASTRA_HEALTHCARE_PVT_LTD.csv,2,0.0,1,1,1,0,36,36.0,36,36,36.0,36
Category_Wikipedia_sockpuppets_of_Sweetindian.csv,4239,61815537.0,1330,2909,500,830,0,45.97971219627271,494,63,19.681056853031375,3
Category_Wikipedia_sockpuppets_of_Boricua78.csv,153,2433756.0,80,73,74,6,0,48.8235294117647,230,20,16.718954248366014,15
Category_Wikipedia_sockpuppets_of_Ankur_Mazumder.csv,14,10427800.0,4,10,2,2,0,27.142857142857142,129,24,14.714285714285714,11
Category_Wikipedia_sockpuppets_of_Ceravantes.csv,118,259225564.0,32,86,17,15,0,59.69491525423729,225,46,27.38135593220339,9
Category_Wikipedia_sockpuppets_of_Dowunioncarbide.csv,331,110073996.0,96,235,36,60,0,50.46525679758308,250,59,23.56797583081571,7
Category_Wikipedia_sockpuppets_of_DarkRaven26.csv,20,187462900.0,4,16,4,0,0,52.4,196,16,11.9,6
Category_Wikipedia_sockpuppets_of_EMT2001.csv,74,6063903.0,28,46,20,8,0,39.067567567567565,211,38,18.635135135135137,9
Category_Wikipedia_sockpuppets_of_Pol64.csv,481,15483547.0,129,352,127,2,0,48.735966735966734,211,67,25.611226611226613,2
Category_Wikipedia_sockpuppets_of_AzLehrer.csv,13,3181940.0,12,1,11,1,0,19.76923076923077,193,13,13.0,13
Category_Wikipedia_sockpuppets_of_Safaque.csv,390,133676889.0,137,253,62,75,0,47.33846153846154,252,47,18.456410256410255,6
Category_Wikipedia_sockpuppets_of_Nicoladegiovanni.csv,15,367576.0,5,10,5,0,0,27.8,146,30,14.533333333333333,11
Category_Wikipedia_sockpuppets_of_Carmellow15.csv,201,23456183.0,61,140,16,45,0,36.243781094527364,203,53,24.248756218905474,13
Category_Wikipedia_sockpuppets_of_Fangthebigblackdog.csv,30,11978033.0,11,19,9,2,0,72.8,163,28,15.1,12
Category_Wikipedia_sockpuppets_of_Sion301.csv,60,156476974.0,12,48,8,4,0,60.833333333333336,222,20,8.466666666666667,6
Category_Wikipedia_sockpuppets_of_Azaishah2000.csv,2165,50375972.0,660,1505,500,160,0,36.4905311778291,376,64,15.084064665127022,5
Category_Wikipedia_sockpuppets_of_Burak.Socialays.csv,53,4330672.0,22,31,11,11,0,94.33962264150944,384,53,23.30188679245283,4
Category_Wikipedia_sockpuppets_of_Eastcoastjourno.csv,22,2718590.0,16,6,14,2,0,33.95454545454545,207,19,13.818181818181818,13
Category_Wikipedia_sockpuppets_of_Mikenew1953.csv,3406,13876244.0,1149,2257,500,649,0,25.61655901350558,255,48,17.533763945977686,3
Category_Wikipedia_sockpuppets_of_Techtrek.csv,591,255158204.0,212,379,179,33,0,48.92216582064298,246,51,20.835871404399324,10
Category_Wikipedia_sockpuppets_of_Raaahulpandey.csv,60,4244342.0,28,32,9,19,0,33.0,141,63,31.966666666666665,14
Category_Wikipedia_sockpuppets_of_American_Centrist.csv,4,42267.0,2,2,1,1,64,128.25,239,25,25.0,25
Category_Wikipedia_sockpuppets_of_Enlighter1.csv,892,19948141.0,299,593,101,198,0,37.25448430493274,203,72,17.663677130044842,3
Category_Wikipedia_sockpuppets_of_Abbas.dlim.csv,26,3182784.0,17,9,15,2,0,46.80769230769231,195,33,14.923076923076923,9
Category_Wikipedia_sockpuppets_of_Baconstrip_rocket.csv,57,25665173.0,12,45,7,5,0,53.78947368421053,235,27,21.49122807017544,12
Category_Wikipedia_sockpuppets_of_EpicMan.csv,2647,33208996.0,844,1803,500,344,0,73.66943709860219,255,79,23.54287873063846,3
Category_Wikipedia_sockpuppets_of_Magyar_nem_ember.csv,29,217450.0,11,18,7,4,0,39.172413793103445,185,34,20.896551724137932,12
Category_Wikipedia_sockpuppets_of_Cricket_Fan_7.csv,232,6583167.0,87,145,21,66,0,52.71551724137931,347,66,24.04741379310345,11
Category_Wikipedia_sockpuppets_of_Kambojharsangeet.csv,3549,10347493.0,931,2618,500,431,0,49.91575091575091,255,51,14.493660185967878,3
Category_Wikipedia_sockpuppets_of_Earth_Exploding_Live.csv,492,6401210.0,147,345,47,100,0,47.197154471544714,237,56,27.367886178861788,3
Category_Wikipedia_sockpuppets_of_LEADERUAE.csv,2,335.0,2,0,2,0,0,123.0,246,19,19.0,19
Category_Wikipedia_sockpuppets_of_Caring-writer.csv,270,27863570.0,86,184,67,19,0,45.44444444444444,247,26,17.414814814814815,9
Category_Wikipedia_sockpuppets_of_Sabuz_mondal.csv,57,101837466.0,22,35,17,5,0,40.421052631578945,185,28,16.017543859649123,5
Category_Wikipedia_sockpuppets_of_Khocon.csv,1352,67653601.0,512,840,500,12,0,47.8542899408284,255,63,18.57396449704142,5
Category_Wikipedia_sockpuppets_of_VedFgo.csv,76,4222696.0,39,37,21,18,0,24.276315789473685,135,24,18.38157894736842,11
Category_Wikipedia_sockpuppets_of_Tosses.csv,1630,544057219.0,363,1267,170,193,0,52.625766871165645,500,49,17.47361963190184,2
Category_Wikipedia_sockpuppets_of_Changingguardsatbuckinghampalace.csv,9075,160812780.0,2504,6571,210,2294,0,49.372121212121215,520,70,17.639669421487604,3
Category_Wikipedia_sockpuppets_of_MaidService.csv,908,184180.0,362,546,335,27,0,26.494493392070485,199,67,11.822687224669604,4
Category_Wikipedia_sockpuppets_of_Nroth12.csv,129,4498744.0,93,36,55,38,0,26.232558139534884,222,54,25.93798449612403,11
Category_Wikipedia_sockpuppets_of_Haldanes.csv,19,1898998.0,7,12,4,3,0,51.05263157894737,255,40,20.789473684210527,13
Category_Wikipedia_sockpuppets_of_00100100a.csv,6,163113.0,6,0,4,2,0,0.0,0,38,38.0,38
Category_Wikipedia_sockpuppets_of_Minecraft_survival_s.csv,84,1304078.0,68,16,55,13,0,52.30952380952381,312,48,21.488095238095237,9
Category_Wikipedia_sockpuppets_of_MadamRupa.csv,31,1046893.0,17,14,12,5,0,81.61290322580645,241,21,18.870967741935484,18
Category_Wikipedia_sockpuppets_of_Arvindrajput22g.csv,8,853209.0,5,3,5,0,20,82.5,165,25,24.0,23
Category_Wikipedia_sockpuppets_of_JCBurke1234.csv,18,978745.0,8,10,5,3,0,69.05555555555556,159,18,18.0,18
Category_Wikipedia_sockpuppets_of_Kelsg93.csv,15,31921120.0,4,11,3,1,0,63.13333333333333,210,24,22.0,14
Category_Wikipedia_sockpuppets_of_Josgandos123.csv,80,360637.0,23,57,6,17,0,21.425,238,32,23.925,14
Category_Wikipedia_sockpuppets_of_BradFalconer.csv,146,421714.0,113,33,78,35,0,91.97260273972603,437,29,22.472602739726028,10
Category_Wikipedia_sockpuppets_of_Maltin_Kant.csv,1097,4395041.0,416,681,279,137,0,35.02278942570647,250,49,16.3126709206928,4
Category_Wikipedia_sockpuppets_of_Oxford2008.csv,620,406567609.0,230,390,184,46,0,43.50967741935484,263,75,19.193548387096776,9
Category_Wikipedia_sockpuppets_of_BigDwiki.csv,991,110442599.0,613,378,500,113,0,49.27043390514632,255,73,33.62159434914228,4
Category_Wikipedia_sockpuppets_of_Ghulamhaider3030.csv,1638,45285522.0,672,966,337,335,0,44.44505494505494,255,113,22.36141636141636,3
Category_Wikipedia_sockpuppets_of_InkHeart.csv,4940,387695000.0,1628,3312,500,1128,0,42.345344129554654,500,54,18.49493927125506,4
Category_Wikipedia_sockpuppets_of_Howardstark23.csv,44,391067.0,22,22,17,5,0,41.95454545454545,188,47,24.15909090909091,6
Category_Wikipedia_sockpuppets_of_Dny123.csv,1259,33334394.0,496,763,187,309,0,45.41858617950754,496,85,23.797458300238283,7
Category_Wikipedia_sockpuppets_of_Pallikanti.csv,42,2047250.0,34,8,18,16,0,40.19047619047619,148,20,6.309523809523809,5
Category_Wikipedia_sockpuppets_of_Alexthijs.csv,21,4262.0,7,14,2,5,0,67.85714285714286,196,27,16.952380952380953,8
Category_Wikipedia_sockpuppets_of_Thissiteisranbyidiots.csv,105,3952.0,39,66,39,0,0,35.647619047619045,376,43,18.247619047619047,5
Category_Wikipedia_sockpuppets_of_Mkd07.csv,1681,300654985.0,561,1120,360,201,0,42.710291493158834,299,87,17.621653777513384,4
Category_Wikipedia_sockpuppets_of_Niles_Schilder.csv,27,904429.0,14,13,12,2,0,24.59259259259259,137,24,17.296296296296298,12
Category_Wikipedia_sockpuppets_of_Hvardanyan.csv,190,25145156.0,65,125,35,30,0,46.921052631578945,409,27,13.689473684210526,6
Category_Wikipedia_sockpuppets_of_Automobililamborghini.csv,210,89968314.0,73,137,70,3,0,51.333333333333336,254,57,19.766666666666666,7
Category_Wikipedia_sockpuppets_of_Efekamer.csv,2175,19426010.0,642,1533,500,142,0,29.091954022988507,250,59,22.866206896551724,12
Category_Wikipedia_sockpuppets_of_Wahhid.csv,749,77645877.0,254,495,119,135,0,53.63684913217624,301,49,18.84512683578104,4
Category_Wikipedia_sockpuppets_of_Diego_Grez-Ca√±ete.csv,1516,193230802.0,500,1016,500,0,0,60.62994722955145,495,59,25.481530343007915,5
Category_Wikipedia_sockpuppets_of_Yadav771.csv,160,165118842.0,45,115,27,18,0,50.575,235,52,20.80625,11
Category_Wikipedia_sockpuppets_of_Rafael_Gev√∫.csv,18,2238115.0,6,12,3,3,0,51.27777777777778,157,29,19.333333333333332,10
Category_Wikipedia_sockpuppets_of_Kuksugare911.csv,7,6338.0,6,1,4,2,0,6.571428571428571,46,21,11.0,7
Category_Wikipedia_sockpuppets_of_I_am_abubakar_500.csv,495,28045033.0,271,224,162,109,0,29.393939393939394,231,51,22.731313131313133,10
Category_Wikipedia_sockpuppets_of_Victimofwolff.csv,79,17015567.0,68,11,66,2,0,12.594936708860759,199,27,11.962025316455696,11
Category_Wikipedia_sockpuppets_of_AThingyofLogos.csv,64,1269133.0,52,12,47,5,0,24.125,256,25,24.5,24
Category_Wikipedia_sockpuppets_of_Andrea_Pietrangeli.csv,21,123581773.0,7,14,5,2,0,41.04761904761905,145,28,24.38095238095238,10
Category_Wikipedia_sockpuppets_of_Trane007.csv,7,3501.0,7,0,7,0,0,27.571428571428573,61,12,12.0,12
Category_Wikipedia_sockpuppets_of_Sidhartha_Vijaya.csv,20,526462.0,5,15,3,2,0,29.6,125,69,39.55,13
Category_Wikipedia_sockpuppets_of_Vdehsh828383.csv,43,1269.0,32,11,26,6,0,27.348837209302324,187,22,20.88372093023256,18
Category_Wikipedia_sockpuppets_of_Toomuchbutt.csv,20,1304.0,8,12,5,3,0,49.9,191,21,6.9,1
Category_Wikipedia_sockpuppets_of_D.Pearson.csv,212,5960550.0,55,157,9,46,0,52.882075471698116,253,47,24.66509433962264,11
Category_Wikipedia_sockpuppets_of_PinkelHossainPhotography.csv,7,4709.0,7,0,7,0,0,57.42857142857143,185,29,26.857142857142858,26
Category_Wikipedia_sockpuppets_of_SourceOnly.csv,212,7546181.0,62,150,47,15,0,57.06603773584906,221,54,13.820754716981131,5
Category_Wikipedia_sockpuppets_of_Kingo7672.csv,2376,18848859.0,559,1817,382,177,0,36.76978114478114,255,60,20.439814814814813,5
Category_Wikipedia_sockpuppets_of_Miyalana.csv,191,2670190.0,70,121,27,43,0,33.05235602094241,197,52,22.654450261780106,13
Category_Wikipedia_sockpuppets_of_Benalmadenagirl.csv,35,12857308.0,27,8,7,20,0,17.114285714285714,229,22,20.057142857142857,20
Category_Wikipedia_sockpuppets_of_Busy_Moose.csv,1343,108330162.0,292,1051,266,26,0,44.17498138495905,255,63,19.760982874162323,3
Category_Wikipedia_sockpuppets_of_Lil_Lez.csv,1703,5895167.0,594,1109,297,297,0,36.24838520258368,220,47,17.396946564885496,3
Category_Wikipedia_sockpuppets_of_Animatictv.csv,19,2774007.0,7,12,3,4,0,37.421052631578945,67,20,14.947368421052632,12
Category_Wikipedia_sockpuppets_of_Raabbustamante.csv,1390,168801575.0,514,876,500,14,0,42.32805755395683,255,55,18.26043165467626,3
Category_Wikipedia_sockpuppets_of_Rootology.csv,1386,13786855.0,432,954,302,130,0,43.199855699855696,250,119,24.3982683982684,7
Category_Wikipedia_sockpuppets_of_Ruin_Cireela.csv,852,13821643.0,337,515,295,42,0,28.188967136150236,224,56,32.0387323943662,13
Category_Wikipedia_sockpuppets_of_BangladeshiBoy.csv,100,241624.0,57,43,26,31,0,39.85,232,39,23.53,14
Category_Wikipedia_sockpuppets_of_Arnegjor.csv,306,8814700.0,83,223,81,2,0,33.470588235294116,197,31,15.571895424836601,4
Category_Wikipedia_sockpuppets_of_Alzalgwiki.csv,146,642338.0,64,82,62,2,0,45.71917808219178,225,43,18.376712328767123,4
Category_Wikipedia_sockpuppets_of_Deanerygal.csv,5,286.0,4,1,2,2,0,40.6,193,18,18.0,18
Category_Wikipedia_sockpuppets_of_OyMosby.csv,2676,133985136.0,867,1809,500,367,0,66.40284005979073,500,58,19.95777279521674,4
Category_Wikipedia_sockpuppets_of_Jake7rubin.csv,37,88476686.0,9,28,5,4,0,81.0,321,16,12.621621621621621,10
Category_Wikipedia_sockpuppets_of_Caracas_2000.csv,3018,180996298.0,1033,1985,500,533,0,28.958581842279656,261,103,17.898608349900595,3
Category_Wikipedia_sockpuppets_of_Hjc2010.csv,1,0.0,1,0,1,0,33,33.0,33,37,37.0,37
Category_Wikipedia_sockpuppets_of_Jennifer_Akalone.csv,33,149204.0,15,18,9,6,0,33.333333333333336,198,75,30.575757575757574,8
Category_Wikipedia_sockpuppets_of_KingofGangsters.csv,4032,12360615.0,1120,2912,500,620,0,64.17857142857143,485,105,20.204117063492063,3
Category_Wikipedia_sockpuppets_of_Listen_to_da_music.csv,33,441976.0,21,12,12,9,0,42.15151515151515,199,50,31.12121212121212,18
Category_Wikipedia_sockpuppets_of_F._Simon_Grant.csv,1443,92364927.0,500,943,500,0,0,43.42550242550242,224,57,17.09286209286209,4
Category_Wikipedia_sockpuppets_of_DavidWood11.csv,2334,57847533.0,898,1436,271,627,0,60.56255355612682,473,70,23.209083119108826,4
Category_Wikipedia_sockpuppets_of_Nishantfoods.csv,128,1372062.0,64,64,59,5,0,54.21875,236,70,19.3671875,6
Category_Wikipedia_sockpuppets_of_Premlesnar007.csv,106,28475013.0,29,77,15,14,0,45.905660377358494,255,34,17.28301886792453,11
Category_Wikipedia_sockpuppets_of_Tounom.csv,1338,83039688.0,493,845,342,151,0,56.25560538116592,483,51,16.198056801195815,4
Category_Wikipedia_sockpuppets_of_Videographer_Joe_1.csv,60,800164.0,23,37,23,0,0,38.13333333333333,198,37,22.066666666666666,11
Category_Wikipedia_sockpuppets_of_Bebbeee.csv,7,609.0,5,2,4,1,0,32.142857142857146,113,17,17.0,17
Category_Wikipedia_sockpuppets_of_Erycyo.csv,72,15848137.0,25,47,15,10,0,45.84722222222222,206,41,31.48611111111111,16
Category_Wikipedia_sockpuppets_of_Bobfran.csv,122,3214239.0,44,78,34,10,0,39.58196721311475,209,35,17.081967213114755,3
Category_Wikipedia_sockpuppets_of_Jodisho.csv,307,18577495.0,105,202,76,29,0,41.74918566775244,269,53,17.29641693811075,5
Category_Wikipedia_sockpuppets_of_1smithmaria.csv,23,510469.0,10,13,8,2,0,48.47826086956522,196,45,36.78260869565217,16
Category_Wikipedia_sockpuppets_of_SR.rubel.csv,7,316.0,3,4,3,0,0,54.142857142857146,146,45,36.857142857142854,26
Category_Wikipedia_sockpuppets_of_Mpf1983.csv,35,3796.0,25,10,23,2,0,79.17142857142858,193,29,23.057142857142857,11
Category_Wikipedia_sockpuppets_of_PoppyTohill.csv,88,795315.0,62,26,61,1,0,35.77272727272727,247,49,19.113636363636363,13
Category_Wikipedia_sockpuppets_of_Amanjodey.csv,153,1735042.0,63,90,55,8,0,42.23529411764706,223,35,17.0,9
Category_Wikipedia_sockpuppets_of_Elijah_Wilder.csv,929,40037476.0,308,621,155,153,0,61.58665231431647,500,54,25.416576964477933,3
Category_Wikipedia_sockpuppets_of_Silviu_Alexandru_Mihaila.csv,53,288845.0,28,25,21,7,0,23.358490566037737,172,46,32.924528301886795,13
Category_Wikipedia_sockpuppets_of_Worldfastingday.csv,50,7879145.0,17,33,8,9,0,38.44,170,51,16.94,8
Category_Wikipedia_sockpuppets_of_Martinmoorejr.csv,42,14981.0,19,23,17,2,0,45.38095238095238,196,49,20.642857142857142,11
Category_Wikipedia_sockpuppets_of_Joveal_George_Joshua.csv,3009,69828988.0,1219,1790,500,719,0,38.072781655034895,456,67,21.1571950814224,3
Category_Wikipedia_sockpuppets_of_85.74.85.109.csv,742,234302540.0,171,571,162,9,0,57.386792452830186,255,36,7.758760107816712,4
Category_Wikipedia_sockpuppets_of_Fustos.csv,1787,16518894.0,500,1287,500,0,0,52.44040290990487,366,50,22.341913822048124,4
Category_Wikipedia_sockpuppets_of_Incagold_richard.csv,27,595797.0,13,14,6,7,0,14.11111111111111,79,48,22.925925925925927,6
Category_Wikipedia_sockpuppets_of_Jake_Fuersturm.csv,1380,20264472.0,502,878,500,2,0,53.67246376811594,258,84,31.51014492753623,5
Category_Wikipedia_sockpuppets_of_Arigato1.csv,3718,74158652.0,1043,2675,500,543,0,40.85233996772458,239,60,16.00484131253362,1
Category_Wikipedia_sockpuppets_of_Dsrtfrk.csv,14,82323.0,12,2,9,3,0,10.142857142857142,35,35,35.0,35
Category_Wikipedia_sockpuppets_of_OSC221.csv,365,18845407.0,103,262,52,51,0,56.50410958904109,493,42,16.44109589041096,3
Category_Wikipedia_sockpuppets_of_Helen8831.csv,9,3361.0,7,2,4,3,0,38.22222222222222,228,7,7.0,7
Category_Wikipedia_sockpuppets_of_Christachrista.csv,102,273383466.0,23,79,16,7,0,39.84313725490196,191,24,10.833333333333334,3
Category_Wikipedia_sockpuppets_of_Siaosjhak.csv,23,194723.0,21,2,10,11,0,22.17391304347826,104,16,16.0,16
Category_Wikipedia_sockpuppets_of_Flyer100009.csv,15,18575326.0,5,10,5,0,0,32.0,167,35,26.6,18
Category_Wikipedia_sockpuppets_of_GregRustFan.csv,333,21120701.0,95,238,95,0,0,41.069069069069066,248,35,16.093093093093092,6
Category_Wikipedia_sockpuppets_of_Leah01.csv,1493,16857881.0,819,674,500,319,0,30.575351640991293,201,53,21.312793034159412,10
Category_Wikipedia_sockpuppets_of_Anupamofficial.csv,313,5348942.0,122,191,82,40,0,42.66453674121406,254,58,19.40894568690096,5
Category_Wikipedia_sockpuppets_of_Bears247.csv,1381,14070095.0,546,835,500,46,0,32.18899348298334,500,43,15.309920347574222,8
Category_Wikipedia_sockpuppets_of_Pelican_Shit.csv,1263,420677705.0,293,970,15,278,0,50.517814726840854,255,111,23.861441013460016,4
Category_Wikipedia_sockpuppets_of_ILiriaALB.csv,84,3030317.0,40,44,25,15,0,54.55952380952381,255,21,11.94047619047619,6
Category_Wikipedia_sockpuppets_of_Mahan_Eftekhary.csv,594,34922326.0,170,424,140,30,0,43.398989898989896,440,56,20.47979797979798,4
Category_Wikipedia_sockpuppets_of_Clownshking.csv,486,1485236.0,168,318,85,83,0,64.26954732510288,454,54,26.847736625514404,6
Category_Wikipedia_sockpuppets_of_Riteshpatil732.csv,2,32218503.0,2,0,1,1,135,137.5,140,24,21.5,19
Category_Wikipedia_sockpuppets_of_Gobaudd.csv,76,805187.0,33,43,18,15,0,36.26315789473684,175,56,27.710526315789473,8
Category_Wikipedia_sockpuppets_of_Robertoconnorofficial.csv,1,0.0,1,0,1,0,0,0.0,0,15,15.0,15
Category_Wikipedia_sockpuppets_of_Dogki11a.csv,5,247.0,3,2,2,1,0,52.8,116,18,18.0,18
Category_Wikipedia_sockpuppets_of_GillianKeegan.csv,49,6926800.0,19,30,9,10,0,69.18367346938776,243,40,19.73469387755102,14
Category_Wikipedia_sockpuppets_of_Professorofcraft.csv,38,32342748.0,31,7,29,2,0,40.44736842105263,496,61,27.842105263157894,14
Category_Wikipedia_sockpuppets_of_Gnetwerker.csv,10020,164772542.0,2744,7276,500,2244,0,44.680439121756486,251,90,18.902694610778443,3
Category_Wikipedia_sockpuppets_of_TheSaintsGuy.csv,168,7682767.0,74,94,69,5,0,39.267857142857146,239,61,24.06547619047619,12
Category_Wikipedia_sockpuppets_of_Balaji_Telefilms_Limited.csv,1690,49359231.0,580,1110,500,80,0,40.84792899408284,496,54,19.83431952662722,7
Category_Wikipedia_sockpuppets_of_Thedayicametowhiskershouse.csv,18,2063.0,12,6,12,0,0,26.166666666666668,167,30,12.38888888888889,11
Category_Wikipedia_sockpuppets_of_Ilias_Ali_MLA.csv,65,27470240.0,38,27,38,0,0,44.38461538461539,196,37,26.96923076923077,21
Category_Wikipedia_sockpuppets_of_Mrbelvedereposter.csv,75,32326796.0,18,57,11,7,0,34.57333333333333,164,27,12.6,5
Category_Wikipedia_sockpuppets_of_Europefan.csv,16027,318706982.0,4610,11417,311,4299,0,51.67411243526549,547,81,16.75216821613527,3
Category_Wikipedia_sockpuppets_of_Abidaoud.csv,400,156813757.0,122,278,56,66,0,44.04,250,53,18.2325,7
Category_Wikipedia_sockpuppets_of_Amanda_F_82.csv,1194,140313026.0,328,866,148,180,0,54.45728643216081,282,55,17.173366834170853,5
Category_Wikipedia_sockpuppets_of_Therewasnoothernameguys1.csv,9,71537.0,6,3,4,2,0,42.77777777777778,249,26,10.333333333333334,5
Category_Wikipedia_sockpuppets_of_MichaelSteinman.csv,147,38042799.0,74,73,42,32,0,39.7687074829932,206,51,17.68027210884354,8
Category_Wikipedia_sockpuppets_of_PaoloNapolitano.csv,5213,94436452.0,1641,3572,500,1141,0,57.556877038173795,255,93,22.3928639938615,1
Category_Wikipedia_sockpuppets_of_Ramsso.csv,1909,244379071.0,686,1223,500,186,0,34.870089051859615,249,45,12.835515976951283,4
Category_Wikipedia_sockpuppets_of_Baba_Mahir.csv,17,17352124.0,6,11,5,1,0,58.64705882352941,281,20,15.705882352941176,10
Category_Wikipedia_sockpuppets_of_Future_MD_217.csv,20,4424.0,9,11,9,0,13,60.35,197,10,10.0,10
Category_Wikipedia_sockpuppets_of_Cbryeaw.csv,155,45581522.0,46,109,39,7,0,49.6,412,71,23.219354838709677,4
Category_Wikipedia_sockpuppets_of_Igec133.csv,1459,31033536.0,639,820,500,139,0,45.66963673749143,498,71,26.11788896504455,7
Category_Wikipedia_sockpuppets_of_OneSmartGuy22.csv,86,58905666.0,30,56,24,6,0,50.94186046511628,292,25,14.63953488372093,4
Category_Wikipedia_sockpuppets_of_Majidmarsh.csv,13,165919.0,6,7,4,2,0,70.53846153846153,254,16,11.76923076923077,11
Category_Wikipedia_sockpuppets_of_Anarose.antonio.csv,1622,34143077.0,749,873,500,249,0,26.419235511713932,255,38,14.02774352651048,3
Category_Wikipedia_sockpuppets_of_Marty_N√°jar.csv,1100,12315972.0,297,803,205,92,0,38.03363636363636,398,64,19.596363636363638,6
Category_Wikipedia_sockpuppets_of_Wetsoap.csv,470,23393368.0,125,345,110,15,0,42.268085106382976,229,41,17.585106382978722,4
Category_Wikipedia_sockpuppets_of_Scmd.csv,292,164238769.0,67,225,39,28,0,33.29109589041096,214,48,16.722602739726028,6
Category_Wikipedia_sockpuppets_of_Muscovite99.csv,515,23500361.0,151,364,101,50,0,42.15339805825243,221,41,18.980582524271846,5
Category_Wikipedia_sockpuppets_of_Essmat_Muhammed.csv,77,2042689.0,36,41,19,17,0,57.74025974025974,296,60,45.5974025974026,17
Category_Wikipedia_sockpuppets_of_Salarbil.csv,264,18954432.0,76,188,48,28,0,49.30681818181818,296,30,17.96212121212121,12
Category_Wikipedia_sockpuppets_of_Batmanarkham8399.csv,22,1085929.0,15,7,12,3,0,28.90909090909091,242,21,21.0,21
Category_Wikipedia_sockpuppets_of_Njaan_Prakashan.csv,577,4957692.0,218,359,164,54,0,37.9792027729636,395,33,17.246100519930675,4
Category_Wikipedia_sockpuppets_of_Alexkyoung.csv,1690,1676486.0,500,1190,500,0,0,58.90591715976331,469,59,23.10532544378698,3
Category_Wikipedia_sockpuppets_of_Seowith.csv,1132,18934128.0,496,636,72,424,0,32.70318021201413,409,96,57.66696113074205,4
Category_Wikipedia_sockpuppets_of_Wesco482.csv,930,858199.0,500,430,500,0,0,34.99354838709677,213,62,23.191397849462366,7
Category_Wikipedia_sockpuppets_of_Polscience.csv,6048,283283046.0,1803,4245,500,1303,0,48.642526455026456,255,79,19.328869047619047,3
Category_Wikipedia_sockpuppets_of_Awardmaniac.csv,1736,31067014.0,572,1164,500,72,0,54.23732718894009,481,89,23.217741935483872,6
Category_Wikipedia_sockpuppets_of_Michaelshea2004.csv,553,108381044.0,170,383,68,102,0,52.54430379746835,430,47,17.06148282097649,5
Category_Wikipedia_sockpuppets_of_Jon2021.csv,42,351178.0,36,6,36,0,0,177.0952380952381,504,19,17.761904761904763,17
Category_Wikipedia_sockpuppets_of_Freshstart101.csv,103,26274740.0,30,73,24,6,0,46.53398058252427,200,47,33.25242718446602,15
Category_Wikipedia_sockpuppets_of_Aaron$richy.csv,1627,6035523.0,566,1061,147,419,0,47.25691456668716,496,42,16.930547019053474,4
Category_Wikipedia_sockpuppets_of_Uygiggu66.csv,14,166196.0,8,6,5,3,0,44.57142857142857,177,21,14.0,8
Category_Wikipedia_sockpuppets_of_BombWord.csv,28,1576.0,17,11,4,13,0,90.96428571428571,277,22,10.071428571428571,9
Category_Wikipedia_sockpuppets_of_Tinkubhoi.csv,126,11320456.0,49,77,26,23,0,45.32539682539682,233,41,19.166666666666668,5
Category_Wikipedia_sockpuppets_of_AskKirbyCarroll.csv,8,1071331.0,5,3,3,2,0,49.5,120,24,24.0,24
Category_Wikipedia_sockpuppets_of_Factt.csv,46,13311.0,19,27,9,10,0,68.56521739130434,228,17,15.0,9
Category_Wikipedia_sockpuppets_of_Sakinajan.csv,64,961709.0,21,43,12,9,0,47.09375,218,34,18.203125,5
Category_Wikipedia_sockpuppets_of_Riyal.khan.csv,580,136348848.0,205,375,124,81,0,41.53793103448276,254,54,35.5448275862069,10
Category_Wikipedia_sockpuppets_of_Dedodatyo.csv,87,4140043.0,31,56,11,20,0,30.873563218390803,138,34,20.42528735632184,8
Category_Wikipedia_sockpuppets_of_Serado.csv,31,426100.0,15,16,7,8,0,41.74193548387097,198,16,8.67741935483871,7
Category_Wikipedia_sockpuppets_of_Tmpafford.csv,1240,166391180.0,289,951,179,110,0,37.133870967741935,245,45,17.607258064516127,5
Category_Wikipedia_sockpuppets_of_Ragnimo.csv,1972,45423002.0,652,1320,500,152,0,60.08265720081136,500,53,19.899594320486816,5
Category_Wikipedia_sockpuppets_of_MIKEL_S._SARWONO.csv,661,11942768.0,236,425,92,144,0,50.276853252647506,253,57,24.012102874432678,10
Category_Wikipedia_sockpuppets_of_Reviewing_Footballers.csv,161,3427791.0,67,94,25,42,0,26.018633540372672,262,40,21.51552795031056,9
Category_Wikipedia_sockpuppets_of_MpOcteber12.csv,178,15981740.0,70,108,23,47,0,43.050561797752806,247,33,21.730337078651687,10
Category_Wikipedia_sockpuppets_of_Drewcoolitback.csv,152,4829533.0,51,101,22,29,0,42.598684210526315,196,52,26.289473684210527,11
Category_Wikipedia_sockpuppets_of_Moroccan_Spaniard.csv,2022,162285013.0,448,1574,253,195,0,34.480712166172104,229,80,15.081107814045499,3
Category_Wikipedia_sockpuppets_of_Sophiedepalmaalexandra.csv,120,2676230.0,36,84,19,17,0,40.325,209,48,17.4,4
Category_Wikipedia_sockpuppets_of_Antapanta45.csv,303,31203653.0,75,228,17,58,0,47.759075907590756,243,30,19.676567656765677,8
Category_Wikipedia_sockpuppets_of_ŸÅŸáÿØ_ÿßÿ≠ŸÖÿØ_ÿπÿ®ÿØÿßŸÑŸÑŸá.csv,2,0.0,1,1,1,0,15,15.0,15,17,17.0,17
Category_Wikipedia_sockpuppets_of_Gallery_history.csv,271,171055847.0,108,163,102,6,0,41.02214022140221,191,25,15.15129151291513,10
Category_Wikipedia_sockpuppets_of_Snootchie44.csv,87,525201.0,43,44,26,17,0,29.67816091954023,199,28,19.666666666666668,12
Category_Wikipedia_sockpuppets_of_Sechnotot.csv,4,83.0,3,1,3,0,0,23.5,33,50,34.75,17
Category_Wikipedia_sockpuppets_of_Hitomi_Kurihara.csv,122,31190933.0,45,77,13,32,0,54.68852459016394,245,51,21.581967213114755,11
Category_Wikipedia_sockpuppets_of_Mayerroute5.csv,1141,97558109.0,465,676,194,271,0,35.03680981595092,268,46,28.075372480280457,10
Category_Wikipedia_sockpuppets_of_Sreerajmajay.csv,102,58084073.0,29,73,25,4,0,53.01960784313726,228,27,18.00980392156863,9
Category_Wikipedia_sockpuppets_of_HailesG.csv,5960,60749420.0,1675,4285,500,1175,0,52.46996644295302,255,53,14.971308724832214,3
Category_Wikipedia_sockpuppets_of_VolleyFan101.csv,122,7766668.0,60,62,32,28,0,39.51639344262295,214,44,17.37704918032787,10
Category_Wikipedia_sockpuppets_of_DJXKbrokaysen.csv,38,9125297.0,21,17,12,9,0,38.5,156,30,22.18421052631579,18
Category_Wikipedia_sockpuppets_of_Henrygb.csv,4159,69581693.0,1286,2873,500,786,0,34.39192113488819,255,80,20.721808126953594,1
Category_Wikipedia_sockpuppets_of_Samofi.csv,1708,149814379.0,553,1155,500,53,0,48.34718969555035,255,87,26.447306791569087,4
Category_Wikipedia_sockpuppets_of_Gaffaray.csv,286,551581.0,128,158,99,29,0,55.67832167832168,237,58,17.39160839160839,7
Category_Wikipedia_sockpuppets_of_Tunesywikier55.csv,8,315699.0,5,3,4,1,0,15.375,47,54,54.0,54
Category_Wikipedia_sockpuppets_of_Samdepp5.csv,33,413166.0,21,12,12,9,0,45.333333333333336,138,69,58.75757575757576,11
Category_Wikipedia_sockpuppets_of_Sju_hav.csv,13854,286548525.0,4983,8871,500,4483,0,49.75963620614985,257,98,20.150786776382272,2
Category_Wikipedia_sockpuppets_of_Alanmadrazo0.csv,370,13034977.0,109,261,62,47,0,30.772972972972973,235,41,21.483783783783785,6
Category_Wikipedia_sockpuppets_of_TammyWynetteEstate.csv,27,6830966.0,13,14,8,5,0,90.29629629629629,466,36,13.851851851851851,13
Category_Wikipedia_sockpuppets_of_CatCafe.csv,1616,18576321.0,720,896,500,220,0,54.038985148514854,496,68,20.85148514851485,6
Category_Wikipedia_sockpuppets_of_JIM_ME_BOY.csv,1729,95638859.0,426,1303,131,295,0,47.452862926547134,252,53,18.89647194910353,6
Category_Wikipedia_sockpuppets_of_Bigplayj.csv,17,3986092.0,6,11,3,3,0,29.41176470588235,84,53,20.294117647058822,11
Category_Wikipedia_sockpuppets_of_Digital_Dancing.csv,419,159289627.0,178,241,55,123,0,77.12649164677805,369,40,18.985680190930786,9
Category_Wikipedia_sockpuppets_of_MDHabibullahbd.csv,40,1025065.0,23,17,12,11,0,42.975,157,25,19.975,11
Category_Wikipedia_sockpuppets_of_Eldorado74.csv,572,392158038.0,234,338,226,8,0,48.46328671328671,271,47,16.902097902097903,8
"Category_Wikipedia_sockpuppets_of_Mikey'Da'Man,_Archangel.csv",1234,69307964.0,502,732,500,2,0,38.705024311183145,496,69,29.25283630470016,3
Category_Wikipedia_sockpuppets_of_Kevinng20021129.csv,64,171764.0,40,24,36,4,0,46.3125,196,25,20.109375,13
Category_Wikipedia_sockpuppets_of_XPatchx.csv,1496,568053516.0,393,1103,392,1,0,45.279411764705884,416,46,15.183155080213904,4
Category_Wikipedia_sockpuppets_of_Atabek.csv,148,187043.0,60,88,60,0,0,36.54054054054054,199,47,23.155405405405407,7
Category_Wikipedia_sockpuppets_of_Mansiagrawal.csv,72,399496.0,31,41,29,2,0,43.416666666666664,196,48,18.375,12
Category_Wikipedia_sockpuppets_of_Vijayabhaskar02.csv,280,166747256.0,103,177,91,12,0,54.40714285714286,274,60,23.982142857142858,11
Category_Wikipedia_sockpuppets_of_Harwoodb.csv,466,66706334.0,114,352,39,75,0,53.457081545064376,271,59,17.0793991416309,4
Category_Wikipedia_sockpuppets_of_Peter_Z_Sam.csv,31,794680.0,9,22,3,6,0,53.225806451612904,199,27,15.387096774193548,7
Category_Wikipedia_sockpuppets_of_Frat070699.csv,840,51322533.0,502,338,500,2,0,34.38690476190476,436,52,23.18095238095238,6
Category_Wikipedia_sockpuppets_of_Chanakya_Volume_2.csv,393,83941613.0,94,299,33,61,0,77.87277353689568,255,46,19.06615776081425,4
Category_Wikipedia_sockpuppets_of_Lkent-08.csv,101,1893106.0,36,65,12,24,0,39.48514851485149,215,32,20.623762376237625,5
Category_Wikipedia_sockpuppets_of_Fq90.csv,335,18958673.0,113,222,50,63,0,66.04776119402985,493,53,18.823880597014924,5
Category_Wikipedia_sockpuppets_of_Miyera20.csv,3567,59522605.0,2391,1176,500,1891,0,59.17970283151107,496,78,28.015138772077375,4
Category_Wikipedia_sockpuppets_of_DeLaughterDO.csv,172,24836.0,67,105,67,0,0,37.72674418604651,250,54,24.88372093023256,8
Category_Wikipedia_sockpuppets_of_Evis_Daison_Marrero.csv,1017,5444432.0,500,517,500,0,0,22.04228121927237,199,36,16.724680432645034,6
Category_Wikipedia_sockpuppets_of_VICTOHH1.csv,183,19540547.0,68,115,36,32,0,66.27868852459017,332,83,26.043715846994534,8
Category_Wikipedia_sockpuppets_of_Wyatt_storey.csv,230,604531.0,66,164,55,11,0,43.36521739130435,228,44,18.33478260869565,2
Category_Wikipedia_sockpuppets_of_ManveerChoudhary.csv,44,220273.0,41,3,28,13,0,22.295454545454547,196,34,16.772727272727273,12
Category_Wikipedia_sockpuppets_of_Fasav7.csv,71,4669930.0,29,42,8,21,0,47.67605633802817,239,46,20.225352112676056,10
Category_Wikipedia_sockpuppets_of_NYC_JKP.csv,101,1210373.0,47,54,45,2,0,32.37623762376238,208,24,22.396039603960396,12
Category_Wikipedia_sockpuppets_of_FrancoLeymas.csv,3684,39559549.0,1273,2411,419,854,0,43.561346362649296,301,66,27.00271444082519,6
Category_Wikipedia_sockpuppets_of_Sabupusi.csv,25,1985940.0,18,7,13,5,0,16.08,130,32,20.96,13
Category_Wikipedia_sockpuppets_of_Banasura.csv,123,4140540.0,52,71,36,16,0,69.1951219512195,993,38,23.276422764227643,15
Category_Wikipedia_sockpuppets_of_Kumanof.csv,321,11590509.0,195,126,170,25,0,33.426791277258566,475,31,9.485981308411215,5
Category_Wikipedia_sockpuppets_of_Bunzil.csv,5341,63248275.0,1500,3841,500,1000,0,34.73057479872683,257,55,16.724770642201836,6
Category_Wikipedia_sockpuppets_of_Pickbothmanlol.csv,5586,108619029.0,2073,3513,500,1573,0,46.269423558897245,255,100,28.591836734693878,4
Category_Wikipedia_sockpuppets_of_Theman81.csv,636,8558389.0,144,492,81,63,0,45.78616352201258,232,37,15.388364779874214,3
Category_Wikipedia_sockpuppets_of_Jamesleicester.csv,18,169183.0,12,6,4,8,16,45.833333333333336,150,44,18.833333333333332,10
Category_Wikipedia_sockpuppets_of_Keven426.csv,14,6150075.0,7,7,4,3,0,46.42857142857143,183,28,25.428571428571427,10
Category_Wikipedia_sockpuppets_of_JoeyDarks11.csv,88,14278125.0,37,51,16,21,0,83.86363636363636,401,50,17.863636363636363,7
Category_Wikipedia_sockpuppets_of_Bishal_Khan.csv,160,132531534.0,32,128,18,14,0,51.05625,240,46,28.54375,7
Category_Wikipedia_sockpuppets_of_KungDongMing1.csv,493,24343810.0,136,357,66,70,0,63.37525354969574,472,46,18.07707910750507,5
Category_Wikipedia_sockpuppets_of_JustStalin.csv,502,6476867.0,194,308,167,27,0,50.625498007968126,317,54,24.669322709163346,6
Category_Wikipedia_sockpuppets_of_Cupcake-Yum.csv,48,5765183.0,36,12,23,13,0,24.895833333333332,158,47,27.020833333333332,16
Category_Wikipedia_sockpuppets_of_MrRighttt.csv,1669,19970730.0,540,1129,500,40,0,34.079688436189336,406,42,15.052726183343319,5
Category_Wikipedia_sockpuppets_of_Randy1234009.csv,3,172604.0,2,1,1,1,10,51.333333333333336,131,12,12.0,12
Category_Wikipedia_sockpuppets_of_Willschmut.csv,6199,67757289.0,2334,3865,500,1834,0,46.97451201806743,438,70,24.640103242458462,4
Category_Wikipedia_sockpuppets_of_AussieKopite.csv,132,130053977.0,32,100,20,12,0,59.484848484848484,252,30,13.901515151515152,4
Category_Wikipedia_sockpuppets_of_BlackBoysonIce.csv,25,160866278.0,5,20,4,1,0,62.52,210,43,23.76,18
Category_Wikipedia_sockpuppets_of_7620ruthik.csv,21,3420593.0,6,15,3,3,0,26.952380952380953,151,53,43.04761904761905,20
Category_Wikipedia_sockpuppets_of_Iran0921.csv,20,242634.0,20,0,5,15,0,11.05,24,9,9.0,9
Category_Wikipedia_sockpuppets_of_Chrismccown.csv,542,5771489.0,213,329,212,1,0,53.42435424354244,337,50,25.551660516605168,4
Category_Wikipedia_sockpuppets_of_Codename_MeatCommand.csv,65,279836352.0,23,42,8,15,0,65.13846153846154,226,39,27.46153846153846,15
Category_Wikipedia_sockpuppets_of_Slothflipper.csv,52,8979059.0,22,30,8,14,0,80.3076923076923,194,51,17.76923076923077,7
Category_Wikipedia_sockpuppets_of_Skittles_The_Boy.csv,70,5356842.0,25,45,18,7,0,51.91428571428571,255,32,16.885714285714286,10
Category_Wikipedia_sockpuppets_of_RavindraKSinha.csv,23,17367.0,17,6,17,0,0,24.82608695652174,162,32,30.956521739130434,24
Category_Wikipedia_sockpuppets_of_Eluike.csv,371,53470622.0,106,265,25,81,0,52.495956873315365,495,66,25.07277628032345,9
Category_Wikipedia_sockpuppets_of_Dewie_Shannon.csv,75,1277574.0,38,37,14,24,0,30.68,149,40,25.04,14
Category_Wikipedia_sockpuppets_of_LEAVEMEALONEPLZ.csv,74,7762912.0,34,40,14,20,0,39.054054054054056,146,32,25.013513513513512,14
Category_Wikipedia_sockpuppets_of_Bsdvjghegy.csv,262,3973223.0,91,171,62,29,0,29.83969465648855,217,28,12.893129770992367,6
Category_Wikipedia_sockpuppets_of_Eril_Geson.csv,164,2625007.0,67,97,50,17,0,49.27439024390244,348,27,19.036585365853657,7
Category_Wikipedia_sockpuppets_of_DavidCharlesII.csv,615,36977172.0,273,342,268,5,0,33.240650406504066,200,59,21.065040650406505,10
Category_Wikipedia_sockpuppets_of_YehudaMedinaMizrahi.csv,1600,84845379.0,525,1075,274,251,0,41.6125,249,48,13.575625,4
Category_Wikipedia_sockpuppets_of_LakshayYadav007.csv,1987,4641237.0,718,1269,500,218,0,40.22445898339205,353,60,32.36688475088072,6
Category_Wikipedia_sockpuppets_of_Viagra-s.csv,48,59179.0,17,31,7,10,0,55.333333333333336,203,28,17.916666666666668,8
Category_Wikipedia_sockpuppets_of_Strider11.csv,4597,23494671.0,1696,2901,500,1196,0,34.94474657385251,261,76,19.199912986730478,3
Category_Wikipedia_sockpuppets_of_AriRichBoyz.csv,210,2532703.0,103,107,40,63,0,42.00476190476191,378,35,20.914285714285715,10
Category_Wikipedia_sockpuppets_of_Smorkach_24.csv,196,12111150.0,71,125,70,1,0,53.765306122448976,280,67,30.23469387755102,4
Category_Wikipedia_sockpuppets_of_Karthikkanch.csv,1352,247898725.0,550,802,500,50,0,40.607988165680474,446,39,13.390532544378699,7
Category_Wikipedia_sockpuppets_of_Veritas-Canada.csv,135,63225892.0,78,57,72,6,0,68.23703703703704,200,49,11.940740740740742,11
Category_Wikipedia_sockpuppets_of_LilRockStarOfficial.csv,8,69880182.0,3,5,3,0,0,108.625,265,29,22.75,19
Category_Wikipedia_sockpuppets_of_Paul_Beaucritz.csv,23,272341.0,9,14,6,3,0,25.956521739130434,119,48,23.82608695652174,13
Category_Wikipedia_sockpuppets_of_Brandon_Lapin.csv,450,64140561.0,153,297,66,87,0,51.38666666666666,475,81,22.537777777777777,3
Category_Wikipedia_sockpuppets_of_Gtgthjgbhjvj.csv,222,2842829.0,77,145,9,68,0,55.33783783783784,217,48,16.84234234234234,3
Category_Wikipedia_sockpuppets_of_PauseForMusic.csv,31,5511109.0,12,19,6,6,0,46.806451612903224,172,23,17.161290322580644,13
Category_Wikipedia_sockpuppets_of_Jyothu.csv,3470,59742891.0,1000,2470,500,500,0,33.745821325648414,419,57,17.656772334293947,3
Category_Wikipedia_sockpuppets_of_Blute_Racers.csv,2,0.0,1,1,1,0,0,0.0,0,22,22.0,22
Category_Wikipedia_sockpuppets_of_Simple_en_(edition).csv,108,3855766.0,32,76,28,4,0,45.574074074074076,263,30,17.75,5
Category_Wikipedia_sockpuppets_of_Foovoo.csv,24,103461.0,10,14,9,1,0,31.791666666666668,171,20,18.5,8
Category_Wikipedia_sockpuppets_of_GedalYah.csv,461,29782699.0,222,239,217,5,0,41.47939262472885,255,43,18.17353579175705,13
Category_Wikipedia_sockpuppets_of_Zbl.csv,805,5958460.0,215,590,176,39,0,33.70062111801242,200,53,27.475776397515528,5
Category_Wikipedia_sockpuppets_of_GrahamWPhillips.csv,1794,154611926.0,541,1253,167,374,0,45.06298773690078,246,61,18.147714604236345,5
Category_Wikipedia_sockpuppets_of_EleonorA125.csv,1259,10866930.0,383,876,239,144,0,55.166004765687056,497,70,18.622716441620334,6
Category_Wikipedia_sockpuppets_of_Its_manjeet_rajput.csv,81,137972819.0,26,55,21,5,0,49.74074074074074,215,59,21.59259259259259,12
Category_Wikipedia_sockpuppets_of_Rahuljain2307.csv,1622,14906294.0,507,1115,500,7,0,44.11467324290999,255,56,17.822441430332923,7
Category_Wikipedia_sockpuppets_of_MJD86.csv,2297,29496029.0,529,1768,500,29,0,35.33478450152373,219,53,17.20287331301698,2
Category_Wikipedia_sockpuppets_of_Bettifm.csv,5590,48311778.0,1857,3733,500,1357,0,55.22611806797853,255,74,23.46189624329159,1
Category_Wikipedia_sockpuppets_of_Johnjupither.csv,543,84053331.0,169,374,81,88,0,58.07550644567219,502,37,14.239410681399631,4
Category_Wikipedia_sockpuppets_of_Kamisato.Ayaka.csv,553,21545597.0,169,384,65,104,0,49.050632911392405,500,51,14.083182640144665,3
Category_Wikipedia_sockpuppets_of_Rictorious.csv,46,1729027.0,17,29,15,2,0,52.71739130434783,172,17,15.26086956521739,12
Category_Wikipedia_sockpuppets_of_Zavika.csv,130,250605.0,89,41,48,41,0,45.63076923076923,362,42,13.73076923076923,6
Category_Wikipedia_sockpuppets_of_Truesayer.csv,329,46129170.0,138,191,75,63,0,56.0516717325228,250,76,19.908814589665653,8
Category_Wikipedia_sockpuppets_of_Heyhellowhite.csv,244,1378889.0,85,159,31,54,0,73.5860655737705,220,42,20.471311475409838,3
Category_Wikipedia_sockpuppets_of_JohnJohnJohnJohn.csv,1685,536233785.0,546,1139,500,46,0,39.120474777448074,473,48,20.924035608308607,7
Category_Wikipedia_sockpuppets_of_Renjishcs.csv,65,134520785.0,27,38,15,12,0,42.53846153846154,255,44,20.615384615384617,6
Category_Wikipedia_sockpuppets_of_Belchfire.csv,3375,16228129.0,1015,2360,500,515,0,64.28977777777777,255,78,25.275555555555556,3
Category_Wikipedia_sockpuppets_of_AshleyNN.csv,100,3717782.0,34,66,34,0,0,31.24,175,29,21.16,13
Category_Wikipedia_sockpuppets_of_Godwatch49.csv,581,7075558.0,203,378,46,157,0,46.39414802065404,286,42,18.87263339070568,5
Category_Wikipedia_sockpuppets_of_Trey_Sartorius.csv,32,31709597.0,12,20,9,3,0,61.46875,228,28,18.125,10
Category_Wikipedia_sockpuppets_of_AnimationWhiz133.csv,583,167352420.0,135,448,107,28,0,44.471698113207545,235,54,19.567753001715264,3
Category_Wikipedia_sockpuppets_of_Louislover1969.csv,480,57573686.0,151,329,84,67,0,58.802083333333336,255,72,23.002083333333335,7
Category_Wikipedia_sockpuppets_of_Lebron_James_the_third.csv,40,4766197.0,16,24,9,7,0,27.25,239,24,15.725,12
Category_Wikipedia_sockpuppets_of_EORTV.csv,41,3377315.0,13,28,13,0,0,44.853658536585364,144,23,19.585365853658537,18
Category_Wikipedia_sockpuppets_of_Nobh4321.csv,184,9926002.0,80,104,14,66,0,64.1086956521739,304,46,19.25,4
Category_Wikipedia_sockpuppets_of_Neofpm.csv,33,940166.0,14,19,9,5,0,33.63636363636363,144,22,17.151515151515152,10
Category_Wikipedia_sockpuppets_of_God_Football.csv,2454,14817022.0,949,1505,500,449,0,40.08638956805216,254,116,27.384270578647108,4
Category_Wikipedia_sockpuppets_of_Sayli_21.csv,9,1203303.0,6,3,1,5,0,42.111111111111114,148,9,9.0,9
Category_Wikipedia_sockpuppets_of_Pclavus.csv,81,9672907.0,41,40,39,2,0,51.98765432098765,495,21,17.296296296296298,16
Category_Wikipedia_sockpuppets_of_Improbablygay.csv,21,24705413.0,6,15,4,2,0,66.23809523809524,182,26,8.19047619047619,4
Category_Wikipedia_sockpuppets_of_Ajkochanowicz.csv,317,356438350.0,73,244,68,5,0,51.91482649842271,254,38,17.485804416403784,5
Category_Wikipedia_sockpuppets_of_Ori2312.csv,66,31118253.0,28,38,24,4,0,65.18181818181819,494,41,26.363636363636363,10
Category_Wikipedia_sockpuppets_of_Inoxent_Anonymous.csv,4159,18482310.0,1256,2903,500,756,0,76.15412358740082,395,67,23.744409713873527,3
Category_Wikipedia_sockpuppets_of_Bradka.csv,2475,332149742.0,578,1897,424,154,0,41.50585858585858,254,80,17.102222222222224,4
Category_Wikipedia_sockpuppets_of_Greg_Jungwirth.csv,2063,42019029.0,633,1430,218,415,0,34.800775569558894,213,84,23.219098400387786,4
Category_Wikipedia_sockpuppets_of_User3355.csv,60,1391738.0,41,19,29,12,0,49.55,246,22,15.783333333333333,10
Category_Wikipedia_sockpuppets_of_Mako976.csv,25,3621216.0,11,14,4,7,0,73.24,207,48,14.16,11
Category_Wikipedia_sockpuppets_of_Huy0075.csv,491,6911999.0,152,339,103,49,0,32.30346232179226,392,74,33.36252545824847,16
Category_Wikipedia_sockpuppets_of_Rihaan_M.csv,1744,11833236.0,717,1027,500,217,0,28.731077981651374,376,50,20.00401376146789,6
Category_Wikipedia_sockpuppets_of_Grapesoda22.csv,4358,470777840.0,1250,3108,500,750,0,39.62849931161083,479,73,24.497246443322624,4
Category_Wikipedia_sockpuppets_of_Josheastman.csv,73,843956.0,29,44,29,0,0,44.83561643835616,243,45,17.19178082191781,2
Category_Wikipedia_sockpuppets_of_Jackcashman.csv,21,338282.0,16,5,9,7,0,77.0,197,34,19.904761904761905,18
Category_Wikipedia_sockpuppets_of_Volvo_B9TL.csv,1362,29384295.0,525,837,500,25,0,42.37738619676946,261,64,23.558737151248163,3
Category_Wikipedia_sockpuppets_of_VarahaAvtr.csv,855,33437082.0,284,571,195,89,0,53.85964912280702,500,64,18.11111111111111,4
Category_Wikipedia_sockpuppets_of_Tholzel.csv,1044,188545104.0,290,754,277,13,0,49.156130268199234,231,71,21.518199233716476,10
Category_Wikipedia_sockpuppets_of_WayneRay.csv,1516,176438574.0,502,1014,500,2,0,56.45382585751979,255,145,28.7434036939314,6
Category_Wikipedia_sockpuppets_of_NASCARGuy18.csv,10,314475.0,5,5,5,0,10,32.1,147,21,15.1,10
Category_Wikipedia_sockpuppets_of_Pethj.csv,229,10983865.0,81,148,37,44,0,19.4235807860262,142,69,18.746724890829693,5
Category_Wikipedia_sockpuppets_of_RockabillyRaccoon.csv,3020,11696215.0,862,2158,500,362,0,47.37582781456954,395,52,15.809933774834438,3
Category_Wikipedia_sockpuppets_of_Jbabylon91.csv,601,21765816.0,194,407,153,41,0,41.108153078202996,255,39,16.66722129783694,6
Category_Wikipedia_sockpuppets_of_Muhammad_Samiuddin_Qazi_(sami).csv,5984,81760208.0,1838,4146,170,1668,0,47.011864973262036,500,66,17.96039438502674,4
Category_Wikipedia_sockpuppets_of_Ayushjioff.csv,35,23609511.0,13,22,12,1,0,65.54285714285714,245,53,28.114285714285714,13
Category_Wikipedia_sockpuppets_of_Akrumoftruth.csv,1472,208048713.0,621,851,500,121,0,50.79891304347826,255,53,17.08016304347826,6
Category_Wikipedia_sockpuppets_of_Premsolanki.cso.csv,9,2738.0,5,4,3,2,0,55.55555555555556,196,33,25.0,18
Category_Wikipedia_sockpuppets_of_Visby_Frisbee.csv,5341,7771652.0,1989,3352,500,1489,0,42.61336828309305,267,64,19.366410784497287,4
Category_Wikipedia_sockpuppets_of_Antony_Willianson.csv,502,52610643.0,229,273,199,30,0,57.71912350597609,482,31,16.545816733067728,6
Category_Wikipedia_sockpuppets_of_CulturalStudy.csv,120,923856.0,34,86,31,3,0,79.68333333333334,500,25,15.125,9
Category_Wikipedia_sockpuppets_of_LilOiltw.csv,978,45727146.0,314,664,224,90,0,41.28118609406953,496,38,12.22597137014315,3
Category_Wikipedia_sockpuppets_of_Siswick.csv,242,6535722.0,61,181,27,34,0,44.40909090909091,229,31,15.413223140495868,5
Category_Wikipedia_sockpuppets_of_Hokkunyc.csv,100,6397351.0,91,9,91,0,0,10.91,135,44,8.32,7
Category_Wikipedia_sockpuppets_of_Deathstrikepk.csv,241,99732866.0,57,184,31,26,0,45.85892116182573,217,52,15.597510373443983,3
Category_Wikipedia_sockpuppets_of_Wallace-it-up.csv,2395,53257118.0,669,1726,495,174,0,54.52567849686847,480,51,18.030062630480167,3
Category_Wikipedia_sockpuppets_of_D3FAULTX8.csv,872,87571892.0,277,595,224,53,0,48.42775229357798,399,76,23.32224770642202,4
Category_Wikipedia_sockpuppets_of_GMIAMIR.2010.csv,1302,1978999.0,411,891,361,50,0,36.75652841781874,245,54,22.198924731182796,4
Category_Wikipedia_sockpuppets_of_DBSSURFER.csv,3600,60791461.0,1108,2492,500,608,0,50.80638888888889,253,85,23.370833333333334,5
Category_Wikipedia_sockpuppets_of_RaymondCHedges.csv,5927,119254239.0,1393,4534,500,893,0,47.93234351273831,446,69,17.159946009785727,3
Category_Wikipedia_sockpuppets_of_BhinmalPratihar.csv,144,3666842.0,57,87,29,28,0,53.770833333333336,291,25,15.01388888888889,6
Category_Wikipedia_sockpuppets_of_Alvi_Z..csv,256,36707695.0,153,103,23,130,0,32.59765625,193,43,21.35546875,7
Category_Wikipedia_sockpuppets_of_MikeFromCanmore.csv,154,12126019.0,59,95,36,23,0,76.1103896103896,254,49,26.18831168831169,11
Category_Wikipedia_sockpuppets_of_OKELLO_BENARD_GOODLUCK.csv,46,101244883.0,18,28,7,11,0,61.26086956521739,196,38,23.717391304347824,10
Category_Wikipedia_sockpuppets_of_Shaikhbasit.csv,6,11077541.0,2,4,1,1,0,9.833333333333334,38,26,15.5,5
Category_Wikipedia_sockpuppets_of_Mailcpathetsang.csv,503,27819901.0,167,336,154,13,0,34.19085487077535,197,77,22.880715705765407,4
Category_Wikipedia_sockpuppets_of_Indicaandsativaarebaes.csv,11,2269.0,6,5,6,0,0,67.54545454545455,157,20,8.545454545454545,6
Category_Wikipedia_sockpuppets_of_HanniMontLol.csv,1153,19195296.0,334,819,231,103,0,46.99653078924545,210,49,18.27753686036427,3
Category_Wikipedia_sockpuppets_of_Jagjagjagjab.csv,193,27736307.0,53,140,8,45,0,50.8860103626943,198,54,11.569948186528498,6
Category_Wikipedia_sockpuppets_of_Iridescentbutterfly.csv,885,160365712.0,321,564,195,126,0,50.175141242937855,260,46,19.563841807909604,10
Category_Wikipedia_sockpuppets_of_Jonjon893.csv,11026,111670287.0,3117,7909,500,2617,0,33.93388354797751,255,97,26.22936695084346,3
Category_Wikipedia_sockpuppets_of_Amarh_moses.csv,36,419496.0,9,27,5,4,0,41.80555555555556,152,27,20.916666666666668,4
Category_Wikipedia_sockpuppets_of_Haeretica_Pravitas.csv,292,1459333.0,104,188,19,85,0,37.78082191780822,236,61,19.39041095890411,6
Category_Wikipedia_sockpuppets_of_Ant_jo.csv,35,44785000.0,13,22,8,5,0,33.65714285714286,199,39,25.34285714285714,10
Category_Wikipedia_sockpuppets_of_Sulaimat.csv,306,99881469.0,73,233,29,44,0,62.20261437908497,433,48,16.258169934640524,4
Category_Wikipedia_sockpuppets_of_CloudKade11.csv,2574,363910759.0,867,1707,500,367,0,37.34654234654235,271,62,20.327894327894327,3
Category_Wikipedia_sockpuppets_of_Nguy·ªÖn_Ng·ªçc_Cao_S∆°nn.csv,120,21808148.0,43,77,11,32,0,40.24166666666667,183,71,23.691666666666666,10
Category_Wikipedia_sockpuppets_of_David_Greener.csv,243,262823749.0,65,178,23,42,0,52.888888888888886,218,49,17.609053497942387,3
Category_Wikipedia_sockpuppets_of_Dragonist2.csv,298,29292706.0,66,232,44,22,0,45.11409395973154,200,35,19.916107382550337,6
Category_Wikipedia_sockpuppets_of_Truth_Lover84.csv,126,1283522.0,40,86,22,18,0,48.27777777777778,232,44,22.1984126984127,7
Category_Wikipedia_sockpuppets_of_Mmoreno25.csv,540,9526898.0,168,372,87,81,0,37.05,496,54,26.501851851851853,5
Category_Wikipedia_sockpuppets_of_Thomas7.csv,24,168229675.0,7,17,4,3,0,64.04166666666667,195,27,21.5,12
Category_Wikipedia_sockpuppets_of_Waffen77.csv,294,97697374.0,80,214,18,62,0,45.7891156462585,229,44,20.261904761904763,5
Category_Wikipedia_sockpuppets_of_Wakeupsgsg.csv,9,701382.0,6,3,4,2,0,36.666666666666664,159,8,8.0,8
Category_Wikipedia_sockpuppets_of_PerfectStorm.csv,3544,13698808.0,1000,2544,500,500,0,37.34593679458239,197,65,20.751975169300227,2
Category_Wikipedia_sockpuppets_of_HellenSummer.csv,40,100014.0,16,24,9,7,0,83.375,332,26,14.2,10
Category_Wikipedia_sockpuppets_of_Anup_Gowda.csv,4,1084083.0,3,1,2,1,0,43.25,157,20,18.5,18
Category_Wikipedia_sockpuppets_of_Nia503.csv,342,25572967.0,99,243,8,91,0,55.30701754385965,378,41,17.573099415204677,10
Category_Wikipedia_sockpuppets_of_RakeshPrem001.csv,11,99390.0,4,7,4,0,15,101.27272727272727,421,22,20.727272727272727,18
Category_Wikipedia_sockpuppets_of_Wordpressstar.csv,990,8555487.0,293,697,165,128,0,39.862626262626264,254,64,19.18080808080808,4
Category_Wikipedia_sockpuppets_of_Dashmax1214plus.csv,1594,33891832.0,535,1059,500,35,0,47.91656210790464,500,53,18.34943538268507,1
Category_Wikipedia_sockpuppets_of_Nitin_Mata_bhadrakali_Mandir.csv,61,610879.0,24,37,15,9,0,53.032786885245905,183,66,21.557377049180328,5
Category_Wikipedia_sockpuppets_of_Ryantodd5.csv,39,2243.0,13,26,7,6,0,55.46153846153846,225,7,6.948717948717949,6
Category_Wikipedia_sockpuppets_of_Musicdjwriter.csv,971,4103278.0,481,490,353,128,0,36.67044284243048,496,47,20.390319258496394,8
Category_Wikipedia_sockpuppets_of_Vera_Lucia_Fraga_Pinheiro.csv,191,1266781.0,75,116,18,57,0,49.81675392670157,329,52,19.49214659685864,3
Category_Wikipedia_sockpuppets_of_Eldhorajan92.csv,2066,14344669.0,926,1140,500,426,0,44.00968054211036,306,56,29.434172313649565,5
Category_Wikipedia_sockpuppets_of_Hendrick_99.csv,1964,35937153.0,559,1405,500,59,0,58.573319755600814,255,64,17.63951120162933,3
Category_Wikipedia_sockpuppets_of_75.165.89.45.csv,35,140628.0,19,16,19,0,0,45.542857142857144,152,22,14.0,8
Category_Wikipedia_sockpuppets_of_Random_user_1085.csv,405,43997150.0,194,211,32,162,0,38.32098765432099,229,34,25.219753086419754,19
Category_Wikipedia_sockpuppets_of_Jabuuti.csv,340,698942.0,102,238,81,21,0,33.73235294117647,199,52,17.08235294117647,3
Category_Wikipedia_sockpuppets_of_NobitaElass.csv,336,12866289.0,94,242,46,48,0,67.03869047619048,500,48,16.482142857142858,5
Category_Wikipedia_sockpuppets_of_Amangpintor.csv,1257,266084478.0,402,855,192,210,0,44.50437549721559,255,53,20.634844868735083,4
Category_Wikipedia_sockpuppets_of_Anonyourmum.csv,81,4991.0,23,58,9,14,0,55.592592592592595,374,28,13.345679012345679,4
Category_Wikipedia_sockpuppets_of_Smatrah.csv,2174,87514623.0,566,1608,500,66,0,56.77736890524379,486,70,18.873965041398343,4
Category_Wikipedia_sockpuppets_of_ModiBhakt786.csv,679,6206306.0,207,472,130,77,0,56.98821796759941,254,63,22.82916053019146,6
Category_Wikipedia_sockpuppets_of_Momjosh12.csv,197,29146550.0,53,144,50,3,0,53.85279187817259,254,31,15.746192893401016,5
Category_Wikipedia_sockpuppets_of_Amanda_d_ireland.csv,29,124847.0,16,13,7,9,0,65.55172413793103,228,26,18.620689655172413,12
Category_Wikipedia_sockpuppets_of_Satt_2.csv,8444,347108624.0,2585,5859,500,2085,0,47.90999526290857,351,67,20.798436759829464,4
Category_Wikipedia_sockpuppets_of_JacquesNguyen.csv,3640,24424472.0,728,2912,500,228,0,33.29010989010989,214,69,20.942857142857143,5
Category_Wikipedia_sockpuppets_of_Bergeronpp.csv,1518,4395399.0,602,916,500,102,0,50.33135704874835,497,46,17.091567852437418,3
Category_Wikipedia_sockpuppets_of_Amirhossini.csv,1665,148114166.0,816,849,490,326,0,30.14954954954955,252,86,25.75015015015015,7
Category_Wikipedia_sockpuppets_of_Alexiulian25.csv,4344,135165831.0,1438,2906,500,938,0,39.5798802946593,438,53,22.482504604051567,4
Category_Wikipedia_sockpuppets_of_Melinda1984.csv,127,3608455.0,42,85,23,19,0,52.74803149606299,334,41,19.52755905511811,4
Category_Wikipedia_sockpuppets_of_Ms349846.csv,1,0.0,1,0,1,0,32,32.0,32,33,33.0,33
Category_Wikipedia_sockpuppets_of_Kaylee_Procter.csv,1073,29811263.0,306,767,116,190,0,39.56290773532153,255,51,19.554520037278657,8
Category_Wikipedia_sockpuppets_of_Jeeteshvaishya.csv,1638,88330408.0,649,989,500,149,0,36.63492063492063,253,60,19.153235653235654,5
Category_Wikipedia_sockpuppets_of_2Glad2BYourDad.csv,7,4538.0,6,1,5,1,0,28.285714285714285,62,49,37.57142857142857,19
Category_Wikipedia_sockpuppets_of_Rc_curiousbrewery.csv,15,2044.0,8,7,6,2,0,67.66666666666667,131,47,28.2,17
Category_Wikipedia_sockpuppets_of_Mothman_777.csv,2023,12684470.0,700,1323,395,305,0,32.40632723677707,236,55,14.754325259515571,7
Category_Wikipedia_sockpuppets_of_Mr.Cheese420.csv,24,12434041.0,13,11,5,8,0,47.875,190,32,22.541666666666668,22
Category_Wikipedia_sockpuppets_of_323dfp.csv,248,95995063.0,89,159,76,13,0,48.45967741935484,235,50,23.02016129032258,4
Category_Wikipedia_sockpuppets_of_Lalmohanlal.csv,123,50319792.0,57,66,49,8,0,54.447154471544714,250,30,21.601626016260163,15
Category_Wikipedia_sockpuppets_of_Neomusicproduction.csv,59,324323.0,47,12,38,9,0,23.728813559322035,204,28,15.728813559322035,11
Category_Wikipedia_sockpuppets_of_Abhijnan18.csv,76,303646875.0,19,57,16,3,0,50.026315789473685,191,53,23.394736842105264,10
Category_Wikipedia_sockpuppets_of_EditsOrArticles.csv,935,12903221.0,318,617,169,149,0,52.082352941176474,255,50,20.152941176470588,3
Category_Wikipedia_sockpuppets_of_Appearedclip.csv,2,27.0,2,0,2,0,0,44.0,88,11,11.0,11
Category_Wikipedia_sockpuppets_of_Sunny_Saab.csv,508,46544062.0,169,339,70,99,0,36.07283464566929,255,54,21.69685039370079,4
Category_Wikipedia_sockpuppets_of_Nitromatt.csv,513,502939432.0,215,298,117,98,0,34.46978557504873,225,42,13.592592592592593,8
Category_Wikipedia_sockpuppets_of_Naghmehetaati.csv,137,30354065.0,53,84,15,38,0,52.24817518248175,255,28,17.83941605839416,11
Category_Wikipedia_sockpuppets_of_Picture_of_a_cloud.csv,108,779411.0,32,76,32,0,0,46.00925925925926,172,47,33.03703703703704,15
Category_Wikipedia_sockpuppets_of_Watnar765.csv,124,9685008.0,29,95,3,26,0,48.814516129032256,239,46,19.379032258064516,5
Category_Wikipedia_sockpuppets_of_JackQPR.csv,714,36980544.0,269,445,80,189,0,43.75770308123249,215,56,20.477591036414566,9
Category_Wikipedia_sockpuppets_of_Atharva_anil_khetle.csv,28,13668408.0,7,21,5,2,0,38.17857142857143,186,53,26.357142857142858,4
Category_Wikipedia_sockpuppets_of_Dineshsp.csv,22,496190.0,12,10,11,1,0,38.72727272727273,253,25,18.227272727272727,17
Category_Wikipedia_sockpuppets_of_Attention887.csv,76,10401083.0,23,53,23,0,0,53.0,342,27,14.026315789473685,7
Category_Wikipedia_sockpuppets_of_Ê•äÈÅé007.csv,2090,23591413.0,1018,1072,500,518,0,33.67272727272727,255,58,15.67177033492823,3
Category_Wikipedia_sockpuppets_of_Arsi786.csv,7596,128915832.0,1803,5793,500,1303,0,59.054370721432335,500,54,16.96274354923644,4
Category_Wikipedia_sockpuppets_of_Jaydeep7070.csv,41,1731485.0,12,29,7,5,0,38.97560975609756,196,31,14.658536585365853,6
Category_Wikipedia_sockpuppets_of_995Star.csv,9436,8657291.0,3226,6210,500,2726,0,26.777660025434507,255,56,18.68238660449343,3
Category_Wikipedia_sockpuppets_of_Sameerclicks.csv,60,3533433.0,21,39,10,11,0,41.86666666666667,241,49,14.333333333333334,6
Category_Wikipedia_sockpuppets_of_Arminzo.csv,86,2725758.0,38,48,29,9,0,45.56976744186046,235,44,15.5,11
Category_Wikipedia_sockpuppets_of_AmirKhan2.csv,1,0.0,1,0,1,0,21,21.0,21,19,19.0,19
Category_Wikipedia_sockpuppets_of_MMXVI.csv,1129,114770376.0,387,742,381,6,0,47.72276350752879,255,61,18.86536758193091,4
Category_Wikipedia_sockpuppets_of_Songboy193.csv,8,6331999.0,8,0,5,3,0,19.25,83,16,14.75,14
Category_Wikipedia_sockpuppets_of_Itsmukeshhere.csv,1229,204516140.0,426,803,86,340,0,42.7786818551668,255,53,18.422294548413344,4
Category_Wikipedia_sockpuppets_of_Mori.ssette.amon.csv,6,1240.0,2,4,1,1,29,81.0,197,19,19.0,19
Category_Wikipedia_sockpuppets_of_JoshuSasori.csv,8609,284090261.0,2412,6197,500,1912,0,53.07654779881519,451,84,18.344523173423163,1
Category_Wikipedia_sockpuppets_of_John_Peyang.csv,72,1034680.0,50,22,30,20,0,17.90277777777778,253,28,10.305555555555555,9
Category_Wikipedia_sockpuppets_of_KeirMorrisIOM.csv,4,638.0,3,1,2,1,13,48.0,119,11,11.0,11
Category_Wikipedia_sockpuppets_of_LogAntiLog.csv,3398,214877597.0,908,2490,500,408,0,63.44114184814597,485,70,16.848734549735138,3
Category_Wikipedia_sockpuppets_of_GOOGOOGAGApb.csv,14,1055.0,8,6,5,3,0,43.642857142857146,192,11,11.0,11
Category_Wikipedia_sockpuppets_of_Troyrodriguez361.csv,475,18601882.0,120,355,52,68,0,32.72210526315789,206,62,18.766315789473683,4
Category_Wikipedia_sockpuppets_of_America_is_the_best.csv,191,1007897.0,85,106,46,39,0,29.267015706806284,231,105,28.089005235602095,7
Category_Wikipedia_sockpuppets_of_Mbrahmana.csv,245,162578302.0,57,188,32,25,0,61.285714285714285,251,45,14.816326530612244,5
Category_Wikipedia_sockpuppets_of_Zerefx.csv,503,26846541.0,161,342,132,29,0,50.232604373757454,255,47,26.630218687872762,10
Category_Wikipedia_sockpuppets_of_Nehabansal1.csv,13,1653.0,6,7,3,3,0,69.84615384615384,229,30,24.23076923076923,13
Category_Wikipedia_sockpuppets_of_2crzppul.csv,1480,8849591.0,544,936,500,44,0,42.51081081081081,496,91,26.54662162162162,8
Category_Wikipedia_sockpuppets_of_Willempramschot.csv,452,4265381.0,206,246,202,4,0,32.573008849557525,236,47,35.98893805309734,25
Category_Wikipedia_sockpuppets_of_Lachiehodge.csv,5,4499537.0,2,3,1,1,24,51.2,80,31,25.0,21
Category_Wikipedia_sockpuppets_of_Dollarnobank.csv,21,770050.0,18,3,15,3,0,37.95238095238095,204,31,28.857142857142858,22
Category_Wikipedia_sockpuppets_of_Lazybugger13.csv,1463,152757939.0,777,686,500,277,0,36.03075871496924,253,76,37.56390977443609,6
Category_Wikipedia_sockpuppets_of_Pugalia_Woollen_Mills.csv,7,4178.0,5,2,4,1,27,66.14285714285714,196,31,23.857142857142858,21
Category_Wikipedia_sockpuppets_of_JewsCanNeverLieJewsAreTrustworthy.csv,27,5652.0,13,14,8,5,0,30.444444444444443,119,43,16.14814814814815,13
Category_Wikipedia_sockpuppets_of_The_Only_Dash.csv,10,513380.0,6,4,6,0,0,65.1,190,23,18.9,11
Category_Wikipedia_sockpuppets_of_Bpkhy69.csv,554,6710204.0,202,352,193,9,0,52.061371841155236,255,35,11.315884476534295,3
Category_Wikipedia_sockpuppets_of_Flyoffacliff.csv,351,161384953.0,100,251,54,46,0,38.04558404558404,255,68,24.196581196581196,10
Category_Wikipedia_sockpuppets_of_Tgabarro14.csv,5,4240664.0,5,0,5,0,0,39.8,199,20,20.0,20
Category_Wikipedia_sockpuppets_of_Keshasuxxs.csv,106,90412632.0,22,84,16,6,0,45.528301886792455,248,28,14.622641509433961,4
Category_Wikipedia_sockpuppets_of_Libertas.csv,1811,1469907.0,636,1175,473,163,0,33.414688017669796,198,92,23.644947542794036,6
Category_Wikipedia_sockpuppets_of_Carolynmiller.csv,19,8490118.0,5,14,4,1,0,46.94736842105263,181,18,11.736842105263158,5
Category_Wikipedia_sockpuppets_of_Pianoplonkers.csv,1432,226613421.0,515,917,500,15,0,56.95810055865922,250,73,22.433659217877096,4
Category_Wikipedia_sockpuppets_of_WaterflameIsAwesome.csv,631,4552403.0,180,451,149,31,0,51.199683042789225,386,33,18.497622820919176,8
Category_Wikipedia_sockpuppets_of_Ogmackdrama1017.csv,31,301661.0,21,10,9,12,0,40.064516129032256,135,46,17.70967741935484,10
Category_Wikipedia_sockpuppets_of_Hellofriendshello.csv,71,36735135.0,28,43,19,9,0,75.74647887323944,494,49,25.661971830985916,14
Category_Wikipedia_sockpuppets_of_Ranveer0020.csv,12,897790.0,6,6,3,3,0,75.83333333333333,494,17,14.833333333333334,7
Category_Wikipedia_sockpuppets_of_Ardnashee2014.csv,1433,8729833.0,479,954,279,200,0,36.90020935101186,253,108,20.48778785764131,3
Category_Wikipedia_sockpuppets_of_036386536a.csv,758,2003387.0,512,246,500,12,0,20.642480211081793,234,47,18.408970976253297,5
Category_Wikipedia_sockpuppets_of_Jeffhardy28.csv,10,337158.0,5,5,5,0,0,28.0,119,24,22.3,16
Category_Wikipedia_sockpuppets_of_Sensei_Ali_Tabatabaei.csv,27,10203085.0,12,15,12,0,0,78.22222222222223,199,31,28.88888888888889,26
Category_Wikipedia_sockpuppets_of_FlitchNitch.csv,8,2129.0,5,3,5,0,14,49.125,130,16,9.0,8
Category_Wikipedia_sockpuppets_of_Denihol.csv,175,10120987.0,35,140,35,0,0,35.497142857142855,200,42,18.49142857142857,4
Category_Wikipedia_sockpuppets_of_Arshi1234.csv,2404,49681288.0,1004,1400,500,504,0,37.10024958402662,255,62,31.794925124792012,7
Category_Wikipedia_sockpuppets_of_Carl_Delos_Arcos.csv,1145,28112752.0,432,713,280,152,0,44.161572052401745,496,64,22.137991266375547,4
Category_Wikipedia_sockpuppets_of_Drells.csv,259,1547636.0,91,168,34,57,0,67.51351351351352,493,60,18.374517374517374,4
Category_Wikipedia_sockpuppets_of_Rawkn89.csv,123,3685970.0,44,79,27,17,0,36.577235772357724,221,35,17.601626016260163,3
Category_Wikipedia_sockpuppets_of_Goveganplease.csv,1311,1969896.0,502,809,500,2,0,61.770404271548436,409,82,20.920671243325707,4
Category_Wikipedia_sockpuppets_of_Evimeader.csv,627,3790361.0,299,328,274,25,0,40.759170653907496,449,44,22.749601275917065,4
Category_Wikipedia_sockpuppets_of_Vivianraichand.csv,10,74805.0,7,3,6,1,0,48.7,153,12,12.0,12
Category_Wikipedia_sockpuppets_of_Sheeba_Asia.csv,32,106282.0,21,11,14,7,0,14.53125,62,27,17.15625,7
Category_Wikipedia_sockpuppets_of_JonusPennington.csv,362,409991.0,149,213,148,1,0,38.90055248618785,449,53,24.79281767955801,8
Category_Wikipedia_sockpuppets_of_PANONIAN.csv,1704,403796542.0,502,1202,500,2,0,44.17899061032864,306,59,17.96713615023474,4
Category_Wikipedia_sockpuppets_of_K_of_the_net.csv,289,37413493.0,124,165,33,91,0,53.88927335640138,255,45,20.01038062283737,10
Category_Wikipedia_sockpuppets_of_Mgrubb4.csv,4,66.0,4,0,4,0,18,33.5,49,17,17.0,17
Category_Wikipedia_sockpuppets_of_AhmedYusufG.csv,11,32275407.0,5,6,4,1,0,98.18181818181819,494,38,31.454545454545453,20
Category_Wikipedia_sockpuppets_of_Timgoodings.csv,23,4958.0,16,7,14,2,0,33.52173913043478,143,19,11.956521739130435,6
Category_Wikipedia_sockpuppets_of_Pkcoolpk.csv,9,46252922.0,3,6,3,0,13,56.55555555555556,153,45,39.666666666666664,29
Category_Wikipedia_sockpuppets_of_Viola589.csv,9,204094.0,5,4,5,0,4,38.0,120,20,18.0,13
Category_Wikipedia_sockpuppets_of_DavidAppletree.csv,876,401719.0,331,545,310,21,0,46.10616438356164,238,49,33.68949771689498,14
Category_Wikipedia_sockpuppets_of_Mgksiegen.csv,36,1908122.0,16,20,15,1,0,46.0,166,22,15.25,10
Category_Wikipedia_sockpuppets_of_Eleon√≥ra_Dubiczki.csv,18,7508779.0,5,13,3,2,0,39.833333333333336,211,16,10.944444444444445,9
Category_Wikipedia_sockpuppets_of_Illuminus_Knight.csv,719,103100710.0,168,551,150,18,0,52.837273991655074,296,54,20.40055632823366,7
Category_Wikipedia_sockpuppets_of_Sentineldk.csv,39,761875.0,19,20,18,1,0,18.487179487179485,136,40,40.0,40
Category_Wikipedia_sockpuppets_of_Chocolate2022.csv,9,354935.0,7,2,5,2,15,28.555555555555557,58,41,29.0,5
Category_Wikipedia_sockpuppets_of_Thomaskh.csv,362,13740703.0,112,250,96,16,0,42.05524861878453,224,66,17.76795580110497,3
Category_Wikipedia_sockpuppets_of_Capitals00.csv,2752,341891576.0,711,2041,500,211,0,62.55523255813954,500,68,21.31468023255814,5
Category_Wikipedia_sockpuppets_of_Grec_man.csv,1212,101446751.0,417,795,312,105,0,52.867161716171616,408,65,19.707095709570957,5
Category_Wikipedia_sockpuppets_of_Gameguest.csv,117,58496235.0,33,84,29,4,0,36.042735042735046,235,39,23.957264957264957,13
Category_Wikipedia_sockpuppets_of_Xoni98.csv,2245,73124797.0,882,1363,476,406,0,60.08596881959911,506,62,19.383964365256126,6
Category_Wikipedia_sockpuppets_of_Ibmeui.csv,22,1152.0,12,10,9,3,0,50.31818181818182,142,18,17.0,16
Category_Wikipedia_sockpuppets_of_Ragamuf12.csv,31,372537.0,17,14,15,2,0,78.7741935483871,243,25,22.096774193548388,10
Category_Wikipedia_sockpuppets_of_FILM_ACTOR_SAI_TEJA_MICHAEL.csv,18,32578977.0,11,7,9,2,0,69.77777777777777,246,37,31.11111111111111,26
Category_Wikipedia_sockpuppets_of_BHMANJAKE.csv,30,4823789.0,22,8,13,9,0,34.36666666666667,196,19,12.5,10
Category_Wikipedia_sockpuppets_of_Shashankamath.csv,2615,63917422.0,1651,964,500,1151,0,43.27533460803059,435,64,20.81491395793499,5
Category_Wikipedia_sockpuppets_of_James_mccosker.csv,628,21021645.0,326,302,280,46,0,40.89331210191083,253,40,23.445859872611464,7
Category_Wikipedia_sockpuppets_of_Markt2727.csv,66,2772987.0,24,42,21,3,0,44.303030303030305,255,34,17.545454545454547,13
Category_Wikipedia_sockpuppets_of_Keanubreeze.csv,60,52274606.0,15,45,8,7,0,44.266666666666666,191,47,19.05,13
Category_Wikipedia_sockpuppets_of_Sciologos.csv,57,1308182.0,32,25,32,0,11,42.63157894736842,97,45,14.157894736842104,9
Category_Wikipedia_sockpuppets_of_Lovetogether.csv,107,65749183.0,34,73,14,20,0,57.41121495327103,273,53,17.850467289719628,7
Category_Wikipedia_sockpuppets_of_Velic02c.csv,50,1028196.0,21,29,11,10,0,39.46,177,45,26.42,3
Category_Wikipedia_sockpuppets_of_Ajwah_Abbas.csv,21,26585.0,7,14,7,0,0,41.666666666666664,164,22,21.571428571428573,19
Category_Wikipedia_sockpuppets_of_Mosin_159.csv,32,1470499.0,13,19,6,7,0,32.21875,234,19,15.875,13
Category_Wikipedia_sockpuppets_of_Venky94.csv,629,235834060.0,176,453,176,0,0,35.213036565977745,283,39,15.40381558028617,7
Category_Wikipedia_sockpuppets_of_Vyom420.csv,5184,28451456.0,1661,3523,384,1277,0,32.288773148148145,495,59,28.761188271604937,4
Category_Wikipedia_sockpuppets_of_Jt5076.csv,10,1035.0,9,1,6,3,0,64.3,196,19,16.9,16
Category_Wikipedia_sockpuppets_of_Iloverussia.csv,2832,21806814.0,887,1945,500,387,0,46.44703389830509,255,100,22.257062146892654,4
Category_Wikipedia_sockpuppets_of_RealElliottCrawford.csv,22,2353197.0,10,12,5,5,0,88.31818181818181,500,55,20.5,9
Category_Wikipedia_sockpuppets_of_Flatts.csv,589,24229894.0,150,439,134,16,0,31.775891341256365,208,61,22.64006791171477,4
Category_Wikipedia_sockpuppets_of_Otgo.csv,895,333268049.0,307,588,172,135,0,39.12067039106145,276,49,16.41117318435754,6
Category_Wikipedia_sockpuppets_of_Haddie579.csv,23,4910488.0,14,9,7,7,0,44.73913043478261,188,23,8.043478260869565,7
Category_Wikipedia_sockpuppets_of_International_Occupational_Hygiene_Association.csv,2,0.0,1,1,1,0,29,29.0,29,61,61.0,61
Category_Wikipedia_sockpuppets_of_Baloch_rukhshani.csv,788,12636482.0,326,462,262,64,0,39.43781725888325,255,31,15.968274111675127,4
Category_Wikipedia_sockpuppets_of_Anaphoto.csv,286,317596302.0,115,171,114,1,0,66.13286713286713,489,58,19.416083916083917,14
Category_Wikipedia_sockpuppets_of_Smooth_Jazz_is_bumpin'.csv,92,1701.0,43,49,31,12,0,35.91304347826087,167,40,28.82608695652174,14
Category_Wikipedia_sockpuppets_of_AlaukikSinghReyansh.csv,34,172288105.0,10,24,10,0,0,58.61764705882353,205,29,12.617647058823529,8
Category_Wikipedia_sockpuppets_of_Marklainer.csv,61,51671313.0,15,46,10,5,0,69.01639344262296,381,51,10.37704918032787,8
Category_Wikipedia_sockpuppets_of_LarryTr7.csv,223,13994097.0,117,106,87,30,0,58.210762331838566,228,52,13.174887892376681,7
Category_Wikipedia_sockpuppets_of_Colorofsidewalk.csv,19,2142.0,9,10,8,1,0,60.73684210526316,206,16,12.631578947368421,10
Category_Wikipedia_sockpuppets_of_Alifnagri.csv,1,0.0,1,0,1,0,50,50.0,50,19,19.0,19
Category_Wikipedia_sockpuppets_of_Yogeshdube.csv,693,61176012.0,310,383,309,1,0,28.936507936507937,255,27,14.171717171717171,5
Category_Wikipedia_sockpuppets_of_YugiMuto.csv,135,13781604.0,51,84,46,5,0,53.77777777777778,243,28,22.48148148148148,14
Category_Wikipedia_sockpuppets_of_Kyung-heeu2030.csv,1377,77378650.0,519,858,497,22,0,38.16485112563544,268,38,16.248366013071895,7
Category_Wikipedia_sockpuppets_of_NiNi_x_Bliitz.csv,12,24599.0,6,6,3,3,0,58.833333333333336,226,32,25.916666666666668,9
Category_Wikipedia_sockpuppets_of_Sameerbhatia2015.csv,89,4078553.0,39,50,10,29,0,49.842696629213485,249,53,39.61797752808989,4
Category_Wikipedia_sockpuppets_of_Macaca.csv,5,1010.0,4,1,4,0,12,24.8,57,39,39.0,39
Category_Wikipedia_sockpuppets_of_SpdrJcksn.csv,340,153278112.0,131,209,55,76,0,43.055882352941175,254,51,15.75294117647059,8
Category_Wikipedia_sockpuppets_of_Sagar.kottappuram777.csv,276,96570162.0,72,204,47,25,0,48.96376811594203,395,42,24.514492753623188,5
Category_Wikipedia_sockpuppets_of_Momanena.csv,72,599198.0,26,46,13,13,0,58.44444444444444,255,52,18.52777777777778,10
Category_Wikipedia_sockpuppets_of_TheKittenBoy.csv,18,352361.0,15,3,9,6,0,69.61111111111111,199,29,22.38888888888889,14
Category_Wikipedia_sockpuppets_of_Simuliid.csv,2432,415293105.0,1000,1432,500,500,0,76.03371710526316,496,57,15.48889802631579,5
Category_Wikipedia_sockpuppets_of_Mikael07.csv,975,50130429.0,338,637,277,61,0,53.61333333333334,248,60,13.371282051282051,4
Category_Wikipedia_sockpuppets_of_Dead_Goldfish.csv,561,74348079.0,203,358,195,8,0,57.6524064171123,255,63,21.796791443850267,11
Category_Wikipedia_sockpuppets_of_Sacredcowda.csv,10,515422.0,6,4,4,2,0,79.8,180,9,9.0,9
Category_Wikipedia_sockpuppets_of_Space_Infinite.csv,4369,36208138.0,1818,2551,500,1318,0,47.192263675898374,255,71,17.301441977569237,3
Category_Wikipedia_sockpuppets_of_Sadhu_Ratan_Puri.csv,2,0.0,1,1,1,0,14,14.0,14,35,35.0,35
Category_Wikipedia_sockpuppets_of_Joseph201.csv,1794,15032748.0,758,1036,500,258,0,40.210144927536234,250,54,20.75195094760312,6
Category_Wikipedia_sockpuppets_of_Kelly97.csv,1814,417287636.0,515,1299,201,314,0,52.70617420066152,446,63,17.946527012127895,3
Category_Wikipedia_sockpuppets_of_Brett23productions.csv,109,9259156.0,23,86,23,0,0,31.128440366972477,173,41,28.541284403669724,9
Category_Wikipedia_sockpuppets_of_JosueThomasDiez.csv,37,1535.0,21,16,21,0,0,56.567567567567565,180,54,33.7027027027027,11
Category_Wikipedia_sockpuppets_of_Becausewhynothuh_.csv,1509,16669906.0,352,1157,187,165,0,62.94367130550033,493,56,20.039098740888004,5
Category_Wikipedia_sockpuppets_of_Ricemaster12.csv,1773,44151832.0,491,1282,346,145,0,51.27523970671179,500,45,12.86576424139876,4
Category_Wikipedia_sockpuppets_of_JohannesCheddar.csv,147,6741987.0,43,104,27,16,0,49.476190476190474,233,42,16.843537414965986,4
Category_Wikipedia_sockpuppets_of_Akshata_Sen.csv,118,9235574.0,38,80,11,27,0,43.54237288135593,248,31,18.78813559322034,9
Category_Wikipedia_sockpuppets_of_Threeafterthree.csv,2672,209481933.0,647,2025,500,147,0,48.136601796407184,253,62,18.66130239520958,6
Category_Wikipedia_sockpuppets_of_Ggg3243.csv,177,1208409.0,60,117,31,29,0,52.10734463276836,292,36,14.372881355932204,6
Category_Wikipedia_sockpuppets_of_Torah28.csv,1100,62464580.0,516,584,500,16,0,37.06909090909091,251,56,21.14818181818182,10
Category_Wikipedia_sockpuppets_of_Astrlpi.csv,137,352800.0,75,62,56,19,0,44.70802919708029,266,66,54.22627737226277,17
Category_Wikipedia_sockpuppets_of_Finnoflannigan.csv,137,6837226.0,42,95,10,32,0,66.56934306569343,255,24,15.014598540145986,5
Category_Wikipedia_sockpuppets_of_StateOfVisChicks.csv,9,196.0,5,4,4,1,1,36.0,117,76,26.666666666666668,11
Category_Wikipedia_sockpuppets_of_Abbayiammayi.csv,389,5334616.0,158,231,126,32,0,33.26478149100257,229,59,15.57840616966581,7
Category_Wikipedia_sockpuppets_of_Ntyhoney.csv,673,25228587.0,258,415,166,92,0,39.31946508172363,255,38,12.799405646359585,4
Category_Wikipedia_sockpuppets_of_Infinenoi.csv,2405,48266833.0,866,1539,231,635,0,36.486902286902286,426,45,16.95051975051975,4
Category_Wikipedia_sockpuppets_of_Alitalha4.csv,19,1624238.0,7,12,4,3,0,39.36842105263158,137,49,36.0,22
Category_Wikipedia_sockpuppets_of_ICanMakeYourBedRockxxx.csv,12,1502.0,8,4,7,1,0,47.333333333333336,141,32,23.75,21
Category_Wikipedia_sockpuppets_of_Ronanin.csv,772,29482110.0,223,549,209,14,0,51.59974093264249,242,60,22.305699481865286,4
Category_Wikipedia_sockpuppets_of_Desibeats933.csv,96,24395361.0,37,59,16,21,0,46.729166666666664,308,17,7.270833333333333,5
Category_Wikipedia_sockpuppets_of_Kardon6.csv,165,50276277.0,59,106,26,33,0,64.83030303030303,461,47,19.848484848484848,12
Category_Wikipedia_sockpuppets_of_PhoenixSummon.csv,309,9760269.0,92,217,36,56,0,44.06472491909385,291,54,22.281553398058254,6
Category_Wikipedia_sockpuppets_of_Iloveonedirection1237.csv,49,6190658.0,21,28,7,14,0,65.85714285714286,235,45,17.755102040816325,10
Category_Wikipedia_sockpuppets_of_Timo3.csv,1621,441730346.0,454,1167,283,171,0,49.39111659469463,276,49,15.174583590376312,1
Category_Wikipedia_sockpuppets_of_Anantam_tripathi.csv,2527,70617978.0,783,1744,299,484,0,57.02453502176494,500,65,14.153937475267115,4
Category_Wikipedia_sockpuppets_of_Raj9910.csv,659,39696905.0,133,526,125,8,0,47.965098634294385,318,21,13.244309559939301,7
Category_Wikipedia_sockpuppets_of_ItsTimeNow.csv,616,111807189.0,181,435,157,24,0,50.94318181818182,395,53,21.90909090909091,7
Category_Wikipedia_sockpuppets_of_–ò–≤–∞–Ω_–ë–æ–≥–¥–∞–Ω–æ–≤.csv,30,377721577.0,6,24,3,3,0,62.96666666666667,404,35,23.5,11
Category_Wikipedia_sockpuppets_of_Zahidul009.csv,18,49686.0,9,9,6,3,0,34.05555555555556,101,52,40.888888888888886,20
Category_Wikipedia_sockpuppets_of_Porshi.csv,5,2537.0,2,3,2,0,0,83.8,220,19,19.0,19
Category_Wikipedia_sockpuppets_of_Enritesh.csv,1,0.0,1,0,1,0,0,0.0,0,6,6.0,6
Category_Wikipedia_sockpuppets_of_Expatkiwi.csv,1846,210532748.0,513,1333,500,13,0,47.08342361863489,252,60,23.011375947995667,5
Category_Wikipedia_sockpuppets_of_AlaskaArticleEditor315.csv,98,360565.0,86,12,82,4,0,56.683673469387756,251,42,30.26530612244898,16
Category_Wikipedia_sockpuppets_of_Neelansh_koshta.csv,611,22695018.0,177,434,31,146,0,46.252045826513914,255,52,18.99509001636661,5
Category_Wikipedia_sockpuppets_of_Ibrahim999.csv,341,4077238.0,124,217,70,54,0,40.58651026392962,207,74,20.882697947214076,5
Category_Wikipedia_sockpuppets_of_Politowski55.csv,798,259998656.0,300,498,215,85,0,36.664160401002505,243,45,17.958646616541355,3
Category_Wikipedia_sockpuppets_of_Mickproper.csv,1028,119365787.0,229,799,130,99,0,43.94649805447471,266,79,17.107003891050585,4
Category_Wikipedia_sockpuppets_of_Thedivyanshsrivastava.csv,42,4065522.0,22,20,15,7,0,17.238095238095237,196,36,31.952380952380953,26
Category_Wikipedia_sockpuppets_of_Sumpsstrip.csv,5,356231.0,2,3,1,1,7,101.6,292,45,22.6,17
Category_Wikipedia_sockpuppets_of_Kevinoleary12.csv,540,49150301.0,144,396,91,53,0,34.3962962962963,230,76,19.43888888888889,7
Category_Wikipedia_sockpuppets_of_Pow!333.csv,3160,16854442.0,999,2161,500,499,0,51.401582278481015,495,103,22.450316455696203,3
Category_Wikipedia_sockpuppets_of_Bader-Sheertex.csv,3,57790.0,2,1,2,0,0,74.66666666666667,126,24,22.333333333333332,19
Category_Wikipedia_sockpuppets_of_The3rdmaster.csv,71,6521239.0,32,39,22,10,0,41.80281690140845,191,51,18.338028169014084,6
Category_Wikipedia_sockpuppets_of_Indresimkun.csv,4,57474.0,3,1,2,1,21,72.0,196,18,16.0,14
Category_Wikipedia_sockpuppets_of_Jfksjxu.csv,59,1112.0,25,34,12,13,0,57.42372881355932,248,65,18.050847457627118,7
Category_Wikipedia_sockpuppets_of_Yenserbull2.csv,36,1073216.0,25,11,24,1,0,63.80555555555556,275,21,16.77777777777778,10
Category_Wikipedia_sockpuppets_of_PortugueseManofPeace.csv,745,5196923.0,203,542,124,79,0,52.033557046979865,255,56,29.628187919463087,5
Category_Wikipedia_sockpuppets_of_WhyDon'tWeZJCDJ.csv,209,780606.0,56,153,54,2,0,54.995215311004785,255,46,15.626794258373206,5
Category_Wikipedia_sockpuppets_of_FapKing.csv,30,6580112.0,17,13,6,11,0,39.6,158,13,13.0,13
Category_Wikipedia_sockpuppets_of_MoonlightNova.csv,133,10722003.0,48,85,32,16,0,46.17293233082707,348,46,19.406015037593985,5
Category_Wikipedia_sockpuppets_of_JBAK.csv,1077,29994107.0,362,715,266,96,0,25.885793871866294,257,47,17.56731662024141,4
Category_Wikipedia_sockpuppets_of_Tomtasget.csv,332,188078645.0,88,244,79,9,0,50.743975903614455,263,52,17.656626506024097,3
Category_Wikipedia_sockpuppets_of_ICEERO.csv,143,339125.0,74,69,47,27,0,67.17482517482517,327,30,20.678321678321677,11
Category_Wikipedia_sockpuppets_of_Btarik77.csv,6,3017963.0,2,4,2,0,20,30.166666666666668,53,18,17.0,16
Category_Wikipedia_sockpuppets_of_Mervin_110694.csv,2921,104975519.0,1040,1881,500,540,0,28.26600479287915,262,71,23.855871276959945,5
Category_Wikipedia_sockpuppets_of_ChrisFashion.csv,147,3807119.0,64,83,35,29,0,28.897959183673468,199,43,16.79591836734694,2
Category_Wikipedia_sockpuppets_of_Thatsoundagency.csv,4,41434.0,3,1,3,0,0,19.25,36,25,25.0,25
Category_Wikipedia_sockpuppets_of_Plyycajk.csv,19,1183929.0,12,7,6,6,0,87.05263157894737,255,36,18.94736842105263,6
Category_Wikipedia_sockpuppets_of_Pizzole.csv,999,11723222.0,361,638,357,4,0,39.84184184184184,255,72,37.7007007007007,8
Category_Wikipedia_sockpuppets_of_Ravisharma2019.csv,46,596544.0,17,29,9,8,0,61.76086956521739,255,20,14.304347826086957,9
Category_Wikipedia_sockpuppets_of_SingaporeUniversity.csv,27,527345.0,24,3,19,5,0,60.333333333333336,196,33,25.962962962962962,16
Category_Wikipedia_sockpuppets_of_W14212121hgjfkdlsj.csv,6,236670.0,2,4,2,0,0,45.666666666666664,157,28,16.0,10
Category_Wikipedia_sockpuppets_of_Mariavallebrizuela.csv,102,48204434.0,85,17,33,52,0,42.61764705882353,202,39,19.61764705882353,11
Category_Wikipedia_sockpuppets_of_Fishdog1769.csv,30,25237560.0,10,20,5,5,0,57.333333333333336,210,23,12.4,5
Category_Wikipedia_sockpuppets_of_Kkekana.csv,16,80258.0,10,6,6,4,0,48.8125,140,18,14.5,8
Category_Wikipedia_sockpuppets_of_HurricaneTyphoonCyclone.csv,683,157198729.0,261,422,131,130,0,46.23865300146413,235,51,30.440702781844802,10
Category_Wikipedia_sockpuppets_of_Imorthodox23.csv,4479,86372145.0,1153,3326,500,653,0,39.80933244027685,255,68,14.22080821611967,3
Category_Wikipedia_sockpuppets_of_AislynnFlores.csv,19,7108.0,7,12,5,2,0,67.89473684210526,200,25,16.94736842105263,11
Category_Wikipedia_sockpuppets_of_Ara.ahmad.na.csv,66,7154606.0,18,48,6,12,0,40.696969696969695,161,53,28.78787878787879,5
Category_Wikipedia_sockpuppets_of_Jujjavarapu_mohith.csv,450,2434477.0,203,247,156,47,0,29.933333333333334,494,32,16.424444444444443,8
Category_Wikipedia_sockpuppets_of_Joyland2017.csv,739,216254391.0,369,370,206,163,0,35.80784844384303,420,26,16.74154262516915,14
Category_Wikipedia_sockpuppets_of_MariskaNanni.csv,62,43008196.0,24,38,19,5,0,77.01612903225806,464,27,10.67741935483871,9
Category_Wikipedia_sockpuppets_of_Raj_vin.csv,430,44345073.0,148,282,53,95,0,57.60232558139535,537,78,27.760465116279068,7
Category_Wikipedia_sockpuppets_of_Wp_zone.csv,30,1867850.0,21,9,9,12,0,12.566666666666666,122,13,13.0,13
Category_Wikipedia_sockpuppets_of_Qu3stionThatN33dAnsw3rs.csv,81,8412991.0,34,47,22,12,0,44.04938271604938,224,59,23.234567901234566,13
Category_Wikipedia_sockpuppets_of_ButtPrince_I.csv,27,3925.0,9,18,5,4,0,58.666666666666664,201,23,16.333333333333332,11
Category_Wikipedia_sockpuppets_of_Shamimanm.csv,294,149600894.0,107,187,102,5,0,42.48639455782313,277,52,16.346938775510203,5
Category_Wikipedia_sockpuppets_of_Ne.pas12.csv,229,211362119.0,55,174,53,2,0,40.75545851528384,236,61,17.847161572052403,10
Category_Wikipedia_sockpuppets_of_Marcorubiocali.csv,283,13642074.0,93,190,82,11,0,47.773851590106005,354,48,25.50530035335689,11
Category_Wikipedia_sockpuppets_of_Dar_tribe.csv,119,64651820.0,37,82,14,23,0,47.52100840336134,232,23,17.084033613445378,11
Category_Wikipedia_sockpuppets_of_WordBomb.csv,1029,52060725.0,306,723,72,234,0,36.371234207968904,209,70,21.878522837706512,3
Category_Wikipedia_sockpuppets_of_Sureshpandey.csv,447,54171405.0,227,220,199,28,0,43.630872483221474,255,41,15.816554809843401,8
Category_Wikipedia_sockpuppets_of_Moore_Physics.csv,193,44987536.0,62,131,42,20,0,35.766839378238345,199,37,16.487046632124354,3
Category_Wikipedia_sockpuppets_of_TracyUK.csv,54,959540.0,32,22,25,7,9,30.59259259259259,145,30,14.333333333333334,12
Category_Wikipedia_sockpuppets_of_EnisTheGreat.csv,40,98578.0,13,27,10,3,0,57.625,184,46,17.375,6
Category_Wikipedia_sockpuppets_of_Sarahjkay.csv,848,140092289.0,254,594,252,2,0,35.1627358490566,248,46,18.294811320754718,4
Category_Wikipedia_sockpuppets_of_Castlehouse17.csv,8,484543.0,5,3,3,2,0,102.5,400,27,26.875,26
Category_Wikipedia_sockpuppets_of_Oslo95.csv,231,10394515.0,91,140,77,14,0,46.70995670995671,236,54,22.545454545454547,6
Category_Wikipedia_sockpuppets_of_Khalid_sadeq.csv,1270,78743446.0,505,765,500,5,0,28.14724409448819,272,63,21.38267716535433,3
Category_Wikipedia_sockpuppets_of_Emilie2606.csv,79,1718492.0,24,55,12,12,0,64.0379746835443,276,61,17.025316455696203,11
Category_Wikipedia_sockpuppets_of_Supervoter.csv,44,213537.0,21,23,20,1,0,40.25,178,126,54.34090909090909,15
Category_Wikipedia_sockpuppets_of_Wiki97828.csv,1357,73885517.0,511,846,500,11,0,43.77597641857037,496,53,20.361090641120118,7
Category_Wikipedia_sockpuppets_of_MaxtronusTechnobotRaidenDinoLandcrosssXephanxo.csv,28,691450.0,16,12,8,8,0,36.92857142857143,196,52,24.892857142857142,7
Category_Wikipedia_sockpuppets_of_Hallaomar.csv,154,192994718.0,53,101,53,0,0,49.40909090909091,247,13,11.194805194805195,11
Category_Wikipedia_sockpuppets_of_Jasonbenz2.csv,69,49459155.0,21,48,14,7,0,45.82608695652174,245,64,15.956521739130435,10
Category_Wikipedia_sockpuppets_of_JJGD.csv,10165,72218416.0,3368,6797,500,2868,0,37.88440727988195,267,76,20.36468273487457,3
Category_Wikipedia_sockpuppets_of_GoOKC.csv,3258,169795970.0,1350,1908,500,850,0,44.59545733578883,500,92,29.21669736034377,9
Category_Wikipedia_sockpuppets_of_Msurtaza19987.csv,4,594.0,3,1,3,0,0,60.25,196,26,21.5,20
Category_Wikipedia_sockpuppets_of_Anchan_Balti.csv,1064,147932361.0,353,711,332,21,0,45.44924812030075,498,66,14.901315789473685,2
Category_Wikipedia_sockpuppets_of_Knotweed.csv,132,3027566.0,63,69,44,19,0,51.5,198,39,23.477272727272727,15
Category_Wikipedia_sockpuppets_of_Txbiassss.csv,32,533099.0,20,12,19,1,0,30.75,260,19,17.5,17
Category_Wikipedia_sockpuppets_of_Webvip.csv,722,218649159.0,165,557,158,7,0,49.5595567867036,255,53,29.121883656509695,4
Category_Wikipedia_sockpuppets_of_Kaththi_Again.csv,13,100806.0,6,7,3,3,0,27.846153846153847,136,23,12.384615384615385,6
Category_Wikipedia_sockpuppets_of_Jared19921j.csv,84,110456437.0,56,28,37,19,0,52.88095238095238,252,37,13.476190476190476,10
Category_Wikipedia_sockpuppets_of_Ushanga1992.csv,66,25673456.0,21,45,17,4,0,41.45454545454545,196,29,14.06060606060606,3
Category_Wikipedia_sockpuppets_of_Fallenleaflake13.csv,23,3019925.0,13,10,11,2,0,46.608695652173914,141,27,24.608695652173914,21
Category_Wikipedia_sockpuppets_of_WikiDon.csv,3536,3291084.0,1066,2470,500,566,0,44.189196832579185,215,67,19.956447963800905,2
Category_Wikipedia_sockpuppets_of_Roadsoap.csv,269,1696497.0,93,176,93,0,0,27.91078066914498,183,77,18.059479553903344,3
Category_Wikipedia_sockpuppets_of_Jannizzero1.csv,1466,3473953.0,597,869,500,97,0,72.10095497953616,497,60,19.78308321964529,7
Category_Wikipedia_sockpuppets_of_Andres_A_Cisneros.csv,25,602944.0,10,15,5,5,0,47.16,192,28,16.0,12
Category_Wikipedia_sockpuppets_of_Piononno.csv,277,250320397.0,97,180,43,54,0,40.104693140794225,208,41,18.63537906137184,8
Category_Wikipedia_sockpuppets_of_Limabean123.csv,3,224.0,2,1,2,0,20,62.333333333333336,140,37,35.333333333333336,32
Category_Wikipedia_sockpuppets_of_Harshhussey.csv,1573,40639456.0,504,1069,500,4,0,44.88429752066116,255,59,23.68213604577241,6
Category_Wikipedia_sockpuppets_of_Epiphytes.csv,60,39347071.0,14,46,6,8,0,80.7,278,19,12.066666666666666,5
Category_Wikipedia_sockpuppets_of_Xboxmanwar.csv,4659,120750163.0,1271,3388,500,771,0,37.00901481004507,427,61,18.375831723545826,3
Category_Wikipedia_sockpuppets_of_Hidden_World_News.csv,37,1219999.0,18,19,12,6,0,29.972972972972972,196,80,53.75675675675676,20
Category_Wikipedia_sockpuppets_of_Hershebar.csv,312,19616552.0,68,244,23,45,0,57.02884615384615,226,54,24.91346153846154,3
Category_Wikipedia_sockpuppets_of_Mikeyasadie.csv,220,33331028.0,77,143,32,45,0,58.07272727272727,225,58,18.336363636363636,3
Category_Wikipedia_sockpuppets_of_Roman888.csv,1668,15462737.0,679,989,500,179,0,42.91546762589928,255,72,23.662470023980816,8
Category_Wikipedia_sockpuppets_of_Hdayejr.csv,1013,83559500.0,292,721,216,76,0,44.24383020730504,215,54,23.918065153010858,4
Category_Wikipedia_sockpuppets_of_Samil20.csv,1799,435779348.0,500,1299,500,0,0,43.54419121734297,374,52,17.33296275708727,3
Category_Wikipedia_sockpuppets_of_Gwity.csv,19,284643.0,14,5,7,7,0,51.63157894736842,189,18,16.42105263157895,15
Category_Wikipedia_sockpuppets_of_Jejeman.csv,32,17451480.0,10,22,9,1,0,44.75,194,91,31.34375,8
Category_Wikipedia_sockpuppets_of_Garfield_Fan_2005.csv,1953,69659888.0,523,1430,500,23,0,38.7163338453661,496,90,28.138760880696363,5
Category_Wikipedia_sockpuppets_of_Robbyfresh.csv,3,853.0,3,0,3,0,0,24.0,36,10,10.0,10
Category_Wikipedia_sockpuppets_of_Vkdutta4u.csv,517,168270155.0,183,334,107,76,0,41.95164410058027,255,46,14.678916827852998,2
Category_Wikipedia_sockpuppets_of_Nikhil43874.csv,11,2163044.0,5,6,3,2,0,74.72727272727273,151,10,6.0,3
Category_Wikipedia_sockpuppets_of_Yeetboi6969.csv,8,160394.0,3,5,2,1,0,65.75,183,10,10.0,10
Category_Wikipedia_sockpuppets_of_ForeverKnowledgeSeeker.csv,1154,12342116.0,373,781,223,150,0,58.370883882149045,492,58,20.574523396880416,4
Category_Wikipedia_sockpuppets_of_Nirmal_baby.csv,159,3472000.0,43,116,42,1,0,43.59748427672956,268,52,17.77358490566038,5
Category_Wikipedia_sockpuppets_of_JShanley98.csv,2139,8574567.0,538,1601,500,38,0,31.266947171575502,255,54,19.9658719027583,5
Category_Wikipedia_sockpuppets_of_Deepjoshi111.csv,47,428481.0,21,26,21,0,0,18.680851063829788,151,28,17.48936170212766,10
Category_Wikipedia_sockpuppets_of_Mifciw.csv,1308,128981758.0,481,827,423,58,0,51.81422018348624,255,59,19.728593272171253,4
Category_Wikipedia_sockpuppets_of_Sabareeshprabhakar.csv,1,0.0,1,0,1,0,12,12.0,12,7,7.0,7
Category_Wikipedia_sockpuppets_of_Itvitn.csv,598,112647378.0,183,415,158,25,0,38.9180602006689,228,50,21.665551839464882,4
Category_Wikipedia_sockpuppets_of_Jahlove1234.csv,2612,74187058.0,1000,1612,500,500,0,33.253062787136294,250,44,17.406967840735067,5
Category_Wikipedia_sockpuppets_of_AnimeLover129.csv,2440,79997593.0,1114,1326,500,614,0,41.85409836065574,496,48,17.435655737704916,3
Category_Wikipedia_sockpuppets_of_ZoomingZebra.csv,2,132.0,2,0,2,0,6,20.0,34,30,30.0,30
Category_Wikipedia_sockpuppets_of_Insert-Belltower.csv,71,1030229.0,26,45,19,7,0,37.59154929577465,135,40,35.521126760563384,6
Category_Wikipedia_sockpuppets_of_Infinitiard.csv,9,157853.0,6,3,3,3,0,70.55555555555556,199,21,17.88888888888889,14
Category_Wikipedia_sockpuppets_of_Thamesinfotech.csv,2423,143359424.0,970,1453,329,641,0,44.21832439125052,493,74,21.217498968221214,3
Category_Wikipedia_sockpuppets_of_TekkenJinKazama.csv,4707,166168549.0,1600,3107,500,1100,0,38.031867431485026,264,78,18.264499681325685,3
Category_Wikipedia_sockpuppets_of_Phones4Uhack.csv,27,5858.0,17,10,12,5,0,38.77777777777778,160,45,21.59259259259259,9
Category_Wikipedia_sockpuppets_of_Uga_Man.csv,1163,46165780.0,354,809,145,209,0,42.16680997420465,215,54,23.77128116938951,5
Category_Wikipedia_sockpuppets_of_Minden_jacob.csv,63,101702784.0,27,36,16,11,0,48.82539682539682,255,47,25.841269841269842,7
Category_Wikipedia_sockpuppets_of_Singer_Jethu_Sisodiya.csv,2823,44287924.0,954,1869,500,454,0,61.113354587318454,473,106,19.535246191994332,5
Category_Wikipedia_sockpuppets_of_MrRohanM.csv,6391,56194118.0,2360,4031,500,1860,0,34.81348771710218,250,52,16.21592864966359,3
Category_Wikipedia_sockpuppets_of_Bob3dog.csv,460,713117.0,161,299,121,40,0,38.47826086956522,213,48,22.05217391304348,6
Category_Wikipedia_sockpuppets_of_JenEli.csv,44,329536653.0,15,29,6,9,0,44.95454545454545,216,31,26.431818181818183,16
Category_Wikipedia_sockpuppets_of_Gutthat.csv,63,517944.0,39,24,28,11,0,33.25396825396825,496,20,14.095238095238095,9
Category_Wikipedia_sockpuppets_of_Aldrich_Hanssen.csv,1437,898036.0,500,937,500,0,0,37.33820459290188,250,73,25.4669450243563,3
Category_Wikipedia_sockpuppets_of_Brono2001C.csv,52,3706402.0,34,18,5,29,0,41.71153846153846,173,32,21.192307692307693,12
Category_Wikipedia_sockpuppets_of_Thulasi12345.csv,1464,6320928.0,513,951,500,13,0,28.884562841530055,263,47,21.450136612021858,5
Category_Wikipedia_sockpuppets_of_Nasharudeen22.csv,43,45283085.0,19,24,13,6,0,38.0,183,41,29.441860465116278,10
Category_Wikipedia_sockpuppets_of_Â∞èÊûóÂäõ.csv,40,5615155.0,31,9,14,17,0,27.9,262,40,8.825,5
Category_Wikipedia_sockpuppets_of_Parveen_raaj_hisampur.csv,170,15885134.0,74,96,22,52,0,49.188235294117646,295,39,20.01764705882353,7
Category_Wikipedia_sockpuppets_of_Bkr3da.csv,116,2739656.0,39,77,33,6,0,63.310344827586206,408,40,23.379310344827587,12
Category_Wikipedia_sockpuppets_of_User_James4750.csv,5,9283.0,5,0,5,0,0,8.4,35,44,38.6,17
Category_Wikipedia_sockpuppets_of_Sridhar100.csv,8961,75725737.0,2792,6169,500,2292,0,38.43745117732396,262,70,14.059814752817767,3
Category_Wikipedia_sockpuppets_of_Wyatt2049.csv,3702,28153841.0,1194,2508,500,694,0,63.16558616963803,497,81,24.869800108049702,4
Category_Wikipedia_sockpuppets_of_TRUN221.csv,43,14017420.0,16,27,10,6,0,46.674418604651166,180,51,25.093023255813954,16
Category_Wikipedia_sockpuppets_of_Irisvalverde1.csv,414,16503451.0,131,283,39,92,0,41.61352657004831,273,32,14.142512077294686,6
Category_Wikipedia_sockpuppets_of_Death3sam.csv,14,1839.0,5,9,5,0,13,63.42857142857143,176,28,20.5,16
Category_Wikipedia_sockpuppets_of_MarkoDalisay.csv,1742,54496725.0,836,906,500,336,0,34.9804822043628,283,47,16.681974741676235,5
Category_Wikipedia_sockpuppets_of_Victor1500.csv,288,75205436.0,117,171,98,19,0,86.64583333333333,255,38,17.59722222222222,13
Category_Wikipedia_sockpuppets_of_Mhernandez715.csv,8,614650.0,6,2,6,0,0,33.875,199,51,46.875,18
Category_Wikipedia_sockpuppets_of_Bldfire.csv,203,175588127.0,59,144,50,9,0,39.610837438423644,199,59,29.502463054187192,12
Category_Wikipedia_sockpuppets_of_Raja_salesh_mandir_agapur.csv,191,5436553.0,102,89,68,34,0,41.654450261780106,257,31,11.596858638743456,6
Category_Wikipedia_sockpuppets_of_SR_Alamgir_Khan.csv,9129,52619261.0,4771,4358,500,4271,0,25.840727352393472,500,68,28.753423156972286,6
Category_Wikipedia_sockpuppets_of_Nickelbackrules1518.csv,1768,5038370.0,536,1232,500,36,0,39.79920814479638,250,54,19.86764705882353,3
Category_Wikipedia_sockpuppets_of_K-ray913.csv,41,1812208.0,11,30,11,0,0,58.53658536585366,214,29,18.73170731707317,11
Category_Wikipedia_sockpuppets_of_SwedishFacts.csv,42,19496334.0,16,26,9,7,0,40.404761904761905,157,19,11.69047619047619,4
Category_Wikipedia_sockpuppets_of_DarknessVisitor.csv,3735,28821683.0,1479,2256,500,979,0,29.978580990629183,261,81,23.37858099062918,4
Category_Wikipedia_sockpuppets_of_Martin_jo.csv,224,17313697.0,102,122,38,64,0,42.30357142857143,255,21,15.116071428571429,5
Category_Wikipedia_sockpuppets_of_Jdhfox.csv,3829,65111361.0,1267,2562,349,918,0,38.306607469313136,496,59,22.39514233481327,3
Category_Wikipedia_sockpuppets_of_JusticeCM.csv,61,4139486.0,29,32,19,10,0,90.55737704918033,294,25,20.704918032786885,18
Category_Wikipedia_sockpuppets_of_Rajnipandey.csv,242,67671854.0,60,182,28,32,0,47.45867768595041,321,32,12.958677685950413,5
Category_Wikipedia_sockpuppets_of_Said.suleiman.juma.csv,3,1230835.0,2,1,1,1,14,75.0,196,28,27.0,25
Category_Wikipedia_sockpuppets_of_Mishash.csv,1457,110508829.0,464,993,166,298,0,52.66781056966369,253,59,22.733013040494168,4
Category_Wikipedia_sockpuppets_of_Headstrust.csv,105,2356130.0,23,82,13,10,0,52.21904761904762,192,37,19.60952380952381,5
Category_Wikipedia_sockpuppets_of_Mgstaggers.csv,974,417909371.0,276,698,271,5,0,51.92505133470226,255,55,17.04517453798768,6
Category_Wikipedia_sockpuppets_of_CharmenderDeol.csv,5957,75045573.0,2115,3842,499,1616,0,47.96844049017962,494,93,20.21084438475743,5
Category_Wikipedia_sockpuppets_of_Liquad_squad.csv,10,1639619.0,7,3,6,1,0,14.6,134,22,22.0,22
Category_Wikipedia_sockpuppets_of_Mauliknayakofficial.csv,23,15496098.0,5,18,4,1,0,49.34782608695652,122,53,47.43478260869565,21
Category_Wikipedia_sockpuppets_of_Sherlock4000.csv,2601,226234645.0,756,1845,500,256,0,47.75432525951557,258,62,23.08958093041138,3
Category_Wikipedia_sockpuppets_of_Hugo.j.diego.csv,17,18424.0,8,9,8,0,0,22.88235294117647,92,28,14.705882352941176,5
Category_Wikipedia_sockpuppets_of_Vanvet122.csv,40,1808179.0,19,21,16,3,0,49.65,243,24,16.175,1
Category_Wikipedia_sockpuppets_of_Ghoshpreet_singh.csv,255,7399214.0,97,158,66,31,0,54.537254901960786,310,28,13.0,5
Category_Wikipedia_sockpuppets_of_Zeynallƒ±_∆èli.csv,86,5272751.0,29,57,19,10,0,55.94186046511628,228,24,17.930232558139537,10
Category_Wikipedia_sockpuppets_of_JashonCuyler12.csv,129,25344644.0,47,82,17,30,0,41.35658914728682,289,53,29.232558139534884,14
Category_Wikipedia_sockpuppets_of_Chawa618.csv,122,163174.0,54,68,26,28,0,62.368852459016395,260,54,25.131147540983605,3
Category_Wikipedia_sockpuppets_of_BittersweetFools.csv,276,70407728.0,83,193,46,37,0,58.53623188405797,499,52,18.920289855072465,4
Category_Wikipedia_sockpuppets_of_Louisehynes11.csv,30,90450465.0,15,15,13,2,0,64.43333333333334,200,39,14.3,11
Category_Wikipedia_sockpuppets_of_FootballPhil.csv,1398,64388723.0,410,988,242,168,0,38.829041487839774,256,49,17.50429184549356,5
Category_Wikipedia_sockpuppets_of_Hbinu.csv,533,2529260.0,245,288,205,40,0,32.21200750469043,254,45,13.872420262664166,5
Category_Wikipedia_sockpuppets_of_Gago219.csv,135,7230620.0,57,78,25,32,0,15.577777777777778,135,41,21.6,11
Category_Wikipedia_sockpuppets_of_Sunny909sharma.csv,96,167164.0,33,63,13,20,0,71.77083333333333,251,41,18.010416666666668,3
Category_Wikipedia_sockpuppets_of_MichaelDabhi.csv,151,154367160.0,59,92,45,14,0,47.66887417218543,328,28,11.927152317880795,5
Category_Wikipedia_sockpuppets_of_Cartoonzaq.csv,564,22109658.0,120,444,112,8,0,34.248226950354606,217,47,21.622340425531913,8
Category_Wikipedia_sockpuppets_of_SchoolcraftT.csv,1281,42636495.0,508,773,471,37,0,41.92818110850898,204,66,30.324746291959407,16
Category_Wikipedia_sockpuppets_of_Muntuwandi.csv,4162,375810371.0,1293,2869,500,793,0,48.705670350792886,324,96,25.28399807784719,4
Category_Wikipedia_sockpuppets_of_Cdfdf.csv,72,864041.0,23,49,10,13,0,51.111111111111114,293,36,20.76388888888889,8
Category_Wikipedia_sockpuppets_of_Aadolf~enwiki.csv,58,29621636.0,15,43,8,7,0,56.741379310344826,224,39,21.551724137931036,8
Category_Wikipedia_sockpuppets_of_RVFan1930.csv,1154,31458258.0,432,722,336,96,0,35.36915077989602,254,57,31.160311958405547,10
Category_Wikipedia_sockpuppets_of_Alexthetranslator.csv,6,68748.0,4,2,3,1,41,42.333333333333336,49,67,67.0,67
Category_Wikipedia_sockpuppets_of_Emma_1984.csv,121,53844890.0,47,74,15,32,0,34.11570247933884,230,57,17.223140495867767,11
Category_Wikipedia_sockpuppets_of_Russellfarazi.csv,16,306276.0,6,10,5,1,0,66.9375,203,52,29.0625,14
Category_Wikipedia_sockpuppets_of_Drpravinpurecha.csv,110,41461593.0,22,88,16,6,0,23.236363636363638,185,37,11.654545454545454,4
Category_Wikipedia_sockpuppets_of_Punk4orchrist.csv,451,48659939.0,159,292,78,81,0,55.527716186252775,243,47,19.09090909090909,4
Category_Wikipedia_sockpuppets_of_Bhavesh_Nial.csv,23,1383922.0,10,13,6,4,0,40.391304347826086,274,22,18.608695652173914,15
Category_Wikipedia_sockpuppets_of_Fydcinnz.csv,562,26829362.0,186,376,101,85,0,58.49110320284697,255,35,20.128113879003557,10
Category_Wikipedia_sockpuppets_of_Graffix_Gaming.csv,3,291.0,3,0,2,1,0,0.0,0,21,21.0,21
Category_Wikipedia_sockpuppets_of_Rural_Support_Programme_Network.csv,16,270015.0,9,7,5,4,0,12.0625,38,18,17.5625,17
Category_Wikipedia_sockpuppets_of_Klbogart55.csv,3984,64469455.0,1183,2801,469,714,0,36.252510040160644,255,85,22.947289156626507,4
Category_Wikipedia_sockpuppets_of_Higheredutrust.csv,202,36909529.0,84,118,43,41,0,44.20792079207921,245,28,21.737623762376238,17
Category_Wikipedia_sockpuppets_of_Condoritofan2012.csv,1367,29572464.0,466,901,118,348,0,47.7798098024872,389,57,19.578639356254573,5
Category_Wikipedia_sockpuppets_of_JoshuaArcilla2.csv,1608,65500771.0,483,1125,429,54,0,45.440298507462686,394,60,20.282960199004975,4
Category_Wikipedia_sockpuppets_of_JanaKozlovska.csv,1,0.0,1,0,1,0,55,55.0,55,25,25.0,25
Category_Wikipedia_sockpuppets_of_Wisegrandaugher.csv,186,3894507.0,134,52,71,63,0,35.44086021505376,247,40,23.032258064516128,6
Category_Wikipedia_sockpuppets_of_Headstrong_neiva.csv,2206,16223448.0,541,1665,500,41,0,31.774252039891206,222,57,19.52175883952856,3
Category_Wikipedia_sockpuppets_of_Shirshaw64.csv,1,0.0,1,0,1,0,34,34.0,34,21,21.0,21
Category_Wikipedia_sockpuppets_of_Ugochimobi.csv,291,73365634.0,116,175,104,12,0,46.96219931271477,273,51,21.120274914089347,6
Category_Wikipedia_sockpuppets_of_Wwww123123123.csv,102,64178741.0,31,71,31,0,0,37.77450980392157,327,44,32.1078431372549,24
Category_Wikipedia_sockpuppets_of_Anime_Is_The_Worst.csv,13,678441.0,11,2,7,4,5,54.92307692307692,166,28,17.615384615384617,12
Category_Wikipedia_sockpuppets_of_Daveydolphin.csv,112,21994031.0,44,68,30,14,0,38.11607142857143,243,52,31.8125,15
Category_Wikipedia_sockpuppets_of_Btw_Santhosh.csv,196,39150662.0,70,126,15,55,0,45.42857142857143,283,53,18.76530612244898,9
Category_Wikipedia_sockpuppets_of_GroundRisk.csv,1103,46978257.0,431,672,158,273,0,40.5131459655485,255,95,20.926563916591114,5
Category_Wikipedia_sockpuppets_of_MarkMysoe.csv,10086,177194115.0,3208,6878,500,2708,0,39.65774340670236,267,70,16.20582986317668,3
Category_Wikipedia_sockpuppets_of_Freecomwireless.csv,40,9516814.0,15,25,8,7,0,65.3,200,38,21.3,7
Category_Wikipedia_sockpuppets_of_RedBoyLI.csv,308,22806806.0,103,205,49,54,0,57.11363636363637,255,32,13.707792207792208,10
Category_Wikipedia_sockpuppets_of_Ediewilbur1982.csv,38,975703.0,13,25,7,6,0,52.026315789473685,223,25,15.105263157894736,11
Category_Wikipedia_sockpuppets_of_Em_fontes.csv,51,5088.0,23,28,21,2,0,50.13725490196079,210,28,17.176470588235293,10
Category_Wikipedia_sockpuppets_of_SameStruggle.csv,1100,425264441.0,466,634,428,38,0,47.64909090909091,317,42,14.963636363636363,4
Category_Wikipedia_sockpuppets_of_HassanHussainOfficial.csv,398,58155039.0,124,274,33,91,0,56.163316582914575,482,53,27.467336683417084,8
Category_Wikipedia_sockpuppets_of_GeraldFord1980.csv,1047,384949941.0,257,790,51,206,0,51.350525310410696,301,72,18.378223495702006,5
Category_Wikipedia_sockpuppets_of_Andreharrell.csv,75,15425709.0,24,51,24,0,0,40.78666666666667,211,30,17.8,10
Category_Wikipedia_sockpuppets_of_Penguinnumbers.csv,3402,181291714.0,1336,2066,500,836,0,41.27395649617872,500,42,14.486478542034098,4
Category_Wikipedia_sockpuppets_of_Iwritegoodarticles.csv,2,350213.0,2,0,1,1,4,4.0,4,23,23.0,23
Category_Wikipedia_sockpuppets_of_Amitkumarkhare.csv,109,450473.0,61,48,48,13,0,28.38532110091743,199,29,11.302752293577981,4
Category_Wikipedia_sockpuppets_of_Harry_weasley.csv,391,48275839.0,108,283,104,4,0,36.1381074168798,216,42,14.734015345268542,6
Category_Wikipedia_sockpuppets_of_Starstarstar123.csv,1399,42524250.0,516,883,246,270,0,32.75839885632595,255,54,23.792709077912797,8
Category_Wikipedia_sockpuppets_of_2211nb.csv,44,860160.0,15,29,13,2,0,57.95454545454545,232,33,12.886363636363637,7
Category_Wikipedia_sockpuppets_of_DaEnforcer.csv,141,1775658.0,44,97,9,35,0,35.5886524822695,188,49,20.76595744680851,9
Category_Wikipedia_sockpuppets_of_Hotrocks.csv,203,10056499.0,48,155,21,27,0,26.832512315270936,174,68,22.54679802955665,5
Category_Wikipedia_sockpuppets_of_Kev519.csv,2103,51693649.0,777,1326,500,277,0,38.080361388492626,394,95,32.2529719448407,4
Category_Wikipedia_sockpuppets_of_Livedhumor22.csv,104,2407603.0,39,65,35,4,0,54.10576923076923,229,25,13.576923076923077,9
Category_Wikipedia_sockpuppets_of_Hclaricejohnson.csv,307,118449628.0,90,217,74,16,0,45.42345276872964,258,35,17.449511400651467,6
Category_Wikipedia_sockpuppets_of_Mr_vili.csv,1554,69967974.0,649,905,500,149,0,49.53217503217503,496,91,28.162805662805663,3
Category_Wikipedia_sockpuppets_of_Jonathan12698m.csv,24,56586.0,8,16,8,0,0,55.25,129,53,23.125,8
Category_Wikipedia_sockpuppets_of_Pokista02.csv,2104,12473389.0,748,1356,437,311,0,28.51045627376426,272,60,20.65494296577947,4
Category_Wikipedia_sockpuppets_of_CSG_Marcomm.csv,11,364611.0,7,4,6,1,0,59.90909090909091,315,21,15.272727272727273,12
Category_Wikipedia_sockpuppets_of_Neha_Sharma7.csv,135,19517798.0,38,97,29,9,0,37.629629629629626,278,26,14.666666666666666,7
Category_Wikipedia_sockpuppets_of_Chasze.csv,17,527172.0,8,9,4,4,13,53.64705882352941,171,24,18.470588235294116,11
Category_Wikipedia_sockpuppets_of_Knight_Crawler_X.csv,411,7423850.0,184,227,107,77,0,64.0705596107056,200,47,20.625304136253042,12
Category_Wikipedia_sockpuppets_of_Russell_Lieber.csv,55,10776566.0,18,37,8,10,0,68.03636363636363,485,49,20.818181818181817,11
Category_Wikipedia_sockpuppets_of_Wikiladderravi.csv,36,12972.0,13,23,8,5,0,53.72222222222222,225,21,11.11111111111111,8
Category_Wikipedia_sockpuppets_of_Rajputbhatti.csv,31061,353963354.0,7534,23527,500,7034,0,49.848588261807414,500,58,14.499404397797882,3
Category_Wikipedia_sockpuppets_of_61602_Peoria_Peoriasphian.csv,68,735157.0,33,35,12,21,0,57.794117647058826,244,24,15.367647058823529,9
Category_Wikipedia_sockpuppets_of_SAADGT.csv,693,53074671.0,153,540,149,4,0,52.25252525252525,255,38,20.075036075036074,3
Category_Wikipedia_sockpuppets_of_ChrisSisley.csv,1,0.0,1,0,1,0,0,0.0,0,8,8.0,8
Category_Wikipedia_sockpuppets_of_Usdavidmartin.csv,48,4399337.0,18,30,6,12,0,57.958333333333336,315,37,15.208333333333334,7
Category_Wikipedia_sockpuppets_of_Hunterkok.csv,1025,62034077.0,396,629,390,6,0,38.15707317073171,250,51,24.92292682926829,3
Category_Wikipedia_sockpuppets_of_Possibility1.csv,27,2456856.0,9,18,8,1,7,51.370370370370374,229,35,20.74074074074074,6
Category_Wikipedia_sockpuppets_of_John_Foxe.csv,3189,490631692.0,1000,2189,500,500,0,57.43179680150517,409,54,18.965506428347446,4
Category_Wikipedia_sockpuppets_of_Relly_Komaruzaman.csv,2733,334295057.0,652,2081,500,152,0,45.37102085620197,489,61,15.01353823637029,2
Category_Wikipedia_sockpuppets_of_Flesek.csv,520,97036248.0,187,333,185,2,0,58.68076923076923,499,34,13.007692307692308,5
Category_Wikipedia_sockpuppets_of_Lilk846.csv,2704,209013285.0,959,1745,500,459,0,37.31434911242604,255,68,16.66826923076923,4
Category_Wikipedia_sockpuppets_of_Amfithea.csv,7934,122771074.0,2923,5011,500,2423,0,45.235946559112676,500,73,17.552810688177463,3
Category_Wikipedia_sockpuppets_of_Wmfy.csv,71,35085244.0,27,44,24,3,0,65.16901408450704,229,42,24.464788732394368,4
Category_Wikipedia_sockpuppets_of_PapayaMan.csv,42,104995.0,21,21,8,13,0,19.571428571428573,126,15,13.80952380952381,10
Category_Wikipedia_sockpuppets_of_Bcmh.csv,1255,553384736.0,432,823,429,3,0,62.51155378486056,499,57,25.673306772908365,5
Category_Wikipedia_sockpuppets_of_Dominicvai.csv,235,2475974.0,79,156,34,45,0,56.182978723404254,289,59,20.574468085106382,8
Category_Wikipedia_sockpuppets_of_Matthewmgtow222.csv,138,865039.0,73,65,43,30,0,44.072463768115945,219,25,17.18840579710145,12
Category_Wikipedia_sockpuppets_of_Dorinavona.csv,192,5681686.0,66,126,40,26,0,27.25,244,67,26.677083333333332,6
Category_Wikipedia_sockpuppets_of_Chaodeknoi.csv,2493,92855571.0,938,1555,500,438,0,34.311271560369036,255,61,29.069795427196148,6
Category_Wikipedia_sockpuppets_of_Jokeshow.csv,29,536354.0,7,22,4,3,0,47.62068965517241,195,24,21.24137931034483,19
Category_Wikipedia_sockpuppets_of_Jameswhatson.csv,54,744156.0,20,34,5,15,0,62.592592592592595,199,28,16.074074074074073,13
Category_Wikipedia_sockpuppets_of_Certundas.csv,12,177911.0,4,8,3,1,0,26.083333333333332,145,28,22.833333333333332,11
Category_Wikipedia_sockpuppets_of_The_Train_Master.csv,2315,183600055.0,564,1751,285,279,0,41.512742980561555,367,53,21.3585313174946,4
Category_Wikipedia_sockpuppets_of_MascotGuyMascotGuy.csv,9,2875.0,5,4,5,0,0,28.555555555555557,107,9,6.555555555555555,5
Category_Wikipedia_sockpuppets_of_Ahmed_aldola.csv,115,197184272.0,35,80,32,3,0,49.02608695652174,239,42,18.965217391304346,10
Category_Wikipedia_sockpuppets_of_Drakemarshall555.csv,85,1830419.0,28,57,16,12,0,54.04705882352941,158,30,20.176470588235293,17
Category_Wikipedia_sockpuppets_of_Gloriousrevolution.csv,2557,158535903.0,956,1601,409,547,0,45.279233476730546,255,57,20.341024638247948,3
Category_Wikipedia_sockpuppets_of_AndrewBasumatary.csv,2028,147745516.0,1349,679,433,916,0,27.597140039447734,302,60,14.821005917159763,6
Category_Wikipedia_sockpuppets_of_Lemon.public.csv,5572,29178604.0,2007,3565,500,1507,0,36.00538406317301,496,47,16.84493898061737,4
Category_Wikipedia_sockpuppets_of_8digits.csv,2108,62900907.0,515,1593,498,17,0,60.8842504743833,250,93,17.272770398481974,4
Category_Wikipedia_sockpuppets_of_Avilla1-1norwich27oct2012.csv,22,355794.0,9,13,5,4,0,41.63636363636363,126,56,27.772727272727273,10
Category_Wikipedia_sockpuppets_of_Williams_taylor.csv,128,6385700.0,33,95,16,17,0,54.5234375,237,36,16.171875,5
Category_Wikipedia_sockpuppets_of_Truebluetwisp.csv,32,109252590.0,10,22,7,3,0,33.78125,135,27,18.3125,4
Category_Wikipedia_sockpuppets_of_Objective33.csv,167,84320008.0,61,106,58,3,0,45.15568862275449,250,31,18.91616766467066,10
Category_Wikipedia_sockpuppets_of_Kendobs.csv,202,1595532.0,69,133,65,4,0,51.06930693069307,196,40,17.628712871287128,8
Category_Wikipedia_sockpuppets_of_Safoyan.csv,1,0.0,1,0,1,0,1,1.0,1,12,12.0,12
Category_Wikipedia_sockpuppets_of_BBN_Chuck.csv,185,296904777.0,63,122,40,23,0,42.83783783783784,242,37,23.356756756756756,4
Category_Wikipedia_sockpuppets_of_Gunvanta.csv,73,2839268.0,37,36,35,2,0,38.273972602739725,260,16,8.917808219178083,6
Category_Wikipedia_sockpuppets_of_Fmtee12.csv,2,43486.0,2,0,2,0,0,0.0,0,21,21.0,21
Category_Wikipedia_sockpuppets_of_JackJillGallaibh.csv,94,26221294.0,44,50,31,13,0,43.87234042553192,250,28,19.382978723404257,11
Category_Wikipedia_sockpuppets_of_Getnetabebe.csv,118,28580181.0,48,70,36,12,0,51.483050847457626,243,51,24.347457627118644,15
Category_Wikipedia_sockpuppets_of_Mcluke180.csv,1298,12199200.0,490,808,228,262,0,43.048536209553156,240,42,14.158705701078583,4
Category_Wikipedia_sockpuppets_of_Jojojohnson2.csv,3708,144316923.0,988,2720,67,921,0,52.32416396979504,254,82,14.119741100323624,3
Category_Wikipedia_sockpuppets_of_Drillians.csv,305,67248500.0,61,244,23,38,0,41.20655737704918,250,55,22.59016393442623,8
Category_Wikipedia_sockpuppets_of_New_Editor_121.csv,151,22771858.0,58,93,7,51,0,45.33112582781457,249,40,19.423841059602648,6
Category_Wikipedia_sockpuppets_of_Leandrokillers.csv,1815,24787448.0,1118,697,500,618,0,25.593939393939394,248,54,26.93608815426997,10
Category_Wikipedia_sockpuppets_of_Pamela_Abalu.csv,101,1580068.0,50,51,25,25,0,41.28712871287129,196,26,16.594059405940595,9
Category_Wikipedia_sockpuppets_of_Ipadm.csv,195,150393130.0,63,132,62,1,0,50.48717948717949,254,57,21.446153846153845,7
Category_Wikipedia_sockpuppets_of_New_baba.csv,47,16153487.0,13,34,10,3,0,52.91489361702128,197,58,22.148936170212767,8
Category_Wikipedia_sockpuppets_of_Ashkalaan.csv,75,203808449.0,32,43,20,12,0,44.46666666666667,208,31,20.786666666666665,9
Category_Wikipedia_sockpuppets_of_Fuquit.csv,154,2073872.0,44,110,39,5,0,43.09090909090909,199,37,14.785714285714286,6
Category_Wikipedia_sockpuppets_of_Kyliechambers99.csv,1241,15909224.0,507,734,500,7,0,39.409347300564065,255,67,34.92103142626914,5
Category_Wikipedia_sockpuppets_of_Wiki_Raja.csv,1950,347125036.0,790,1160,500,290,0,39.30358974358975,255,73,22.688205128205126,5
Category_Wikipedia_sockpuppets_of_SaveUnisQueens.csv,6,161392.0,4,2,2,2,22,111.66666666666667,258,17,17.0,17
Category_Wikipedia_sockpuppets_of_BugMenn.csv,1381,214460448.0,506,875,500,6,0,41.34902244750181,296,69,21.379435191889936,6
Category_Wikipedia_sockpuppets_of_Chensiyuan.csv,1171,37910186.0,550,621,500,50,0,36.11357813834329,496,69,21.90862510674637,6
Category_Wikipedia_sockpuppets_of_JanolovLindgren.csv,6,120833.0,4,2,4,0,14,53.333333333333336,145,33,30.5,28
Category_Wikipedia_sockpuppets_of_Ikekansas.csv,24,29878.0,12,12,6,6,0,45.541666666666664,228,9,7.083333333333333,4
Category_Wikipedia_sockpuppets_of_Jayemd.csv,1600,30300552.0,510,1090,500,10,0,46.0125,247,59,21.261875,5
Category_Wikipedia_sockpuppets_of_Trishamalford.csv,122,17203906.0,37,85,29,8,0,53.704918032786885,451,47,19.65573770491803,8
Category_Wikipedia_sockpuppets_of_Davenbelle.csv,19920,336407912.0,6351,13569,500,5851,0,45.24708835341365,258,101,21.953263052208836,3
Category_Wikipedia_sockpuppets_of_Nebuchadnezzer56.csv,27,334388.0,14,13,5,9,0,32.888888888888886,227,29,13.518518518518519,10
Category_Wikipedia_sockpuppets_of_Shilo_communcations_inc.csv,8,24001290.0,6,2,3,3,0,11.75,51,4,4.0,4
Category_Wikipedia_sockpuppets_of_Cwat2.csv,511,333234622.0,181,330,152,29,0,53.94716242661448,249,44,19.665362035225048,7
Category_Wikipedia_sockpuppets_of_Rick570.csv,3311,54857783.0,1474,1837,500,974,0,39.86741165810933,255,81,24.02204771972214,4
Category_Wikipedia_sockpuppets_of_HarryJohnson1964.csv,3,10670.0,2,1,1,1,41,86.33333333333333,160,13,13.0,13
Category_Wikipedia_sockpuppets_of_Johnjoecavanagh.csv,391,38490642.0,125,266,57,68,0,49.767263427109974,250,65,29.066496163682864,7
Category_Wikipedia_sockpuppets_of_Pallster.csv,305,9330206.0,81,224,36,45,0,51.74426229508197,355,76,25.57377049180328,5
Category_Wikipedia_sockpuppets_of_Ierierie.csv,348,15089031.0,183,165,168,15,0,37.189655172413794,254,54,24.75287356321839,11
Category_Wikipedia_sockpuppets_of_Surfer-boy94.csv,2167,40667310.0,822,1345,500,322,0,29.128749423165665,215,81,22.461005999077067,4
Category_Wikipedia_sockpuppets_of_HaterOf.csv,21,2682137.0,8,13,4,4,0,48.0,214,47,31.428571428571427,17
Category_Wikipedia_sockpuppets_of_Amirharbo.csv,195,24797361.0,54,141,27,27,0,44.06666666666667,232,53,20.184615384615384,7
Category_Wikipedia_sockpuppets_of_Kennethcooke213.csv,267,35829040.0,85,182,46,39,0,36.655430711610485,236,61,16.636704119850187,5
Category_Wikipedia_sockpuppets_of_Arun_verma_khator.csv,63,604558.0,27,36,15,12,0,59.492063492063494,248,53,25.317460317460316,4
Category_Wikipedia_sockpuppets_of_Hannahji2003.csv,89,14179472.0,20,69,16,4,0,54.71910112359551,200,17,8.07865168539326,4
Category_Wikipedia_sockpuppets_of_Chaseline.csv,18,1290.0,8,10,4,4,0,63.166666666666664,220,45,38.94444444444444,21
Category_Wikipedia_sockpuppets_of_Flamingoflorida.csv,1601,1019326.0,539,1062,500,39,0,45.579013116801995,255,53,20.084322298563396,9
Category_Wikipedia_sockpuppets_of_Lfeza.csv,1278,25813488.0,474,804,45,429,0,39.14945226917058,345,56,26.0962441314554,10
Category_Wikipedia_sockpuppets_of_Pizzafan300.csv,548,59026990.0,176,372,125,51,0,60.52372262773723,444,48,21.233576642335766,6
Category_Wikipedia_sockpuppets_of_Md.a.sattar.official.csv,26,792770.0,18,8,10,8,0,41.23076923076923,188,30,26.807692307692307,17
Category_Wikipedia_sockpuppets_of_Spanishdictionary.csv,6,170993.0,2,4,1,1,0,42.666666666666664,176,15,15.0,15
Category_Wikipedia_sockpuppets_of_Lee_Nysted.csv,961,474632137.0,364,597,176,188,0,45.75234131113424,289,67,27.189386056191466,3
Category_Wikipedia_sockpuppets_of_Michael_Friedrich.csv,780,80953331.0,218,562,98,120,0,31.157692307692308,210,40,12.973076923076922,2
Category_Wikipedia_sockpuppets_of_Toronto2028.csv,23,6833023.0,14,9,14,0,0,48.08695652173913,493,45,28.434782608695652,10
Category_Wikipedia_sockpuppets_of_Ankit_yadav_529.csv,22,528044.0,6,16,4,2,0,44.68181818181818,150,53,27.772727272727273,18
Category_Wikipedia_sockpuppets_of_Yearifrasaj.csv,70,7070745.0,36,34,16,20,0,52.82857142857143,326,48,33.6,13
Category_Wikipedia_sockpuppets_of_KingoftheWorld000.csv,4366,88241638.0,1249,3117,500,749,0,62.95945945945946,255,67,22.48625744388456,2
Category_Wikipedia_sockpuppets_of_Nothughthomas.csv,1245,4121772.0,504,741,500,4,0,41.86987951807229,236,77,33.35983935742972,3
Category_Wikipedia_sockpuppets_of_Pretzky.csv,4225,50997153.0,1413,2812,500,913,0,22.487100591715976,226,68,18.0901775147929,3
Category_Wikipedia_sockpuppets_of_Yroneide40221.csv,718,132191003.0,174,544,62,112,0,40.928969359331475,499,72,33.809192200557106,6
Category_Wikipedia_sockpuppets_of_Toma1999!.csv,2103,24972902.0,657,1446,407,250,0,37.205420827389446,462,61,26.59771754636234,5
Category_Wikipedia_sockpuppets_of_Startvector.csv,360,19899167.0,118,242,112,6,0,52.25277777777778,448,51,22.363888888888887,3
Category_Wikipedia_sockpuppets_of_Spanky_pic3.csv,1153,182586424.0,307,846,121,186,0,46.534258456201215,378,95,19.48482220294883,4
Category_Wikipedia_sockpuppets_of_SoyokoAnis.csv,2221,91820369.0,653,1568,500,153,0,66.41107609185052,441,87,21.64655560558307,3
Category_Wikipedia_sockpuppets_of_Juicib.csv,61,3564.0,19,42,13,6,0,57.34426229508197,243,37,21.704918032786885,7
Category_Wikipedia_sockpuppets_of_Sabeeh_butt.csv,2469,18040501.0,974,1495,500,474,0,33.448764682057515,395,57,20.572296476306196,6
Category_Wikipedia_sockpuppets_of_Elliemay46.csv,37,1030200.0,15,22,8,7,0,35.13513513513514,157,43,32.16216216216216,19
Category_Wikipedia_sockpuppets_of_Johncena453.csv,82,78805511.0,23,59,13,10,0,61.292682926829265,213,27,14.365853658536585,10
Category_Wikipedia_sockpuppets_of_Mondolkiri1.csv,3276,34113625.0,1153,2123,500,653,0,52.89468864468864,255,68,21.02930402930403,4
Category_Wikipedia_sockpuppets_of_Syrianview.csv,1063,28604711.0,495,568,310,185,0,36.86077140169332,255,58,17.552210724365004,4
Category_Wikipedia_sockpuppets_of_Scudo_Lives_Once.csv,54,32551744.0,19,35,17,2,0,37.55555555555556,204,40,20.203703703703702,5
Category_Wikipedia_sockpuppets_of_Francescurn.csv,171,3583843.0,76,95,45,31,0,60.85964912280702,313,35,24.128654970760234,8
Category_Wikipedia_sockpuppets_of_MrDingleDaddy.csv,44,10972121.0,18,26,7,11,0,56.27272727272727,203,65,24.977272727272727,13
Category_Wikipedia_sockpuppets_of_Gwenboy.csv,1025,10070508.0,230,795,99,131,0,28.076097560975608,190,38,19.90341463414634,7
Category_Wikipedia_sockpuppets_of_Kishanshetty03.csv,38,6652331.0,18,20,9,9,0,54.10526315789474,197,25,20.57894736842105,17
Category_Wikipedia_sockpuppets_of_BereniceMulubah.csv,4,1966.0,3,1,3,0,14,26.25,49,25,22.5,20
Category_Wikipedia_sockpuppets_of_Tarucha5000.csv,44,3793074.0,16,28,7,9,0,71.18181818181819,497,27,11.522727272727273,8
Category_Wikipedia_sockpuppets_of_Orchomen.csv,10139,232154634.0,2774,7365,455,2319,0,59.42509123187691,500,86,18.32537725613966,1
Category_Wikipedia_sockpuppets_of_Vanrobert99.csv,157,5258423.0,48,109,36,12,0,48.605095541401276,237,24,16.21656050955414,4
Category_Wikipedia_sockpuppets_of_Seth.corcoran.csv,3,302.0,2,1,1,1,0,65.33333333333333,189,14,14.0,14
Category_Wikipedia_sockpuppets_of_Contemporary_aa_writer.csv,33,448047.0,11,22,7,4,0,58.54545454545455,229,52,24.303030303030305,6
Category_Wikipedia_sockpuppets_of_Slartlkt.csv,117,1834133.0,36,81,14,22,0,41.14529914529915,258,55,16.632478632478634,5
Category_Wikipedia_sockpuppets_of_Sandhya2012.csv,1281,99906248.0,512,769,500,12,0,33.69320843091335,376,51,17.511319281811087,6
Category_Wikipedia_sockpuppets_of_El_chulito.csv,1462,1393456.0,535,927,500,35,0,27.658686730506155,204,69,19.899452804377564,7
Category_Wikipedia_sockpuppets_of_Srinandan_rocks.csv,2,0.0,1,1,1,0,195,195.0,195,25,25.0,25
Category_Wikipedia_sockpuppets_of_IamMehrose.csv,116,44200261.0,45,71,45,0,0,49.043103448275865,221,47,14.0,5
Category_Wikipedia_sockpuppets_of_71.171.88.220.csv,19,30011.0,18,1,8,10,0,45.0,119,17,17.0,17
Category_Wikipedia_sockpuppets_of_Ekramul_56.csv,1224,10658891.0,572,652,500,72,0,32.14297385620915,437,49,18.267156862745097,5
Category_Wikipedia_sockpuppets_of_Biscuits101101.csv,22,2121.0,13,9,5,8,0,44.09090909090909,231,15,12.0,8
Category_Wikipedia_sockpuppets_of_Father_of_Mukesh.csv,11,82870.0,7,4,4,3,0,50.81818181818182,125,11,11.0,11
Category_Wikipedia_sockpuppets_of_PoliticalJunkie2006.csv,1080,40183233.0,394,686,387,7,0,52.13333333333333,493,79,36.28703703703704,6
Category_Wikipedia_sockpuppets_of_Bank_of_Wikipedia.csv,215,7142912.0,77,138,75,2,0,35.38604651162791,119,52,20.753488372093024,13
Category_Wikipedia_sockpuppets_of_Soulmwandi.csv,86,7068775.0,37,49,25,12,0,40.63953488372093,206,54,21.906976744186046,7
Category_Wikipedia_sockpuppets_of_Rinty43.csv,199,22845362.0,102,97,84,18,0,33.07537688442211,245,37,16.236180904522612,9
Category_Wikipedia_sockpuppets_of_TheMikol23.csv,73,1642700.0,41,32,26,15,0,48.45205479452055,250,38,23.013698630136986,13
Category_Wikipedia_sockpuppets_of_Jcalag.csv,24,696086.0,14,10,6,8,0,22.875,111,50,28.416666666666668,13
Category_Wikipedia_sockpuppets_of_Royer2356.csv,1436,465827791.0,436,1000,130,306,0,60.07033426183844,255,62,22.135097493036213,3
Category_Wikipedia_sockpuppets_of_EmirKaraman.csv,1649,17776188.0,494,1155,260,234,0,42.123711340206185,233,46,17.231655548817464,4
Category_Wikipedia_sockpuppets_of_Grbfly.csv,5,1268.0,4,1,3,1,17,24.4,30,6,6.0,6
Category_Wikipedia_sockpuppets_of_Jamescool101.csv,215,73425943.0,94,121,71,23,0,51.49302325581395,248,37,19.995348837209303,10
Category_Wikipedia_sockpuppets_of_Sonic2030.csv,437,13892024.0,142,295,53,89,0,61.19679633867277,255,108,23.043478260869566,6
Category_Wikipedia_sockpuppets_of_Andrew5.csv,5712,159446907.0,2040,3672,500,1540,0,57.18452380952381,500,85,26.78063725490196,4
Category_Wikipedia_sockpuppets_of_Zodiakillr.csv,344,18139337.0,75,269,4,71,0,60.89244186046512,317,59,19.802325581395348,6
Category_Wikipedia_sockpuppets_of_Justinhu8.csv,458,61442221.0,99,359,81,18,0,43.786026200873366,248,45,14.344978165938864,3
Category_Wikipedia_sockpuppets_of_Cruks.csv,2880,75711238.0,1000,1880,500,500,0,42.953472222222224,255,54,19.023958333333333,3
Category_Wikipedia_sockpuppets_of_AdmiralKolchak.csv,1614,43690978.0,490,1124,281,209,0,55.15923172242875,253,106,24.473977695167285,3
Category_Wikipedia_sockpuppets_of_Marcinkuzminski.csv,88,158364590.0,22,66,22,0,0,54.22727272727273,242,63,21.852272727272727,3
Category_Wikipedia_sockpuppets_of_Mooters_1563.csv,1213,11218988.0,432,781,318,114,0,60.18301731244848,255,51,18.48062654575433,4
Category_Wikipedia_sockpuppets_of_Mausebru.csv,1574,32897594.0,550,1024,500,50,0,49.50190597204574,500,76,27.786531130876746,6
Category_Wikipedia_sockpuppets_of_A_conceptual_entity.csv,9921,153872755.0,2710,7211,500,2210,0,42.71323455296845,500,83,22.035278701743774,2
Category_Wikipedia_sockpuppets_of_Cheesetree.csv,18,177935.0,10,8,10,0,0,41.0,132,14,12.166666666666666,11
Category_Wikipedia_sockpuppets_of_Ducdatsang12.csv,1379,7958357.0,449,930,405,44,0,35.640319071791154,253,69,15.250181290790428,3
Category_Wikipedia_sockpuppets_of_Duncantash.csv,453,85787118.0,97,356,21,76,0,47.69094922737307,242,41,14.79690949227373,3
Category_Wikipedia_sockpuppets_of_Antovlad1.csv,10,61222.0,5,5,4,1,0,47.8,153,15,9.0,7
Category_Wikipedia_sockpuppets_of_Nigel_tempest.csv,896,6124700.0,330,566,183,147,0,34.276785714285715,250,41,18.912946428571427,9
Category_Wikipedia_sockpuppets_of_Azra_Arda_Gusema.csv,1087,8477193.0,523,564,500,23,0,25.125114995400185,253,51,18.348666053357867,3
Category_Wikipedia_sockpuppets_of_Georgian-patriots.csv,114,8894650.0,62,52,47,15,0,41.31578947368421,237,35,29.36842105263158,15
Category_Wikipedia_sockpuppets_of_Gretab.csv,876,48719936.0,284,592,284,0,0,43.88356164383562,207,53,20.960045662100455,7
Category_Wikipedia_sockpuppets_of_Okoloko.csv,59,71783015.0,14,45,12,2,0,71.0,255,24,9.745762711864407,7
Category_Wikipedia_sockpuppets_of_Adope26.csv,138,3787122.0,51,87,33,18,0,33.905797101449274,274,38,17.094202898550726,10
Category_Wikipedia_sockpuppets_of_Tchatchioff.csv,4,3292886.0,3,1,2,1,8,32.25,64,33,24.0,21
Category_Wikipedia_sockpuppets_of_Jindalpolyfilmsltd.csv,6,18049.0,2,4,1,1,0,55.333333333333336,180,45,39.333333333333336,28
Category_Wikipedia_sockpuppets_of_Hermitstudy.csv,1549,70268347.0,567,982,500,67,0,75.78050355067786,248,49,13.752098127824404,3
Category_Wikipedia_sockpuppets_of_Soso_freak.csv,595,429503290.0,190,405,186,4,0,52.7109243697479,268,55,19.225210084033613,3
Category_Wikipedia_sockpuppets_of_Ohjaypea.csv,28,6236674.0,6,22,6,0,0,69.64285714285714,222,9,7.0,4
Category_Wikipedia_sockpuppets_of_Dtemkin4.csv,26,195690.0,23,3,20,3,0,1.2692307692307692,19,26,11.576923076923077,4
Category_Wikipedia_sockpuppets_of_September911.csv,57,1180188.0,20,37,10,10,0,35.771929824561404,159,30,18.50877192982456,13
Category_Wikipedia_sockpuppets_of_Luisitoalonzo.csv,1793,11748529.0,597,1196,500,97,0,32.07529280535415,255,50,22.029559397657557,7
Category_Wikipedia_sockpuppets_of_Instalok.csv,984,6121138.0,458,526,361,97,0,35.56910569105691,253,46,28.45528455284553,11
Category_Wikipedia_sockpuppets_of_Lobert_jyet.csv,211,1812127.0,58,153,5,53,0,51.66824644549763,243,32,13.777251184834123,5
Category_Wikipedia_sockpuppets_of_BalancedHistorians.csv,40,604698.0,13,27,6,7,0,60.675,198,35,29.9,21
Category_Wikipedia_sockpuppets_of_Taokaka.csv,25941,35773267.0,7406,18535,500,6906,0,60.58660036236074,255,91,29.553409660383178,1
Category_Wikipedia_sockpuppets_of_Objective001.csv,644,29738315.0,145,499,90,55,0,73.29813664596273,500,43,15.096273291925465,6
Category_Wikipedia_sockpuppets_of_Samvalmonte.csv,4,360012.0,3,1,3,0,28,41.75,66,21,19.75,16
Category_Wikipedia_sockpuppets_of_Nightbreed6261.csv,130,769990.0,43,87,37,6,0,68.15384615384616,276,33,8.746153846153845,5
Category_Wikipedia_sockpuppets_of_Sureshkajal.csv,470,264462953.0,170,300,129,41,0,44.295744680851065,255,48,18.848936170212767,8
Category_Wikipedia_sockpuppets_of_Keminet.csv,50,18017.0,31,19,9,22,0,46.04,214,19,13.06,12
Category_Wikipedia_sockpuppets_of_Pradeep276.csv,611,287015462.0,176,435,130,46,0,39.38625204582652,255,50,18.986906710310965,5
Category_Wikipedia_sockpuppets_of_Tamlinwah.csv,3596,83402448.0,1164,2432,500,664,0,36.84538375973304,255,62,18.365962180200224,4
Category_Wikipedia_sockpuppets_of_Lastsearle.csv,321,5213924.0,101,220,13,88,0,69.64174454828661,255,54,27.376947040498443,8
Category_Wikipedia_sockpuppets_of_YYa_dj.csv,3,750.0,2,1,1,1,34,41.333333333333336,45,18,18.0,18
Category_Wikipedia_sockpuppets_of_Depauldem.csv,1560,16689889.0,527,1033,500,27,0,48.16858974358974,255,56,25.741666666666667,6
Category_Wikipedia_sockpuppets_of_Lollipop83380.csv,15,68542.0,3,12,3,0,15,52.733333333333334,101,18,18.0,18
Category_Wikipedia_sockpuppets_of_74.132.151.234.csv,508,1458254.0,188,320,188,0,0,37.70275590551181,229,29,14.411417322834646,4
Category_Wikipedia_sockpuppets_of_Billyatthewheels.csv,1407,8362363.0,500,907,500,0,0,42.828002842928214,391,56,18.566453447050463,4
Category_Wikipedia_sockpuppets_of_MFajarMardiansyah24.csv,673,85610694.0,174,499,55,119,0,49.13670133729569,496,42,14.068350668647845,2
Category_Wikipedia_sockpuppets_of_Markjamesrobertson74.csv,216,67380367.0,101,115,86,15,0,40.3287037037037,229,47,17.75,9
Category_Wikipedia_sockpuppets_of_Itzzveer.csv,13,648527.0,10,3,10,0,0,31.46153846153846,195,31,26.384615384615383,26
Category_Wikipedia_sockpuppets_of_The_Erudite_Philosopher.csv,423,5950165.0,143,280,41,102,0,39.026004728132385,239,42,17.293144208037827,5
Category_Wikipedia_sockpuppets_of_Spt172012.csv,33,302783.0,18,15,15,3,0,57.696969696969695,239,57,24.454545454545453,10
Category_Wikipedia_sockpuppets_of_Unka_10.csv,15,180926.0,7,8,6,1,0,44.93333333333333,157,17,7.4,5
Category_Wikipedia_sockpuppets_of_Zaid_Zayd.csv,5818,26975956.0,2135,3683,496,1639,0,45.74905465795806,496,76,20.004640770024064,1
Category_Wikipedia_sockpuppets_of_Tabbytoxic.csv,1,0.0,1,0,1,0,0,0.0,0,20,20.0,20
Category_Wikipedia_sockpuppets_of_Lawjournals.csv,39,604675.0,10,29,9,1,0,55.76923076923077,189,23,20.205128205128204,18
Category_Wikipedia_sockpuppets_of_Wolfowit.csv,526,10969378.0,115,411,61,54,0,45.09125475285171,212,48,14.5893536121673,6
Category_Wikipedia_sockpuppets_of_ENGLISH_WHELPS.csv,1725,17806653.0,748,977,246,502,0,35.37913043478261,247,48,18.854492753623187,3
Category_Wikipedia_sockpuppets_of_NexcopyUser1.csv,3,7132.0,2,1,1,1,40,83.66666666666667,167,11,11.0,11
Category_Wikipedia_sockpuppets_of_2helloworld123.csv,5,611.0,4,1,2,2,0,39.6,195,15,15.0,15
Category_Wikipedia_sockpuppets_of_Meepsheep.csv,61,22264433.0,23,38,10,13,0,53.08196721311475,199,32,20.901639344262296,13
Category_Wikipedia_sockpuppets_of_Thealirizvi.csv,16,262315443.0,5,11,2,3,0,39.25,116,31,26.9375,18
Category_Wikipedia_sockpuppets_of_Apacherr310.csv,49,192138303.0,21,28,16,5,0,35.38775510204081,459,17,10.714285714285714,10
Category_Wikipedia_sockpuppets_of_Garza_17.csv,572,5046590.0,242,330,223,19,0,42.81818181818182,213,56,12.356643356643357,3
Category_Wikipedia_sockpuppets_of_NomanPK44.csv,2710,130296092.0,805,1905,500,305,0,56.343173431734314,500,103,25.49520295202952,6
Category_Wikipedia_sockpuppets_of_Slideshot.csv,1439,2795977.0,535,904,248,287,0,35.67338429464906,248,41,16.9638637943016,5
Category_Wikipedia_sockpuppets_of_Spencelach.csv,3,252.0,3,0,2,1,22,22.0,22,12,12.0,12
Category_Wikipedia_sockpuppets_of_Pjowenhouse.csv,26,30204.0,14,12,9,5,0,25.076923076923077,150,32,26.346153846153847,16
Category_Wikipedia_sockpuppets_of_Mann_7s.csv,13,6336.0,7,6,6,1,0,20.307692307692307,140,4,4.0,4
Category_Wikipedia_sockpuppets_of_Notfaget.csv,144,6647591.0,45,99,33,12,0,57.96527777777778,246,31,13.5625,4
Category_Wikipedia_sockpuppets_of_JC_Kotisow.csv,960,5461805.0,500,460,500,0,0,34.442708333333336,496,64,22.180208333333333,10
Category_Wikipedia_sockpuppets_of_Pulvis_angelus.csv,525,31696947.0,193,332,115,78,0,22.356190476190477,200,53,15.634285714285713,4
Category_Wikipedia_sockpuppets_of_Poliproofreader.csv,64,114837418.0,23,41,16,7,0,53.25,253,29,19.59375,9
Category_Wikipedia_sockpuppets_of_Wikiproducer123.csv,108,29770065.0,31,77,22,9,0,50.583333333333336,232,39,15.074074074074074,9
Category_Wikipedia_sockpuppets_of_Foxbro69.csv,112,2678797.0,65,47,34,31,0,68.75892857142857,269,49,25.848214285714285,13
Category_Wikipedia_sockpuppets_of_Halal-haram-hallam.csv,1926,31111634.0,621,1305,407,214,0,52.40134994807892,480,75,19.422118380062305,5
Category_Wikipedia_sockpuppets_of_Wikiman122112.csv,1875,80483053.0,526,1349,264,262,0,53.072,500,50,17.875733333333333,7
Category_Wikipedia_sockpuppets_of_Charitydeleiver.h.csv,318,259640240.0,91,227,50,41,0,50.764150943396224,307,52,26.60691823899371,7
Category_Wikipedia_sockpuppets_of_Spamfree007.csv,94,34835234.0,27,67,9,18,0,40.01063829787234,151,53,22.47872340425532,3
Category_Wikipedia_sockpuppets_of_JamikaPolama.csv,2,22.0,2,0,2,0,21,21.0,21,26,26.0,26
Category_Wikipedia_sockpuppets_of_Barryhorne2.csv,30,5231161.0,16,14,13,3,0,33.0,177,24,12.0,9
Category_Wikipedia_sockpuppets_of_The_cheapo.csv,508,8895403.0,146,362,123,23,0,21.391732283464567,220,30,17.818897637795274,10
Category_Wikipedia_sockpuppets_of_Hbsdfsd656fs.csv,14,91676.0,10,4,5,5,0,86.07142857142857,169,39,39.0,39
Category_Wikipedia_sockpuppets_of_Junchow.csv,14,2301521.0,4,10,1,3,4,59.285714285714285,129,46,41.857142857142854,17
Category_Wikipedia_sockpuppets_of_Krish990.csv,713,12804857.0,256,457,195,61,0,29.225806451612904,499,47,22.223001402524545,5
Category_Wikipedia_sockpuppets_of_Koraent.csv,130,5786741.0,67,63,37,30,0,31.084615384615386,194,53,15.892307692307693,5
Category_Wikipedia_sockpuppets_of_Helentopia.csv,22,12770762.0,6,16,4,2,0,48.22727272727273,199,22,13.909090909090908,7
Category_Wikipedia_sockpuppets_of_Jawad_ali_comando.csv,76,126761214.0,27,49,9,18,0,34.60526315789474,194,30,12.039473684210526,4
Category_Wikipedia_sockpuppets_of_Aapkadayaram.csv,14,1296774.0,6,8,3,3,0,39.357142857142854,123,56,39.642857142857146,22
Category_Wikipedia_sockpuppets_of_Deloop82.csv,3385,181878452.0,735,2650,500,235,0,51.16632200886263,484,53,19.507237813884785,4
Category_Wikipedia_sockpuppets_of_Triplicatio.csv,80,34273418.0,43,37,31,12,0,64.4375,224,27,14.7375,8
Category_Wikipedia_sockpuppets_of_Duhamel6666.csv,1,0.0,1,0,1,0,0,0.0,0,10,10.0,10
Category_Wikipedia_sockpuppets_of_Destinyseeker89.csv,6513,124747674.0,2152,4361,500,1652,0,70.18869952402886,500,62,21.85306310456011,3
Category_Wikipedia_sockpuppets_of_Bowjangles.csv,111,4771479.0,42,69,17,25,0,50.252252252252255,250,38,19.945945945945947,12
Category_Wikipedia_sockpuppets_of_EE_Researcher.csv,219,5831337.0,55,164,45,10,0,69.5296803652968,247,34,14.926940639269406,2
Category_Wikipedia_sockpuppets_of_Cordelia_Hasanah.csv,962,21396595.0,339,623,156,183,0,38.437629937629936,278,34,13.47920997920998,4
Category_Wikipedia_sockpuppets_of_Dr_Karl_fan.csv,64,1955082.0,22,42,6,16,0,53.875,183,35,20.6875,16
Category_Wikipedia_sockpuppets_of_RajaRajan_Tamilian.csv,950,28492795.0,329,621,146,183,0,45.42842105263158,255,47,20.549473684210525,3
Category_Wikipedia_sockpuppets_of_Tren_Ligero_GDL.csv,1236,33352951.0,592,644,500,92,0,29.99757281553398,241,63,27.820388349514563,6
Category_Wikipedia_sockpuppets_of_Philip_Dauzi_Diegbegha.csv,16,21246139.0,4,12,2,2,0,71.5,159,33,30.25,28
Category_Wikipedia_sockpuppets_of_Crisis.csv,1963,309656396.0,511,1452,500,11,0,55.84921039225675,376,93,22.423841059602648,4
"Category_Wikipedia_sockpuppets_of_Olusola_David,_Ayibiowu.csv",79,27347975.0,34,45,18,16,0,56.79746835443038,255,63,34.9746835443038,6
Category_Wikipedia_sockpuppets_of_Persononthinternet.csv,4638,27750748.0,1422,3216,500,922,0,65.33527382492454,476,68,21.709788702026735,3
Category_Wikipedia_sockpuppets_of_Mumbaipsytrance.csv,1280,89082744.0,399,881,303,96,0,44.99453125,499,48,22.79296875,6
Category_Wikipedia_sockpuppets_of_Hermahgerd.csv,230,4614184.0,146,84,92,54,0,52.54347826086956,254,32,22.121739130434783,19
Category_Wikipedia_sockpuppets_of_Rockiban.csv,7,100823881.0,7,0,6,1,0,27.428571428571427,164,13,13.0,13
Category_Wikipedia_sockpuppets_of_Wikipediatrix.csv,2428,33417694.0,766,1662,500,266,0,40.560131795716636,255,86,26.756177924217464,4
Category_Wikipedia_sockpuppets_of_Jess_Coppola.csv,517,18418169.0,155,362,119,36,0,50.91876208897485,287,53,18.433268858800773,5
Category_Wikipedia_sockpuppets_of_Wigeshjupityu.csv,63,2552054.0,18,45,14,4,0,38.41269841269841,114,49,32.44444444444444,14
Category_Wikipedia_sockpuppets_of_Leugen9001.csv,439,3113423.0,169,270,63,106,0,47.829157175398635,245,46,15.902050113895216,6
Category_Wikipedia_sockpuppets_of_Amoruso.csv,2966,205504965.0,803,2163,500,303,0,50.61935266351989,255,56,20.80310182063385,4
Category_Wikipedia_sockpuppets_of_Doorshair1.csv,83,172425.0,19,64,15,4,0,11.265060240963855,197,22,17.349397590361445,17
Category_Wikipedia_sockpuppets_of_Harlowraman.csv,299,23485178.0,74,225,74,0,0,39.39464882943144,182,67,30.65551839464883,5
Category_Wikipedia_sockpuppets_of_ThatAboriginalKid.csv,91,30086403.0,28,63,25,3,0,53.604395604395606,211,47,29.395604395604394,7
Category_Wikipedia_sockpuppets_of_Elazardo.csv,25,4326189.0,11,14,11,0,0,37.08,186,55,35.88,14
Category_Wikipedia_sockpuppets_of_Reedabplanalpcowan.csv,107,107508655.0,48,59,19,29,0,55.299065420560744,247,28,11.69158878504673,10
Category_Wikipedia_sockpuppets_of_Sonashaskew.csv,111,1039612.0,68,43,66,2,0,36.747747747747745,226,26,12.504504504504505,6
Category_Wikipedia_sockpuppets_of_Its_Guddu_Chauhan.csv,375,3856477.0,138,237,125,13,0,44.328,500,32,15.128,5
Category_Wikipedia_sockpuppets_of_David7756.csv,27,498205.0,26,1,15,11,0,19.0,200,14,14.0,14
Category_Wikipedia_sockpuppets_of_Kandathil.csv,151,140493789.0,43,108,28,15,0,45.70860927152318,199,19,13.139072847682119,9
Category_Wikipedia_sockpuppets_of_Ftindia.csv,31,22117.0,16,15,16,0,0,22.419354838709676,136,26,18.903225806451612,9
Category_Wikipedia_sockpuppets_of_Lautner_of_the_king.csv,198,80044197.0,75,123,36,39,0,51.0,241,38,19.02020202020202,7
Category_Wikipedia_sockpuppets_of_Wizboyll51.csv,174,8861090.0,58,116,52,6,0,36.747126436781606,198,53,14.718390804597702,7
Category_Wikipedia_sockpuppets_of_Fighterforfreedom.csv,310,38935953.0,88,222,22,66,0,35.38709677419355,249,47,30.48709677419355,11
Category_Wikipedia_sockpuppets_of_Rajputro.nagaland.csv,1974,75867519.0,730,1244,374,356,0,51.09219858156028,500,58,21.121580547112462,6
Category_Wikipedia_sockpuppets_of_Mrg3105.csv,3601,220395224.0,995,2606,500,495,0,49.06831435712302,255,80,23.422660372118855,3
Category_Wikipedia_sockpuppets_of_Abnodfashcefdarf.csv,401,1307582.0,123,278,68,55,0,43.63092269326683,222,47,20.32418952618454,6
Category_Wikipedia_sockpuppets_of_Bottlepop123.csv,21,205876.0,6,15,4,2,0,16.285714285714285,151,44,24.0,13
Category_Wikipedia_sockpuppets_of_Seraborum.csv,100,42290187.0,27,73,22,5,0,61.24,254,62,19.49,5
Category_Wikipedia_sockpuppets_of_TyMega.csv,11355,145138996.0,3577,7778,500,3077,0,35.689211800968735,497,62,16.27203874944958,5
Category_Wikipedia_sockpuppets_of_161darts161darts.csv,1254,10551684.0,424,830,249,175,0,40.66108452950558,255,72,26.525518341307816,3
Category_Wikipedia_sockpuppets_of_Thisisthebestusername!.csv,1384,2064410.0,322,1062,277,45,0,20.778179190751445,228,58,19.01950867052023,3
Category_Wikipedia_sockpuppets_of_Ofthepeace.csv,32,775698.0,21,11,13,8,0,76.3125,227,14,12.75,6
Category_Wikipedia_sockpuppets_of_IuliBal.csv,214,3027604.0,65,149,12,53,0,65.49532710280374,240,35,15.602803738317757,5
Category_Wikipedia_sockpuppets_of_GeniusHistory.csv,28,360319.0,12,16,11,1,0,77.53571428571429,383,23,15.785714285714286,9
Category_Wikipedia_sockpuppets_of_Koskidzrules1.csv,36,2842441.0,23,13,21,2,0,49.138888888888886,119,27,22.694444444444443,22
Category_Wikipedia_sockpuppets_of_Carrot_tops.csv,44,1977652.0,14,30,7,7,0,71.9090909090909,203,24,10.386363636363637,4
Category_Wikipedia_sockpuppets_of_84.64.15.181.csv,23,13237.0,6,17,6,0,0,26.695652173913043,135,28,13.08695652173913,3
Category_Wikipedia_sockpuppets_of_Tonks_of_iCommP.csv,95,9778832.0,70,25,64,6,0,48.305263157894736,229,26,25.91578947368421,25
Category_Wikipedia_sockpuppets_of_Paul_Gibson1971.csv,321,27981589.0,131,190,112,19,0,25.258566978193148,239,51,20.74454828660436,6
Category_Wikipedia_sockpuppets_of_Ryn78.csv,6336,296810482.0,1654,4682,500,1154,0,67.44681186868686,500,93,21.28188131313131,4
Category_Wikipedia_sockpuppets_of_Zerva.csv,392,61955272.0,126,266,77,49,0,61.82397959183673,334,58,17.380102040816325,4
Category_Wikipedia_sockpuppets_of_Lsdjfhkjsb.csv,798,27657847.0,282,516,248,34,0,42.67042606516291,216,57,22.37719298245614,4
Category_Wikipedia_sockpuppets_of_BallaratClarendonCollegeIsTheBest.csv,8,1564.0,5,3,4,1,0,80.375,207,26,26.0,26
Category_Wikipedia_sockpuppets_of_Martin_karu.csv,25,332392.0,9,16,9,0,0,45.16,152,53,29.72,17
Category_Wikipedia_sockpuppets_of_LimabeanAdrianalima.csv,18,3518019.0,6,12,4,2,0,38.111111111111114,172,33,32.05555555555556,30
Category_Wikipedia_sockpuppets_of_Dasithawagmee1.csv,55,4534815.0,27,28,19,8,0,31.563636363636363,196,27,19.363636363636363,17
Category_Wikipedia_sockpuppets_of_Sulavxettri.csv,1612,30534602.0,515,1097,270,245,0,38.61786600496278,496,64,20.949751861042184,6
Category_Wikipedia_sockpuppets_of_LegendStopper.csv,443,8848963.0,124,319,54,70,0,18.873589164785553,167,24,12.474040632054177,8
Category_Wikipedia_sockpuppets_of_Lpcyu.csv,68,12110330.0,24,44,16,8,0,64.1029411764706,218,62,29.544117647058822,8
Category_Wikipedia_sockpuppets_of_CAPSasia.csv,21,943873.0,19,2,17,2,0,9.714285714285714,78,18,12.285714285714286,12
Category_Wikipedia_sockpuppets_of_Jamerutl.csv,353,15036177.0,128,225,66,62,0,72.06798866855524,254,44,20.339943342776206,11
Category_Wikipedia_sockpuppets_of_ManiSahota.csv,177,2594636.0,40,137,15,25,0,61.293785310734464,228,44,17.096045197740114,5
Category_Wikipedia_sockpuppets_of_Florentino_floro.csv,4815,168368393.0,1082,3733,500,582,0,43.61786085150571,255,67,19.012045690550362,3
Category_Wikipedia_sockpuppets_of_HardeepSaluja.csv,163,7511973.0,77,86,64,13,0,54.736196319018404,262,23,13.533742331288343,6
Category_Wikipedia_sockpuppets_of_Herbert_McCallum.csv,422,19889914.0,160,262,23,137,0,56.24881516587678,254,54,18.53791469194313,4
Category_Wikipedia_sockpuppets_of_TotalBrainrot.csv,6,119574.0,3,3,3,0,0,71.5,208,26,24.0,20
Category_Wikipedia_sockpuppets_of_Mattclifford.csv,14,2310.0,10,4,6,4,0,14.642857142857142,89,37,28.142857142857142,18
Category_Wikipedia_sockpuppets_of_Jorfo.csv,118,6210796.0,50,68,22,28,0,36.49152542372882,224,20,16.983050847457626,10
Category_Wikipedia_sockpuppets_of_Jimitesh.csv,487,4612305.0,238,249,174,64,0,44.03901437371663,278,52,30.683778234086244,8
Category_Wikipedia_sockpuppets_of_Kalra_Vishaw.csv,794,27518316.0,294,500,277,17,0,36.159949622166245,243,48,17.505037783375315,5
Category_Wikipedia_sockpuppets_of_Munshi_Jam.csv,94,24713553.0,36,58,20,16,0,55.1063829787234,255,40,20.872340425531913,10
Category_Wikipedia_sockpuppets_of_Atulask.csv,506,62824902.0,126,380,104,22,0,47.12252964426877,288,52,23.140316205533598,3
Category_Wikipedia_sockpuppets_of_Katai.rabbit.csv,152,2209489.0,50,102,8,42,0,35.11184210526316,226,38,21.710526315789473,5
Category_Wikipedia_sockpuppets_of_Nick_John_User.csv,209,1469977.0,69,140,19,50,0,51.933014354066984,495,67,18.976076555023923,7
Category_Wikipedia_sockpuppets_of_Kumasojin_ÁÜäË•≤.csv,858,14219000.0,255,603,156,99,0,49.82867132867133,255,59,17.576923076923077,4
Category_Wikipedia_sockpuppets_of_Radheshariaofficial.csv,139,91662907.0,29,110,11,18,0,53.302158273381295,255,53,25.66906474820144,14
Category_Wikipedia_sockpuppets_of_Jimlantabanao.csv,5880,311821894.0,2052,3828,500,1552,0,42.7,506,62,13.516836734693877,4
Category_Wikipedia_sockpuppets_of_Efefwefwef.csv,7,525338.0,6,1,4,2,0,13.428571428571429,41,31,31.0,31
Category_Wikipedia_sockpuppets_of_Bgenocchio.csv,134,184631498.0,58,76,30,28,0,47.850746268656714,248,42,17.91044776119403,6
Category_Wikipedia_sockpuppets_of_Beckjord.csv,1325,44227064.0,519,806,500,19,0,37.2022641509434,200,47,17.30264150943396,7
Category_Wikipedia_sockpuppets_of_Mollymiller.csv,725,206834974.0,180,545,155,25,0,59.17793103448276,500,76,20.260689655172413,5
Category_Wikipedia_sockpuppets_of_Askme11.csv,475,288017638.0,132,343,126,6,0,36.63157894736842,255,38,23.73894736842105,7
Category_Wikipedia_sockpuppets_of_Sarah_jamison.csv,27,654983.0,12,15,9,3,0,35.925925925925924,127,23,15.407407407407407,13
Category_Wikipedia_sockpuppets_of_Sadman_Sakibzz.csv,1162,1462377.0,525,637,500,25,0,37.68330464716007,255,65,25.1592082616179,5
Category_Wikipedia_sockpuppets_of_SpencerTarrence7981.csv,36,4134519.0,21,15,15,6,0,42.30555555555556,208,22,16.444444444444443,10
Category_Wikipedia_sockpuppets_of_Flipper98.csv,12,11624256.0,10,2,7,3,0,84.91666666666667,122,21,21.0,21
Category_Wikipedia_sockpuppets_of_Fairness_And_Accuracy_For_All.csv,2843,16558462.0,1000,1843,500,500,0,39.8325712275765,208,91,32.02427013717904,7
Category_Wikipedia_sockpuppets_of_ItsBrey.csv,365,159010077.0,102,263,100,2,0,52.51780821917808,250,36,15.956164383561644,4
Category_Wikipedia_sockpuppets_of_Tehsilmailsi.csv,107,3962111.0,82,25,69,13,0,20.429906542056074,229,22,8.16822429906542,6
Category_Wikipedia_sockpuppets_of_HUngryhippo17.csv,462,4754949.0,183,279,84,99,0,49.50865800865801,421,53,18.586580086580085,5
Category_Wikipedia_sockpuppets_of_Mathemagician57721.csv,378,3831509.0,120,258,51,69,0,47.576719576719576,250,54,26.677248677248677,4
Category_Wikipedia_sockpuppets_of_GustavoReinoso7777.csv,215,38976705.0,108,107,78,30,0,40.544186046511626,225,28,16.106976744186046,7
Category_Wikipedia_sockpuppets_of_Mattoonafish.csv,22,4256.0,8,14,6,2,0,65.04545454545455,171,44,19.40909090909091,10
Category_Wikipedia_sockpuppets_of_Cchiera.csv,85,215661513.0,48,37,45,3,0,35.95294117647059,231,23,12.611764705882353,6
Category_Wikipedia_sockpuppets_of_Steve_Franker.csv,782,35059954.0,207,575,163,44,0,42.9002557544757,324,43,12.808184143222507,5
Category_Wikipedia_sockpuppets_of_Kmaguir1.csv,1616,118329170.0,595,1021,500,95,0,35.464727722772274,250,105,29.558168316831683,4
Category_Wikipedia_sockpuppets_of_MIna1230.csv,25,3834401.0,11,14,2,9,0,198.0,499,22,18.72,17
Category_Wikipedia_sockpuppets_of_Schavhanke.csv,202,230217191.0,81,121,72,9,0,34.0990099009901,229,30,19.97029702970297,10
Category_Wikipedia_sockpuppets_of_IPhonehurricane95.csv,6461,215261202.0,2492,3969,500,1992,0,49.086983439096116,255,59,23.54078316050147,4
Category_Wikipedia_sockpuppets_of_Frankish_101.csv,2598,7701280.0,931,1667,500,431,0,42.9072363356428,499,57,26.413394919168592,4
"Category_Wikipedia_sockpuppets_of_Bienvenido_Bones_Banez,_Jr..csv",196,173001462.0,66,130,30,36,0,47.03061224489796,215,80,45.96938775510204,15
Category_Wikipedia_sockpuppets_of_Vira_ghandi.csv,50,61852029.0,23,27,13,10,0,33.34,273,47,15.56,11
Category_Wikipedia_sockpuppets_of_AbdullahYakub772.csv,751,23742895.0,224,527,135,89,0,46.00133155792277,500,53,27.504660452729695,6
Category_Wikipedia_sockpuppets_of_Ugochukwu75.csv,1505,8260318.0,525,980,500,25,0,30.327574750830564,354,53,16.222591362126245,6
Category_Wikipedia_sockpuppets_of_Manse_cool.csv,13,2515.0,9,4,8,1,0,24.384615384615383,56,12,12.0,12
Category_Wikipedia_sockpuppets_of_Inumwanews24.csv,34,2967244.0,12,22,7,5,0,73.6470588235294,496,25,12.735294117647058,4
Category_Wikipedia_sockpuppets_of_Quacking.csv,858,1829605.0,304,554,77,227,0,49.44755244755245,212,57,19.361305361305362,4
Category_Wikipedia_sockpuppets_of_Max_roosevelt.csv,519,372198293.0,219,300,176,43,0,59.287090558766856,295,69,19.886319845857418,5
Category_Wikipedia_sockpuppets_of_NoThanks.csv,18,5771750.0,11,7,7,4,0,16.77777777777778,92,57,48.0,30
Category_Wikipedia_sockpuppets_of_NecrozmaSpin.csv,1259,4056346.0,377,882,223,154,0,59.215250198570295,254,54,25.212867355043684,4
Category_Wikipedia_sockpuppets_of_Karamellpudding1999.csv,2234,222139871.0,504,1730,498,6,0,48.449865711727846,496,62,22.470008952551478,4
Category_Wikipedia_sockpuppets_of_Bowei_Huang_2.csv,3817,141076977.0,1051,2766,500,551,0,47.47419439350275,255,65,20.569033272203303,3
Category_Wikipedia_sockpuppets_of_ChitranshYasharth896.csv,277,768009.0,134,143,62,72,0,43.22382671480145,300,56,27.830324909747294,7
Category_Wikipedia_sockpuppets_of_Sregor_Ylloj.csv,37,1374362.0,12,25,11,1,7,44.16216216216216,128,41,21.783783783783782,7
Category_Wikipedia_sockpuppets_of_JamesOredan.csv,6366,169442968.0,1674,4692,500,1174,0,57.77348413446434,500,66,18.133993088281496,4
Category_Wikipedia_sockpuppets_of_Estradadarwin29.csv,1734,41185199.0,576,1158,387,189,0,35.8881199538639,496,59,17.426758938869664,3
Category_Wikipedia_sockpuppets_of_OsmanRF34.csv,2090,88714213.0,522,1568,500,22,0,50.26172248803828,253,44,32.27464114832536,7
Category_Wikipedia_sockpuppets_of_Sforshanu.csv,1,0.0,1,0,1,0,28,28.0,28,19,19.0,19
Category_Wikipedia_sockpuppets_of_Joeidaho.csv,1250,60501821.0,344,906,165,179,0,44.1712,219,54,15.6792,9
Category_Wikipedia_sockpuppets_of_Roc19892005.csv,66,3776664.0,23,43,22,1,0,29.515151515151516,166,53,24.53030303030303,8
Category_Wikipedia_sockpuppets_of_Nelsonndc.csv,98,2777316.0,60,38,49,11,0,33.95918367346939,496,37,22.377551020408163,15
Category_Wikipedia_sockpuppets_of_KingFreshmagz.csv,17,13097302.0,6,11,3,3,6,100.76470588235294,196,30,14.235294117647058,6
Category_Wikipedia_sockpuppets_of_Bi_sokhan.csv,3,36208279.0,2,1,1,1,34,44.0,49,20,16.0,14
Category_Wikipedia_sockpuppets_of_Jb423.csv,2958,6849612.0,976,1982,500,476,0,33.1000676132522,248,60,17.157538877620013,3
Category_Wikipedia_sockpuppets_of_JediJeremy.csv,134,33637.0,89,45,71,18,0,36.440298507462686,199,36,23.865671641791046,20
Category_Wikipedia_sockpuppets_of_BarbieFilmLover.csv,1194,136664436.0,410,784,171,239,0,42.438860971524285,496,60,21.778056951423785,6
Category_Wikipedia_sockpuppets_of_Fungusandfurball.csv,4002,75313927.0,1868,2134,500,1368,0,33.063468265867066,353,65,25.87881059470265,10
Category_Wikipedia_sockpuppets_of_I-10.csv,1268,711101.0,500,768,500,0,0,37.27444794952682,250,54,23.426656151419557,7
Category_Wikipedia_sockpuppets_of_Ariana_Williscroft.csv,1018,161147642.0,321,697,223,98,0,56.32121807465619,500,54,21.31139489194499,5
Category_Wikipedia_sockpuppets_of_Charito2000.csv,782,286136141.0,197,585,63,134,0,46.831202046035806,300,53,16.685421994884912,4
Category_Wikipedia_sockpuppets_of_Deekafinate.csv,77,9884594.0,20,57,13,7,0,55.532467532467535,208,38,20.25974025974026,8
Category_Wikipedia_sockpuppets_of_Jklmnopr.csv,254,148424760.0,108,146,101,7,0,45.58267716535433,254,35,19.255905511811022,8
Category_Wikipedia_sockpuppets_of_CeRcVa13.csv,568,9834309.0,216,352,113,103,0,38.875,477,29,13.922535211267606,5
Category_Wikipedia_sockpuppets_of_Itstrinidii14.csv,8,300.0,5,3,3,2,0,58.625,192,11,11.0,11
Category_Wikipedia_sockpuppets_of_Ilokon.csv,19,7586988.0,4,15,2,2,0,26.157894736842106,89,77,35.89473684210526,19
Category_Wikipedia_sockpuppets_of_Thikkamasala.csv,18,1122510.0,12,6,11,1,0,18.61111111111111,94,22,11.833333333333334,4
Category_Wikipedia_sockpuppets_of_Get4abhi.csv,6,1241.0,4,2,2,2,0,27.833333333333332,106,18,18.0,18
Category_Wikipedia_sockpuppets_of_Abc-wtf-def.csv,1262,17020056.0,565,697,500,65,0,45.253565768621236,255,45,21.259112519809825,12
Category_Wikipedia_sockpuppets_of_Asif_Altaf_Khan.csv,71,15095170.0,31,40,20,11,0,42.80281690140845,225,38,15.464788732394366,9
Category_Wikipedia_sockpuppets_of_Ragus28.csv,2,2182.0,2,0,2,0,0,0.0,0,45,45.0,45
Category_Wikipedia_sockpuppets_of_DorsetTiger.csv,1700,73945933.0,632,1068,500,132,0,39.69352941176471,340,39,19.358823529411765,3
Category_Wikipedia_sockpuppets_of_JammyKH.csv,133,1433725.0,104,29,85,19,0,27.1203007518797,171,48,19.24812030075188,12
Category_Wikipedia_sockpuppets_of_Spliff_Joint_Blunt.csv,1549,3737828.0,577,972,500,77,0,54.10845706907682,255,67,29.072304712717884,4
Category_Wikipedia_sockpuppets_of_Kulvir97.csv,101,177267.0,39,62,35,4,0,39.742574257425744,249,23,14.584158415841584,4
Category_Wikipedia_sockpuppets_of_Wikisam125.csv,108,60634.0,31,77,16,15,0,42.72222222222222,223,30,14.027777777777779,6
Category_Wikipedia_sockpuppets_of_Nof9.csv,161,333024.0,63,98,35,28,0,57.142857142857146,253,47,26.48447204968944,9
Category_Wikipedia_sockpuppets_of_Dani_de_santa.csv,1039,270604967.0,509,530,500,9,0,36.25312800769971,496,26,15.452358036573628,8
Category_Wikipedia_sockpuppets_of_Mesact.csv,143,3457849.0,48,95,29,19,0,31.195804195804197,199,60,18.783216783216783,5
Category_Wikipedia_sockpuppets_of_Sexyking54321.csv,60,5435987.0,51,9,48,3,0,24.383333333333333,199,23,22.85,20
Category_Wikipedia_sockpuppets_of_Jamesallen2.csv,953,360227114.0,450,503,439,11,0,36.59601259181532,376,44,14.48373557187828,8
Category_Wikipedia_sockpuppets_of_Flameboy182.csv,712,5814430.0,286,426,194,92,0,34.883426966292134,323,57,27.26685393258427,3
Category_Wikipedia_sockpuppets_of_Cadmus90.csv,2667,27225927.0,899,1768,500,399,0,40.40869891263592,255,61,20.887889013873266,4
Category_Wikipedia_sockpuppets_of_RMHED.csv,2681,105326821.0,889,1792,500,389,0,55.08765386049981,259,121,22.703095859753823,4
Category_Wikipedia_sockpuppets_of_Maude~Duggel.csv,400,12981430.0,157,243,117,40,0,42.305,500,56,24.3775,7
Category_Wikipedia_sockpuppets_of_Barack_obamna_lover.csv,235,48293596.0,66,169,27,39,0,56.774468085106385,348,73,22.663829787234043,4
Category_Wikipedia_sockpuppets_of_Proudbharati.csv,165,168251574.0,45,120,27,18,0,43.68484848484849,202,38,22.36969696969697,5
Category_Wikipedia_sockpuppets_of_Tennisskatinggymnasticsfan.csv,237,772583.0,109,128,36,73,0,47.21518987341772,255,43,23.29535864978903,8
Category_Wikipedia_sockpuppets_of_ShantaePirate.csv,61,2331682.0,31,30,13,18,0,58.42622950819672,173,28,27.508196721311474,23
Category_Wikipedia_sockpuppets_of_Drock1993.csv,41,431175.0,14,27,12,2,0,49.829268292682926,135,31,16.73170731707317,6
Category_Wikipedia_sockpuppets_of_MrDavr.csv,7187,24919127.0,2423,4764,500,1923,0,45.273688604424656,504,46,15.467789063587032,2
Category_Wikipedia_sockpuppets_of_MichaelPWSmith.csv,868,281805651.0,184,684,170,14,0,58.81336405529954,333,39,14.834101382488479,5
Category_Wikipedia_sockpuppets_of_RainbowBambi.csv,1218,44562381.0,356,862,244,112,0,55.039408866995075,304,53,19.79720853858785,4
Category_Wikipedia_sockpuppets_of_MileyFan1990.csv,1035,5924869.0,427,608,76,351,0,48.138164251207726,242,59,15.298550724637682,3
Category_Wikipedia_sockpuppets_of_Thileepanmathivanan.csv,2958,25242539.0,931,2027,144,787,0,37.76943881000676,227,57,18.274509803921568,4
Category_Wikipedia_sockpuppets_of_Herschelkrustofsky.csv,10925,315800070.0,3958,6967,500,3458,0,48.53327231121281,255,82,24.563020594965675,6
Category_Wikipedia_sockpuppets_of_ARA_SANTA_FE.csv,379,57193289.0,84,295,47,37,0,40.675461741424805,334,108,23.65963060686016,7
Category_Wikipedia_sockpuppets_of_Redbranch1984.csv,1929,14907244.0,597,1332,326,271,0,46.354069466044585,255,53,16.153965785381025,3
Category_Wikipedia_sockpuppets_of_AJona1992.csv,1314,437015978.0,527,787,500,27,0,50.10502283105023,496,105,23.345509893455098,6
Category_Wikipedia_sockpuppets_of_SkepticAnonymous.csv,2047,237692921.0,723,1324,500,223,0,61.42452369320957,255,80,27.468978993649245,5
Category_Wikipedia_sockpuppets_of_Rademire.csv,3687,15458123.0,1262,2425,466,796,0,39.94250067805804,248,71,23.966639544344996,7
Category_Wikipedia_sockpuppets_of_Crackhead1945.csv,81,2523926.0,32,49,17,15,0,65.77777777777777,252,49,19.580246913580247,9
Category_Wikipedia_sockpuppets_of_Yemiolutoye.csv,87,144853165.0,31,56,16,15,0,44.60919540229885,194,21,16.885057471264368,13
Category_Wikipedia_sockpuppets_of_BretonAmoux.csv,815,30961865.0,226,589,84,142,0,57.31901840490798,498,61,22.41717791411043,6
Category_Wikipedia_sockpuppets_of_Young_Zaphod.csv,733,34225630.0,290,443,170,120,0,30.46111869031378,200,54,20.002728512960438,3
Category_Wikipedia_sockpuppets_of_CHISM890.csv,170,19462086.0,45,125,4,41,0,59.305882352941175,257,46,14.041176470588235,4
Category_Wikipedia_sockpuppets_of_NGreeley2009.csv,22,828.0,15,7,8,7,0,67.9090909090909,214,26,12.727272727272727,7
Category_Wikipedia_sockpuppets_of_Matwun545.csv,2,83.0,2,0,2,0,17,40.0,63,14,14.0,14
Category_Wikipedia_sockpuppets_of_Dorjeshugden.csv,11,484920.0,5,6,3,2,0,72.54545454545455,190,26,26.0,26
Category_Wikipedia_sockpuppets_of_Testly1004.csv,26,3218420.0,10,16,5,5,0,41.26923076923077,150,30,16.923076923076923,11
Category_Wikipedia_sockpuppets_of_Fallywaky.csv,213,7858419.0,81,132,79,2,0,58.690140845070424,323,45,21.009389671361504,8
Category_Wikipedia_sockpuppets_of_8simran.csv,3,17067.0,3,0,1,2,25,25.0,25,51,51.0,51
Category_Wikipedia_sockpuppets_of_CarloHi.csv,256,19103014.0,64,192,64,0,0,40.078125,219,26,14.04296875,6
Category_Wikipedia_sockpuppets_of_Thomasfilbert.csv,11,3094345.0,8,3,8,0,0,11.181818181818182,36,26,19.636363636363637,13
Category_Wikipedia_sockpuppets_of_GoDrink.csv,3,3474.0,3,0,2,1,7,17.333333333333332,38,22,21.333333333333332,20
Category_Wikipedia_sockpuppets_of_Ktpetersen.csv,3,4655.0,3,0,3,0,46,80.0,103,19,19.0,19
Category_Wikipedia_sockpuppets_of_Malek_alame.csv,42,244715714.0,10,32,7,3,0,47.142857142857146,312,39,14.714285714285714,8
Category_Wikipedia_sockpuppets_of_Zeosurfer.csv,243,1392834.0,81,162,50,31,0,38.83127572016461,172,34,14.555555555555555,4
Category_Wikipedia_sockpuppets_of_James_brown1605.csv,54,712722.0,24,30,12,12,0,30.425925925925927,199,47,23.203703703703702,12
Category_Wikipedia_sockpuppets_of_SheryOfficial.csv,30040,181735441.0,8900,21140,500,8400,0,54.07523302263648,505,71,17.54916777629827,1
Category_Wikipedia_sockpuppets_of_Kunnalgupta.csv,99,2451262.0,40,59,37,3,0,47.97979797979798,300,44,17.0,5
Category_Wikipedia_sockpuppets_of_Nrse.csv,3442,47502020.0,1210,2232,294,916,0,38.02963393375944,255,54,17.068855316676352,5
Category_Wikipedia_sockpuppets_of_Threepoint34.csv,142,11517826.0,36,106,3,33,0,63.38028169014085,348,46,18.507042253521128,4
Category_Wikipedia_sockpuppets_of_Ghost_rider14.csv,181,53672209.0,53,128,52,1,0,45.08839779005525,232,47,21.30939226519337,8
Category_Wikipedia_sockpuppets_of_Eddiep803b.csv,1592,37003047.0,539,1053,237,302,0,35.18090452261306,244,46,20.104899497487438,9
Category_Wikipedia_sockpuppets_of_Mzasloff.csv,167,148851901.0,87,80,70,17,0,36.712574850299404,210,30,14.904191616766466,8
Category_Wikipedia_sockpuppets_of_Rahinthan.csv,20,138853.0,14,6,10,4,0,28.35,144,27,14.25,10
Category_Wikipedia_sockpuppets_of_Mf._von_Karma.csv,999,291640610.0,235,764,163,72,0,41.194194194194196,267,55,24.22122122122122,9
Category_Wikipedia_sockpuppets_of_TI1880.csv,1891,142978407.0,505,1386,500,5,0,49.663670015864625,496,51,15.79111581173982,3
Category_Wikipedia_sockpuppets_of_G16CONSTI.csv,21,1948960.0,21,0,8,13,0,53.80952380952381,196,87,21.61904761904762,11
Category_Wikipedia_sockpuppets_of_Filmingnz.csv,849,147402848.0,273,576,187,86,0,41.74676089517079,271,50,18.28150765606596,4
Category_Wikipedia_sockpuppets_of_John_L._Booth.csv,1014,6147140.0,341,673,207,134,0,48.72879684418146,328,67,18.90138067061144,5
Category_Wikipedia_sockpuppets_of_Politicalnooby.csv,361,25785739.0,95,266,50,45,0,65.81717451523545,408,58,22.1191135734072,7
Category_Wikipedia_sockpuppets_of_Hasanali090.csv,44,17052310.0,15,29,14,1,0,53.79545454545455,298,35,16.09090909090909,5
Category_Wikipedia_sockpuppets_of_MCE-CN.csv,236,1668347.0,74,162,41,33,0,52.38559322033898,255,50,10.961864406779661,4
Category_Wikipedia_sockpuppets_of_ZidarZ.csv,678,3240213.0,267,411,164,103,0,50.87758112094395,388,49,19.567846607669615,6
Category_Wikipedia_sockpuppets_of_Ed.Valdez.csv,440,26168967.0,158,282,104,54,0,55.05909090909091,229,47,14.281818181818181,7
Category_Wikipedia_sockpuppets_of_TheHothead432.csv,375,1821275.0,193,182,167,26,0,29.530666666666665,217,34,24.101333333333333,23
Category_Wikipedia_sockpuppets_of_Lordbilby.csv,176,5840292.0,60,116,55,5,0,36.30681818181818,198,59,20.176136363636363,4
Category_Wikipedia_sockpuppets_of_Standandpoors.csv,7,3581746.0,4,3,3,1,14,104.71428571428571,255,46,37.42857142857143,26
Category_Wikipedia_sockpuppets_of_Hyfufugugufufc.csv,6,676.0,5,1,5,0,4,24.666666666666668,128,20,20.0,20
Category_Wikipedia_sockpuppets_of_Shrikanthv.csv,1774,376908058.0,504,1270,500,4,0,56.91262683201804,327,96,17.12739571589628,4
Category_Wikipedia_sockpuppets_of_JohnWilkinson.csv,213,228660248.0,49,164,36,13,0,56.671361502347416,338,47,22.586854460093896,10
Category_Wikipedia_sockpuppets_of_Realwords101.csv,1970,134773949.0,686,1284,500,186,0,37.88223350253807,228,38,13.232994923857868,5
Category_Wikipedia_sockpuppets_of_ItsLife1.csv,763,2917575.0,255,508,251,4,0,50.34862385321101,494,76,20.283093053735257,4
Category_Wikipedia_sockpuppets_of_Nintendofan5000.csv,399,25559877.0,103,296,61,42,0,46.659147869674186,226,40,14.824561403508772,5
Category_Wikipedia_sockpuppets_of_Rishad_Talukdar.csv,312,31745687.0,100,212,47,53,0,38.131410256410255,356,91,28.51923076923077,6
Category_Wikipedia_sockpuppets_of_Zurich00swiss.csv,2923,152007449.0,849,2074,500,349,0,38.4960656859391,255,61,24.618542593226138,6
Category_Wikipedia_sockpuppets_of_San_De_Paola.csv,6,2554.0,3,3,2,1,0,81.16666666666667,234,12,12.0,12
Category_Wikipedia_sockpuppets_of_MosheReuven.csv,45,17401394.0,17,28,12,5,0,54.13333333333333,242,27,16.42222222222222,9
Category_Wikipedia_sockpuppets_of_Ramprakash1000.csv,688,4845130.0,198,490,133,65,0,62.5625,499,51,16.47093023255814,5
Category_Wikipedia_sockpuppets_of_Canofortrix.csv,29,616143.0,13,16,12,1,0,67.44827586206897,146,50,39.689655172413794,21
Category_Wikipedia_sockpuppets_of_DontSpreadMisinformationGuys.csv,949,11188340.0,513,436,308,205,0,55.09905163329821,496,64,21.125395152792414,4
Category_Wikipedia_sockpuppets_of_Moestown.csv,515,143065483.0,191,324,60,131,0,46.033009708737865,255,46,17.679611650485437,4
Category_Wikipedia_sockpuppets_of_Paulwalked.csv,121,1182712.0,35,86,24,11,0,54.71900826446281,255,37,22.65289256198347,9
Category_Wikipedia_sockpuppets_of_Mharvey23.csv,7,4008.0,5,2,3,2,0,73.28571428571429,199,40,12.571428571428571,8
Category_Wikipedia_sockpuppets_of_Ariella_Sinclaire.csv,170,1039154.0,140,30,131,9,0,10.24705882352941,161,25,21.070588235294117,11
Category_Wikipedia_sockpuppets_of_VeronicaPR.csv,8298,428023326.0,2342,5956,500,1842,0,45.57266811279826,399,60,16.797541576283443,3
Category_Wikipedia_sockpuppets_of_Rruz1986.csv,1028,20655247.0,388,640,385,3,0,35.14494163424124,225,83,24.17898832684825,2
Category_Wikipedia_sockpuppets_of_Fayyazg.csv,9,41475.0,4,5,2,2,0,56.111111111111114,137,33,25.22222222222222,13
Category_Wikipedia_sockpuppets_of_Lkinartain.csv,75,14817614.0,47,28,45,2,0,42.32,218,45,19.893333333333334,7
Category_Wikipedia_sockpuppets_of_JohnT122.csv,436,88039344.0,123,313,117,6,0,45.71330275229358,254,59,27.03669724770642,3
Category_Wikipedia_sockpuppets_of_Blappo.csv,195,11709388.0,77,118,77,0,0,46.3948717948718,216,22,16.943589743589744,8
Category_Wikipedia_sockpuppets_of_CallanGrey1972.csv,113,229445427.0,37,76,19,18,0,54.92035398230089,199,65,20.76991150442478,5
Category_Wikipedia_sockpuppets_of_-Ilhador-.csv,5386,183726140.0,1622,3764,500,1122,0,39.135907909394724,255,77,19.889157073895284,2
Category_Wikipedia_sockpuppets_of_Zeus856.csv,4,583.0,3,1,2,1,2,56.0,174,14,14.0,14
Category_Wikipedia_sockpuppets_of_Jointomission.csv,122,74115807.0,29,93,16,13,0,42.17213114754098,232,73,21.639344262295083,8
Category_Wikipedia_sockpuppets_of_Sporcler_10.csv,558,9164459.0,181,377,148,33,0,49.23297491039426,249,83,26.732974910394265,7
Category_Wikipedia_sockpuppets_of_Emmanuel_okon269.csv,168,3969152.0,57,111,57,0,0,49.916666666666664,301,48,12.797619047619047,5
Category_Wikipedia_sockpuppets_of_Rajmaan.csv,1250,65910590.0,407,843,174,233,0,41.4672,490,54,16.2968,4
Category_Wikipedia_sockpuppets_of_Impossible_Project.csv,297,60568085.0,88,209,88,0,0,70.10774410774411,419,49,19.47138047138047,3
Category_Wikipedia_sockpuppets_of_David_Arriela.csv,26,23492150.0,10,16,4,6,0,39.15384615384615,138,53,45.92307692307692,23
Category_Wikipedia_sockpuppets_of_TheWatchtowerIsLyingToYou.csv,149,312978.0,67,82,20,47,0,74.51006711409396,230,51,28.838926174496645,13
Category_Wikipedia_sockpuppets_of_Unicatt's_puppets.csv,24,32378.0,13,11,13,0,0,13.708333333333334,83,56,34.458333333333336,6
Category_Wikipedia_sockpuppets_of_Daisymendylover1976.csv,44,20885829.0,16,28,9,7,0,56.70454545454545,254,29,21.636363636363637,16
Category_Wikipedia_sockpuppets_of_Victory93.csv,2647,107998929.0,682,1965,500,182,0,40.53683415187004,263,63,21.39743105402342,6
Category_Wikipedia_sockpuppets_of_Peter_R_LS_2_SK_COK.csv,4,144.0,2,2,2,0,28,112.0,196,24,24.0,24
Category_Wikipedia_sockpuppets_of_Norman304.csv,91,18829915.0,56,35,26,30,0,23.45054945054945,207,53,23.64835164835165,15
Category_Wikipedia_sockpuppets_of_Veinakh.csv,308,1961220.0,124,184,23,101,0,71.55194805194805,437,47,19.9025974025974,8
Category_Wikipedia_sockpuppets_of_Pedantisch.csv,19,19317929.0,10,9,5,5,0,172.21052631578948,418,16,11.526315789473685,11
Category_Wikipedia_sockpuppets_of_Kaulimona.csv,961,124753577.0,347,614,60,287,0,42.14880332986473,500,46,17.556711758584807,5
Category_Wikipedia_sockpuppets_of_Darkness2005.csv,12281,135277193.0,3431,8850,500,2931,0,31.863854734956437,248,79,22.812555980783323,4
Category_Wikipedia_sockpuppets_of_Renamed_user_9845238491.csv,647,8987688.0,222,425,134,88,0,55.12982998454405,422,59,20.43740340030912,6
Category_Wikipedia_sockpuppets_of_FuturePil()t.csv,2299,24600351.0,575,1724,500,75,0,46.498912570682904,250,66,20.137016093953893,3
Category_Wikipedia_sockpuppets_of_Doreenmoore2222.csv,68,1661417.0,38,30,19,19,0,51.39705882352941,246,25,19.352941176470587,13
Category_Wikipedia_sockpuppets_of_Graciekwillie.csv,217,2422615.0,115,102,67,48,0,45.91244239631337,245,36,15.654377880184331,4
Category_Wikipedia_sockpuppets_of_Pptt226.csv,3221,34431458.0,1265,1956,500,765,0,39.53244334057746,438,61,18.284073269171063,2
Category_Wikipedia_sockpuppets_of_Afrodizifunk3.csv,73,581609.0,31,42,29,2,0,58.50684931506849,190,47,34.35616438356164,20
Category_Wikipedia_sockpuppets_of_Thesciencenewsonline.csv,72,10528604.0,29,43,25,4,0,77.69444444444444,386,33,15.819444444444445,6
Category_Wikipedia_sockpuppets_of_Sponge20.csv,105,7443865.0,21,84,10,11,0,41.06666666666667,233,39,24.552380952380954,10
Category_Wikipedia_sockpuppets_of_Ednas.csv,155,1151856.0,65,90,63,2,0,40.348387096774196,194,47,21.490322580645163,12
Category_Wikipedia_sockpuppets_of_Raj0216.csv,45,145626187.0,10,35,10,0,0,50.422222222222224,172,30,14.066666666666666,9
Category_Wikipedia_sockpuppets_of_Deredneck_Acorah.csv,54,294989.0,18,36,7,11,0,50.24074074074074,193,54,21.27777777777778,7
Category_Wikipedia_sockpuppets_of_Tiny_Dancer_48.csv,702,16095433.0,284,418,264,20,0,54.62108262108262,255,50,32.12678062678063,4
Category_Wikipedia_sockpuppets_of_ChrisBlankC.csv,1441,65446368.0,571,870,500,71,0,35.996530187369885,260,46,20.024288688410827,6
Category_Wikipedia_sockpuppets_of_AsIGooglePackupYaBagsInUrOldSkin.csv,379,7154473.0,105,274,72,33,0,51.11873350923483,238,84,22.556728232189975,5
Category_Wikipedia_sockpuppets_of_HurricaneResearcher.csv,318,2831780.0,122,196,113,9,0,58.90251572327044,345,50,25.069182389937108,5
Category_Wikipedia_sockpuppets_of_Harut111.csv,1284,258892960.0,505,779,500,5,0,45.324766355140184,496,88,23.0404984423676,4
Category_Wikipedia_sockpuppets_of_Scientus.csv,3189,212184483.0,672,2517,500,172,0,54.602383192223265,255,59,15.35434305424898,3
Category_Wikipedia_sockpuppets_of_Reycool83.csv,52,109406.0,36,16,36,0,0,22.5,199,36,26.21153846153846,10
Category_Wikipedia_sockpuppets_of_Kenjimayo.csv,72,502615.0,53,19,50,3,0,30.51388888888889,184,25,19.15277777777778,12
Category_Wikipedia_sockpuppets_of_4elopuck.csv,422,7091096.0,254,168,190,64,0,35.725118483412324,500,47,14.654028436018958,4
Category_Wikipedia_sockpuppets_of_Lomerezco.csv,232,119135531.0,74,158,26,48,0,65.65517241379311,241,38,11.538793103448276,7
Category_Wikipedia_sockpuppets_of_MARTIN_TIERNEY_SOCCER.csv,18,3533870.0,8,10,4,4,0,78.38888888888889,217,31,21.055555555555557,18
Category_Wikipedia_sockpuppets_of_Virginia48.csv,1629,75165928.0,439,1190,260,179,0,50.920196439533456,370,77,16.986494782074892,4
Category_Wikipedia_sockpuppets_of_Rushmi.csv,474,13142479.0,172,302,109,63,0,35.0042194092827,203,61,23.371308016877638,4
Category_Wikipedia_sockpuppets_of_Marandalaw59.csv,99,529929.0,20,79,14,6,0,41.0,199,38,33.55555555555556,19
Category_Wikipedia_sockpuppets_of_Creative_raymark.csv,676,33099213.0,192,484,44,148,0,30.80325443786982,235,48,20.727810650887573,5
Category_Wikipedia_sockpuppets_of_Histoire2020.csv,1769,119570262.0,632,1137,338,294,0,48.714527981910685,255,84,18.245336348219332,5
Category_Wikipedia_sockpuppets_of_Whittardofchelsea.csv,10,633977.0,5,5,3,2,6,47.1,142,36,26.5,18
Category_Wikipedia_sockpuppets_of_Obedium.csv,470,42081142.0,166,304,166,0,0,44.58510638297872,250,41,16.687234042553193,10
Category_Wikipedia_sockpuppets_of_Wudumindif.csv,1284,70654810.0,345,939,310,35,0,52.322429906542055,255,82,18.32943925233645,6
Category_Wikipedia_sockpuppets_of_Global_fanatics.csv,71,1379536.0,19,52,10,9,0,42.38028169014085,258,43,21.140845070422536,6
Category_Wikipedia_sockpuppets_of_Krystalgreat.csv,868,37963162.0,320,548,156,164,0,46.91244239631337,496,44,14.773041474654377,4
Category_Wikipedia_sockpuppets_of_112qw34er.csv,3770,4881383.0,1120,2650,500,620,0,36.91538461538462,334,70,23.838726790450927,3
Category_Wikipedia_sockpuppets_of_Analia_Smith.csv,47,6402903.0,16,31,12,4,0,45.0,196,23,15.702127659574469,3
Category_Wikipedia_sockpuppets_of_Action1212.csv,233,12716732.0,97,136,22,75,0,54.64377682403433,255,54,18.334763948497855,7
Category_Wikipedia_sockpuppets_of_Cocap31.csv,270,26289601.0,99,171,43,56,0,51.477777777777774,500,65,18.22222222222222,10
Category_Wikipedia_sockpuppets_of_Anandnaik7196.csv,1,0.0,1,0,1,0,196,196.0,196,28,28.0,28
Category_Wikipedia_sockpuppets_of_Separesh.csv,1883,73504778.0,621,1262,182,439,0,35.71322357939458,226,76,15.67020711630377,4
Category_Wikipedia_sockpuppets_of_Mouse001.csv,805,10299784.0,308,497,156,152,0,62.72298136645963,255,58,29.973913043478262,8
Category_Wikipedia_sockpuppets_of_Pegorex.csv,18,2396549.0,6,12,4,2,0,78.22222222222223,220,38,35.5,29
Category_Wikipedia_sockpuppets_of_YOGENDRA_PRATAP_SINGH_ARCHAEOLOGIST.csv,17,342319.0,9,8,8,1,0,60.588235294117645,229,14,9.588235294117647,9
Category_Wikipedia_sockpuppets_of_Raj_sahu_z.csv,109,11332860.0,41,68,41,0,0,38.981651376146786,206,33,15.174311926605505,5
Category_Wikipedia_sockpuppets_of_Solodev.csv,33,7181739.0,10,23,6,4,0,42.60606060606061,130,53,29.727272727272727,13
Category_Wikipedia_sockpuppets_of_Mirtalebi.official.csv,68,9163033.0,20,48,15,5,0,50.80882352941177,245,33,14.955882352941176,6
Category_Wikipedia_sockpuppets_of_Jolemile.csv,22,7919284.0,10,12,5,5,0,46.04545454545455,208,9,7.818181818181818,7
Category_Wikipedia_sockpuppets_of_Vivekdigital.csv,82,4569683.0,29,53,21,8,0,48.59756097560975,239,31,18.585365853658537,3
Category_Wikipedia_sockpuppets_of_Sunilgaral.csv,685,32052321.0,255,430,219,36,0,32.63503649635037,226,44,16.656934306569344,4
Category_Wikipedia_sockpuppets_of_PenPaper45.csv,211,6180114.0,62,149,23,39,0,43.4218009478673,395,27,16.777251184834125,7
Category_Wikipedia_sockpuppets_of_Nawaz2435.csv,1188,2504219.0,414,774,245,169,0,35.755050505050505,257,47,15.43013468013468,4
Category_Wikipedia_sockpuppets_of_Ohnoitsmetsroc12.csv,5,653.0,2,3,1,1,11,51.4,158,27,24.0,22
Category_Wikipedia_sockpuppets_of_Hamed_Miranii.csv,62,132823.0,47,15,25,22,0,17.274193548387096,261,18,12.193548387096774,11
Category_Wikipedia_sockpuppets_of_Chicken_in_a_bun.csv,240,799930.0,68,172,48,20,0,56.670833333333334,376,63,17.733333333333334,4
Category_Wikipedia_sockpuppets_of_HubdarBrohi.csv,453,79187617.0,185,268,142,43,0,35.317880794701985,243,53,23.147902869757175,3
Category_Wikipedia_sockpuppets_of_Mememax.csv,50,258616478.0,18,32,12,6,0,40.18,179,44,14.08,6
Category_Wikipedia_sockpuppets_of_Fortofolio.csv,96,1451104.0,36,60,17,19,0,46.052083333333336,203,25,16.489583333333332,8
Category_Wikipedia_sockpuppets_of_Bobsbasement.csv,97,3111516.0,41,56,38,3,0,26.79381443298969,149,63,34.52577319587629,10
Category_Wikipedia_sockpuppets_of_Wikidrifterr.csv,2547,28118081.0,613,1934,471,142,0,52.99921476246565,499,61,17.742834707499018,4
Category_Wikipedia_sockpuppets_of_Cretanpride.csv,1524,10051334.0,545,979,192,353,0,29.990813648293962,200,63,23.441601049868765,6
Category_Wikipedia_sockpuppets_of_Ecoboy90.csv,1710,3353959.0,581,1129,500,81,0,39.64093567251462,253,63,15.930994152046784,4
Category_Wikipedia_sockpuppets_of_JRSpencer89.csv,116,18083588.0,60,56,35,25,0,42.94827586206897,217,24,21.637931034482758,6
Category_Wikipedia_sockpuppets_of_Vanessaliam.csv,1136,35327028.0,683,453,500,183,0,39.69278169014085,255,56,20.609154929577464,9
Category_Wikipedia_sockpuppets_of_Abbas888.csv,365,6685120.0,168,197,116,52,0,86.66575342465754,259,45,22.34246575342466,4
Category_Wikipedia_sockpuppets_of_Gary_Bukky.csv,95,1225817.0,51,44,51,0,0,30.53684210526316,168,50,29.13684210526316,20
Category_Wikipedia_sockpuppets_of_Vorspire.csv,263,82119802.0,79,184,48,31,0,40.79467680608365,226,75,20.53231939163498,9
Category_Wikipedia_sockpuppets_of_ManyVersions.csv,355,1061758.0,126,229,50,76,0,50.56901408450704,496,53,22.935211267605634,3
Category_Wikipedia_sockpuppets_of_JamesterDude.csv,36,13940983.0,8,28,5,3,0,38.888888888888886,140,42,30.25,16
Category_Wikipedia_sockpuppets_of_Thestarborn1028.csv,1674,14064271.0,659,1015,500,159,0,30.372759856630825,255,34,22.74611708482676,10
Category_Wikipedia_sockpuppets_of_Richard_Relucio.csv,4577,404533906.0,1604,2973,500,1104,0,40.45641249726896,308,87,19.52829364212366,3
Category_Wikipedia_sockpuppets_of_RICHIErich.csv,156,6875132.0,52,104,33,19,0,55.09615384615385,255,52,17.128205128205128,6
Category_Wikipedia_sockpuppets_of_GTGYEET.csv,18,4368114.0,8,10,4,4,0,54.888888888888886,208,20,9.555555555555555,6
Category_Wikipedia_sockpuppets_of_Martin.musatov.csv,61,1237275.0,30,31,15,15,0,43.131147540983605,198,24,20.704918032786885,11
Category_Wikipedia_sockpuppets_of_Aecws.csv,163,16776913.0,75,88,71,4,0,61.3680981595092,496,53,27.950920245398773,12
Category_Wikipedia_sockpuppets_of_Sdfghjkgh.csv,29,88528.0,9,20,9,0,0,59.10344827586207,196,70,34.58620689655172,10
Category_Wikipedia_sockpuppets_of_Shilpa_Bhawana.csv,34,2431920.0,22,12,16,6,0,31.88235294117647,177,35,28.235294117647058,13
Category_Wikipedia_sockpuppets_of_Puppypaw7.csv,112,8028532.0,42,70,18,24,0,62.526785714285715,247,41,12.5625,3
Category_Wikipedia_sockpuppets_of_Compactembedding.csv,33,196718.0,22,11,16,6,0,20.87878787878788,74,52,24.90909090909091,18
Category_Wikipedia_sockpuppets_of_Fdkjfdsalkjfdsakjl.csv,1283,13576554.0,410,873,174,236,0,41.55650818394388,255,59,26.35385814497272,3
Category_Wikipedia_sockpuppets_of_Ali_Mohammad_Khilji.csv,4164,142099516.0,1652,2512,500,1152,0,38.287223823246876,261,98,23.498799231508166,4
Category_Wikipedia_sockpuppets_of_VJ_Rathod.csv,17,8205599.0,8,9,6,2,0,47.35294117647059,157,44,21.235294117647058,8
Category_Wikipedia_sockpuppets_of_Bruhsmillah.csv,851,21219201.0,243,608,81,162,0,54.071680376028205,502,38,17.300822561692126,3
Category_Wikipedia_sockpuppets_of_Jangorango.csv,101,25063778.0,47,54,46,1,0,45.54455445544554,222,20,11.277227722772277,10
Category_Wikipedia_sockpuppets_of_Talker36912.csv,595,7280315.0,210,385,166,44,0,32.680672268907564,252,56,26.880672268907563,9
Category_Wikipedia_sockpuppets_of_Dopenguins.csv,21274,207388180.0,6387,14887,500,5887,0,41.50474757920466,671,80,18.827770988060543,4
Category_Wikipedia_sockpuppets_of_Lisa_Estrine.csv,95,21640213.0,89,6,73,16,10,31.2,204,22,19.2,17
Category_Wikipedia_sockpuppets_of_Personalattacksonlyaccount.csv,36,437644.0,24,12,24,0,2,44.27777777777778,200,22,19.02777777777778,8
Category_Wikipedia_sockpuppets_of_Annd112.csv,23,2077158.0,19,4,18,1,21,63.08695652173913,134,17,17.0,17
Category_Wikipedia_sockpuppets_of_Rabbijason.csv,236,381526170.0,54,182,53,1,0,46.33474576271186,252,49,19.889830508474578,10
Category_Wikipedia_sockpuppets_of_Thatdollcalledriley.csv,1593,8658239.0,478,1115,453,25,0,47.35718769617075,433,54,14.826114249843064,2
Category_Wikipedia_sockpuppets_of_HindustaniHindu.csv,356,6150772.0,139,217,57,82,0,52.146067415730336,312,51,19.77247191011236,4
Category_Wikipedia_sockpuppets_of_Usman_Farooq.csv,225,194618735.0,45,180,42,3,0,55.24888888888889,247,45,24.653333333333332,5
Category_Wikipedia_sockpuppets_of_Khanshanzan.csv,13,15234.0,7,6,4,3,0,51.38461538461539,149,26,22.153846153846153,16
Category_Wikipedia_sockpuppets_of_Dfasdgjndkja.csv,21,2404.0,16,5,13,3,0,29.285714285714285,154,32,32.0,32
Category_Wikipedia_sockpuppets_of_Aetoss.csv,242,22225667.0,87,155,81,6,0,36.69421487603306,215,39,17.40909090909091,8
Category_Wikipedia_sockpuppets_of_Daniel_Muokebe.csv,201,51960486.0,63,138,54,9,0,47.024875621890544,321,55,22.761194029850746,4
Category_Wikipedia_sockpuppets_of_Kgomzak.csv,643,63448187.0,202,441,133,69,0,34.944012441679625,255,68,21.758942457231726,4
Category_Wikipedia_sockpuppets_of_100110100.csv,1819,12341345.0,565,1254,500,65,0,33.85101704233095,250,60,20.434854315558,3
Category_Wikipedia_sockpuppets_of_Rosedaler.csv,2348,3437273.0,758,1590,500,258,0,61.07708688245315,415,52,17.00681431005111,2
Category_Wikipedia_sockpuppets_of_Shawwal.csv,3975,85318845.0,1354,2621,500,854,0,47.94943396226415,255,63,20.897610062893083,5
Category_Wikipedia_sockpuppets_of_Lotus_L-12.csv,2974,433070303.0,1128,1846,416,712,0,35.63651647612643,282,53,21.684263618022865,3
Category_Wikipedia_sockpuppets_of_Taram.csv,1916,351452063.0,591,1325,500,91,0,59.39457202505219,488,79,19.667536534446764,6
Category_Wikipedia_sockpuppets_of_Paulydee.csv,1227,53402175.0,427,800,276,151,0,47.63732681336593,253,52,22.406682966585166,9
Category_Wikipedia_sockpuppets_of_Praispranav.csv,90,62352657.0,23,67,14,9,0,52.31111111111111,255,49,14.1,8
Category_Wikipedia_sockpuppets_of_Jason_James_Scott.csv,342,92176405.0,236,106,100,136,0,42.15204678362573,225,43,26.67543859649123,10
Category_Wikipedia_sockpuppets_of_Catcreekcitycouncil.csv,4484,214149147.0,1533,2951,283,1250,0,64.69870651204282,255,67,17.409678858162355,1
Category_Wikipedia_sockpuppets_of_Macklevine.csv,1385,236550579.0,505,880,500,5,0,47.772563176895304,374,116,19.665703971119132,3
Category_Wikipedia_sockpuppets_of_Twentyfour-dot-something.csv,442,4358501.0,121,321,100,21,0,52.984162895927604,237,70,20.82579185520362,5
Category_Wikipedia_sockpuppets_of_Vintagekits.csv,5878,164564708.0,1994,3884,500,1494,0,39.91408642395373,255,103,22.177101054780536,5
Category_Wikipedia_sockpuppets_of_Sahadishere.csv,5,9152.0,3,2,3,0,0,33.0,66,21,21.0,21
Category_Wikipedia_sockpuppets_of_Professor_Abdur_Raheem_Kidwai.csv,37,15094357.0,17,20,17,0,0,87.0,214,39,30.675675675675677,20
Category_Wikipedia_sockpuppets_of_IanChris948.csv,43,35006450.0,13,30,11,2,0,74.32558139534883,207,38,22.837209302325583,16
Category_Wikipedia_sockpuppets_of_Aksh_Mondal.csv,2673,34989511.0,716,1957,381,335,0,32.15114104002993,259,41,16.73213617658062,5
Category_Wikipedia_sockpuppets_of_Hacker.or.id.csv,238,3643688.0,96,142,91,5,0,55.247899159663866,232,41,24.95378151260504,14
Category_Wikipedia_sockpuppets_of_Chep40unit.csv,3,68166.0,2,1,1,1,0,10.0,30,25,25.0,25
Category_Wikipedia_sockpuppets_of_Helloidonthaveaname.csv,519,1132943.0,175,344,168,7,0,48.71868978805395,290,57,22.520231213872833,6
Category_Wikipedia_sockpuppets_of_JasonD26.csv,68,641410.0,33,35,20,13,0,47.294117647058826,198,34,21.176470588235293,6
Category_Wikipedia_sockpuppets_of_Lennieteague04.csv,179,26747697.0,47,132,35,12,0,49.608938547486034,255,37,14.603351955307263,7
Category_Wikipedia_sockpuppets_of_Elransfo.csv,127,128607269.0,50,77,39,11,0,48.71653543307087,253,39,11.700787401574804,4
Category_Wikipedia_sockpuppets_of_MohamedHawkar.csv,54,1293612.0,26,28,16,10,0,42.24074074074074,210,44,20.055555555555557,6
Category_Wikipedia_sockpuppets_of_Thabo_Daniels.csv,425,11471156.0,179,246,154,25,0,40.112941176470585,267,60,20.068235294117645,5
Category_Wikipedia_sockpuppets_of_Ayoub.jghalef.csv,156,5037343.0,61,95,55,6,0,49.87179487179487,381,53,18.71153846153846,5
Category_Wikipedia_sockpuppets_of_UnknownPro.csv,481,3450350.0,157,324,146,11,0,49.604989604989605,255,54,21.002079002079004,4
Category_Wikipedia_sockpuppets_of_Arnav108.csv,2498,67968109.0,781,1717,268,513,0,38.64091273018415,500,72,20.309447558046436,2
Category_Wikipedia_sockpuppets_of_Eman52.csv,1354,42433446.0,473,881,300,173,0,41.52954209748892,253,83,23.09231905465288,6
Category_Wikipedia_sockpuppets_of_Im_here_to_do_great_things.csv,109,38907570.0,35,74,14,21,0,43.87155963302752,228,36,22.605504587155963,13
Category_Wikipedia_sockpuppets_of_Protect1835.csv,54,1984631.0,25,29,22,3,0,51.22222222222222,243,25,12.222222222222221,6
Category_Wikipedia_sockpuppets_of_Yfazili.csv,28,73111758.0,20,8,17,3,0,45.785714285714285,218,43,13.0,11
Category_Wikipedia_sockpuppets_of_Techoview.csv,64,21107842.0,19,45,12,7,0,68.328125,275,34,18.296875,8
Category_Wikipedia_sockpuppets_of_Cosialscastells.csv,1218,35045542.0,445,773,240,205,0,38.1871921182266,250,42,20.671592775041052,5
Category_Wikipedia_sockpuppets_of_Intartok.csv,47,5966390.0,17,30,7,10,0,48.659574468085104,159,53,27.21276595744681,15
Category_Wikipedia_sockpuppets_of_Ak_770.csv,1106,101996254.0,399,707,305,94,0,40.896021699819165,424,42,17.41500904159132,5
Category_Wikipedia_sockpuppets_of_Jhedah12.csv,3,128.0,3,0,3,0,0,11.0,19,35,35.0,35
Category_Wikipedia_sockpuppets_of_FlabbyLiam.csv,36,21423161.0,11,25,3,8,0,29.333333333333332,188,50,33.861111111111114,20
Category_Wikipedia_sockpuppets_of_Professor_Henyo.csv,8,24270003.0,5,3,5,0,9,42.75,96,25,23.875,22
Category_Wikipedia_sockpuppets_of_Tethria.csv,22,129608.0,13,9,7,6,0,21.636363636363637,84,42,32.04545454545455,17
Category_Wikipedia_sockpuppets_of_Minombreesjean.csv,1297,87434768.0,536,761,500,36,0,38.78565921356978,255,110,27.61295296838859,6
Category_Wikipedia_sockpuppets_of_Articleandrault.csv,268,60062476.0,100,168,36,64,0,57.05597014925373,255,54,21.257462686567163,5
Category_Wikipedia_sockpuppets_of_Sukriti_maurya.csv,87,599263.0,31,56,22,9,0,58.37931034482759,283,40,17.850574712643677,7
Category_Wikipedia_sockpuppets_of_Soledad22.csv,1395,67222697.0,343,1052,307,36,0,42.074551971326166,208,47,19.60931899641577,4
Category_Wikipedia_sockpuppets_of_Hawalul399.csv,563,9851038.0,188,375,82,106,0,42.83303730017762,496,67,19.21847246891652,8
Category_Wikipedia_sockpuppets_of_Greatgroot.csv,151,52810209.0,42,109,12,30,0,52.13907284768212,500,58,19.62251655629139,9
Category_Wikipedia_sockpuppets_of_Markanthony101.csv,271,3550495.0,97,174,31,66,0,45.99261992619926,237,52,24.136531365313655,4
Category_Wikipedia_sockpuppets_of_Iamsnag12.csv,860,262389975.0,221,639,110,111,0,72.81395348837209,372,77,20.85348837209302,4
Category_Wikipedia_sockpuppets_of_P√≥rokhov.csv,3594,316153913.0,1084,2510,500,584,0,71.21035058430718,496,78,20.697829716193656,2
Category_Wikipedia_sockpuppets_of_UnitedUK.csv,1187,14425210.0,599,588,500,99,0,33.7329401853412,500,54,22.2089300758214,5
Category_Wikipedia_sockpuppets_of_Jadu-op-444.csv,84,1411501.0,46,38,23,23,0,25.738095238095237,160,33,18.571428571428573,13
Category_Wikipedia_sockpuppets_of_Hwhoop56.csv,12,261379.0,9,3,9,0,0,31.916666666666668,120,18,18.0,18
Category_Wikipedia_sockpuppets_of_Paulisw.csv,11,1206122.0,9,2,5,4,0,54.90909090909091,194,21,11.545454545454545,9
Category_Wikipedia_sockpuppets_of_Jalal_police_kharkoo_Lahar.csv,190,3233915.0,82,108,70,12,0,44.5,441,32,13.31578947368421,5
Category_Wikipedia_sockpuppets_of_Zephead999.csv,585,1798583.0,164,421,160,4,0,41.92136752136752,200,34,14.757264957264958,3
Category_Wikipedia_sockpuppets_of_Fatty_black_man.csv,25,40665.0,10,15,8,2,0,63.72,225,27,21.52,13
Category_Wikipedia_sockpuppets_of_Whofan1964.csv,485,41585143.0,114,371,46,68,0,43.94845360824742,254,76,20.424742268041236,8
Category_Wikipedia_sockpuppets_of_Fajkfnjsak.csv,1197,43523160.0,501,696,329,172,0,60.74018379281537,413,51,17.844611528822057,5
Category_Wikipedia_sockpuppets_of_Vhacker_Vicky_kadian.csv,751,106542431.0,258,493,67,191,0,42.46471371504661,456,56,19.121171770972037,4
Category_Wikipedia_sockpuppets_of_BeUtkarsh.csv,14,269546.0,5,9,4,1,0,70.64285714285714,238,29,15.642857142857142,7
Category_Wikipedia_sockpuppets_of_Potentet.csv,9,1936.0,6,3,5,1,105,122.55555555555556,135,13,13.0,13
Category_Wikipedia_sockpuppets_of_Romil.Choudary.csv,506,7855649.0,186,320,87,99,0,38.569169960474305,255,68,22.76086956521739,6
Category_Wikipedia_sockpuppets_of_Draculaura2023.csv,255,16360096.0,61,194,48,13,0,38.28235294117647,256,72,32.03529411764706,11
Category_Wikipedia_sockpuppets_of_BeatlesGirl7.csv,221,998239.0,73,148,24,49,0,43.321266968325794,233,80,22.823529411764707,8
Category_Wikipedia_sockpuppets_of_Tahw1988.csv,5,237.0,2,3,1,1,0,62.0,144,8,8.0,8
Category_Wikipedia_sockpuppets_of_Imranhusain.csv,179,1132559.0,64,115,59,5,0,70.07821229050279,255,41,26.64245810055866,6
Category_Wikipedia_sockpuppets_of_Darth_Vader_is_your_Father.csv,139,4312798.0,48,91,20,28,0,56.64748201438849,222,65,21.74820143884892,5
Category_Wikipedia_sockpuppets_of_Dave_kersey.csv,120,1377358.0,61,59,34,27,0,97.14166666666667,243,31,24.691666666666666,8
Category_Wikipedia_sockpuppets_of_IchibanNOAH.csv,1327,51300702.0,537,790,500,37,0,56.325546345139415,500,58,19.589299171062546,6
Category_Wikipedia_sockpuppets_of_ExoQuest.csv,1535,72384910.0,545,990,500,45,0,58.31074918566775,500,62,24.917915309446254,6
Category_Wikipedia_sockpuppets_of_Andrepower.csv,867,139377946.0,579,288,173,406,0,27.434832756632066,254,23,14.534025374855824,6
Category_Wikipedia_sockpuppets_of_Balljgh.csv,561,230207150.0,295,266,251,44,0,42.750445632798574,255,47,11.192513368983958,6
Category_Wikipedia_sockpuppets_of_Allen_reginald.csv,16,12383.0,10,6,7,3,4,35.5625,165,16,16.0,16
Category_Wikipedia_sockpuppets_of_Yosoyjake.csv,1,0.0,1,0,1,0,25,25.0,25,15,15.0,15
Category_Wikipedia_sockpuppets_of_Ilija96216.csv,37,3481706.0,18,19,9,9,0,52.648648648648646,228,31,12.324324324324325,3
Category_Wikipedia_sockpuppets_of_Downtown007.csv,63,18478498.0,24,39,23,1,0,31.984126984126984,210,37,30.666666666666668,16
Category_Wikipedia_sockpuppets_of_Nealante.csv,34,498857.0,17,17,16,1,0,50.970588235294116,199,18,13.264705882352942,6
Category_Wikipedia_sockpuppets_of_Irish_Loughmoe_castle.csv,362,11479048.0,120,242,104,16,0,49.60220994475138,441,55,19.35082872928177,5
Category_Wikipedia_sockpuppets_of_Gcguevarra.csv,1725,16606202.0,583,1142,338,245,0,43.75942028985507,255,72,22.493913043478262,5
Category_Wikipedia_sockpuppets_of_Vishwanath2245.csv,170,2310103.0,70,100,43,27,0,32.1,231,54,19.711764705882352,8
Category_Wikipedia_sockpuppets_of_Dameon_Catusco.csv,11,11810.0,8,3,5,3,11,50.81818181818182,196,16,13.272727272727273,4
Category_Wikipedia_sockpuppets_of_BTPproductions.csv,64,1833682.0,23,41,17,6,0,56.203125,313,22,15.0,7
Category_Wikipedia_sockpuppets_of_Maryanne35.csv,17,1007102.0,5,12,3,2,0,71.47058823529412,195,18,13.647058823529411,9
Category_Wikipedia_sockpuppets_of_Krlzh.csv,394,11342026.0,103,291,103,0,0,43.07106598984772,223,41,17.472081218274113,7
Category_Wikipedia_sockpuppets_of_Aldota.csv,5965,29368312.0,1901,4064,500,1401,0,42.92556580050293,255,94,20.227326068734282,3
Category_Wikipedia_sockpuppets_of_Reynolds89.csv,16,3049145.0,10,6,6,4,0,43.0,238,24,16.375,15
Category_Wikipedia_sockpuppets_of_Rjensen.csv,2007,568165758.0,508,1499,500,8,0,54.59441953163926,310,81,22.026407573492776,5
Category_Wikipedia_sockpuppets_of_King_Prithviraj_II.csv,2170,40269752.0,893,1277,500,393,0,39.140092165898615,347,101,16.36635944700461,4
Category_Wikipedia_sockpuppets_of_Mdtemp_(school).csv,10,604449.0,5,5,4,1,0,22.3,63,77,63.3,19
Category_Wikipedia_sockpuppets_of_Barbaragomperts.csv,290,51054032.0,145,145,108,37,0,37.10344827586207,259,52,24.117241379310343,10
Category_Wikipedia_sockpuppets_of_Gonzafer001.csv,1721,230311289.0,560,1161,500,60,0,57.25740848343986,500,79,19.577571179546776,5
Category_Wikipedia_sockpuppets_of_ZackDickens12.csv,1244,4603422.0,530,714,500,30,0,43.910771704180064,244,57,24.171221864951768,4
Category_Wikipedia_sockpuppets_of_15joonp.csv,119,3191886.0,60,59,58,2,0,30.42016806722689,196,45,23.638655462184875,12
Category_Wikipedia_sockpuppets_of_Divyanka_Babu.csv,65,55061391.0,25,40,13,12,0,50.52307692307692,213,33,22.907692307692308,13
Category_Wikipedia_sockpuppets_of_Maniacop.csv,981,18766045.0,347,634,328,19,0,37.56371049949031,254,47,17.862385321100916,8
Category_Wikipedia_sockpuppets_of_Ëµ§Ë∫´.csv,21,832051.0,21,0,19,2,0,20.047619047619047,214,25,12.142857142857142,10
Category_Wikipedia_sockpuppets_of_Johnsonwatts.csv,802,96169054.0,337,465,141,196,0,41.32793017456359,234,49,15.810473815461346,9
Category_Wikipedia_sockpuppets_of_Hi16512.csv,8,1041813.0,4,4,3,1,0,37.125,116,40,40.0,40
Category_Wikipedia_sockpuppets_of_Trackp.csv,4,74344.0,3,1,2,1,11,45.25,129,14,14.0,14
Category_Wikipedia_sockpuppets_of_Usha_tandon.csv,8,421348.0,6,2,4,2,0,46.0,124,35,29.75,21
Category_Wikipedia_sockpuppets_of_Amanharleen.csv,1710,57767883.0,581,1129,115,466,0,41.87953216374269,253,44,18.35204678362573,4
Category_Wikipedia_sockpuppets_of_The_coqmeister.csv,146,9487022.0,43,103,20,23,0,59.43150684931507,234,28,15.116438356164384,3
Category_Wikipedia_sockpuppets_of_AmyFuller.csv,81,4849151.0,32,49,16,16,0,53.098765432098766,200,25,17.604938271604937,10
Category_Wikipedia_sockpuppets_of_ProTaylorCraft.csv,2736,139092292.0,701,2035,272,429,0,43.49744152046784,496,61,21.526315789473685,3
Category_Wikipedia_sockpuppets_of_UK-WK-ed.csv,19,688554.0,13,6,12,1,6,35.68421052631579,87,24,22.736842105263158,20
Category_Wikipedia_sockpuppets_of_Palkanetoijala.csv,450,305598595.0,157,293,79,78,0,44.86222222222222,319,104,23.184444444444445,6
Category_Wikipedia_sockpuppets_of_Gayatri0704.csv,702,95170170.0,233,469,183,50,0,38.477207977207975,253,58,17.172364672364672,4
Category_Wikipedia_sockpuppets_of_Jackthomas321.csv,488,35444623.0,127,361,127,0,0,50.4344262295082,255,47,18.016393442622952,6
Category_Wikipedia_sockpuppets_of_Max_Trahan.csv,35,458328.0,17,18,13,4,0,50.74285714285714,219,25,17.571428571428573,10
Category_Wikipedia_sockpuppets_of_Kashimathvarnasi.csv,356,1365877.0,142,214,61,81,0,45.04213483146067,250,47,19.99438202247191,10
Category_Wikipedia_sockpuppets_of_ThaiFutsal.csv,520,8189299.0,231,289,154,77,0,34.74423076923077,228,37,16.25,7
Category_Wikipedia_sockpuppets_of_T23tran.csv,1523,24928840.0,562,961,500,62,0,39.73013788575181,257,69,14.653315824031516,6
Category_Wikipedia_sockpuppets_of_Dkarga.csv,8,79446.0,5,3,5,0,26,42.25,120,16,16.0,16
Category_Wikipedia_sockpuppets_of_Jim_Pooele.csv,78,8976.0,36,42,34,2,0,36.48717948717949,175,57,32.88461538461539,12
Category_Wikipedia_sockpuppets_of_Shaddai_Wright.csv,3272,177610532.0,862,2410,500,362,0,44.73991442542787,500,50,16.801650366748166,4
Category_Wikipedia_sockpuppets_of_Wilson_James_0.csv,12,22102.0,7,5,5,2,0,61.083333333333336,253,24,24.0,24
Category_Wikipedia_sockpuppets_of_Shani_Atif.csv,96,469946.0,37,59,30,7,0,48.46875,204,31,14.166666666666666,6
Category_Wikipedia_sockpuppets_of_Lima_Bean_Farmer.csv,2260,108725875.0,1000,1260,500,500,0,50.77787610619469,496,91,51.08362831858407,6
Category_Wikipedia_sockpuppets_of_NhatMinh1701.csv,381,3183070.0,128,253,126,2,0,44.51706036745407,317,34,15.989501312335959,3
Category_Wikipedia_sockpuppets_of_WMCproofreader.csv,22,5147965.0,9,13,7,2,0,75.68181818181819,196,59,30.0,8
Category_Wikipedia_sockpuppets_of_MiltonP_Ottawa.csv,4472,37279070.0,1063,3409,389,674,0,40.52728085867621,247,84,19.94566189624329,3
Category_Wikipedia_sockpuppets_of_TheImmortalKitten.csv,608,17790331.0,178,430,102,76,0,50.9046052631579,351,39,21.87171052631579,3
Category_Wikipedia_sockpuppets_of_Thumpgoggles.csv,107,6205831.0,47,60,14,33,0,51.728971962616825,255,58,30.39252336448598,7
Category_Wikipedia_sockpuppets_of_ParalelUni.csv,1492,30556593.0,562,930,434,128,0,34.26072386058981,200,62,34.007372654155496,7
Category_Wikipedia_sockpuppets_of_Go_im_so_horny.csv,550,9950460.0,171,379,37,134,0,64.39272727272727,328,56,22.48181818181818,7
Category_Wikipedia_sockpuppets_of_Cgcitytour.csv,8,53104.0,4,4,3,1,0,42.625,189,20,13.5,11
Category_Wikipedia_sockpuppets_of_Jtkiefer.csv,3611,16110631.0,1237,2374,500,737,0,37.42481307117142,248,93,27.771808363334255,3
Category_Wikipedia_sockpuppets_of_GhostDust.csv,3094,92049695.0,1092,2002,500,592,0,53.88720103425986,491,60,17.873949579831933,5
Category_Wikipedia_sockpuppets_of_Discawe.csv,55,33163.0,33,22,23,10,0,43.14545454545455,255,23,16.8,12
Category_Wikipedia_sockpuppets_of_Bhumil777.csv,4,50675.0,2,2,2,0,0,38.75,95,31,26.75,14
Category_Wikipedia_sockpuppets_of_LavrentiyRafail.csv,216,138895287.0,84,132,22,62,0,46.879629629629626,254,53,17.675925925925927,6
Category_Wikipedia_sockpuppets_of_Profpugh.csv,28,198222374.0,9,19,8,1,0,58.535714285714285,205,20,12.714285714285714,8
Category_Wikipedia_sockpuppets_of_Malayala_Sahityam.csv,2581,369360816.0,841,1740,500,341,0,49.102285935683845,496,63,20.14258039519566,4
Category_Wikipedia_sockpuppets_of_Mfs10000.csv,13,191.0,5,8,5,0,0,59.84615384615385,189,33,20.384615384615383,18
Category_Wikipedia_sockpuppets_of_Ivarhcp4ever.csv,62,17071318.0,36,26,23,13,0,40.483870967741936,196,62,30.596774193548388,11
Category_Wikipedia_sockpuppets_of_Wicks_Steve.csv,1950,2139831.0,529,1421,500,29,0,42.31333333333333,255,74,21.76974358974359,4
Category_Wikipedia_sockpuppets_of_Rahulkashiramka30041995.csv,55,770676.0,20,35,17,3,0,38.78181818181818,144,33,19.581818181818182,5
Category_Wikipedia_sockpuppets_of_David_G_Music.csv,29,373255.0,21,8,15,6,0,32.13793103448276,197,29,25.20689655172414,14
Category_Wikipedia_sockpuppets_of_Rina_Bovrisse.csv,31,851178.0,21,10,15,6,0,43.12903225806452,255,32,22.35483870967742,5
Category_Wikipedia_sockpuppets_of_DaBlobfish.csv,8,829.0,5,3,3,2,0,66.75,196,7,7.0,7
Category_Wikipedia_sockpuppets_of_Rosberg_the_great.csv,53,68695.0,26,27,19,7,0,45.62264150943396,165,26,23.830188679245282,22
Category_Wikipedia_sockpuppets_of_Kevin_TNA&IWEWrestling2010.csv,138,4048121.0,45,93,31,14,0,51.007246376811594,230,41,24.246376811594203,7
Category_Wikipedia_sockpuppets_of_Gotam502.csv,1440,24419939.0,476,964,466,10,0,40.03888888888889,303,53,11.4375,3
Category_Wikipedia_sockpuppets_of_Ranjeet_kumar_shukla.csv,13,158815992.0,3,10,3,0,17,48.07692307692308,143,30,26.615384615384617,26
Category_Wikipedia_sockpuppets_of_Kimiczv02.csv,129,794840.0,58,71,47,11,0,31.472868217054263,235,19,13.868217054263566,10
Category_Wikipedia_sockpuppets_of_Brunodams.csv,12,404050.0,6,6,6,0,0,41.916666666666664,112,32,27.916666666666668,13
Category_Wikipedia_sockpuppets_of_Innican_Soufou.csv,748,54032628.0,271,477,216,55,0,58.55213903743316,350,75,24.494652406417114,9
Category_Wikipedia_sockpuppets_of_Bradles_01.csv,568,10792512.0,207,361,102,105,0,33.528169014084504,200,49,19.27288732394366,3
Category_Wikipedia_sockpuppets_of_DoladDack.csv,8,622.0,5,3,5,0,0,22.625,121,15,10.5,9
Category_Wikipedia_sockpuppets_of_Marcus_Hoaegen.csv,134,116504100.0,37,97,28,9,0,51.59701492537314,242,35,18.559701492537314,8
Category_Wikipedia_sockpuppets_of_Dave8899.csv,1685,3829953.0,824,861,493,331,0,40.874777448071214,258,90,18.986943620178042,4
Category_Wikipedia_sockpuppets_of_Jossi.csv,3008,28629744.0,1012,1996,500,512,0,45.44315159574468,247,75,24.997672872340427,3
Category_Wikipedia_sockpuppets_of_Desiphral.csv,4810,120507434.0,1549,3261,500,1049,0,34.61538461538461,263,55,17.88045738045738,3
Category_Wikipedia_sockpuppets_of_Tenod888.csv,136,26842043.0,53,83,23,30,0,67.33823529411765,255,40,15.852941176470589,8
Category_Wikipedia_sockpuppets_of_Haneywonders.csv,15,1069383.0,8,7,5,3,0,70.93333333333334,285,22,17.8,15
Category_Wikipedia_sockpuppets_of_Donut_691.csv,21,602610.0,12,9,4,8,0,28.428571428571427,184,37,24.61904761904762,17
Category_Wikipedia_sockpuppets_of_Dumbo-buzo.csv,1696,6757031.0,532,1164,496,36,0,48.247051886792455,430,60,19.5501179245283,4
Category_Wikipedia_sockpuppets_of_Coltonlee.csv,11,76164.0,6,5,6,0,0,32.36363636363637,155,19,15.454545454545455,10
Category_Wikipedia_sockpuppets_of_ImraanInfinity88.csv,108,377413.0,33,75,23,10,0,49.129629629629626,195,54,25.52777777777778,5
Category_Wikipedia_sockpuppets_of_GiorgosY.csv,1130,195699114.0,366,764,321,45,0,52.33716814159292,255,61,23.598230088495576,6
Category_Wikipedia_sockpuppets_of_Ernest_Yiu.csv,40,47111574.0,10,30,5,5,0,72.75,314,47,30.075,11
Category_Wikipedia_sockpuppets_of_Kazandre.csv,155,19220400.0,55,100,33,22,0,45.83870967741935,252,40,22.219354838709677,8
Category_Wikipedia_sockpuppets_of_Papamayani.csv,372,69933948.0,146,226,95,51,0,41.564516129032256,254,50,15.088709677419354,6
Category_Wikipedia_sockpuppets_of_FiveSidedFistagon.csv,463,115032839.0,124,339,24,100,0,50.038876889848815,255,47,21.7170626349892,4
Category_Wikipedia_sockpuppets_of_Arksneat.csv,99,6854574.0,47,52,24,23,0,54.42424242424242,375,38,22.434343434343436,7
Category_Wikipedia_sockpuppets_of_Ma.darbandi.csv,16,2340993.0,8,8,7,1,0,46.6875,192,29,17.1875,8
Category_Wikipedia_sockpuppets_of_My_Lord.csv,2759,81974507.0,776,1983,500,276,0,62.98042769119246,415,65,16.316781442551648,2
Category_Wikipedia_sockpuppets_of_Communityknlodege.csv,75,2091908.0,34,41,21,13,0,52.45333333333333,197,43,23.466666666666665,11
Category_Wikipedia_sockpuppets_of_Bubaikumar.csv,4157,190596795.0,1543,2614,500,1043,0,49.26653836901612,395,64,25.6148664902574,4
Category_Wikipedia_sockpuppets_of_Binila.csv,2,101.0,2,0,2,0,0,0.0,0,8,8.0,8
Category_Wikipedia_sockpuppets_of_Burak18.csv,1487,17286770.0,567,920,489,78,0,22.07397444519166,213,34,16.75252185608608,7
Category_Wikipedia_sockpuppets_of_Khiafanatic.csv,18,107989.0,10,8,7,3,0,43.166666666666664,150,16,6.666666666666667,4
Category_Wikipedia_sockpuppets_of_Iliochori2.csv,951,34124590.0,565,386,500,65,0,40.02208201892744,500,65,23.08937960042061,10
Category_Wikipedia_sockpuppets_of_Andrewbf.csv,1219,19527301.0,349,870,185,164,0,42.425758818703855,255,38,15.358490566037736,4
Category_Wikipedia_sockpuppets_of_ComputingPower.csv,275,22097851.0,86,189,15,71,0,59.54545454545455,255,50,16.54909090909091,5
Category_Wikipedia_sockpuppets_of_Altimgamr.csv,3029,71503544.0,811,2218,91,720,0,54.26609442060086,255,53,20.89303400462199,2
Category_Wikipedia_sockpuppets_of_Clemy_Zm.in.csv,103,2814875.0,36,67,16,20,0,44.970873786407765,214,60,21.320388349514563,7
Category_Wikipedia_sockpuppets_of_Rian13.csv,3517,102823744.0,965,2552,500,465,0,33.606482797839064,250,108,17.913847028717658,5
Category_Wikipedia_sockpuppets_of_Longhornsrock3498.csv,306,28603627.0,71,235,7,64,0,28.68300653594771,217,43,14.637254901960784,8
Category_Wikipedia_sockpuppets_of_Riffraff1977.csv,111,3198000.0,33,78,17,16,0,49.792792792792795,250,37,14.54954954954955,10
Category_Wikipedia_sockpuppets_of_AryaShahMum.csv,9,5881.0,5,4,2,3,0,25.0,61,33,26.22222222222222,20
Category_Wikipedia_sockpuppets_of_RealCowboys.csv,631,15269898.0,234,397,204,30,0,52.109350237717905,247,49,18.077654516640255,8
Category_Wikipedia_sockpuppets_of_Evazeitz.csv,8,1112745.0,6,2,5,1,0,44.375,125,18,14.5,11
Category_Wikipedia_sockpuppets_of_Erik_Peterson7846.csv,56,781006.0,16,40,10,6,0,65.25,259,45,31.196428571428573,13
Category_Wikipedia_sockpuppets_of_Developer22.csv,5,140526.0,3,2,2,1,15,34.4,61,21,13.8,3
Category_Wikipedia_sockpuppets_of_Exciting2015.csv,437,43276744.0,223,214,78,145,0,53.23112128146453,255,49,19.155606407322654,11
Category_Wikipedia_sockpuppets_of_Bhaumikahir09.csv,11,13029.0,10,1,9,1,0,14.545454545454545,60,29,28.272727272727273,25
Category_Wikipedia_sockpuppets_of_Rovington.csv,1518,58289555.0,617,901,500,117,0,47.551383399209485,250,67,21.217391304347824,5
Category_Wikipedia_sockpuppets_of_Siamfootball.csv,5203,120520982.0,2049,3154,500,1549,0,27.228522006534693,432,57,20.77359215837017,9
Category_Wikipedia_sockpuppets_of_SuperSkinnyBoi69.csv,13,7033.0,7,6,7,0,0,63.23076923076923,200,17,16.153846153846153,16
Category_Wikipedia_sockpuppets_of_Kaki_joe.csv,489,7246789.0,159,330,140,19,0,46.351738241308794,230,35,12.593047034764826,5
Category_Wikipedia_sockpuppets_of_KidoS12307.csv,171,78505823.0,62,109,32,30,0,39.90643274853801,247,23,14.192982456140351,5
Category_Wikipedia_sockpuppets_of_Baseball_Card_Guy.csv,1075,17488947.0,333,742,248,85,0,40.647441860465115,262,57,25.733023255813954,4
Category_Wikipedia_sockpuppets_of_Gamsbart.csv,3651,460217368.0,1322,2329,500,822,0,45.43412763626404,500,86,19.225691591344837,3
Category_Wikipedia_sockpuppets_of_Grtfrnds.csv,4,75859.0,3,1,2,1,28,50.0,84,24,22.5,21
Category_Wikipedia_sockpuppets_of_Dorikonu.csv,6,42161.0,3,3,1,2,0,18.0,42,57,57.0,57
Category_Wikipedia_sockpuppets_of_Tknifton.csv,1588,16872743.0,538,1050,500,38,0,58.03904282115869,395,85,21.376574307304786,5
Category_Wikipedia_sockpuppets_of_Confederate_till_Death.csv,1484,13650997.0,392,1092,148,244,0,51.71765498652291,221,85,17.095013477088948,3
Category_Wikipedia_sockpuppets_of_Andybarnes1984.csv,11,63703.0,7,4,6,1,0,28.181818181818183,161,14,9.636363636363637,7
Category_Wikipedia_sockpuppets_of_Smithsteven20.csv,17,3770294.0,5,12,3,2,0,95.70588235294117,218,24,21.058823529411764,19
Category_Wikipedia_sockpuppets_of_Nicky_jam_el_cangri.csv,1868,87464142.0,500,1368,167,333,0,41.57708779443255,267,57,16.512847965738757,3
Category_Wikipedia_sockpuppets_of_Westinbuss.csv,72,12532495.0,34,38,14,20,0,52.0,189,38,25.208333333333332,8
Category_Wikipedia_sockpuppets_of_Randallrobinstine.csv,1360,351387631.0,288,1072,136,152,0,40.150735294117645,250,45,15.222058823529412,2
Category_Wikipedia_sockpuppets_of_Vitalii_Moshkivskyi.csv,293,80531741.0,112,181,84,28,0,59.32081911262799,312,20,9.071672354948806,5
Category_Wikipedia_sockpuppets_of_Theonetwoandthree.csv,311,110194822.0,74,237,38,36,0,45.855305466237944,233,53,21.681672025723472,8
Category_Wikipedia_sockpuppets_of_Almustyy.csv,4116,13315201.0,1292,2824,480,812,0,45.65354713313897,496,44,13.724975704567541,3
Category_Wikipedia_sockpuppets_of_Knowledge_Updater_1999.csv,913,13397868.0,358,555,194,164,0,57.68565169769989,500,42,16.514786418400877,4
Category_Wikipedia_sockpuppets_of_LucyAyoubFan.csv,10628,151299901.0,2855,7773,256,2599,0,40.224595408355285,496,64,17.378246142265713,4
Category_Wikipedia_sockpuppets_of_Mirianth.csv,171,51359615.0,59,112,58,1,0,44.74269005847953,243,50,23.473684210526315,10
Category_Wikipedia_sockpuppets_of_Corbin_Estep.csv,479,10145294.0,145,334,61,84,0,48.07724425887265,255,48,18.010438413361168,3
Category_Wikipedia_sockpuppets_of_SidChat2048.csv,754,25447933.0,244,510,173,71,0,56.12997347480106,496,56,16.96949602122016,4
Category_Wikipedia_sockpuppets_of_Lonata.csv,11,2176.0,6,5,5,1,18,85.54545454545455,203,13,13.0,13
Category_Wikipedia_sockpuppets_of_Fraberj.csv,1042,126564922.0,334,708,137,197,0,52.3320537428023,250,55,21.97792706333973,5
Category_Wikipedia_sockpuppets_of_ClintBruex.csv,6,35188.0,4,2,4,0,0,76.83333333333333,195,48,37.166666666666664,23
Category_Wikipedia_sockpuppets_of_DifficTones.csv,100,134568092.0,34,66,33,1,0,39.35,281,24,15.58,6
Category_Wikipedia_sockpuppets_of_CounterCorp.csv,42,124282713.0,10,32,7,3,0,27.023809523809526,112,50,30.0,14
Category_Wikipedia_sockpuppets_of_Neo500.csv,710,187396445.0,305,405,281,24,0,54.27042253521127,458,43,14.022535211267606,5
Category_Wikipedia_sockpuppets_of_DiGiorgio_Maija.csv,8,681396.0,7,1,3,4,15,63.875,196,35,27.75,17
Category_Wikipedia_sockpuppets_of_Ajax1995.csv,4143,207936387.0,1292,2851,500,792,0,80.06420468259715,255,52,15.57929036929761,3
Category_Wikipedia_sockpuppets_of_Username363636.csv,61,778529.0,42,19,22,20,0,32.39344262295082,191,24,20.114754098360656,5
Category_Wikipedia_sockpuppets_of_23prootie.csv,14254,473336580.0,4538,9716,500,4038,0,45.95966044619054,500,94,23.04426827557177,4
Category_Wikipedia_sockpuppets_of_DU2010OR.csv,628,22870616.0,226,402,102,124,0,38.745222929936304,255,61,20.154458598726116,4
Category_Wikipedia_sockpuppets_of_Dnharbin.csv,80,75573089.0,17,63,10,7,0,34.8375,225,20,13.6,11
Category_Wikipedia_sockpuppets_of_Jcpag2012.csv,1862,110179921.0,553,1309,500,53,0,53.54403866809882,512,66,22.876476906552096,3
Category_Wikipedia_sockpuppets_of_ScrumpyF69.csv,10,684564.0,5,5,3,2,18,86.3,186,20,18.6,17
Category_Wikipedia_sockpuppets_of_Szerkeszt≈ë_10.csv,98,4648177.0,39,59,13,26,0,48.3469387755102,295,30,18.1734693877551,5
Category_Wikipedia_sockpuppets_of_MadridjaimeME.csv,114,9119562.0,93,21,66,27,0,20.25438596491228,174,18,17.42982456140351,17
Category_Wikipedia_sockpuppets_of_Abhishek_Singh_III.csv,62,2257743.0,27,35,25,2,0,45.983870967741936,216,28,12.838709677419354,7
Category_Wikipedia_sockpuppets_of_Wikimeniahindusthan.csv,53,7133560.0,20,33,20,0,0,34.9811320754717,211,29,20.39622641509434,11
Category_Wikipedia_sockpuppets_of_Roger_Pearse.csv,1225,11208832.0,504,721,500,4,0,42.22204081632653,244,66,18.21061224489796,5
Category_Wikipedia_sockpuppets_of_Sheikh_Zaman_ll.csv,132,42385450.0,58,74,30,28,0,56.59090909090909,254,29,21.40909090909091,13
Category_Wikipedia_sockpuppets_of_Vitrox92.csv,1644,6410395.0,568,1076,150,418,0,29.195863746958636,209,47,25.52676399026764,5
Category_Wikipedia_sockpuppets_of_Gabnite.csv,79,13549827.0,60,19,57,3,0,35.10126582278481,196,79,30.227848101265824,12
Category_Wikipedia_sockpuppets_of_Pokemon123man.csv,134,31881072.0,37,97,15,22,0,34.6044776119403,213,56,29.19402985074627,5
Category_Wikipedia_sockpuppets_of_Jess1243638291.csv,9,11101890.0,4,5,2,2,0,50.22222222222222,196,19,17.666666666666668,17
Category_Wikipedia_sockpuppets_of_TareTone.csv,1780,3227204.0,641,1139,431,210,0,28.97921348314607,200,48,22.0561797752809,6
Category_Wikipedia_sockpuppets_of_MrColorado2014.csv,3665,119755262.0,956,2709,286,670,0,47.30177353342428,255,57,16.863028649386084,4
Category_Wikipedia_sockpuppets_of_Suarneduj.csv,37,1292017.0,12,25,10,2,0,44.91891891891892,188,47,31.89189189189189,8
Category_Wikipedia_sockpuppets_of_MARdF.csv,1286,217907424.0,304,982,144,160,0,52.03654743390358,269,67,19.042768273716952,4
Category_Wikipedia_sockpuppets_of_Boycott_LA_Times.csv,13,74667.0,10,3,8,2,0,30.76923076923077,159,52,21.384615384615383,17
Category_Wikipedia_sockpuppets_of_Pins12.csv,136,62523195.0,47,89,29,18,0,55.654411764705884,494,53,18.977941176470587,5
Category_Wikipedia_sockpuppets_of_Nhanphan6667.csv,11,82077.0,5,6,1,4,0,49.18181818181818,181,17,13.090909090909092,10
Category_Wikipedia_sockpuppets_of_WhiteDragonSlayer.csv,7,13617.0,3,4,1,2,19,100.0,199,54,36.857142857142854,14
Category_Wikipedia_sockpuppets_of_CharlesRKiss.csv,747,84133219.0,219,528,116,103,0,46.41767068273092,255,51,21.240963855421686,6
Category_Wikipedia_sockpuppets_of_Buttcheeks6969.csv,1,0.0,1,0,1,0,0,0.0,0,11,11.0,11
Category_Wikipedia_sockpuppets_of_Darkalleymedia.csv,7,1046.0,4,3,4,0,13,13.0,13,25,25.0,25
Category_Wikipedia_sockpuppets_of_Noebse.csv,1841,441433481.0,541,1300,500,41,0,47.37533948940793,496,97,16.783269961977187,3
Category_Wikipedia_sockpuppets_of_Gotallytime.csv,53,29534075.0,14,39,7,7,0,35.716981132075475,183,21,12.641509433962264,7
Category_Wikipedia_sockpuppets_of_AndyAndyAndy.csv,1295,19319136.0,505,790,500,5,0,21.45791505791506,197,50,11.777606177606177,4
Category_Wikipedia_sockpuppets_of_Joseph.ludwig.csv,197,2982499.0,79,118,55,24,0,52.0507614213198,248,40,20.04060913705584,13
Category_Wikipedia_sockpuppets_of_Pushpaizol.csv,1617,257461309.0,785,832,500,285,0,35.82993197278912,494,42,22.163883735312307,9
Category_Wikipedia_sockpuppets_of_Kevinsaur1115.csv,112,944087.0,41,71,27,14,0,42.07142857142857,262,43,24.491071428571427,8
Category_Wikipedia_sockpuppets_of_Google_Phone.csv,19,7916.0,9,10,9,0,0,33.578947368421055,126,35,21.263157894736842,15
Category_Wikipedia_sockpuppets_of_Doro100.csv,16,589441.0,9,7,7,2,0,31.0,157,44,22.375,6
Category_Wikipedia_sockpuppets_of_Deondrerye84.csv,154,17603.0,52,102,40,12,0,48.91558441558441,246,46,24.5974025974026,5
Category_Wikipedia_sockpuppets_of_The_expert101.csv,13,1217.0,8,5,6,2,9,67.38461538461539,171,23,13.0,10
Category_Wikipedia_sockpuppets_of_LevaSoul_SA.csv,10,18719999.0,4,6,3,1,0,41.3,133,25,23.0,21
Category_Wikipedia_sockpuppets_of_SmtrSR.csv,1458,50465338.0,577,881,500,77,0,38.96844993141289,496,57,20.058984910836763,4
Category_Wikipedia_sockpuppets_of_Jt14905.csv,344,3723810.0,107,237,29,78,0,62.575581395348834,250,43,17.872093023255815,8
Category_Wikipedia_sockpuppets_of_Erysolesvska.csv,22,58024.0,15,7,15,0,5,41.04545454545455,197,22,13.5,11
Category_Wikipedia_sockpuppets_of_Wiki15071.csv,1051,52269900.0,580,471,500,80,0,42.177925784966696,301,73,20.897240723120838,9
Category_Wikipedia_sockpuppets_of_FerrerFour.csv,1118,9953005.0,386,732,165,221,0,42.711985688729875,247,73,36.509838998211094,7
Category_Wikipedia_sockpuppets_of_Stadleyrc.csv,9,92918.0,3,6,2,1,0,46.77777777777778,140,44,26.666666666666668,16
Category_Wikipedia_sockpuppets_of_16minutesoffame.csv,45,662.0,44,1,19,25,0,107.24444444444444,122,7,7.0,7
Category_Wikipedia_sockpuppets_of_Ste11aeres.csv,378,626813.0,133,245,96,37,0,59.52910052910053,255,54,18.62962962962963,5
Category_Wikipedia_sockpuppets_of_LovelyAngle.csv,2070,231316148.0,589,1481,500,89,0,40.13913043478261,255,66,18.17874396135266,5
Category_Wikipedia_sockpuppets_of_Maasuni.csv,902,258771715.0,340,562,92,248,0,39.129711751662974,266,65,22.619733924611975,9
Category_Wikipedia_sockpuppets_of_A2director.csv,61,1518066.0,32,29,21,11,0,38.85245901639344,217,26,17.78688524590164,11
Category_Wikipedia_sockpuppets_of_RishabhInsurance.csv,22,5089839.0,10,12,10,0,0,53.09090909090909,150,46,20.181818181818183,9
Category_Wikipedia_sockpuppets_of_17yge.csv,286,18994585.0,71,215,45,26,0,58.02097902097902,419,61,18.832167832167833,6
Category_Wikipedia_sockpuppets_of_Elavarasan_Devarajan-Eladev.csv,59,1825414.0,27,32,27,0,0,41.94915254237288,189,54,25.576271186440678,8
Category_Wikipedia_sockpuppets_of_Chan_f.c..csv,378,6181023.0,165,213,50,115,0,46.55820105820106,243,45,25.65343915343915,6
Category_Wikipedia_sockpuppets_of_ChineseLamps.csv,268,39227968.0,82,186,52,30,0,45.01119402985075,242,76,20.354477611940297,6
Category_Wikipedia_sockpuppets_of_Haflksjkf.csv,360,32316512.0,108,252,63,45,0,58.625,313,54,25.105555555555554,6
Category_Wikipedia_sockpuppets_of_Abonazzi.csv,2315,6441385.0,1007,1308,500,507,0,43.16414686825054,500,64,30.176673866090713,7
Category_Wikipedia_sockpuppets_of_Techcover1998.csv,1,0.0,1,0,1,0,99,99.0,99,14,14.0,14
Category_Wikipedia_sockpuppets_of_Noalla.csv,9,25667711.0,3,6,1,2,0,64.22222222222223,191,12,12.0,12
Category_Wikipedia_sockpuppets_of_Piazzajordan2.csv,2185,513812430.0,504,1681,500,4,0,42.52173913043478,421,53,22.40183066361556,3
Category_Wikipedia_sockpuppets_of_Wikieditlobs.csv,631,36989409.0,215,416,129,86,0,50.41838351822504,496,53,22.497622820919176,3
Category_Wikipedia_sockpuppets_of_Shworks999.csv,244,1193739.0,99,145,82,17,0,35.59016393442623,259,26,15.573770491803279,11
Category_Wikipedia_sockpuppets_of_Ambia_Akter_Sadia.csv,37,398091.0,15,22,13,2,0,41.91891891891892,259,39,19.43243243243243,8
Category_Wikipedia_sockpuppets_of_Matt_gingell.csv,107,6487382.0,31,76,17,14,0,72.58878504672897,212,26,13.850467289719626,5
Category_Wikipedia_sockpuppets_of_Peytondaley.csv,406,87564095.0,172,234,100,72,0,38.27339901477833,233,35,13.827586206896552,9
Category_Wikipedia_sockpuppets_of_KnewtonSoft.csv,7,1024742.0,5,2,5,0,0,19.428571428571427,63,31,25.285714285714285,21
Category_Wikipedia_sockpuppets_of_Shidykenzo.csv,6,116358.0,2,4,1,1,10,47.166666666666664,81,23,21.666666666666668,15
Category_Wikipedia_sockpuppets_of_Knyphausen56.csv,39,326255.0,19,20,11,8,0,38.717948717948715,199,72,43.23076923076923,7
Category_Wikipedia_sockpuppets_of_JamesGoodmansBooks.csv,80,343660043.0,20,60,11,9,0,45.3375,315,31,20.7875,14
Category_Wikipedia_sockpuppets_of_Roosevelt234.csv,18,300283.0,9,9,8,1,0,83.66666666666667,247,18,10.0,5
Category_Wikipedia_sockpuppets_of_Sagarlakhara23.csv,82,91554.0,32,50,32,0,0,42.30487804878049,176,52,20.682926829268293,13
Category_Wikipedia_sockpuppets_of_Bypossibleboat.csv,186,4897356.0,69,117,30,39,0,67.53225806451613,267,37,15.940860215053764,4
Category_Wikipedia_sockpuppets_of_BLACKDRAGON.csv,876,11144068.0,391,485,391,0,0,25.022831050228312,189,22,17.085616438356166,7
Category_Wikipedia_sockpuppets_of_1868mike.csv,53,18153672.0,13,40,4,9,0,86.32075471698113,337,30,13.566037735849056,6
Category_Wikipedia_sockpuppets_of_Zishan2007.csv,12,152411.0,11,1,8,3,0,8.416666666666666,33,8,8.0,8
Category_Wikipedia_sockpuppets_of_Tinarajbhandari.csv,141,8054879.0,118,23,66,52,0,17.893617021276597,290,28,16.27659574468085,16
Category_Wikipedia_sockpuppets_of_Spicejohnson.csv,940,10978230.0,348,592,331,17,0,37.263829787234044,255,61,21.27127659574468,9
Category_Wikipedia_sockpuppets_of_Stntn.csv,82,63774307.0,30,52,27,3,0,36.853658536585364,198,22,17.353658536585368,13
Category_Wikipedia_sockpuppets_of_Swamilive.csv,4019,130119677.0,1062,2957,500,562,0,52.57128638964917,272,105,17.312017914904207,1
Category_Wikipedia_sockpuppets_of_Sdruvss.csv,1320,45766102.0,532,788,500,32,0,44.75606060606061,248,77,39.68030303030303,12
Category_Wikipedia_sockpuppets_of_Miazhogynagyonis.csv,22,336409.0,7,15,7,0,0,47.22727272727273,159,13,13.0,13
Category_Wikipedia_sockpuppets_of_Lagiadagiapponese.csv,1,0.0,1,0,1,0,62,62.0,62,22,22.0,22
Category_Wikipedia_sockpuppets_of_Hero_Dashboard.csv,80,11253716.0,26,54,11,15,0,35.2125,136,50,23.8625,8
Category_Wikipedia_sockpuppets_of_Munshi_Talab.csv,374,2073892.0,109,265,65,44,0,46.42780748663102,494,80,20.267379679144383,4
Category_Wikipedia_sockpuppets_of_Joe_Irvin.csv,30,1837356.0,12,18,11,1,0,42.0,199,42,22.866666666666667,10
Category_Wikipedia_sockpuppets_of_REDYVA.csv,1532,16151121.0,587,945,500,87,0,40.73890339425587,250,48,23.172323759791123,8
Category_Wikipedia_sockpuppets_of_Pippopo.csv,62,6063.0,44,18,41,3,36,102.09677419354838,251,47,21.0,16
Category_Wikipedia_sockpuppets_of_ActressVenba.csv,26,3598108.0,7,19,7,0,0,38.53846153846154,163,53,43.69230769230769,22
Category_Wikipedia_sockpuppets_of_Trigarta.csv,967,16674827.0,418,549,342,76,0,58.076525336091,500,47,17.233712512926576,6
Category_Wikipedia_sockpuppets_of_ArdaOnay2004.csv,1523,14503190.0,504,1019,500,4,0,40.94024950755089,388,54,22.797767564018386,3
Category_Wikipedia_sockpuppets_of_Rockdiedout.csv,503,20639631.0,174,329,86,88,0,36.65407554671968,215,55,21.829025844930417,10
Category_Wikipedia_sockpuppets_of_Afterbrew.csv,3480,42525740.0,1264,2216,500,764,0,31.995402298850575,496,53,22.027873563218392,5
Category_Wikipedia_sockpuppets_of_Cornelius.Ealy1000.csv,49,7359817.0,20,29,14,6,0,45.285714285714285,172,26,16.571428571428573,9
Category_Wikipedia_sockpuppets_of_Smuge22.csv,93,5946900.0,31,62,16,15,0,41.623655913978496,226,60,32.935483870967744,8
Category_Wikipedia_sockpuppets_of_DM38416.csv,208,1118502.0,79,129,75,4,0,51.74038461538461,253,50,29.067307692307693,7
Category_Wikipedia_sockpuppets_of_Soriano67.csv,50,810181.0,23,27,12,11,0,40.06,193,29,22.44,12
Category_Wikipedia_sockpuppets_of_Fjkdjfjf.csv,3,412.0,2,1,1,1,0,0.0,0,20,17.333333333333332,12
Category_Wikipedia_sockpuppets_of_Pks1142.csv,373,4162512.0,139,234,139,0,0,39.501340482573724,230,102,19.45308310991957,8
Category_Wikipedia_sockpuppets_of_IrfaniMediaCellpcr.csv,89,1104488.0,50,39,30,20,0,38.2247191011236,221,38,22.730337078651687,14
Category_Wikipedia_sockpuppets_of_Rrarteditor.csv,171,106866798.0,94,77,88,6,0,38.7953216374269,276,29,15.304093567251462,14
Category_Wikipedia_sockpuppets_of_Domthedude001.csv,1571,297712934.0,509,1062,500,9,0,56.37237428389561,255,82,20.85677912157861,3
Category_Wikipedia_sockpuppets_of_AndrewFirestone777.csv,48,51410309.0,26,22,17,9,0,57.270833333333336,171,9,9.0,9
Category_Wikipedia_sockpuppets_of_Hjkinfo.csv,38,7257779.0,18,20,16,2,0,31.263157894736842,166,59,29.63157894736842,3
Category_Wikipedia_sockpuppets_of_Made_In_Norfolk.csv,318,153944628.0,78,240,78,0,0,43.613207547169814,255,42,22.663522012578618,8
Category_Wikipedia_sockpuppets_of_Vipinahir.csv,2378,27462613.0,936,1442,500,436,0,55.88982338099243,410,54,22.1148023549201,4
Category_Wikipedia_sockpuppets_of_Rastishka.csv,916,178409089.0,268,648,120,148,0,35.7467248908297,224,50,18.24890829694323,6
Category_Wikipedia_sockpuppets_of_Giorwnviwvnwianv.csv,66,82852.0,15,51,8,7,0,46.03030303030303,190,20,15.303030303030303,3
Category_Wikipedia_sockpuppets_of_Smithtony.csv,48,5457659.0,23,25,18,5,0,33.3125,232,81,33.854166666666664,3
Category_Wikipedia_sockpuppets_of_Ovedc.csv,984,186696971.0,540,444,500,40,0,41.603658536585364,512,61,20.103658536585368,9
Category_Wikipedia_sockpuppets_of_Penna_Turnpike.csv,30,777699.0,14,16,6,8,0,33.666666666666664,231,32,19.666666666666668,13
Category_Wikipedia_sockpuppets_of_Cyberacex.csv,18,5820.0,8,10,8,0,0,22.22222222222222,125,42,29.22222222222222,19
Category_Wikipedia_sockpuppets_of_Kenneth__Kenny__McCormick.csv,16,42502.0,11,5,7,4,0,94.25,219,46,29.375,15
Category_Wikipedia_sockpuppets_of_TheMKHerald.csv,17,98153.0,11,6,7,4,0,47.76470588235294,196,21,16.764705882352942,5
Category_Wikipedia_sockpuppets_of_Lackanherbert.csv,321,439126.0,101,220,35,66,0,43.545171339563865,299,55,18.1588785046729,5
Category_Wikipedia_sockpuppets_of_Vidhee2.csv,450,8653094.0,216,234,113,103,0,39.64,264,58,20.173333333333332,8
Category_Wikipedia_sockpuppets_of_Luke_Bryan_USA.csv,51,3225575.0,24,27,11,13,0,40.333333333333336,219,29,24.03921568627451,12
Category_Wikipedia_sockpuppets_of_Iarsalanansari.csv,43,32556072.0,15,28,11,4,0,65.65116279069767,336,24,13.651162790697674,11
Category_Wikipedia_sockpuppets_of_Ososem.csv,1,0.0,1,0,1,0,0,0.0,0,19,19.0,19
Category_Wikipedia_sockpuppets_of_Gjadfsiiovonrenbuontrgzsd.csv,2,0.0,1,1,1,0,0,0.0,0,6,6.0,6
Category_Wikipedia_sockpuppets_of_2000voltaire.csv,471,104709779.0,155,316,71,84,0,42.43524416135881,254,63,25.54140127388535,6
Category_Wikipedia_sockpuppets_of_Kingtharapper.csv,10,27691.0,4,6,3,1,0,42.1,157,47,45.0,37
Category_Wikipedia_sockpuppets_of_Damjudidench.csv,315,3793365.0,131,184,89,42,0,49.77460317460317,250,33,14.88888888888889,6
Category_Wikipedia_sockpuppets_of_Ted_Shackelford.csv,2788,37314233.0,1000,1788,500,500,0,43.00466284074606,496,74,22.578909612625537,3
Category_Wikipedia_sockpuppets_of_JamesBurns.csv,11202,183952023.0,3902,7300,500,3402,0,28.831101589001964,264,98,21.384217104088556,1
Category_Wikipedia_sockpuppets_of_Shawn1ilk.csv,7,57748.0,4,3,2,2,7,29.714285714285715,117,28,27.285714285714285,27
Category_Wikipedia_sockpuppets_of_Trio_The_Punch.csv,10570,59909796.0,3033,7537,500,2533,0,52.78618732261116,255,95,23.838032166508988,3
Category_Wikipedia_sockpuppets_of_Amadoni.csv,235,274453674.0,69,166,44,25,0,40.672340425531914,236,43,14.86808510638298,5
Category_Wikipedia_sockpuppets_of_Cgmellor.csv,68,3285192.0,25,43,22,3,0,48.01470588235294,241,34,16.308823529411764,5
Category_Wikipedia_sockpuppets_of_Hayatgm.csv,85,30721183.0,32,53,25,7,0,32.470588235294116,232,48,16.04705882352941,6
Category_Wikipedia_sockpuppets_of_Ayazf.csv,62,75318799.0,15,47,12,3,0,49.83870967741935,244,53,21.919354838709676,15
Category_Wikipedia_sockpuppets_of_Nestofbirdnests.csv,2478,70371964.0,763,1715,349,414,0,59.91081517352704,496,67,20.487086359967716,3
Category_Wikipedia_sockpuppets_of_Katelyn456.csv,131,12447011.0,31,100,11,20,0,52.0,248,29,14.51908396946565,6
Category_Wikipedia_sockpuppets_of_Contconcord.csv,120,1816061.0,33,87,14,19,0,60.05833333333333,326,23,14.516666666666667,5
Category_Wikipedia_sockpuppets_of_GoatMans.csv,1775,18306814.0,534,1241,145,389,0,48.36732394366197,372,57,22.694647887323942,4
Category_Wikipedia_sockpuppets_of_1shields1.csv,1338,16151368.0,467,871,255,212,0,45.31165919282511,247,75,20.06203288490284,4
Category_Wikipedia_sockpuppets_of_Bones_Jones.csv,1632,167155013.0,519,1113,500,19,0,57.528799019607845,439,52,19.848039215686274,5
Category_Wikipedia_sockpuppets_of_Paulgrra.csv,39,11823287.0,16,23,16,0,0,33.23076923076923,167,18,17.46153846153846,17
Category_Wikipedia_sockpuppets_of_ThomasMatt22.csv,1110,52344253.0,382,728,110,272,0,45.3018018018018,255,67,24.11081081081081,10
Category_Wikipedia_sockpuppets_of_Maxordan.csv,98,318861485.0,36,62,36,0,0,46.69387755102041,253,31,19.877551020408163,13
Category_Wikipedia_sockpuppets_of_MegaSmike46.csv,1410,51172175.0,505,905,500,5,0,41.833333333333336,488,53,22.83758865248227,3
Category_Wikipedia_sockpuppets_of_TripleBald1.csv,23,176285.0,15,8,4,11,0,34.34782608695652,91,55,55.0,55
Category_Wikipedia_sockpuppets_of_Rubiesar.csv,559,103755114.0,176,383,111,65,0,49.48479427549195,500,53,22.54561717352415,6
Category_Wikipedia_sockpuppets_of_12345ak.csv,366,6459608.0,117,249,88,29,0,41.2896174863388,199,92,21.18032786885246,7
Category_Wikipedia_sockpuppets_of_Blck93.csv,16,17184182.0,6,10,5,1,0,13.875,122,14,13.5625,13
Category_Wikipedia_sockpuppets_of_Lotty94.csv,3,329884.0,2,1,2,0,0,14.0,42,17,17.0,17
Category_Wikipedia_sockpuppets_of_SturzaCosmin.csv,11,694802.0,9,2,7,2,18,80.18181818181819,171,21,9.363636363636363,5
Category_Wikipedia_sockpuppets_of_BToons.csv,19,12717153.0,13,6,7,6,0,55.26315789473684,115,23,17.94736842105263,11
Category_Wikipedia_sockpuppets_of_GeorgeOwell.csv,1,0.0,1,0,1,0,12,12.0,12,21,21.0,21
Category_Wikipedia_sockpuppets_of_HirmizM.csv,91,7010828.0,30,61,25,5,0,51.27472527472528,327,53,24.0989010989011,12
Category_Wikipedia_sockpuppets_of_Hussan_Naqvi.csv,996,5974849.0,353,643,287,66,0,28.17269076305221,272,59,20.71987951807229,5
Category_Wikipedia_sockpuppets_of_Rahulmeghoffical.csv,11,153961.0,6,5,5,1,5,16.181818181818183,61,26,25.09090909090909,25
Category_Wikipedia_sockpuppets_of_125BOP.csv,536,43273116.0,206,330,16,190,0,63.617537313432834,470,44,16.815298507462686,5
Category_Wikipedia_sockpuppets_of_A23101990.csv,291,68406167.0,84,207,55,29,0,46.292096219931274,237,29,15.048109965635739,4
Category_Wikipedia_sockpuppets_of_Scribbley.csv,1351,6386607.0,500,851,500,0,0,55.60917838638046,446,59,16.001480384900074,9
Category_Wikipedia_sockpuppets_of_Spacecowboi.csv,417,161759797.0,232,185,188,44,0,27.97841726618705,234,31,15.410071942446043,11
Category_Wikipedia_sockpuppets_of_Harikumar0015.csv,98,9957007.0,30,68,24,6,0,44.826530612244895,202,53,18.6734693877551,8
Category_Wikipedia_sockpuppets_of_Azeemdargroup.csv,40,40511896.0,15,25,9,6,0,71.925,500,19,14.875,9
Category_Wikipedia_sockpuppets_of_Southernhirak.csv,203,31942990.0,76,127,71,5,0,39.91133004926108,236,53,22.753694581280786,11
Category_Wikipedia_sockpuppets_of_Raptor232.csv,461,21377198.0,149,312,100,49,0,54.68329718004338,251,47,16.54013015184382,6
Category_Wikipedia_sockpuppets_of_Realwishall.csv,34,2906421.0,26,8,21,5,0,34.55882352941177,242,26,20.764705882352942,6
Category_Wikipedia_sockpuppets_of_Boredsohere.csv,279,1559359.0,108,171,76,32,0,37.26881720430107,225,37,17.555555555555557,3
Category_Wikipedia_sockpuppets_of_Twittner.csv,20,345087.0,18,2,11,7,0,41.6,199,18,16.55,13
Category_Wikipedia_sockpuppets_of_Parsbyte.csv,83,192416350.0,22,61,19,3,0,54.04819277108434,192,46,21.903614457831324,11
Category_Wikipedia_sockpuppets_of_Amarsh10.csv,13,324236.0,12,1,10,2,0,26.615384615384617,90,20,19.53846153846154,18
Category_Wikipedia_sockpuppets_of_Whitechristian2013.csv,134,4586681.0,67,67,65,2,0,44.09701492537314,211,47,25.746268656716417,10
Category_Wikipedia_sockpuppets_of_Kwilliams100.csv,2281,27055105.0,814,1467,500,314,0,37.239807102148184,242,49,17.61771153003069,7
Category_Wikipedia_sockpuppets_of_Xgates2017.csv,18,460579.0,13,5,12,1,0,52.666666666666664,168,21,18.333333333333332,15
Category_Wikipedia_sockpuppets_of_Lh1011.csv,137,15801490.0,32,105,9,23,0,51.197080291970806,496,53,22.394160583941606,11
Category_Wikipedia_sockpuppets_of_Mr_Birchwood.csv,130,46570876.0,53,77,47,6,0,60.3,480,25,14.715384615384615,7
Category_Wikipedia_sockpuppets_of_◊ô◊©◊®◊ê◊ú_◊ô◊©◊®◊ê◊ú.csv,8,271.0,5,3,5,0,0,17.75,107,28,20.875,16
Category_Wikipedia_sockpuppets_of_Schekanov.csv,279,378425981.0,65,214,51,14,0,45.63799283154122,316,54,24.379928315412187,4
Category_Wikipedia_sockpuppets_of_LegendaryChristopher.csv,637,49757939.0,197,440,189,8,0,57.51805337519623,448,72,32.73155416012559,7
Category_Wikipedia_sockpuppets_of_Coffeeloverlarge.csv,146,3233019.0,86,60,67,19,0,60.582191780821915,216,27,18.863013698630137,14
Category_Wikipedia_sockpuppets_of_Enlightened105747.csv,1142,78929770.0,315,827,112,203,0,63.36952714535902,500,54,17.029772329246935,5
Category_Wikipedia_sockpuppets_of_Anne-Sophie_Gourin.csv,77,184018.0,24,53,20,4,0,32.142857142857146,237,45,20.87012987012987,4
Category_Wikipedia_sockpuppets_of_Hugo1009.csv,347,284406868.0,126,221,125,1,0,49.247838616714695,249,66,19.81556195965418,8
Category_Wikipedia_sockpuppets_of_MelbourneValuer.csv,42,984257.0,15,27,8,7,0,59.26190476190476,271,29,18.928571428571427,11
Category_Wikipedia_sockpuppets_of_GraceClark22.csv,6,511852.0,5,1,3,2,0,22.5,37,8,8.0,8
Category_Wikipedia_sockpuppets_of_Advait.kansal.csv,1791,14442405.0,571,1220,500,71,0,62.04187604690117,500,99,27.89782244556114,4
Category_Wikipedia_sockpuppets_of_Danju87.csv,479,27466376.0,195,284,102,93,0,67.24217118997912,330,54,16.304801670146137,7
Category_Wikipedia_sockpuppets_of_Nate2357.csv,1130,30229342.0,356,774,289,67,0,43.087610619469025,214,54,22.953982300884956,3
Category_Wikipedia_sockpuppets_of_Dialinn.csv,697,230240002.0,154,543,128,26,0,51.685796269727405,255,47,14.99139167862267,5
Category_Wikipedia_sockpuppets_of_Dp210.csv,2019,34796603.0,934,1085,500,434,0,31.895492818226845,498,55,22.026745913818722,7
Category_Wikipedia_sockpuppets_of_Amruta_Parande.csv,17,4651980.0,9,8,4,5,0,68.70588235294117,191,3,3.0,3
Category_Wikipedia_sockpuppets_of_YilevBot.csv,3068,3767347.0,992,2076,229,763,0,35.815514993481095,495,44,16.314211212516298,1
Category_Wikipedia_sockpuppets_of_Jermboy27.csv,3420,407397270.0,1136,2284,500,636,0,45.04619883040936,384,81,24.824269005847952,4
Category_Wikipedia_sockpuppets_of_TheBellaTwins1445.csv,8032,128669111.0,2188,5844,500,1688,0,46.22584661354582,500,57,11.986429282868526,4
Category_Wikipedia_sockpuppets_of_Lolgirl78.csv,1,0.0,1,0,1,0,0,0.0,0,7,7.0,7
Category_Wikipedia_sockpuppets_of_SednaXV.csv,2552,31528260.0,902,1650,500,402,0,49.27468652037618,255,71,23.760188087774296,4
Category_Wikipedia_sockpuppets_of_Strongwik2324.csv,207,159420653.0,70,137,28,42,0,49.1207729468599,241,65,25.67632850241546,13
Category_Wikipedia_sockpuppets_of_Skullballoons.csv,2268,25335333.0,895,1373,500,395,0,40.217813051146386,253,46,11.091710758377426,8
Category_Wikipedia_sockpuppets_of_Dj_Guchy.csv,5,24493.0,2,3,2,0,0,47.4,103,23,19.0,13
Category_Wikipedia_sockpuppets_of_Reynoldsj333.csv,85,51226071.0,17,68,12,5,0,51.35294117647059,233,41,17.48235294117647,4
Category_Wikipedia_sockpuppets_of_Aogouguo.csv,3587,21171172.0,952,2635,500,452,0,52.80289935879565,242,64,17.479788123780317,3
Category_Wikipedia_sockpuppets_of_NickOrnstein.csv,1241,230484762.0,502,739,500,2,0,45.443190975020144,255,52,27.09105560032232,9
Category_Wikipedia_sockpuppets_of_Kuldeep_Mishra_ACTOR_BHOJPURI_cinema.csv,41,2760571.0,23,18,12,11,0,50.51219512195122,228,39,20.024390243902438,14
Category_Wikipedia_sockpuppets_of_Atomsaleb.csv,168,4847072.0,58,110,26,32,0,51.42261904761905,247,43,18.732142857142858,5
Category_Wikipedia_sockpuppets_of_Jump2255.csv,178,21510363.0,59,119,18,41,0,38.98876404494382,209,54,20.679775280898877,12
Category_Wikipedia_sockpuppets_of_Ghassul.csv,1733,38414389.0,553,1180,222,331,0,43.25043277553376,255,47,12.753606462781304,4
Category_Wikipedia_sockpuppets_of_AcceptRequestMovesGuidelines.csv,427,1905105.0,115,312,113,2,0,53.604215456674474,373,47,11.353629976580796,4
Category_Wikipedia_sockpuppets_of_MCVerstappen.csv,67,52083172.0,29,38,29,0,0,51.44776119402985,199,67,19.62686567164179,10
Category_Wikipedia_sockpuppets_of_Accopulocrat.csv,6848,108257134.0,2026,4822,346,1680,0,57.7647488317757,500,79,24.656396028037385,5
Category_Wikipedia_sockpuppets_of_VPD7102001.csv,1529,436634361.0,467,1062,94,373,0,48.74166121648136,496,68,20.899280575539567,4
Category_Wikipedia_sockpuppets_of_Terneris.csv,1350,24114363.0,486,864,464,22,0,29.33185185185185,249,41,24.68148148148148,3
Category_Wikipedia_sockpuppets_of_Chdefforts.csv,1,0.0,1,0,1,0,123,123.0,123,19,19.0,19
Category_Wikipedia_sockpuppets_of_Mynameisking21102002.csv,3311,26776110.0,1307,2004,500,807,0,32.32165508909695,515,68,20.35940803382664,3
Category_Wikipedia_sockpuppets_of_–≠–º–∏–ª—å_–ó–æ–ª—è.csv,23,1056.0,6,17,2,4,0,67.8695652173913,250,25,15.26086956521739,8
Category_Wikipedia_sockpuppets_of_AnwarHossainAS.csv,76,70320896.0,41,35,18,23,0,29.07894736842105,192,29,21.013157894736842,18
Category_Wikipedia_sockpuppets_of_Arturo_Ungaro.csv,1750,12528982.0,536,1214,500,36,0,34.18457142857143,363,51,19.23485714285714,4
Category_Wikipedia_sockpuppets_of_Chorlseton.csv,78,11867025.0,22,56,14,8,0,41.756410256410255,228,61,20.564102564102566,4
Category_Wikipedia_sockpuppets_of_Ashlesh84.csv,118,60304182.0,36,82,32,4,0,48.61864406779661,247,51,23.822033898305083,8
Category_Wikipedia_sockpuppets_of_Kashmiri123.csv,381,15852257.0,165,216,93,72,0,38.46194225721785,250,26,15.650918635170603,4
Category_Wikipedia_sockpuppets_of_Rami_Sastra.csv,186,1328008.0,57,129,36,21,0,76.28494623655914,175,52,21.586021505376344,13
Category_Wikipedia_sockpuppets_of_NYkid0709.csv,319,8213523.0,92,227,91,1,0,34.95297805642633,196,46,16.275862068965516,6
Category_Wikipedia_sockpuppets_of_Bibin996.csv,1629,213169618.0,540,1089,224,316,0,31.214241866175566,486,55,18.915899324739105,3
Category_Wikipedia_sockpuppets_of_Tarkattack.csv,361,9410500.0,116,245,116,0,0,48.958448753462605,255,48,21.681440443213297,6
Category_Wikipedia_sockpuppets_of_SuperiorMalkom.csv,2874,29584254.0,895,1979,500,395,0,37.52609603340292,394,53,20.080027835768963,4
Category_Wikipedia_sockpuppets_of_Pet.Classification_Association.csv,2,0.0,1,1,1,0,38,38.0,38,35,35.0,35
Category_Wikipedia_sockpuppets_of_Benjolyman.csv,81,81565136.0,29,52,28,1,0,55.67901234567901,228,27,21.88888888888889,11
Category_Wikipedia_sockpuppets_of_Tt789eryu.csv,114,11390140.0,40,74,28,12,0,72.94736842105263,266,45,14.596491228070175,9
Category_Wikipedia_sockpuppets_of_BMX_On_WheeIs.csv,655,59577133.0,185,470,89,96,0,51.03664122137405,414,47,19.957251908396948,3
Category_Wikipedia_sockpuppets_of_Object404.csv,1501,198420572.0,508,993,500,8,0,51.51632245169887,496,59,24.0346435709527,6
Category_Wikipedia_sockpuppets_of_Ravi_Wildnet.csv,76,14699400.0,21,55,20,1,0,49.078947368421055,222,49,22.44736842105263,6
Category_Wikipedia_sockpuppets_of_TheLongestRoadToIndiaGate.csv,121,56907150.0,63,58,63,0,0,56.95867768595041,217,38,17.96694214876033,14
Category_Wikipedia_sockpuppets_of_Tehepicness.csv,1558,33883409.0,317,1241,87,230,0,56.86328626444159,357,46,15.240693196405648,3
Category_Wikipedia_sockpuppets_of_CrazyBannana.csv,54,577222.0,23,31,17,6,0,80.98148148148148,428,23,18.203703703703702,7
Category_Wikipedia_sockpuppets_of_HinnT.csv,23,602419.0,9,14,4,5,0,63.73913043478261,219,15,10.347826086956522,9
Category_Wikipedia_sockpuppets_of_Roshanmalviya89.csv,693,13137055.0,172,521,32,140,0,47.265512265512264,395,52,15.715728715728716,4
Category_Wikipedia_sockpuppets_of_StuRat.csv,4158,75464707.0,1058,3100,500,558,0,49.97691197691198,499,56,29.602693602693602,4
Category_Wikipedia_sockpuppets_of_Hazbinhotelpersian.csv,68,20403816.0,36,32,28,8,0,34.220588235294116,255,44,20.705882352941178,6
Category_Wikipedia_sockpuppets_of_Here2help.csv,2454,2194074.0,618,1836,500,118,0,44.32681336593317,253,68,20.03911980440098,3
Category_Wikipedia_sockpuppets_of_WillieOnFeels.csv,76,244479.0,27,49,12,15,0,41.73684210526316,229,24,16.236842105263158,11
Category_Wikipedia_sockpuppets_of_Impcomunicare.csv,110,4068968.0,30,80,10,20,0,51.24545454545454,347,41,17.3,5
Category_Wikipedia_sockpuppets_of_Mayweatherpaulfight.csv,57,608794.0,20,37,9,11,0,64.7719298245614,236,29,19.45614035087719,15
Category_Wikipedia_sockpuppets_of_Marnie_Hawes.csv,3316,10969174.0,849,2467,500,349,0,69.24638118214716,498,87,19.405307599517492,4
Category_Wikipedia_sockpuppets_of_–ê–ª–∞–Ω10.csv,305,679982.0,119,186,112,7,0,40.93114754098361,235,24,14.931147540983607,6
Category_Wikipedia_sockpuppets_of_’ç’°’¥’∏÷Ç’ß’¨.csv,394,47531013.0,132,262,92,40,0,47.04060913705584,448,47,21.101522842639593,6
Category_Wikipedia_sockpuppets_of_Carolyn_Baker_III.csv,352,51322659.0,104,248,97,7,0,42.35511363636363,199,66,26.073863636363637,7
Category_Wikipedia_sockpuppets_of_Jdogno5.csv,2998,92020099.0,864,2134,500,364,0,46.53335557038025,255,68,19.83288859239493,5
Category_Wikipedia_sockpuppets_of_Octavian_history.csv,1856,18024120.0,612,1244,500,112,0,36.48599137931034,250,56,19.64008620689655,4
Category_Wikipedia_sockpuppets_of_VBBIHFudbalFan.csv,85,10609922.0,54,31,31,23,0,46.63529411764706,494,45,22.36470588235294,15
Category_Wikipedia_sockpuppets_of_Joshua7900.csv,1393,198371646.0,650,743,384,266,0,34.36468054558507,496,69,31.91457286432161,14
Category_Wikipedia_sockpuppets_of_Dievans.csv,1437,84162560.0,462,975,344,118,0,43.79471120389701,376,60,14.778705636743215,4
Category_Wikipedia_sockpuppets_of_Ervin1118.csv,4168,60762322.0,1115,3053,500,615,0,40.65762955854127,296,67,23.35940499040307,2
Category_Wikipedia_sockpuppets_of_Souniel_Yadav.csv,6141,99169315.0,2300,3841,500,1800,0,51.313792541931285,486,77,23.520436411007978,5
Category_Wikipedia_sockpuppets_of_NeoSpire.csv,1,0.0,1,0,1,0,0,0.0,0,18,18.0,18
Category_Wikipedia_sockpuppets_of_Insidious123.csv,201,5773342.0,63,138,46,17,0,39.223880597014926,465,31,18.0,9
Category_Wikipedia_sockpuppets_of_Grurukripa.csv,9,406201.0,6,3,3,3,14,66.88888888888889,129,22,22.0,22
Category_Wikipedia_sockpuppets_of_Mrkopolo123.csv,11,480585.0,4,7,1,3,0,56.45454545454545,151,24,19.90909090909091,18
Category_Wikipedia_sockpuppets_of_Myounes22.csv,131,155001234.0,58,73,30,28,0,52.33587786259542,267,75,32.2442748091603,14
Category_Wikipedia_sockpuppets_of_BushidoBrown.csv,3091,57464736.0,721,2370,409,312,0,40.42672274344872,395,50,15.658686509220317,3
Category_Wikipedia_sockpuppets_of_Amirali_shokri.csv,37,83883.0,18,19,11,7,0,31.62162162162162,205,47,23.91891891891892,11
Category_Wikipedia_sockpuppets_of_Sinofdreams.csv,864,6500697.0,329,535,279,50,0,31.40509259259259,225,59,23.016203703703702,3
Category_Wikipedia_sockpuppets_of_Luvdawayudie.csv,61,303257.0,28,33,22,6,0,54.16393442622951,255,47,35.0,16
Category_Wikipedia_sockpuppets_of_Siremeowington.csv,72,252053.0,24,48,11,13,0,56.52777777777778,238,47,26.52777777777778,16
Category_Wikipedia_sockpuppets_of_Richard_S._Lee_Cooper.csv,82,47890041.0,25,57,24,1,0,38.0,244,57,29.865853658536587,17
Category_Wikipedia_sockpuppets_of_111695.csv,212,9442566.0,79,133,24,55,0,48.0188679245283,242,67,20.910377358490567,6
Category_Wikipedia_sockpuppets_of_semofolkie.csv,3,223.0,2,1,2,0,13,59.666666666666664,153,15,15.0,15
Category_Wikipedia_sockpuppets_of_LataMangeshkar1980.csv,111,6190.0,39,72,11,28,0,44.62162162162162,239,69,18.81081081081081,8
Category_Wikipedia_sockpuppets_of_Me12356.csv,1460,8994731.0,568,892,500,68,0,28.454794520547946,233,47,17.322602739726026,4
Category_Wikipedia_sockpuppets_of_Bluthmark.csv,2457,23806100.0,766,1691,500,266,0,42.793243793243796,495,77,17.715913715913715,2
Category_Wikipedia_sockpuppets_of_Furqanrizwan.csv,229,104767776.0,59,170,24,35,0,50.47598253275109,253,30,14.908296943231441,3
Category_Wikipedia_sockpuppets_of_Ksoileau.csv,1744,378402713.0,503,1241,500,3,0,47.28038990825688,360,55,18.5177752293578,5
Category_Wikipedia_sockpuppets_of_Benbuff91.csv,1566,164587340.0,502,1064,500,2,0,42.692848020434226,397,83,28.98786717752235,4
Category_Wikipedia_sockpuppets_of_Humanitarian2.csv,145,150448.0,60,85,41,19,0,47.38620689655173,213,49,23.806896551724137,12
Category_Wikipedia_sockpuppets_of_Ddbarnes15.csv,93,130359695.0,58,35,57,1,0,34.74193548387097,224,20,10.10752688172043,10
Category_Wikipedia_sockpuppets_of_Ryanspir.csv,1564,16387389.0,622,942,500,122,0,44.20907928388747,249,56,28.072890025575447,7
Category_Wikipedia_sockpuppets_of_Theryx7.csv,2543,45879788.0,1053,1490,500,553,0,54.993708218639405,255,66,16.60440424695242,4
Category_Wikipedia_sockpuppets_of_Œî.csv,4823,417148393.0,1172,3651,500,672,0,50.162761766535354,500,78,20.544681733360978,3
Category_Wikipedia_sockpuppets_of_OzWrestlemaniac.csv,403,12866083.0,146,257,98,48,0,24.034739454094293,163,57,30.86104218362283,3
Category_Wikipedia_sockpuppets_of_Ramesh985.csv,137,1387169.0,48,89,36,12,0,49.941605839416056,231,72,34.2043795620438,6
Category_Wikipedia_sockpuppets_of_SPOV.csv,80,167128.0,24,56,24,0,0,29.0875,210,57,30.9375,9
Category_Wikipedia_sockpuppets_of_Kebapkebvab.csv,211,32137551.0,73,138,63,10,0,97.69668246445498,500,50,17.009478672985782,6
Category_Wikipedia_sockpuppets_of_Mickie_fan.csv,23,1785.0,8,15,5,3,0,47.391304347826086,184,17,12.869565217391305,12
Category_Wikipedia_sockpuppets_of_Arab_Cowboy.csv,1378,17410706.0,544,834,500,44,0,45.46734397677794,250,57,21.790275761973874,5
Category_Wikipedia_sockpuppets_of_Coolest_Kid20.csv,411,13399067.0,166,245,166,0,0,27.581508515815084,219,35,20.097323600973237,4
Category_Wikipedia_sockpuppets_of_384400km.csv,462,7819437.0,224,238,184,40,0,41.95238095238095,231,37,16.98051948051948,7
Category_Wikipedia_sockpuppets_of_Sasquatch2.csv,1067,4315522.0,441,626,223,218,0,43.70384254920337,214,51,12.381443298969073,3
Category_Wikipedia_sockpuppets_of_Savedbygracealonethroughfaith1.csv,11,62284.0,8,3,8,0,0,16.90909090909091,87,55,40.09090909090909,26
Category_Wikipedia_sockpuppets_of_Formal_Appointee_Number_6.csv,336,9960934.0,83,253,26,57,0,47.48809523809524,253,47,23.107142857142858,11
Category_Wikipedia_sockpuppets_of_KidAtUrSchool.csv,14,3956.0,8,6,3,5,0,62.07142857142857,231,28,28.0,28
Category_Wikipedia_sockpuppets_of_Gamerguy94.csv,857,115210007.0,350,507,126,224,0,51.841306884480744,496,49,27.21820303383897,8
Category_Wikipedia_sockpuppets_of_Yetijumps.csv,19,552.0,8,11,8,0,0,106.84210526315789,239,47,17.31578947368421,9
Category_Wikipedia_sockpuppets_of_AhmedAndaleeb.csv,119,1897287.0,40,79,36,4,0,32.67226890756302,248,35,18.26050420168067,6
Category_Wikipedia_sockpuppets_of_Mario1987.csv,2334,57880449.0,879,1455,500,379,0,34.30377035132819,217,76,25.32133676092545,6
Category_Wikipedia_sockpuppets_of_Mubaoinam.csv,778,309257092.0,294,484,159,135,0,42.458868894601544,455,53,15.132390745501285,6
Category_Wikipedia_sockpuppets_of_Patriotaei.csv,37,873305.0,26,11,10,16,0,101.89189189189189,224,20,15.54054054054054,15
Category_Wikipedia_sockpuppets_of_AlexxMichaelShameless.csv,16,213219.0,8,8,8,0,0,42.75,137,22,13.1875,10
Category_Wikipedia_sockpuppets_of_Zhoban.csv,3707,151737893.0,1031,2676,500,531,0,46.1653628270839,255,73,22.205557054221742,5
Category_Wikipedia_sockpuppets_of_Craft37by.csv,1261,110789512.0,386,875,351,35,0,53.052339413164155,343,96,19.182394924662965,5
Category_Wikipedia_sockpuppets_of_HannahVerg.csv,75,44659579.0,29,46,22,7,0,56.266666666666666,218,72,39.2,14
Category_Wikipedia_sockpuppets_of_Ofiretl.csv,2,2702501.0,2,0,1,1,0,69.0,138,19,14.0,9
Category_Wikipedia_sockpuppets_of_University_of_Allahabad.csv,36,1675770.0,23,13,18,5,0,41.27777777777778,147,55,24.38888888888889,16
Category_Wikipedia_sockpuppets_of_Boysrsocute.csv,515,25114689.0,204,311,41,163,0,47.83495145631068,250,38,24.079611650485436,10
Category_Wikipedia_sockpuppets_of_Policina.csv,1315,23862741.0,339,976,140,199,0,47.407604562737646,500,52,15.889733840304183,3
Category_Wikipedia_sockpuppets_of_One1two2three3.csv,63,22621623.0,33,30,19,14,0,49.682539682539684,255,37,35.25396825396825,15
Category_Wikipedia_sockpuppets_of_McFrancfurter.csv,70,887.0,23,47,15,8,0,30.7,208,38,14.628571428571428,5
Category_Wikipedia_sockpuppets_of_UnbornEra.csv,36,786685.0,29,7,20,9,0,21.083333333333332,199,22,14.88888888888889,6
Category_Wikipedia_sockpuppets_of_Oh_My_Volcano.csv,225,100650846.0,68,157,57,11,0,55.70666666666666,255,28,11.03111111111111,6
Category_Wikipedia_sockpuppets_of_Accomplished_Dough.csv,89,1980297.0,30,59,7,23,0,46.42696629213483,191,62,25.303370786516854,9
Category_Wikipedia_sockpuppets_of_Rienzo.csv,814,23311540.0,255,559,255,0,0,18.584766584766584,144,48,14.986486486486486,3
Category_Wikipedia_sockpuppets_of_Aig1aa6ohga5ieJae0aiH2naigh6feiShae6thaX4etho3iz9s.csv,24,6534151.0,15,9,3,12,4,40.583333333333336,148,60,19.041666666666668,14
Category_Wikipedia_sockpuppets_of_M√¨thrandir.csv,1793,67785318.0,515,1278,500,15,0,56.58114891243726,255,54,18.789180145008366,3
Category_Wikipedia_sockpuppets_of_93asif.csv,18,3728101.0,18,0,17,1,0,16.555555555555557,52,37,32.27777777777778,32
Category_Wikipedia_sockpuppets_of_Wikitada.csv,422,115187552.0,153,269,120,33,0,52.24644549763033,247,36,17.798578199052134,3
Category_Wikipedia_sockpuppets_of_Ray2513.csv,84,12779072.0,28,56,11,17,0,53.476190476190474,209,20,12.702380952380953,5
Category_Wikipedia_sockpuppets_of_YuukiHirohiko.csv,561,4874551.0,269,292,244,25,0,49.50089126559715,377,50,30.686274509803923,10
Category_Wikipedia_sockpuppets_of_Art_Dominique.csv,1663,91726363.0,676,987,107,569,0,31.660853878532773,250,51,17.62236921226699,4
Category_Wikipedia_sockpuppets_of_Brian_Reddyb.csv,3642,139707862.0,854,2788,500,354,0,38.4843492586491,250,57,17.88330587589237,1
Category_Wikipedia_sockpuppets_of_LSS_2552.csv,2158,65830497.0,814,1344,500,314,0,32.877201112140874,496,49,20.089898053753476,7
Category_Wikipedia_sockpuppets_of_Znznzn.csv,9,518069.0,3,6,3,0,0,42.666666666666664,101,26,18.666666666666668,15
Category_Wikipedia_sockpuppets_of_Conflictorabuse.csv,64,20940625.0,27,37,12,15,0,37.0,167,25,20.671875,14
Category_Wikipedia_sockpuppets_of_Kileyburk.csv,95,28605064.0,61,34,37,24,0,24.8,140,27,18.33684210526316,12
Category_Wikipedia_sockpuppets_of_Justiceformen.csv,30,34749.0,13,17,4,9,0,51.46666666666667,248,13,12.333333333333334,9
Category_Wikipedia_sockpuppets_of_Mahendra27.csv,450,56986603.0,148,302,46,102,0,48.78888888888889,246,58,19.14,8
Category_Wikipedia_sockpuppets_of_DasSoumik.csv,3749,54950204.0,1617,2132,500,1117,0,50.6540410776207,496,89,21.334222459322486,4
Category_Wikipedia_sockpuppets_of_Daddycakes304020.csv,38,231459.0,24,14,16,8,0,50.78947368421053,241,34,18.394736842105264,11
Category_Wikipedia_sockpuppets_of_Amaravathiarun.csv,963,13702234.0,465,498,304,161,0,29.050882658359296,238,49,16.12357217030114,5
Category_Wikipedia_sockpuppets_of_Doors_and_Shelters_Realty.csv,10,182697.0,8,2,4,4,5,64.7,170,36,29.2,17
Category_Wikipedia_sockpuppets_of_Carnaticnerd.csv,105,5965315.0,55,50,32,23,0,37.43809523809524,170,29,20.771428571428572,9
Category_Wikipedia_sockpuppets_of_Dr_L_V_MURALIKRISHNA.csv,2,0.0,1,1,1,0,20,20.0,20,17,17.0,17
Category_Wikipedia_sockpuppets_of_R√ºdiger.Ingrid.csv,834,13061712.0,217,617,193,24,0,50.57194244604317,424,61,17.408872901678656,3
Category_Wikipedia_sockpuppets_of_TheColdPrince.csv,584,52542385.0,181,403,134,47,0,64.29965753424658,500,63,16.398972602739725,4
Category_Wikipedia_sockpuppets_of_Rahul.anchan.csv,46,18248710.0,40,6,30,10,0,17.804347826086957,192,25,22.608695652173914,13
Category_Wikipedia_sockpuppets_of_Nitzkovic.csv,133,134770288.0,86,47,75,11,0,42.6390977443609,196,53,23.0,6
Category_Wikipedia_sockpuppets_of_Dneail.csv,29,8366400.0,12,17,12,0,0,33.10344827586207,116,19,17.75862068965517,17
Category_Wikipedia_sockpuppets_of_StrattonEquities.csv,18,780244.0,9,9,9,0,0,55.111111111111114,161,23,12.88888888888889,3
Category_Wikipedia_sockpuppets_of_ColScott.csv,2439,116597123.0,725,1714,200,525,0,42.176301763017634,248,73,20.512505125051252,3
Category_Wikipedia_sockpuppets_of_Avatar_buss.csv,770,15860200.0,322,448,61,261,0,55.98831168831169,280,76,24.066233766233765,9
Category_Wikipedia_sockpuppets_of_Pumpkinona.csv,2655,41003495.0,974,1681,500,474,0,34.38606403013183,250,56,16.144256120527306,4
Category_Wikipedia_sockpuppets_of_Mfcmaster.csv,89,108329207.0,27,62,14,13,0,45.82022471910113,220,50,21.258426966292134,4
Category_Wikipedia_sockpuppets_of_Buysomebananas.csv,1018,22204844.0,433,585,166,267,0,42.86738703339882,359,60,17.19941060903733,4
Category_Wikipedia_sockpuppets_of_Tennis_scores.csv,20,32387429.0,4,16,2,2,0,43.6,114,33,21.25,19
Category_Wikipedia_sockpuppets_of_Angelo1345.csv,1183,22196033.0,463,720,394,69,0,37.89010989010989,255,61,19.36601859678783,6
Category_Wikipedia_sockpuppets_of_Karmafist.csv,1717,19080273.0,597,1120,500,97,0,44.010483401281306,250,71,21.56493884682586,4
Category_Wikipedia_sockpuppets_of_AFA.csv,1634,40277343.0,528,1106,500,28,0,38.65605875152999,243,66,19.06670746634027,2
Category_Wikipedia_sockpuppets_of_Loofus5.csv,307,1467971.0,100,207,42,58,0,44.241042345276874,245,64,21.684039087947884,4
Category_Wikipedia_sockpuppets_of_ConnectedEquality.csv,683,57959215.0,261,422,207,54,0,45.97071742313324,254,55,20.209370424597363,8
Category_Wikipedia_sockpuppets_of_Ardo27.csv,926,51904302.0,522,404,500,22,0,35.31857451403888,319,78,24.870410367170628,6
Category_Wikipedia_sockpuppets_of_BlazerBall.csv,46,31623276.0,27,19,26,1,0,48.47826086956522,250,12,12.0,12
Category_Wikipedia_sockpuppets_of_Madyanja.csv,28,100566869.0,18,10,17,1,0,52.535714285714285,200,33,33.0,33
Category_Wikipedia_sockpuppets_of_Dojarca.csv,3305,34688976.0,1000,2305,500,500,0,44.64720121028744,255,110,26.35552193645991,3
Category_Wikipedia_sockpuppets_of_Potatornado.csv,1583,11981929.0,507,1076,500,7,0,42.118761844598865,255,93,20.329121920404294,3
Category_Wikipedia_sockpuppets_of_Myperfectcousin.csv,83,12443994.0,36,47,33,3,0,45.75903614457831,214,45,21.57831325301205,12
Category_Wikipedia_sockpuppets_of_Evilkingzarkon.csv,69,88622162.0,26,43,7,19,0,38.18840579710145,229,51,23.55072463768116,10
Category_Wikipedia_sockpuppets_of_Humbierto.csv,64,23218649.0,25,39,20,5,0,57.734375,225,38,23.203125,4
Category_Wikipedia_sockpuppets_of_Sgphawker.csv,932,6150953.0,430,502,267,163,0,36.006437768240346,436,50,15.32510729613734,4
Category_Wikipedia_sockpuppets_of_Robo786.csv,371,9615037.0,124,247,108,16,0,37.33692722371968,231,52,13.21832884097035,4
Category_Wikipedia_sockpuppets_of_Anonymous_to_the_power_of_Anonymous.csv,19,251344.0,11,8,4,7,0,81.3157894736842,216,79,37.36842105263158,21
Category_Wikipedia_sockpuppets_of_Nsereko_Afriqana.csv,184,57068354.0,68,116,34,34,0,49.34782608695652,258,48,17.79891304347826,10
Category_Wikipedia_sockpuppets_of_Emanresu99.csv,202,296532588.0,62,140,47,15,0,57.193069306930695,337,73,24.797029702970296,3
Category_Wikipedia_sockpuppets_of_EpicFlame.csv,3492,177913926.0,1075,2417,500,575,0,50.83132875143185,233,67,20.190435280641466,2
Category_Wikipedia_sockpuppets_of_SamuilKrasavtsev.csv,390,135375388.0,154,236,58,96,0,42.06923076923077,307,32,17.633333333333333,8
Category_Wikipedia_sockpuppets_of_Michaelm.csv,2056,69468288.0,564,1492,500,64,0,48.28988326848249,428,46,18.007782101167315,4
Category_Wikipedia_sockpuppets_of_Syamsu.csv,843,145578161.0,269,574,154,115,0,61.85172004744958,250,50,15.124555160142348,6
Category_Wikipedia_sockpuppets_of_842U.csv,2531,550114513.0,790,1741,500,290,0,41.261556696957726,320,65,15.851442117740024,5
Category_Wikipedia_sockpuppets_of_Michaelsmv.csv,27,58683.0,20,7,16,4,0,58.666666666666664,227,24,19.40740740740741,19
Category_Wikipedia_sockpuppets_of_Jyotirmoy25.csv,742,180747519.0,192,550,160,32,0,45.16711590296496,255,63,31.72911051212938,3
Category_Wikipedia_sockpuppets_of_Coastergeekperson04.csv,2589,97505896.0,729,1860,500,229,0,46.88451139436076,243,58,21.703360370799537,3
Category_Wikipedia_sockpuppets_of_AaronAdamKhan007.csv,1361,30309850.0,706,655,239,467,0,31.47685525349008,500,51,33.28802351212344,8
Category_Wikipedia_sockpuppets_of_SwaranKumar007.csv,12,69365.0,8,4,3,5,0,48.916666666666664,196,40,24.666666666666668,20
Category_Wikipedia_sockpuppets_of_Daniel-darren_charles.csv,96,31316603.0,32,64,8,24,0,42.739583333333336,216,53,21.833333333333332,10
Category_Wikipedia_sockpuppets_of_HorseGuy83.csv,94,97408.0,38,56,23,15,0,48.691489361702125,223,47,22.351063829787233,12
Category_Wikipedia_sockpuppets_of_FudgeCake01.csv,1,0.0,1,0,1,0,91,91.0,91,13,13.0,13
Category_Wikipedia_sockpuppets_of_Potnpan123.csv,835,9766047.0,258,577,102,156,0,50.051497005988026,255,62,19.732934131736528,3
Category_Wikipedia_sockpuppets_of_Glman83.csv,221,1956053.0,85,136,84,1,0,51.80542986425339,490,32,15.452488687782806,8
Category_Wikipedia_sockpuppets_of_Qwerty800.csv,67,134941.0,25,42,7,18,0,61.208955223880594,255,38,22.567164179104477,4
Category_Wikipedia_sockpuppets_of_Akashjyotinath.csv,63,20510132.0,25,38,24,1,0,55.80952380952381,252,50,20.0,9
Category_Wikipedia_sockpuppets_of_8675309.csv,2561,197237474.0,781,1780,500,281,0,40.56501366653651,362,61,19.051151893791488,4
Category_Wikipedia_sockpuppets_of_HaleyBrand.csv,1,0.0,1,0,1,0,29,29.0,29,20,20.0,20
Category_Wikipedia_sockpuppets_of_Greenmixa.csv,69,277418.0,29,40,15,14,0,65.71014492753623,245,38,28.82608695652174,22
Category_Wikipedia_sockpuppets_of_Ffabian11.csv,1722,195267336.0,628,1094,442,186,0,37.174216027874564,500,45,18.6260162601626,1
Category_Wikipedia_sockpuppets_of_Pittbook.csv,80,44894225.0,26,54,14,12,0,86.4125,255,39,20.4,14
Category_Wikipedia_sockpuppets_of_Pkeets.csv,1295,23601853.0,519,776,500,19,0,49.02857142857143,500,97,21.616988416988416,6
Category_Wikipedia_sockpuppets_of_Zachingles22.csv,109,3199810.0,28,81,14,14,0,44.07339449541284,189,27,17.605504587155963,8
Category_Wikipedia_sockpuppets_of_Drueburgendy.csv,11,2348.0,5,6,3,2,0,26.727272727272727,133,21,21.0,21
Category_Wikipedia_sockpuppets_of_Goldenhawk_0.csv,3324,41921666.0,1035,2289,500,535,0,41.80234657039711,250,58,15.13387484957882,3
Category_Wikipedia_sockpuppets_of_Professor_of_Art.csv,1752,62030437.0,677,1075,354,323,0,53.53082191780822,255,64,23.06678082191781,5
Category_Wikipedia_sockpuppets_of_Hrips.csv,25,8171.0,20,5,17,3,0,29.76,214,14,14.0,14
Category_Wikipedia_sockpuppets_of_The_French_Are_Dorks.csv,57,2725986.0,23,34,10,13,0,61.26315789473684,230,30,17.140350877192983,10
Category_Wikipedia_sockpuppets_of_Sajjadimanian.csv,1176,46475592.0,443,733,164,279,0,42.74659863945578,328,46,15.753401360544217,5
Category_Wikipedia_sockpuppets_of_TRL_Studios.csv,612,2141970.0,215,397,88,127,0,39.49673202614379,481,60,24.65032679738562,6
Category_Wikipedia_sockpuppets_of_Meboycheese.csv,78,14233984.0,43,35,31,12,0,46.58974358974359,255,23,16.67948717948718,5
Category_Wikipedia_sockpuppets_of_Quicklyagile.csv,24,10080.0,10,14,4,6,0,60.458333333333336,232,39,17.666666666666668,10
Category_Wikipedia_sockpuppets_of_Af1grazel.csv,237,70836144.0,103,134,63,40,0,35.64556962025316,491,32,15.717299578059071,12
Category_Wikipedia_sockpuppets_of_Q22221.csv,30,501628.0,18,12,11,7,0,45.666666666666664,248,27,11.233333333333333,6
Category_Wikipedia_sockpuppets_of_UC_Bill.csv,3303,22622329.0,1040,2263,500,540,0,46.639721465334546,218,85,24.795640326975477,4
Category_Wikipedia_sockpuppets_of_Yadhu_Krishna_BP.csv,114,25493933.0,43,71,41,2,0,40.675438596491226,196,28,18.42105263157895,7
Category_Wikipedia_sockpuppets_of_Ankit_G_Dubey.csv,101,33484552.0,43,58,39,4,0,38.21782178217822,376,51,21.198019801980198,7
Category_Wikipedia_sockpuppets_of_Aurora_Prince.csv,149,31808415.0,50,99,20,30,0,42.080536912751676,191,49,22.369127516778523,12
Category_Wikipedia_sockpuppets_of_Drhunterhamilton21.csv,528,13033646.0,160,368,108,52,0,56.55492424242424,396,53,20.073863636363637,4
Category_Wikipedia_sockpuppets_of_RushdySulivan.csv,13,39120554.0,10,3,6,4,0,52.07692307692308,196,43,28.615384615384617,13
Category_Wikipedia_sockpuppets_of_EljanM.csv,926,21641480.0,348,578,291,57,0,40.77429805615551,494,50,19.64902807775378,6
Category_Wikipedia_sockpuppets_of_LondonManchester.csv,26,83443.0,11,15,6,5,0,57.23076923076923,227,26,7.3076923076923075,4
Category_Wikipedia_sockpuppets_of_SawanAroraji.csv,68,47984352.0,23,45,15,8,0,45.970588235294116,222,42,22.529411764705884,10
Category_Wikipedia_sockpuppets_of_LivingMuse.csv,1368,424165290.0,518,850,494,24,0,48.6483918128655,503,99,21.876461988304094,7
Category_Wikipedia_sockpuppets_of_Rembo01.csv,1428,5356200.0,616,812,500,116,0,34.01890756302521,496,53,21.66386554621849,5
Category_Wikipedia_sockpuppets_of_Goodreads5398.csv,320,17023714.0,102,218,41,61,0,53.74375,254,41,17.53125,8
Category_Wikipedia_sockpuppets_of_Nyanchoka.csv,49,172628.0,25,24,25,0,0,39.08163265306123,196,27,16.632653061224488,10
Category_Wikipedia_sockpuppets_of_Lovemeet_Singh.csv,32,7699906.0,10,22,10,0,0,32.28125,204,11,7.46875,5
Category_Wikipedia_sockpuppets_of_Kaufmanitay.csv,692,7983557.0,224,468,64,160,0,64.96820809248555,255,55,17.095375722543352,3
Category_Wikipedia_sockpuppets_of_Zippogeek.csv,72,117481010.0,22,50,19,3,0,47.81944444444444,196,49,16.59722222222222,3
Category_Wikipedia_sockpuppets_of_Digital_Akshit12.csv,52,87258.0,21,31,4,17,0,75.38461538461539,229,26,10.73076923076923,3
Category_Wikipedia_sockpuppets_of_Tony_Fan123.csv,719,81102170.0,175,544,174,1,0,55.07510431154381,349,54,22.407510431154382,3
Category_Wikipedia_sockpuppets_of_NiceDesktop.csv,273,17816048.0,76,197,44,32,0,68.98534798534799,500,35,13.739926739926739,3
Category_Wikipedia_sockpuppets_of_Fanofxijinping.csv,132,4891531.0,59,73,22,37,0,50.196969696969695,500,36,17.643939393939394,5
Category_Wikipedia_sockpuppets_of_Liquid_foundation.csv,280,4809016.0,104,176,90,14,0,58.767857142857146,255,27,18.042857142857144,8
Category_Wikipedia_sockpuppets_of_Asadf25.csv,1572,13302153.0,570,1002,500,70,0,40.39312977099237,406,79,23.40903307888041,4
Category_Wikipedia_sockpuppets_of_Qwertywander.csv,1901,81258935.0,669,1232,138,531,0,44.60862703840084,500,69,15.155181483429773,4
Category_Wikipedia_sockpuppets_of_Notimelivelong.csv,1410,864165.0,453,957,451,2,0,63.03120567375886,269,67,22.53404255319149,4
Category_Wikipedia_sockpuppets_of_HIUDIWID.csv,25,1941489.0,11,14,6,5,0,65.8,222,17,12.8,10
Category_Wikipedia_sockpuppets_of_Qrc2006.csv,8623,59030906.0,3125,5498,500,2625,0,38.607329235764816,218,100,24.29688043604314,3
Category_Wikipedia_sockpuppets_of_MataNui44.csv,1759,50757114.0,617,1142,373,244,0,43.55031267765776,249,67,21.288231949971575,4
Category_Wikipedia_sockpuppets_of_MirabelIkwuebe.csv,100,521615.0,51,49,38,13,0,38.75,228,68,23.19,12
Category_Wikipedia_sockpuppets_of_Groger95.csv,3883,30231744.0,866,3017,465,401,0,52.28199845480299,494,50,30.33530775173835,6
Category_Wikipedia_sockpuppets_of_Bigdong6ix9ine4our20enty.csv,8,16952.0,7,1,6,1,0,29.375,185,20,10.375,9
Category_Wikipedia_sockpuppets_of_World's_Lamest_Critic.csv,2168,171874643.0,607,1561,500,107,0,62.30581180811808,375,128,28.250461254612546,5
Category_Wikipedia_sockpuppets_of_Kindsouvik.csv,689,43614197.0,239,450,99,140,0,50.42960812772134,255,72,21.67924528301887,4
Category_Wikipedia_sockpuppets_of_Jessica_Feliciano.csv,450,5960721.0,129,321,104,25,0,41.971111111111114,253,39,17.72,3
Category_Wikipedia_sockpuppets_of_Jackdebest1.csv,667,30625112.0,359,308,250,109,0,34.844077961019494,237,44,21.863568215892055,8
Category_Wikipedia_sockpuppets_of_Micky90.csv,358,45884384.0,115,243,39,76,0,55.444134078212294,253,52,17.29608938547486,7
Category_Wikipedia_sockpuppets_of_Mint69.csv,1057,3098377.0,649,408,500,149,0,32.693472090823086,496,46,21.53926206244087,9
Category_Wikipedia_sockpuppets_of_PromX1.csv,212,4592692.0,76,136,45,31,0,50.68396226415094,193,44,18.816037735849058,4
Category_Wikipedia_sockpuppets_of_The_Oh-So_Humble_One.csv,253,8176076.0,63,190,49,14,0,43.6798418972332,205,47,20.802371541501977,3
Category_Wikipedia_sockpuppets_of_Mihi_Credite.csv,261,53964635.0,116,145,88,28,0,55.13409961685824,487,31,15.206896551724139,4
Category_Wikipedia_sockpuppets_of_Star_cricketer.csv,387,27563602.0,129,258,81,48,0,31.30749354005168,200,33,11.772609819121447,9
Category_Wikipedia_sockpuppets_of_Bolekpolivka.csv,2668,236524782.0,1056,1612,500,556,0,36.23388305847077,263,105,24.712893553223388,4
Category_Wikipedia_sockpuppets_of_Maxwellzps21.csv,91,3138376.0,28,63,24,4,0,45.79120879120879,242,25,14.56043956043956,6
Category_Wikipedia_sockpuppets_of_KumarVenati.csv,4312,7234319.0,1882,2430,500,1382,0,34.38102968460111,500,83,28.86247680890538,9
Category_Wikipedia_sockpuppets_of_Colton_Cosmic.csv,1152,101193501.0,413,739,406,7,0,51.60503472222222,255,51,26.29340277777778,8
Category_Wikipedia_sockpuppets_of_Patrick.Maxie1.csv,538,56850500.0,200,338,196,4,0,37.32156133828996,242,41,18.369888475836433,9
Category_Wikipedia_sockpuppets_of_MrBeanEdits.csv,372,7527717.0,130,242,71,59,0,55.685483870967744,374,48,26.803763440860216,7
Category_Wikipedia_sockpuppets_of_RPrinter.csv,1656,12876309.0,611,1045,500,111,0,35.32185990338164,255,56,15.978260869565217,8
Category_Wikipedia_sockpuppets_of_Expertwikiguy.csv,3438,313864778.0,1321,2117,500,821,0,48.20564281559046,484,89,20.527341477603258,4
Category_Wikipedia_sockpuppets_of_Roqui15.csv,1062,142482604.0,388,674,344,44,0,54.663841807909606,450,56,22.596045197740114,5
Category_Wikipedia_sockpuppets_of_Gregeroszlar.csv,20,33293566.0,7,13,6,1,0,54.2,195,33,28.6,22
Category_Wikipedia_sockpuppets_of_HelpSomeDoubleStandard.csv,5,199479.0,2,3,1,1,15,65.0,129,46,46.0,46
Category_Wikipedia_sockpuppets_of_Jizzy.csv,402,6913634.0,85,317,82,3,0,25.480099502487562,206,40,14.967661691542288,6
Category_Wikipedia_sockpuppets_of_Shhshdnx272773.csv,33,95788.0,17,16,14,3,0,51.24242424242424,251,36,20.636363636363637,10
Category_Wikipedia_sockpuppets_of_Palvoncha_abbai.csv,286,8747311.0,94,192,15,79,0,49.30419580419581,255,52,17.944055944055943,6
Category_Wikipedia_sockpuppets_of_Rand_Editor.csv,123,156149.0,72,51,21,51,0,20.26829268292683,192,29,21.75609756097561,13
Category_Wikipedia_sockpuppets_of_Satnap.csv,585,41039030.0,230,355,216,14,0,35.99145299145299,322,40,18.394871794871793,7
Category_Wikipedia_sockpuppets_of_Holliganman123.csv,3711,82349527.0,1361,2350,366,995,0,35.89948800862301,500,48,21.585825922931825,3
Category_Wikipedia_sockpuppets_of_Makrajdhawaj_pandey.csv,14,1081807.0,10,4,6,4,0,45.92857142857143,196,38,21.642857142857142,10
Category_Wikipedia_sockpuppets_of_Mark_Imanuel_Granados.csv,4165,165454689.0,1200,2965,401,799,0,44.29051620648259,500,58,18.963025210084034,5
Category_Wikipedia_sockpuppets_of_South_Philly.csv,2324,192237112.0,676,1648,500,176,0,41.34767641996557,250,79,28.663080895008605,4
Category_Wikipedia_sockpuppets_of_Crazy1980.csv,293,54411283.0,66,227,24,42,0,71.41296928327645,250,53,20.993174061433447,10
Category_Wikipedia_sockpuppets_of_Jazza418.csv,8,1470.0,4,4,3,1,10,46.0,173,14,12.75,9
Category_Wikipedia_sockpuppets_of_Topnespressomachine.csv,525,20060197.0,176,349,12,164,0,46.10857142857143,239,69,22.426666666666666,3
Category_Wikipedia_sockpuppets_of_Wiki_brah.csv,11967,277065503.0,4155,7812,500,3655,0,39.41806634912677,250,103,25.51784072867051,3
Category_Wikipedia_sockpuppets_of_Spaceman5478.csv,203,6982514.0,55,148,34,21,0,48.891625615763544,283,33,18.586206896551722,9
Category_Wikipedia_sockpuppets_of_Shoebringer.csv,489,7862467.0,162,327,143,19,0,45.9120654396728,371,70,31.357873210633947,9
Category_Wikipedia_sockpuppets_of_Shawndavissecure.csv,1,0.0,1,0,1,0,48,48.0,48,26,26.0,26
Category_Wikipedia_sockpuppets_of_Thatohadi.csv,106,2670385.0,39,67,19,20,0,48.471698113207545,149,53,29.50943396226415,13
Category_Wikipedia_sockpuppets_of_Emdad_Tafsir.csv,1442,123603775.0,542,900,500,42,0,55.08876560332871,501,61,17.449375866851597,5
Category_Wikipedia_sockpuppets_of_Ed.Sonaelz.csv,174,6569810.0,61,113,34,27,0,49.7183908045977,227,31,16.614942528735632,5
Category_Wikipedia_sockpuppets_of_StopChangingThisMonkey.csv,88,6837310.0,32,56,14,18,0,60.02272727272727,217,27,15.636363636363637,7
Category_Wikipedia_sockpuppets_of_Elianna_Sei.csv,42,141469.0,25,17,20,5,0,22.11904761904762,125,26,22.38095238095238,20
Category_Wikipedia_sockpuppets_of_Davidgartery.csv,6,1448.0,4,2,2,2,15,65.83333333333333,157,15,15.0,15
Category_Wikipedia_sockpuppets_of_V.Putnam.csv,69,26037300.0,43,26,22,21,0,44.01449275362319,196,70,32.405797101449274,5
Category_Wikipedia_sockpuppets_of_JeffHarlen123.csv,1486,72913437.0,462,1024,91,371,0,41.306191117092865,250,53,16.778600269179005,5
Category_Wikipedia_sockpuppets_of_Namiin_Azhar.csv,207,751397.0,66,141,32,34,0,40.111111111111114,237,48,24.082125603864736,4
Category_Wikipedia_sockpuppets_of_2636z.csv,3837,253332020.0,2291,1546,500,1791,0,42.591608027104506,407,53,20.332290852228304,9
Category_Wikipedia_sockpuppets_of_Aron&April654321.csv,310,19623925.0,115,195,25,90,0,36.880645161290325,255,34,21.125806451612902,6
Category_Wikipedia_sockpuppets_of_Lilliam_pumpernickle.csv,13,450.0,6,7,3,3,0,47.69230769230769,189,14,14.0,14
Category_Wikipedia_sockpuppets_of_Truconservative.csv,71,23789886.0,29,42,23,6,0,50.66197183098591,234,38,18.098591549295776,11
Category_Wikipedia_sockpuppets_of_Sheffno1gunner.csv,3104,28375275.0,1319,1785,500,819,0,44.94523195876289,255,75,36.379188144329895,7
Category_Wikipedia_sockpuppets_of_RoundTeen.csv,2982,31193506.0,1161,1821,500,661,0,38.01743796109993,495,64,18.740107310529847,3
Category_Wikipedia_sockpuppets_of_Iantresman.csv,1956,516179297.0,616,1340,500,116,0,49.49437627811861,298,112,26.749488752556235,3
Category_Wikipedia_sockpuppets_of_Historyou.csv,680,8374180.0,175,505,68,107,0,66.41617647058824,494,58,17.29264705882353,3
Category_Wikipedia_sockpuppets_of_MayhemMario.csv,82,30339065.0,25,57,21,4,0,39.829268292682926,233,37,31.975609756097562,10
Category_Wikipedia_sockpuppets_of_Fatlargenellyish.csv,8,461261.0,5,3,5,0,0,48.625,217,40,19.0,6
Category_Wikipedia_sockpuppets_of_Cancerresearch2014.csv,202,148268347.0,70,132,29,41,0,65.04455445544555,249,54,34.44059405940594,12
Category_Wikipedia_sockpuppets_of_Lastcodetr.csv,77,509991.0,36,41,21,15,0,49.03896103896104,497,58,39.61038961038961,9
Category_Wikipedia_sockpuppets_of_Zaki199105.csv,1584,6124763.0,555,1029,342,213,0,53.644570707070706,436,50,14.192550505050505,4
Category_Wikipedia_sockpuppets_of_Ivan_Artaza.csv,64,823868.0,30,34,14,16,0,37.4375,190,32,18.921875,8
Category_Wikipedia_sockpuppets_of_Vocale.csv,18,169587702.0,5,13,4,1,0,64.5,235,27,20.5,4
Category_Wikipedia_sockpuppets_of_Gibby_68.csv,27,2331119.0,25,2,12,13,0,21.333333333333332,117,22,19.962962962962962,17
Category_Wikipedia_sockpuppets_of_Jaysweet.csv,2080,453319749.0,516,1564,500,16,0,64.02403846153847,395,61,23.25048076923077,4
Category_Wikipedia_sockpuppets_of_Hotandspicychickenwings.csv,22,33880.0,14,8,8,6,0,55.54545454545455,211,21,10.863636363636363,7
Category_Wikipedia_sockpuppets_of_Soapspant.csv,39,3517.0,18,21,6,12,0,69.07692307692308,260,45,19.94871794871795,15
Category_Wikipedia_sockpuppets_of_VanishedUser_sdu9aya9fs654654.csv,776,101641974.0,215,561,177,38,0,62.26417525773196,255,56,15.81701030927835,3
Category_Wikipedia_sockpuppets_of_InfantryRifleman0311.csv,24,108002.0,21,3,14,7,0,59.958333333333336,154,24,24.0,24
Category_Wikipedia_sockpuppets_of_Ascentpc.csv,216,178471736.0,79,137,78,1,0,49.76851851851852,295,35,21.333333333333332,8
Category_Wikipedia_sockpuppets_of_SKauane.csv,4780,182037218.0,1762,3018,500,1262,0,63.001882845188284,498,97,17.765271966527198,1
Category_Wikipedia_sockpuppets_of_Y000000000.csv,119,10907981.0,39,80,25,14,0,56.294117647058826,251,32,18.537815126050422,6
Category_Wikipedia_sockpuppets_of_DennyMoss.csv,168,485379.0,61,107,48,13,0,30.88095238095238,233,47,23.803571428571427,5
Category_Wikipedia_sockpuppets_of_DragoLink08.csv,12885,161214587.0,3583,9302,500,3083,0,38.37004268529298,255,73,27.203880481179667,3
Category_Wikipedia_sockpuppets_of_Jurisdrew.csv,295,81332070.0,92,203,53,39,0,51.28813559322034,500,43,24.0135593220339,7
Category_Wikipedia_sockpuppets_of_NawlinzzWiki.csv,26,2940.0,9,17,2,7,0,56.03846153846154,207,31,24.923076923076923,12
Category_Wikipedia_sockpuppets_of_Mittelbau.csv,264,11837760.0,91,173,69,22,0,63.121212121212125,246,86,16.299242424242426,6
Category_Wikipedia_sockpuppets_of_Pravirmalhotra.csv,86,5832280.0,32,54,17,15,0,65.16279069767442,247,24,15.313953488372093,6
Category_Wikipedia_sockpuppets_of_BuickCenturyDriver.csv,5878,545630201.0,2193,3685,500,1693,0,48.23715549506635,453,95,27.16502211636611,3
Category_Wikipedia_sockpuppets_of_Bumbumbum2.csv,8,517.0,5,3,5,0,0,58.75,184,16,16.0,16
Category_Wikipedia_sockpuppets_of_Sayangarai32.csv,488,57298760.0,177,311,122,55,0,33.47540983606557,255,36,18.32172131147541,5
Category_Wikipedia_sockpuppets_of_Cardstand.csv,8,4019.0,6,2,2,4,0,10.875,59,22,19.375,18
Category_Wikipedia_sockpuppets_of_Daysoflight.csv,24,129258.0,11,13,6,5,0,33.875,140,35,19.208333333333332,6
Category_Wikipedia_sockpuppets_of_Hunter91.csv,401,6466402.0,166,235,138,28,0,25.468827930174562,250,49,22.251870324189525,12
Category_Wikipedia_sockpuppets_of_Amar_Jilu.csv,46,21203.0,15,31,7,8,0,38.84782608695652,161,50,19.956521739130434,7
Category_Wikipedia_sockpuppets_of_Bayreuth0115.csv,1278,30286160.0,618,660,500,118,0,32.07276995305164,494,66,33.19640062597809,9
Category_Wikipedia_sockpuppets_of_Medit16.csv,52,2620695.0,22,30,12,10,0,43.59615384615385,155,49,29.423076923076923,16
Category_Wikipedia_sockpuppets_of_Peacebigline.csv,489,22910141.0,170,319,124,46,0,60.74437627811861,255,42,17.75869120654397,5
Category_Wikipedia_sockpuppets_of_Pride_Purple_Group.csv,13,14003.0,8,5,7,1,0,62.15384615384615,496,28,23.384615384615383,22
Category_Wikipedia_sockpuppets_of_MosesM1017.csv,317,2569039.0,91,226,91,0,0,47.63406940063091,255,41,14.201892744479496,2
Category_Wikipedia_sockpuppets_of_„ÅΩ„Çì„Åö„ÇÅ„Åó.csv,7,44678.0,4,3,4,0,19,54.857142857142854,72,13,12.571428571428571,12
Category_Wikipedia_sockpuppets_of_PHYDOZX.csv,53,1050433.0,14,39,13,1,0,102.84905660377359,226,31,15.622641509433961,8
Category_Wikipedia_sockpuppets_of_Brian_dalee.csv,729,69176945.0,185,544,76,109,0,47.11934156378601,248,37,15.947873799725652,6
Category_Wikipedia_sockpuppets_of_BlueRobe.csv,1663,8099949.0,794,869,500,294,0,40.28322309079976,250,100,25.924834636199638,13
Category_Wikipedia_sockpuppets_of_SniperHat.csv,20,2590967.0,20,0,20,0,0,23.8,196,16,16.0,16
Category_Wikipedia_sockpuppets_of_Godhctaw.csv,25,5683576.0,17,8,7,10,0,74.72,164,20,20.0,20
Category_Wikipedia_sockpuppets_of_HankMoodyTZ.csv,4568,224842900.0,1356,3212,500,856,0,22.342819614711033,500,57,17.237302977232925,6
Category_Wikipedia_sockpuppets_of_Ney_ney_changa.csv,45,852233.0,17,28,16,1,0,30.133333333333333,137,28,20.355555555555554,13
Category_Wikipedia_sockpuppets_of_Allgoodalrightalright.csv,23,3182.0,15,8,10,5,0,107.65217391304348,216,15,15.0,15
Category_Wikipedia_sockpuppets_of_Sam9980.csv,129,4225450.0,47,82,31,16,0,55.51937984496124,355,46,14.782945736434108,6
Category_Wikipedia_sockpuppets_of_ReaperLonely.csv,257,12044040.0,75,182,39,36,0,52.98054474708171,308,65,17.929961089494164,1
Category_Wikipedia_sockpuppets_of_Varsha1990.csv,262,375755920.0,94,168,91,3,0,40.847328244274806,215,53,26.5381679389313,12
Category_Wikipedia_sockpuppets_of_Opp2.csv,1170,71430127.0,582,588,500,82,0,49.78290598290598,212,42,19.147008547008546,6
Category_Wikipedia_sockpuppets_of_Yourbasis101.csv,256,55665476.0,83,173,68,15,0,35.4140625,200,62,27.16796875,4
Category_Wikipedia_sockpuppets_of_RogerPTStevenson.csv,720,36510751.0,247,473,23,224,0,40.90555555555556,252,37,16.288888888888888,3
Category_Wikipedia_sockpuppets_of_Ablasaur.csv,381,11516914.0,123,258,39,84,0,45.43569553805774,500,56,19.46194225721785,6
Category_Wikipedia_sockpuppets_of_Stonegeek123.csv,1,0.0,1,0,1,0,10,10.0,10,6,6.0,6
Category_Wikipedia_sockpuppets_of_Zalgt.csv,1475,61538467.0,457,1018,276,181,0,30.74576271186441,217,70,20.31322033898305,1
Category_Wikipedia_sockpuppets_of_Inner_strength_from_love.csv,301,188872798.0,98,203,53,45,0,39.30232558139535,254,29,10.990033222591363,4
Category_Wikipedia_sockpuppets_of_Oneononetvseries.csv,1691,4650236.0,508,1183,500,8,0,36.0816085156712,247,59,21.82909520993495,5
Category_Wikipedia_sockpuppets_of_Loveroftheworld14710.csv,1685,60472714.0,513,1172,500,13,0,43.88486646884273,271,72,17.331750741839762,3
Category_Wikipedia_sockpuppets_of_Soberknight.csv,113,1197643.0,38,75,38,0,0,47.991150442477874,227,62,26.168141592920353,10
Category_Wikipedia_sockpuppets_of_Mcv369.csv,128,131628845.0,32,96,30,2,0,43.84375,228,35,25.2578125,13
Category_Wikipedia_sockpuppets_of_History_of_the_Earth_and_World_and_history_and_history.csv,177,2029662.0,76,101,43,33,0,41.01129943502825,281,64,14.288135593220339,7
Category_Wikipedia_sockpuppets_of_Penhaot10028.csv,618,10230669.0,187,431,69,118,0,45.71844660194175,400,45,19.29935275080906,7
Category_Wikipedia_sockpuppets_of_Barackbush.csv,142,4237330.0,47,95,33,14,0,49.2112676056338,226,43,21.007042253521128,7
Category_Wikipedia_sockpuppets_of_Shivamshaiv.csv,37,1874154.0,18,19,10,8,0,62.0,187,24,16.83783783783784,11
Category_Wikipedia_sockpuppets_of_AbsoluteGleek92.csv,4941,69314111.0,1111,3830,500,611,0,38.265735681036226,255,58,20.156041287188827,2
Category_Wikipedia_sockpuppets_of_Vladpulbere681.csv,60,8743093.0,22,38,8,14,0,49.21666666666667,222,32,16.833333333333332,7
Category_Wikipedia_sockpuppets_of_Mirvate.csv,221,28439500.0,91,130,63,28,0,24.149321266968325,196,24,12.30316742081448,8
Category_Wikipedia_sockpuppets_of_DavidYork71.csv,18159,357125483.0,5363,12796,500,4863,0,48.47155680378876,325,104,20.593975439176166,1
Category_Wikipedia_sockpuppets_of_Ghxsshny.csv,3,1371.0,2,1,1,1,13,81.33333333333333,217,14,14.0,14
Category_Wikipedia_sockpuppets_of_WikAdvisor.csv,134,5974840.0,85,49,84,1,0,37.58955223880597,170,20,10.85820895522388,9
Category_Wikipedia_sockpuppets_of_David3829128.csv,415,27109797.0,218,197,217,1,0,39.96867469879518,494,63,26.228915662650603,5
Category_Wikipedia_sockpuppets_of_Judenwatch.csv,68,362027.0,21,47,14,7,0,53.9264705882353,155,44,26.279411764705884,11
Category_Wikipedia_sockpuppets_of_WorldwideBallcaps.csv,2101,83468353.0,559,1542,500,59,0,49.60590195145169,483,61,16.486910994764397,3
Category_Wikipedia_sockpuppets_of_North_Carolina_Vandal.csv,6,53541411.0,2,4,1,1,0,41.333333333333336,118,15,10.0,5
Category_Wikipedia_sockpuppets_of_RAZIQTALASH.csv,206,6079296.0,71,135,24,47,0,36.407766990291265,227,27,18.16504854368932,6
Category_Wikipedia_sockpuppets_of_Prof.Dr.Ikram_Ullah_Khan.csv,99,1168341.0,46,53,16,30,0,34.55555555555556,237,34,19.272727272727273,12
Category_Wikipedia_sockpuppets_of_Jor27.csv,7,1075.0,4,3,4,0,0,41.714285714285715,110,41,26.142857142857142,15
Category_Wikipedia_sockpuppets_of_Hashem_sfarim.csv,2506,15170561.0,1034,1472,500,534,0,47.910614525139664,255,54,20.492817238627296,5
Category_Wikipedia_sockpuppets_of_MosMusy.csv,2277,322161167.0,660,1617,500,160,0,49.397452788757136,432,58,18.232323232323232,5
Category_Wikipedia_sockpuppets_of_Novalis69.csv,3009,496698750.0,818,2191,500,318,0,47.32967763376537,434,50,16.84413426387504,4
Category_Wikipedia_sockpuppets_of_Alongthesoar.csv,384,48127095.0,83,301,56,27,0,71.3125,478,62,25.2890625,5
Category_Wikipedia_sockpuppets_of_Rosejones1411.csv,15,2103.0,6,9,4,2,4,74.73333333333333,192,23,13.8,10
Category_Wikipedia_sockpuppets_of_Meowy.csv,1491,93633382.0,540,951,500,40,0,49.63983903420523,250,66,22.59423205902079,4
Category_Wikipedia_sockpuppets_of_VST_Mobility_Solutions.csv,18,5016405.0,12,6,7,5,0,31.27777777777778,157,32,24.666666666666668,14
Category_Wikipedia_sockpuppets_of_Robertbenjmain.csv,153,29294314.0,54,99,34,20,0,56.48366013071895,496,35,17.058823529411764,4
Category_Wikipedia_sockpuppets_of_MikeTerrance.csv,27,3928.0,12,15,11,1,0,44.96296296296296,153,38,22.85185185185185,11
Category_Wikipedia_sockpuppets_of_Athanasious01.csv,120,37475411.0,48,72,42,6,0,61.15,294,30,18.325,8
Category_Wikipedia_sockpuppets_of_Jt029350.csv,699,18197582.0,254,445,65,189,0,50.85407725321888,253,62,23.320457796852647,7
Category_Wikipedia_sockpuppets_of_MickMacNee.csv,2382,298257190.0,719,1663,500,219,0,50.79219143576826,255,74,32.46767422334173,7
Category_Wikipedia_sockpuppets_of_Bitterpillsandalcohol.csv,2072,173845215.0,558,1514,98,460,0,38.24855212355212,255,53,14.566119691119692,5
Category_Wikipedia_sockpuppets_of_ZamokuhleG5.csv,7,98631.0,3,4,3,0,0,40.857142857142854,108,21,15.285714285714286,13
Category_Wikipedia_sockpuppets_of_Smith.katie.csv,356,30882733.0,81,275,12,69,0,43.907303370786515,232,47,12.654494382022472,4
Category_Wikipedia_sockpuppets_of_Harrison8.csv,12,30920.0,8,4,8,0,0,47.0,238,17,17.0,17
Category_Wikipedia_sockpuppets_of_Sadokpam_Axn.csv,23,109367.0,13,10,10,3,0,55.56521739130435,194,48,22.0,9
Category_Wikipedia_sockpuppets_of_Arnabb.bannerjee.csv,985,8657324.0,277,708,134,143,0,35.03959390862944,255,49,18.624365482233504,4
Category_Wikipedia_sockpuppets_of_Wk7sn.csv,411,99426956.0,98,313,71,27,0,58.68369829683698,285,48,14.987834549878345,7
Category_Wikipedia_sockpuppets_of_Muxhi.csv,8,108595.0,6,2,5,1,0,33.5,89,16,13.0,10
Category_Wikipedia_sockpuppets_of_Hydrocolloid.csv,244,217494103.0,71,173,44,27,0,57.39344262295082,255,59,21.15573770491803,3
Category_Wikipedia_sockpuppets_of_Salik_Mir.csv,46,40739020.0,18,28,14,4,0,64.52173913043478,185,33,28.217391304347824,14
Category_Wikipedia_sockpuppets_of_RogVikaaa.csv,654,36618129.0,196,458,18,178,0,56.55045871559633,359,64,18.495412844036696,4
Category_Wikipedia_sockpuppets_of_Mcelite.csv,4573,106820355.0,1475,3098,500,975,0,58.549529849114364,449,95,22.541220205554342,4
Category_Wikipedia_sockpuppets_of_Pajko123.csv,104,413640.0,37,67,13,24,0,81.11538461538461,240,66,20.903846153846153,9
Category_Wikipedia_sockpuppets_of_ÿ≥ÿ®_ÿ≥€í_ÿ®⁄ë€å_⁄Ø⁄ëÿ®⁄ë.csv,1656,2471839.0,675,981,500,175,0,38.490338164251206,500,65,17.81461352657005,4
Category_Wikipedia_sockpuppets_of_Sietecolores.csv,3795,76650823.0,1337,2458,500,837,0,53.284584980237156,500,84,17.9133069828722,4
Category_Wikipedia_sockpuppets_of_Balthazarduju.csv,7660,561892160.0,1696,5964,500,1196,0,45.81657963446475,500,82,15.934073107049608,3
Category_Wikipedia_sockpuppets_of_Beds16.csv,21,1289784.0,8,13,7,1,0,30.0,192,88,49.61904761904762,18
Category_Wikipedia_sockpuppets_of_Chticalifornia.csv,27,1570193.0,17,10,14,3,0,28.555555555555557,140,31,19.62962962962963,14
Category_Wikipedia_sockpuppets_of_WikiVandal.csv,2446,386480239.0,706,1740,217,489,0,49.633278822567455,259,62,17.67988552739166,2
Category_Wikipedia_sockpuppets_of_WP_MANIKHANTA.csv,1795,16075404.0,549,1246,500,49,0,43.986072423398326,255,56,19.67242339832869,4
Category_Wikipedia_sockpuppets_of_Iamsaa.csv,4202,96841617.0,1432,2770,500,932,0,42.64588291289862,255,92,17.762970014278913,3
Category_Wikipedia_sockpuppets_of_Nsmutte.csv,2165,199909993.0,615,1550,20,595,0,55.19445727482679,374,69,28.838337182448036,4
Category_Wikipedia_sockpuppets_of_As15878.csv,104,1204526.0,57,47,52,5,0,13.451923076923077,112,37,24.39423076923077,10
Category_Wikipedia_sockpuppets_of_Careueyes.csv,16,446696.0,7,9,5,2,0,68.9375,143,27,20.875,13
Category_Wikipedia_sockpuppets_of_Ashleyleggat404.csv,1212,71811063.0,459,753,401,58,0,32.976897689768975,232,41,25.602310231023104,6
Category_Wikipedia_sockpuppets_of_Chrissy_smith16.csv,202,1874889.0,166,36,30,136,0,32.554455445544555,230,29,21.940594059405942,17
Category_Wikipedia_sockpuppets_of_DJWalia.csv,493,4238411.0,171,322,171,0,0,35.14198782961461,243,45,16.06896551724138,5
Category_Wikipedia_sockpuppets_of_Vermont_Hardcore_Punk.csv,141,3581128.0,70,71,51,19,0,55.94326241134752,196,54,28.588652482269502,17
Category_Wikipedia_sockpuppets_of_KJ12102.csv,33,52477398.0,9,24,6,3,0,44.63636363636363,156,14,14.0,14
Category_Wikipedia_sockpuppets_of_Biog.csv,195,280849179.0,59,136,39,20,0,57.333333333333336,210,57,20.851282051282052,11
Category_Wikipedia_sockpuppets_of_Thomas.young234.csv,4284,94606744.0,1559,2725,237,1322,0,27.439075630252102,238,66,22.15732959850607,5
Category_Wikipedia_sockpuppets_of_ÿ®ŸàŸÉŸàÿ≥.csv,167,9013029.0,79,88,24,55,0,70.07185628742515,509,45,23.269461077844312,16
Category_Wikipedia_sockpuppets_of_Bosna.csv,254,11974596.0,74,180,48,26,0,35.811023622047244,198,50,17.358267716535433,5
Category_Wikipedia_sockpuppets_of_Edipo_yocasta.csv,1053,48823069.0,368,685,305,63,0,38.23361823361823,250,27,12.931623931623932,5
Category_Wikipedia_sockpuppets_of_Franklylucky.csv,34,25697297.0,25,9,25,0,0,38.73529411764706,210,18,12.705882352941176,12
Category_Wikipedia_sockpuppets_of_Kishor_salvi.csv,234,168306910.0,84,150,32,52,0,38.111111111111114,331,43,20.726495726495727,6
Category_Wikipedia_sockpuppets_of_Turtletop.csv,1878,30855835.0,838,1040,417,421,0,50.32002129925453,255,49,26.617678381256656,9
Category_Wikipedia_sockpuppets_of_Plantithe.csv,3,571.0,2,1,1,1,17,101.0,196,19,15.666666666666666,14
Category_Wikipedia_sockpuppets_of_Hilcee.csv,7,769.0,5,2,3,2,0,52.857142857142854,163,10,10.0,10
Category_Wikipedia_sockpuppets_of_Rumble74.csv,1883,28765134.0,717,1166,500,217,0,41.17419012214551,250,41,14.89537971322358,5
Category_Wikipedia_sockpuppets_of_Jayden_Quenano.csv,606,10402460.0,214,392,121,93,0,38.62376237623762,496,56,22.643564356435643,5
Category_Wikipedia_sockpuppets_of_QueensDivision.csv,1040,10481948.0,294,746,145,149,0,56.44519230769231,500,78,26.17596153846154,6
Category_Wikipedia_sockpuppets_of_Quickbase.csv,10,2411723.0,8,2,5,3,0,61.0,253,9,9.0,9
Category_Wikipedia_sockpuppets_of_Clementine2015.2015.csv,10,966.0,8,2,5,3,39,79.1,196,47,35.2,22
Category_Wikipedia_sockpuppets_of_Dragovit.csv,2927,52635162.0,723,2204,500,223,0,51.92791253843526,500,51,22.092586265801163,6
Category_Wikipedia_sockpuppets_of_Mortas_Nemarus.csv,22,3004118.0,8,14,3,5,0,29.363636363636363,100,24,21.5,15
Category_Wikipedia_sockpuppets_of_Wikophile.csv,2480,289339444.0,813,1667,500,313,0,48.83709677419355,260,95,29.508467741935483,6
Category_Wikipedia_sockpuppets_of_Phrasia.csv,6645,547101317.0,1874,4771,500,1374,0,41.263205417607224,496,79,20.90188111361926,5
Category_Wikipedia_sockpuppets_of_Advaith_Anil_Kumar.csv,316,5067450.0,121,195,16,105,0,28.212025316455698,283,49,24.72151898734177,9
Category_Wikipedia_sockpuppets_of_Korn-Muffin.csv,824,6453125.0,172,652,156,16,0,33.70509708737864,212,85,17.531553398058254,2
Category_Wikipedia_sockpuppets_of_Wildlover22.csv,1921,51918491.0,594,1327,500,94,0,39.64497657470068,500,50,18.772514315460697,4
Category_Wikipedia_sockpuppets_of_Ali_Muratovic.csv,2657,10434365.0,752,1905,500,252,0,29.249529544599174,255,64,14.446368084305607,3
Category_Wikipedia_sockpuppets_of_Bot-AutomatedScript(No-Reply).csv,12,579449.0,4,8,3,1,0,50.916666666666664,159,27,21.75,18
Category_Wikipedia_sockpuppets_of_Cmmmm.csv,2754,85428073.0,976,1778,500,476,0,52.18881626724764,255,72,24.079883805374003,5
Category_Wikipedia_sockpuppets_of_TheUserOfWiki14Robbie.csv,4479,30091342.0,1466,3013,500,966,0,44.07747265014512,268,72,16.757311899977672,4
Category_Wikipedia_sockpuppets_of_Albrighton_Titon.csv,518,16078438.0,226,292,170,56,0,60.1988416988417,303,64,21.714285714285715,4
Category_Wikipedia_sockpuppets_of_Fadiga09.csv,1645,41314112.0,535,1110,500,35,0,36.728267477203644,255,61,20.005471124620062,7
Category_Wikipedia_sockpuppets_of_Pika62221.csv,210,6273945.0,61,149,60,1,0,50.13809523809524,199,43,17.614285714285714,4
Category_Wikipedia_sockpuppets_of_Hunter_Warringham.csv,60,1625067.0,41,19,27,14,0,25.5,160,37,27.2,14
Category_Wikipedia_sockpuppets_of_Ghazi_ut_din.csv,451,29459505.0,111,340,62,49,0,55.886917960088695,493,29,14.849223946784923,3
Category_Wikipedia_sockpuppets_of_Intsar_Khatana.csv,422,22122424.0,151,271,79,72,0,55.38151658767772,299,26,12.938388625592417,6
Category_Wikipedia_sockpuppets_of_Mutley100.csv,50,596558.0,12,38,7,5,0,67.14,224,21,9.0,4
Category_Wikipedia_sockpuppets_of_Ginger1978.csv,3,2613.0,3,0,2,1,38,145.33333333333334,199,19,16.333333333333332,15
Category_Wikipedia_sockpuppets_of_Jizzygizzyfoshizzyyy.csv,672,5374398.0,230,442,202,28,0,57.55654761904762,500,79,21.27827380952381,5
Category_Wikipedia_sockpuppets_of_Omegacommand.csv,527,65359621.0,174,353,86,88,0,38.59392789373814,217,56,20.798861480075903,5
Category_Wikipedia_sockpuppets_of_Davebrayfb.csv,1456,64792455.0,327,1129,255,72,0,45.25686813186813,255,74,19.067307692307693,5
Category_Wikipedia_sockpuppets_of_Franklin.vp.csv,2427,32335437.0,829,1598,500,329,0,52.07210548001648,246,97,23.545941491553357,4
Category_Wikipedia_sockpuppets_of_DaReaFantasticMrFox.csv,14,73621.0,11,3,4,7,0,37.5,199,37,30.714285714285715,20
Category_Wikipedia_sockpuppets_of_Mel.monro.csv,60,83379981.0,32,28,29,3,0,61.266666666666666,301,19,19.0,19
Category_Wikipedia_sockpuppets_of_Yourmom3003.csv,8,421.0,5,3,5,0,0,58.0,161,45,26.0,19
Category_Wikipedia_sockpuppets_of_Daniellenavy.csv,20,575431.0,12,8,11,1,16,41.95,200,22,18.5,12
Category_Wikipedia_sockpuppets_of_8-f4t-r4t-8.csv,85,3238860.0,56,29,50,6,0,53.741176470588236,255,47,16.858823529411765,6
Category_Wikipedia_sockpuppets_of_Shikagami03.csv,1430,10792367.0,515,915,500,15,0,18.655244755244755,496,47,15.545454545454545,6
Category_Wikipedia_sockpuppets_of_Bosniak.csv,1593,34738761.0,500,1093,500,0,0,46.379786566227246,253,67,20.659761456371626,4
Category_Wikipedia_sockpuppets_of_EricSnow3.csv,123,108186523.0,39,84,35,4,0,42.08943089430894,223,28,14.317073170731707,4
Category_Wikipedia_sockpuppets_of_Ramesh_shankar4432.csv,133,11590343.0,49,84,5,44,0,37.91729323308271,250,28,13.571428571428571,7
Category_Wikipedia_sockpuppets_of_Snoopdobi.csv,1,0.0,1,0,1,0,31,31.0,31,17,17.0,17
Category_Wikipedia_sockpuppets_of_Adamstony3333.csv,53,22104521.0,16,37,9,7,0,45.79245283018868,170,35,19.245283018867923,1
Category_Wikipedia_sockpuppets_of_Tassosl.csv,174,114384197.0,57,117,40,17,0,49.48275862068966,197,55,20.93103448275862,9
Category_Wikipedia_sockpuppets_of_Johnbuchta.csv,6,640296.0,5,1,3,2,0,31.333333333333332,140,12,12.0,12
Category_Wikipedia_sockpuppets_of_LiamSAFC.csv,41,1551435.0,10,31,9,1,0,30.4390243902439,132,25,19.48780487804878,11
Category_Wikipedia_sockpuppets_of_Katie_Jepsen.csv,36,538072.0,17,19,7,10,0,78.86111111111111,296,25,17.083333333333332,14
Category_Wikipedia_sockpuppets_of_Cristianpogi678.csv,45,30551.0,24,21,24,0,0,51.6,312,40,19.6,12
Category_Wikipedia_sockpuppets_of_Thimoty_Freick.csv,2277,74550737.0,500,1777,249,251,0,45.97891963109355,443,61,21.65788317962231,8
Category_Wikipedia_sockpuppets_of_Lisahamilton90.csv,48,3080346.0,13,35,7,6,0,58.6875,237,19,14.0,6
Category_Wikipedia_sockpuppets_of_Fethermintz.csv,572,62888942.0,154,418,129,25,0,43.03671328671329,369,53,19.03146853146853,3
Category_Wikipedia_sockpuppets_of_Carthage44.csv,2909,305275301.0,1143,1766,500,643,0,41.06015812994156,351,70,25.348917153661052,7
Category_Wikipedia_sockpuppets_of_Pinkydsos.csv,46,20050.0,14,32,14,0,0,40.65217391304348,231,22,14.26086956521739,12
Category_Wikipedia_sockpuppets_of_Annmorgan24.csv,98,4942592.0,40,58,35,5,0,63.214285714285715,498,44,18.040816326530614,6
Category_Wikipedia_sockpuppets_of_Dubai_knowsitsall.csv,104,2130194.0,56,48,32,24,0,40.54807692307692,319,35,30.067307692307693,18
Category_Wikipedia_sockpuppets_of_Boater87.csv,1,0.0,1,0,1,0,10,10.0,10,18,18.0,18
Category_Wikipedia_sockpuppets_of_Raptorgthegod.csv,2,51.0,2,0,2,0,0,0.0,0,8,8.0,8
Category_Wikipedia_sockpuppets_of_Wattlebird.csv,1651,217125744.0,506,1145,500,6,0,50.20956995760145,273,67,25.125378558449423,7
Category_Wikipedia_sockpuppets_of_Countybrooklyn.csv,6,103849.0,3,3,2,1,11,62.333333333333336,133,65,65.0,65
Category_Wikipedia_sockpuppets_of_Gudu4.csv,225,36963606.0,118,107,86,32,0,42.45333333333333,237,51,14.657777777777778,6
Category_Wikipedia_sockpuppets_of_CosmicEmperor.csv,5906,263664059.0,2173,3733,500,1673,0,60.65509651202167,382,100,27.910091432441586,4
Category_Wikipedia_sockpuppets_of_Ilikebigformulas.csv,16,2395.0,6,10,6,0,0,80.875,192,30,25.375,19
Category_Wikipedia_sockpuppets_of_Jeremybloomfan.csv,57,1641446.0,44,13,28,16,0,69.45614035087719,496,17,13.403508771929825,12
Category_Wikipedia_sockpuppets_of_Siddhant_Ghegadmal.csv,217,62408515.0,56,161,30,26,0,45.755760368663594,492,47,18.953917050691246,7
Category_Wikipedia_sockpuppets_of_Faisal71945.csv,461,9562741.0,152,309,136,16,0,45.80694143167028,306,39,22.010845986984815,8
Category_Wikipedia_sockpuppets_of_Kigenkigen.csv,158,92031569.0,52,106,36,16,0,50.860759493670884,492,51,24.196202531645568,15
Category_Wikipedia_sockpuppets_of_Str8t_arrow.csv,247,278696718.0,77,170,23,54,0,53.008097165991906,235,35,16.10931174089069,10
Category_Wikipedia_sockpuppets_of_AH999.csv,7188,177486954.0,2012,5176,500,1512,0,45.723427935447965,426,83,17.050918196994992,3
Category_Wikipedia_sockpuppets_of_ESCStudent774441.csv,550,2675976.0,200,350,200,0,0,31.065454545454546,200,49,20.783636363636365,12
Category_Wikipedia_sockpuppets_of_Noelscott515.csv,28,85497.0,20,8,18,2,0,23.464285714285715,127,22,7.142857142857143,5
Category_Wikipedia_sockpuppets_of_RedSkyParka.csv,386,21888614.0,102,284,102,0,0,32.26424870466321,248,43,20.38082901554404,10
Category_Wikipedia_sockpuppets_of_Jabrona.csv,3019,234126461.0,797,2222,500,297,0,44.79927128188142,500,75,22.1517058628685,4
Category_Wikipedia_sockpuppets_of_JDamanWP.csv,1476,376084074.0,519,957,500,19,0,41.83130081300813,297,71,27.268970189701896,4
Category_Wikipedia_sockpuppets_of_Gingerfield_rocks.csv,1488,104988314.0,500,988,500,0,0,31.09005376344086,220,58,13.21236559139785,3
Category_Wikipedia_sockpuppets_of_CAD_Red_Plaanet.csv,1385,12438903.0,398,987,37,361,0,42.336462093862814,255,81,18.19927797833935,4
Category_Wikipedia_sockpuppets_of_Uruuru.csv,147,452873.0,55,92,23,32,0,71.96598639455782,189,35,17.58503401360544,8
Category_Wikipedia_sockpuppets_of_Frog_Tamer.csv,216,2607879.0,64,152,20,44,0,59.39351851851852,468,50,29.953703703703702,13
Category_Wikipedia_sockpuppets_of_Esbjnow.csv,97,2218171.0,44,53,43,1,0,51.36082474226804,448,62,33.94845360824742,12
Category_Wikipedia_sockpuppets_of_Oficialtowhid.csv,2081,21158360.0,679,1402,500,179,0,63.512253724171075,500,76,24.50408457472369,5
Category_Wikipedia_sockpuppets_of_ChrisRock1998.csv,572,9740039.0,227,345,160,67,0,37.76573426573427,255,50,39.11888111888112,7
Category_Wikipedia_sockpuppets_of_TheWordFixer.csv,236,10569933.0,59,177,34,25,0,52.402542372881356,253,50,14.322033898305085,3
Category_Wikipedia_sockpuppets_of_Vherter.csv,17,28154560.0,15,2,10,5,0,43.294117647058826,196,21,10.764705882352942,5
Category_Wikipedia_sockpuppets_of_Who_R_U_.csv,27,6548781.0,8,19,7,1,0,71.96296296296296,171,32,13.074074074074074,4
Category_Wikipedia_sockpuppets_of_Orugaberuteika.csv,532,15869922.0,202,330,140,62,0,56.50187969924812,309,40,17.00187969924812,4
Category_Wikipedia_sockpuppets_of_DescendantsFanatic2019.csv,136,34925759.0,42,94,19,23,0,41.38970588235294,265,44,21.455882352941178,7
Category_Wikipedia_sockpuppets_of_Sanad_real.csv,177,31438096.0,71,106,53,18,0,46.80225988700565,345,46,27.6045197740113,15
Category_Wikipedia_sockpuppets_of_MikeHalpert.csv,134,5853053.0,43,91,12,31,0,35.156716417910445,199,31,15.582089552238806,8
Category_Wikipedia_sockpuppets_of_LocalLANerd.csv,1942,8988432.0,548,1394,500,48,0,41.54994850669413,255,69,22.43923789907312,4
Category_Wikipedia_sockpuppets_of_Restaru.csv,35,252180.0,21,14,16,5,0,36.371428571428574,216,17,12.571428571428571,11
Category_Wikipedia_sockpuppets_of_Zhenfund.csv,5,740084.0,3,2,2,1,31,74.4,130,8,8.0,8
Category_Wikipedia_sockpuppets_of_Jeremydandrus.csv,82,2182370.0,25,57,20,5,0,43.829268292682926,150,53,23.902439024390244,12
Category_Wikipedia_sockpuppets_of_Themaker1.csv,1375,12370288.0,559,816,237,322,0,60.22981818181818,306,84,20.55709090909091,4
Category_Wikipedia_sockpuppets_of_Aziz_bader.csv,815,70877225.0,205,610,175,30,0,55.296932515337424,500,54,25.595092024539877,6
Category_Wikipedia_sockpuppets_of_Anujanu81.csv,79,145045047.0,18,61,16,2,0,40.67088607594937,205,37,16.367088607594937,5
"Category_Wikipedia_sockpuppets_of_The_fool_doth_think_he_is_wise,_but_the_wise_man_knows_himself_to_be_a_fool..csv",18,111232.0,10,8,10,0,0,50.22222222222222,193,81,77.22222222222223,73
Category_Wikipedia_sockpuppets_of_Tooj117.csv,2658,55450385.0,804,1854,315,489,0,37.106471030850265,362,73,15.168924003009781,1
Category_Wikipedia_sockpuppets_of_Africanhistory1930.csv,1562,13181920.0,600,962,281,319,0,41.10691421254801,500,50,18.606274007682458,4
Category_Wikipedia_sockpuppets_of_WereWolf.csv,1809,306221532.0,511,1298,500,11,0,48.308457711442784,395,78,16.41127694859038,3
Category_Wikipedia_sockpuppets_of_Splat5572.csv,1204,886290.0,500,704,500,0,0,42.44269102990033,219,62,25.07890365448505,6
Category_Wikipedia_sockpuppets_of_1-1-2-2-SixtySix.csv,1573,816957.0,519,1054,219,300,0,38.14876033057851,496,61,20.66497139224412,3
Category_Wikipedia_sockpuppets_of_Shreeshampandey.csv,46,113016633.0,14,32,9,5,0,54.97826086956522,232,70,29.608695652173914,16
Category_Wikipedia_sockpuppets_of_Joaquinito01.csv,880,39763402.0,272,608,56,216,0,58.160227272727276,224,71,24.369318181818183,4
Category_Wikipedia_sockpuppets_of_Paulsubhojit.csv,420,4958103.0,264,156,260,4,0,32.82857142857143,253,40,12.426190476190476,7
Category_Wikipedia_sockpuppets_of_The_spanish_wizard.csv,40,111888534.0,9,31,9,0,0,48.125,222,33,19.075,9
Category_Wikipedia_sockpuppets_of_Blt8472.csv,11,2861.0,5,6,4,1,0,30.09090909090909,157,51,51.0,51
Category_Wikipedia_sockpuppets_of_Pyro227.csv,25,5933778.0,5,20,5,0,0,62.92,137,9,4.52,2
Category_Wikipedia_sockpuppets_of_Skull_'n'_Femurs.csv,1128,3959970.0,536,592,500,36,0,35.526595744680854,200,28,14.743794326241135,6
Category_Wikipedia_sockpuppets_of_Kinggam3r679popo999.csv,6,620.0,4,2,3,1,0,63.666666666666664,205,12,12.0,12
Category_Wikipedia_sockpuppets_of_Dualipa95.csv,1494,17222224.0,495,999,456,39,0,34.6954484605087,317,57,18.738286479250334,9
Category_Wikipedia_sockpuppets_of_Peasesoon.csv,237,1296188.0,82,155,66,16,0,43.68354430379747,252,65,20.09704641350211,5
Category_Wikipedia_sockpuppets_of_H·ªì_ƒê·ª©c_H·∫£i.csv,569,89369002.0,208,361,181,27,0,51.42530755711775,496,31,13.040421792618629,4
Category_Wikipedia_sockpuppets_of_TheChallenge01.csv,1,0.0,1,0,1,0,27,27.0,27,24,24.0,24
Category_Wikipedia_sockpuppets_of_VillegasD2002.csv,3829,212358844.0,887,2942,500,387,0,44.63619744058501,400,60,19.94855053538783,3
Category_Wikipedia_sockpuppets_of_Arifhasan23.csv,641,67982261.0,176,465,71,105,0,52.06552262090484,255,53,21.97191887675507,4
Category_Wikipedia_sockpuppets_of_Ddorai3.csv,210,11718182.0,46,164,17,29,0,36.833333333333336,233,43,17.952380952380953,8
Category_Wikipedia_sockpuppets_of_Makks2010.csv,2946,3848387.0,936,2010,500,436,0,52.48506449422946,500,104,18.748472505091648,2
Category_Wikipedia_sockpuppets_of_Blastikus.csv,4596,335997128.0,1867,2729,500,1367,0,47.47563098346388,255,50,21.793298520452566,5
Category_Wikipedia_sockpuppets_of_Johanricher.csv,62,209373738.0,16,46,15,1,0,51.564516129032256,203,57,23.838709677419356,4
Category_Wikipedia_sockpuppets_of_Why_Other.csv,3335,15932708.0,950,2385,500,450,0,49.52893553223388,250,62,28.597001499250375,4
Category_Wikipedia_sockpuppets_of_Keerthi78.csv,90,482005.0,66,24,47,19,0,37.67777777777778,178,30,11.988888888888889,7
Category_Wikipedia_sockpuppets_of_Kaccatuk.csv,148,3663561.0,57,91,46,11,0,45.2972972972973,259,47,20.7027027027027,7
Category_Wikipedia_sockpuppets_of_805LyricalMusic.csv,1463,31451093.0,500,963,393,107,0,38.05263157894737,255,56,18.382091592617908,4
Category_Wikipedia_sockpuppets_of_Slaviƒá.csv,268,13998338.0,93,175,77,16,0,46.69776119402985,248,62,20.69402985074627,5
Category_Wikipedia_sockpuppets_of_Samjeed.csv,171,23502500.0,40,131,39,1,0,48.85964912280702,255,46,17.54385964912281,8
Category_Wikipedia_sockpuppets_of_Alikhan090.csv,762,6479609.0,320,442,291,29,0,44.001312335958005,255,47,23.17979002624672,9
Category_Wikipedia_sockpuppets_of_Renamed_user_nnnnnnnnnn.csv,483,38490520.0,177,306,151,26,0,50.149068322981364,255,53,34.52795031055901,12
Category_Wikipedia_sockpuppets_of_Wp4321.csv,102,13379626.0,21,81,16,5,0,38.5,190,53,25.725490196078432,3
Category_Wikipedia_sockpuppets_of_MWMainPage.csv,1,0.0,1,0,1,0,28,28.0,28,20,20.0,20
Category_Wikipedia_sockpuppets_of_Dcasey98.csv,2410,259544295.0,685,1725,182,503,0,61.23402489626556,499,54,21.221161825726142,5
Category_Wikipedia_sockpuppets_of_LukeIsTheBestAtUsernames.csv,16,6592.0,9,7,8,1,0,57.5,209,32,28.25,16
Category_Wikipedia_sockpuppets_of_Fangusu.csv,8627,468653491.0,2179,6448,500,1679,0,46.464240176191026,420,92,18.676133070592325,3
Category_Wikipedia_sockpuppets_of_M.srihari.csv,1335,124380342.0,534,801,500,34,0,48.55580524344569,302,62,21.58576779026217,4
Category_Wikipedia_sockpuppets_of_Mary.prichard.kember.15.csv,15,65307.0,10,5,6,4,0,32.666666666666664,216,40,16.0,12
Category_Wikipedia_sockpuppets_of_Satyam_Kushwaha_official.csv,9,1624628.0,7,2,6,1,0,9.444444444444445,33,34,20.666666666666668,18
Category_Wikipedia_sockpuppets_of_USEDfan.csv,3382,180113332.0,1341,2041,500,841,0,45.8672383205204,261,50,17.336487285629804,4
Category_Wikipedia_sockpuppets_of_Alpinist.csv,688,88405687.0,290,398,248,42,0,30.1671511627907,210,50,21.204941860465116,7
Category_Wikipedia_sockpuppets_of_Xng.csv,1405,375012764.0,432,973,279,153,0,43.48825622775801,339,44,16.73238434163701,4
Category_Wikipedia_sockpuppets_of_Saeedfakhar.csv,2283,35601763.0,773,1510,500,273,0,36.03022339027595,279,50,18.648269820411738,5
Category_Wikipedia_sockpuppets_of_Ravindra_H_K.csv,325,1557313.0,216,109,112,104,0,21.00307692307692,255,22,14.852307692307692,7
Category_Wikipedia_sockpuppets_of_Stnickssch.csv,15,23215.0,9,6,5,4,0,78.0,244,30,26.533333333333335,19
Category_Wikipedia_sockpuppets_of_Bannarb123.csv,25,112851.0,19,6,16,3,0,33.48,171,33,25.08,9
Category_Wikipedia_sockpuppets_of_Ayyappancs.csv,484,60575580.0,173,311,87,86,0,39.603305785123965,237,44,15.022727272727273,5
Category_Wikipedia_sockpuppets_of_City_warming.csv,51,41438.0,26,25,25,1,0,40.96078431372549,199,65,21.823529411764707,13
Category_Wikipedia_sockpuppets_of_Sk8terguy27.csv,3650,68183519.0,1373,2277,500,873,0,38.81178082191781,254,90,20.87835616438356,3
Category_Wikipedia_sockpuppets_of_WorldCup2026.csv,1046,69543710.0,328,718,96,232,0,35.33365200764818,450,74,28.979923518164437,4
Category_Wikipedia_sockpuppets_of_Welcomeinnewindia.csv,21,80319406.0,9,12,7,2,0,78.47619047619048,196,35,29.61904761904762,22
Category_Wikipedia_sockpuppets_of_Hasina95.csv,85,10060714.0,21,64,9,12,0,78.72941176470589,396,29,15.129411764705882,8
Category_Wikipedia_sockpuppets_of_Nktshrd1234.csv,14,282477.0,10,4,6,4,15,40.214285714285715,88,21,21.0,21
Category_Wikipedia_sockpuppets_of_Soiamhere.csv,3,150.0,2,1,2,0,0,1.3333333333333333,4,10,10.0,10
Category_Wikipedia_sockpuppets_of_Jvcquemus.csv,465,18922091.0,173,292,80,93,0,61.546236559139786,494,58,19.851612903225806,4
Category_Wikipedia_sockpuppets_of_Andy4190.csv,1860,22116254.0,745,1115,500,245,0,30.09516129032258,237,56,29.651612903225807,9
Category_Wikipedia_sockpuppets_of_Oconner12.csv,68,2718322.0,24,44,15,9,0,41.64705882352941,176,47,26.41176470588235,14
Category_Wikipedia_sockpuppets_of_Simpu07.csv,533,21867431.0,189,344,112,77,0,54.073170731707314,496,60,23.191369606003754,5
Category_Wikipedia_sockpuppets_of_Jakefps.csv,8,736.0,5,3,5,0,0,47.125,201,18,18.0,18
Category_Wikipedia_sockpuppets_of_UMAGE_design.csv,41,5555114.0,19,22,13,6,0,48.390243902439025,205,33,17.951219512195124,4
Category_Wikipedia_sockpuppets_of_Emico.csv,1325,53308288.0,537,788,500,37,0,38.18037735849057,200,49,21.14943396226415,7
Category_Wikipedia_sockpuppets_of_Hunter_(TV_Show).csv,34,19247.0,27,7,16,11,0,28.176470588235293,199,36,27.470588235294116,24
Category_Wikipedia_sockpuppets_of_Delhisentinel44.csv,28,143384.0,16,12,6,10,0,38.607142857142854,138,44,35.785714285714285,9
Category_Wikipedia_sockpuppets_of_Valleyhollandman.csv,496,326320898.0,165,331,162,3,0,54.868951612903224,372,50,18.993951612903224,6
Category_Wikipedia_sockpuppets_of_Poopsniffa2.csv,40,236231.0,13,27,6,7,0,70.95,233,24,11.675,4
Category_Wikipedia_sockpuppets_of_Paulmagoo.csv,195,340003067.0,80,115,77,3,0,70.31282051282051,258,126,39.89230769230769,14
Category_Wikipedia_sockpuppets_of_Ericnorcross.csv,1713,13476855.0,657,1056,194,463,0,27.008172796263864,250,69,20.34325744308231,4
Category_Wikipedia_sockpuppets_of_Ria_Cruz.csv,6346,243086949.0,2767,3579,500,2267,0,29.661361487551215,508,73,26.15395524739994,5
Category_Wikipedia_sockpuppets_of_Mctrain.csv,5813,74171338.0,2149,3664,500,1649,0,35.972131429554445,255,56,22.029244796146568,4
Category_Wikipedia_sockpuppets_of_Mikefredwick.csv,56,329534.0,14,42,1,13,0,62.285714285714285,225,35,16.803571428571427,3
Category_Wikipedia_sockpuppets_of_Vidal_1077.csv,2390,25659246.0,631,1759,500,131,0,43.21213389121339,255,55,16.817154811715483,5
Category_Wikipedia_sockpuppets_of_Enidblyton11.csv,3125,66634428.0,1059,2066,304,755,0,40.22784,250,122,25.75712,5
Category_Wikipedia_sockpuppets_of_Spj345.csv,981,21399951.0,330,651,203,127,0,40.59021406727829,456,80,26.599388379204893,5
Category_Wikipedia_sockpuppets_of_Infinitejjang.csv,749,6208580.0,478,271,215,263,0,66.67957276368492,250,29,16.837116154873165,6
Category_Wikipedia_sockpuppets_of_King_stepper.csv,8,24486182.0,7,1,6,1,13,22.5,52,22,19.5,14
Category_Wikipedia_sockpuppets_of_Kobykoby99.csv,240,3948865.0,77,163,31,46,0,44.0875,241,46,19.425,5
Category_Wikipedia_sockpuppets_of_Prab_Toor.csv,707,20477644.0,189,518,116,73,0,35.52192362093352,255,33,14.537482319660537,3
Category_Wikipedia_sockpuppets_of_ToviaNelson.csv,68,2447455.0,27,41,21,6,0,45.23529411764706,249,51,25.264705882352942,4
Category_Wikipedia_sockpuppets_of_Umais_Bin_Sajjad.csv,2497,225424822.0,784,1713,500,284,0,50.81497797356828,463,94,21.416499799759713,4
Category_Wikipedia_sockpuppets_of_Weathereditor.csv,1733,111709019.0,509,1224,176,333,0,54.80380842469706,339,61,13.913444893248702,3
Category_Wikipedia_sockpuppets_of_Tobi710.csv,8,43402.0,5,3,5,0,0,31.625,77,17,17.0,17
Category_Wikipedia_sockpuppets_of_Mrsalsa13.csv,26,1745883.0,22,4,15,7,0,45.46153846153846,192,15,15.0,15
Category_Wikipedia_sockpuppets_of_6^q61z4FFBpr.csv,181,181780399.0,65,116,29,36,0,36.28729281767956,255,34,21.34254143646409,13
Category_Wikipedia_sockpuppets_of_ZappyLongNose.csv,902,1980726.0,430,472,429,1,0,40.24057649667406,240,69,27.681818181818183,4
Category_Wikipedia_sockpuppets_of_Cheeselor1.csv,25,882.0,8,17,8,0,0,59.16,142,19,13.4,11
Category_Wikipedia_sockpuppets_of_Gibraltarian.csv,1050,28973654.0,315,735,269,46,0,33.170476190476194,194,73,21.595238095238095,5
Category_Wikipedia_sockpuppets_of_Surena.csv,1139,180536789.0,306,833,119,187,0,40.16417910447761,250,66,16.39332748024583,4
Category_Wikipedia_sockpuppets_of_Mclist.csv,68,342037489.0,19,49,18,1,0,52.14705882352941,216,32,18.397058823529413,7
Category_Wikipedia_sockpuppets_of_ZincRobinson.csv,8,246400.0,5,3,3,2,0,202.875,456,15,15.0,15
Category_Wikipedia_sockpuppets_of_Hungrygirl.csv,798,1169549.0,268,530,228,40,0,27.417293233082706,200,54,21.25689223057644,10
Category_Wikipedia_sockpuppets_of_Vintage_1234.csv,555,8118383.0,190,365,186,4,0,39.6036036036036,292,23,10.931531531531531,5
Category_Wikipedia_sockpuppets_of_ShaunitNishant.csv,119,197223846.0,40,79,23,17,0,50.252100840336134,250,43,23.07563025210084,11
Category_Wikipedia_sockpuppets_of_Shy-Boy.csv,1532,47909266.0,522,1010,133,389,0,51.92689295039165,255,67,20.402088772845953,4
Category_Wikipedia_sockpuppets_of_Antonio_cachia.csv,829,45700056.0,284,545,269,15,0,25.752714113389626,221,44,17.681544028950544,4
Category_Wikipedia_sockpuppets_of_Victor_Okpala.csv,21,1083012.0,14,7,9,5,0,40.76190476190476,139,23,14.857142857142858,9
Category_Wikipedia_sockpuppets_of_EchoAyatoZhao53.csv,415,31317215.0,105,310,15,90,0,80.90361445783132,500,48,17.674698795180724,4
Category_Wikipedia_sockpuppets_of_Perlinked.csv,2462,45967483.0,912,1550,500,412,0,43.00243704305443,499,56,18.114541023558083,3
Category_Wikipedia_sockpuppets_of_George_Nyiam.csv,2406,63625173.0,554,1852,500,54,0,47.87946799667498,494,52,17.1404821280133,4
Category_Wikipedia_sockpuppets_of_Lhowarth234.csv,36,1659594.0,21,15,14,7,0,43.833333333333336,183,22,15.777777777777779,4
Category_Wikipedia_sockpuppets_of_Mae1983.csv,64,78916.0,48,16,46,2,0,75.859375,255,27,25.28125,22
Category_Wikipedia_sockpuppets_of_Simarty.csv,886,11160873.0,322,564,216,106,0,50.13882618510158,496,79,21.153498871331827,3
Category_Wikipedia_sockpuppets_of_Donald_Trung.csv,1249,216380699.0,578,671,500,78,0,62.79183346677342,360,108,31.957566052842274,4
Category_Wikipedia_sockpuppets_of_Sportstir.csv,3590,93491464.0,1301,2289,388,913,0,66.9284122562674,496,67,21.44401114206128,6
Category_Wikipedia_sockpuppets_of_Icarus_the_Great.csv,511,5303959.0,103,408,94,9,0,55.0958904109589,255,42,14.542074363992173,4
Category_Wikipedia_sockpuppets_of_Jomonkechery.csv,11,3703812.0,11,0,10,1,0,37.18181818181818,195,25,24.181818181818183,16
Category_Wikipedia_sockpuppets_of_Goldfinger98.csv,1,0.0,1,0,1,0,0,0.0,0,14,14.0,14
Category_Wikipedia_sockpuppets_of_JRobinson99.csv,934,44886038.0,213,721,206,7,0,50.74089935760171,355,47,18.312633832976445,6
Category_Wikipedia_sockpuppets_of_Jerseybusinesswatch.csv,87,9524207.0,41,46,22,19,0,54.35632183908046,252,47,25.655172413793103,15
Category_Wikipedia_sockpuppets_of_Matthew_Josef.csv,2608,20337018.0,1150,1458,500,650,0,41.747315950920246,401,61,31.26073619631902,5
Category_Wikipedia_sockpuppets_of_Hotshot950.csv,113,16299526.0,26,87,17,9,0,60.48672566371681,236,21,13.43362831858407,4
Category_Wikipedia_sockpuppets_of_BicliotecaMusicalColombia.csv,6,64837.0,3,3,2,1,0,31.333333333333332,76,21,19.5,18
Category_Wikipedia_sockpuppets_of_Drizzyruiz.csv,601,9086002.0,267,334,255,12,0,40.3044925124792,255,49,23.57737104825291,8
Category_Wikipedia_sockpuppets_of_Azul411.csv,4145,375115936.0,1554,2591,40,1514,0,52.130518697225575,438,76,18.46755126658625,4
Category_Wikipedia_sockpuppets_of_Alias_the_Jester.csv,1566,51277608.0,547,1019,232,315,0,52.96679438058749,497,66,23.497445721583652,3
Category_Wikipedia_sockpuppets_of_Luckyguna96.csv,181,203371913.0,54,127,52,2,0,49.74585635359116,332,33,18.972375690607734,5
Category_Wikipedia_sockpuppets_of_WP.Raj_Sharma.csv,481,93214412.0,137,344,51,86,0,72.24948024948024,496,61,18.118503118503117,4
Category_Wikipedia_sockpuppets_of_Sven70.csv,2740,52507496.0,638,2102,500,138,0,40.64270072992701,245,71,16.134306569343067,1
Category_Wikipedia_sockpuppets_of_SirEdimon.csv,154,9650962.0,135,19,73,62,0,18.006493506493506,223,47,23.467532467532468,14
Category_Wikipedia_sockpuppets_of_Mari_tennouji.csv,29,320337.0,19,10,6,13,0,48.758620689655174,199,23,19.310344827586206,18
Category_Wikipedia_sockpuppets_of_SaudAlkhaldi.csv,59,60069.0,21,38,20,1,0,50.32203389830509,249,50,26.88135593220339,8
Category_Wikipedia_sockpuppets_of_Animemeuk.csv,188,1997374.0,62,126,33,29,0,50.98936170212766,196,34,23.04255319148936,6
Category_Wikipedia_sockpuppets_of_DogInTheWild.csv,87,19952875.0,20,67,16,4,0,48.6551724137931,210,37,17.17241379310345,6
Category_Wikipedia_sockpuppets_of_Banchanseoul.csv,63,13764291.0,22,41,13,9,0,58.36507936507937,185,21,10.031746031746032,7
Category_Wikipedia_sockpuppets_of_Patrickdene.csv,88,389384.0,49,39,49,0,0,44.40909090909091,155,27,16.59090909090909,12
Category_Wikipedia_sockpuppets_of_Cavefish777.csv,644,15216761.0,198,446,18,180,0,64.1863354037267,255,30,14.321428571428571,5
Category_Wikipedia_sockpuppets_of_Shankar_1382.csv,1368,15493370.0,526,842,500,26,0,27.86330409356725,395,46,16.81140350877193,5
Category_Wikipedia_sockpuppets_of_Vogiahuy2005.csv,159,415019.0,59,100,55,4,0,35.937106918238996,293,67,21.433962264150942,10
Category_Wikipedia_sockpuppets_of_Patrice_Starr.csv,20,1502563.0,8,12,6,2,0,147.6,490,51,21.55,10
Category_Wikipedia_sockpuppets_of_Sdav.csv,20,89627.0,19,1,19,0,0,2.25,19,27,21.05,20
Category_Wikipedia_sockpuppets_of_Offender9000.csv,4556,121384864.0,2035,2521,500,1535,0,52.05289727831431,255,51,22.21422300263389,7
Category_Wikipedia_sockpuppets_of_Ameer_hakim.csv,18,78330.0,14,4,12,2,0,22.666666666666668,196,23,22.666666666666668,20
Category_Wikipedia_sockpuppets_of_MagdaOakewoman.csv,358,51416350.0,117,241,68,49,0,52.9804469273743,224,51,25.88268156424581,5
Category_Wikipedia_sockpuppets_of_TomJasendro.csv,2968,130183794.0,1078,1890,500,578,0,35.79177897574124,364,47,20.783692722371967,5
Category_Wikipedia_sockpuppets_of_Anokhinalz.csv,50,259742.0,44,6,26,18,0,8.66,187,35,15.64,13
Category_Wikipedia_sockpuppets_of_WezerFan.csv,26,4312895.0,12,14,8,4,0,79.0,442,22,20.5,19
Category_Wikipedia_sockpuppets_of_Lalotra.csv,139,17888521.0,93,46,78,15,0,29.834532374100718,373,23,9.46043165467626,6
Category_Wikipedia_sockpuppets_of_Serghiy_Hrabarook.csv,950,56653602.0,250,700,129,121,0,49.27684210526316,439,44,14.330526315789474,3
Category_Wikipedia_sockpuppets_of_Î∞±Îèå.csv,4148,342048130.0,1297,2851,483,814,0,49.412246865959496,404,41,13.493490838958534,3
Category_Wikipedia_sockpuppets_of_Doxelary.csv,1,0.0,1,0,1,0,69,69.0,69,21,21.0,21
Category_Wikipedia_sockpuppets_of_Iamthelotus.csv,228,58230801.0,128,100,72,56,0,32.89473684210526,235,51,10.93859649122807,4
Category_Wikipedia_sockpuppets_of_Robertpattinsons.csv,667,293486260.0,159,508,99,60,0,52.45127436281859,333,44,17.70464767616192,7
Category_Wikipedia_sockpuppets_of_RadheSlate.csv,1129,160937892.0,453,676,323,130,0,36.40832595217006,258,51,16.24977856510186,4
Category_Wikipedia_sockpuppets_of_Imissharambe.csv,11,258895.0,6,5,4,2,0,68.63636363636364,187,32,18.454545454545453,10
Category_Wikipedia_sockpuppets_of_Talentbcian.csv,37,538647.0,33,4,27,6,0,22.405405405405407,195,21,20.56756756756757,19
Category_Wikipedia_sockpuppets_of_Donaldduck13.csv,4878,167887922.0,1690,3188,500,1190,0,59.31652316523165,496,52,22.5489954899549,3
Category_Wikipedia_sockpuppets_of_Jamesreadsbooks.csv,958,123737461.0,273,685,261,12,0,37.95198329853862,234,58,20.177453027139876,5
Category_Wikipedia_sockpuppets_of_Deen_Mohammad_khan.csv,77,39139499.0,28,49,20,8,0,51.77922077922078,389,70,20.636363636363637,8
Category_Wikipedia_sockpuppets_of_Carriearchdale.csv,2692,65623239.0,1000,1692,500,500,0,50.21768202080238,255,103,23.08841010401189,2
Category_Wikipedia_sockpuppets_of_Auson.csv,2420,30626098.0,839,1581,500,339,0,50.08305785123967,228,66,31.79297520661157,4
Category_Wikipedia_sockpuppets_of_Zidane7z.csv,106,18907492.0,32,74,15,17,0,42.93396226415094,265,40,14.981132075471699,5
Category_Wikipedia_sockpuppets_of_Banterlolsweg.csv,149,2502627.0,48,101,7,41,0,49.48322147651007,225,43,14.738255033557047,8
Category_Wikipedia_sockpuppets_of_EGGLI_ANDREOU.csv,82,9431153.0,34,48,13,21,0,51.34146341463415,221,77,30.085365853658537,14
Category_Wikipedia_sockpuppets_of_Chowkatsun9.csv,6549,202785048.0,1545,5004,255,1290,0,47.97419453351657,457,54,15.605741334554894,4
Category_Wikipedia_sockpuppets_of_Davidabbott9011.csv,28,161573.0,13,15,9,4,0,55.357142857142854,191,34,22.464285714285715,8
Category_Wikipedia_sockpuppets_of_Mohammad_Anisur_Rahaman.csv,5,809.0,3,2,3,0,0,22.0,55,28,28.0,28
Category_Wikipedia_sockpuppets_of_NoHopeGroup.csv,30,3041485.0,19,11,10,9,0,19.733333333333334,136,23,18.866666666666667,13
Category_Wikipedia_sockpuppets_of_Lieutenant_of_Melkor.csv,7865,132532740.0,2316,5549,500,1816,0,53.65645263827082,254,85,19.17813095994914,2
Category_Wikipedia_sockpuppets_of_Mrinetwork.csv,263,226958356.0,86,177,79,7,0,46.17110266159696,248,51,19.11787072243346,4
Category_Wikipedia_sockpuppets_of_Jsr2171.csv,3,20990.0,2,1,2,0,15,22.333333333333332,30,17,17.0,17
Category_Wikipedia_sockpuppets_of_Bozo33.csv,2424,232613679.0,775,1649,500,275,0,46.99876237623762,255,53,17.7013201320132,2
Category_Wikipedia_sockpuppets_of_SGT-Craig.csv,338,135070894.0,113,225,110,3,0,60.65384615384615,457,65,18.47041420118343,9
Category_Wikipedia_sockpuppets_of_Ebandola.csv,22,18554.0,16,6,8,8,0,51.86363636363637,214,44,15.5,11
Category_Wikipedia_sockpuppets_of_William313.csv,1849,75855770.0,512,1337,260,252,0,34.673877771768524,248,70,24.665765278528934,5
Category_Wikipedia_sockpuppets_of_Danieleb82.csv,8401,38772040.0,2579,5822,500,2079,0,40.98559695274372,411,65,20.463873348410903,4
Category_Wikipedia_sockpuppets_of_Amangpaintor.csv,17,171495.0,9,8,7,2,0,22.529411764705884,196,22,19.235294117647058,17
Category_Wikipedia_sockpuppets_of_Rokabluecheese.csv,38,10892831.0,23,15,9,14,0,82.44736842105263,218,18,18.0,18
Category_Wikipedia_sockpuppets_of_Md_11_air_wales.csv,891,12147966.0,313,578,45,268,0,39.09652076318743,255,49,27.772166105499437,7
Category_Wikipedia_sockpuppets_of_Savvy_Tarafdar.csv,21,34671573.0,20,1,14,6,0,47.857142857142854,139,32,19.428571428571427,12
Category_Wikipedia_sockpuppets_of_Pshibe.csv,9,22816.0,8,1,2,6,0,4.222222222222222,38,46,42.0,15
Category_Wikipedia_sockpuppets_of_Veeti_Davidsson.csv,6284,120623779.0,1814,4470,500,1314,0,56.63749204328453,500,60,13.216740929344367,3
Category_Wikipedia_sockpuppets_of_Jabed015.csv,552,29131410.0,311,241,178,133,0,28.532608695652176,240,32,15.483695652173912,4
Category_Wikipedia_sockpuppets_of_Ilovetrevordaniel.csv,821,52443659.0,213,608,147,66,0,42.80876979293544,297,40,16.365408038976856,5
Category_Wikipedia_sockpuppets_of_Findblogging.csv,3098,38965465.0,939,2159,313,626,0,49.210135571336345,255,76,18.431891542930924,3
Category_Wikipedia_sockpuppets_of_Marimbambito.csv,258,56816502.0,107,151,55,52,0,37.97674418604651,250,36,24.414728682170544,11
Category_Wikipedia_sockpuppets_of_CarlaalraC.csv,5,1784.0,5,0,3,2,0,5.0,25,23,23.0,23
Category_Wikipedia_sockpuppets_of_Woomoobs57.csv,63,3688384.0,23,40,12,11,0,30.761904761904763,136,52,21.07936507936508,12
Category_Wikipedia_sockpuppets_of_Nijuchola.csv,55,275187.0,33,22,23,10,0,33.14545454545455,209,28,22.654545454545456,9
Category_Wikipedia_sockpuppets_of_Keltik31.csv,1314,38724297.0,347,967,327,20,0,36.05936073059361,221,52,18.988584474885844,5
Category_Wikipedia_sockpuppets_of_PowerSane.csv,1250,183604490.0,291,959,153,138,0,48.8064,247,67,19.3832,4
Category_Wikipedia_sockpuppets_of_–Æ—Ä—ñ–π_–ú—ñ—Ä–æ—à–Ω–∏—á–µ–Ω–∫–æ.csv,4,1502.0,2,2,2,0,0,98.0,196,30,30.0,30
Category_Wikipedia_sockpuppets_of_Mukwano_Group.csv,6,1718816.0,5,1,3,2,0,119.33333333333333,339,13,13.0,13
Category_Wikipedia_sockpuppets_of_Rohit_Ravindra_Kutar.csv,3,9455915.0,2,1,1,1,14,90.0,196,30,24.333333333333332,13
Category_Wikipedia_sockpuppets_of_Nelior70.csv,203,231284650.0,68,135,66,2,0,41.41379310344828,255,43,14.270935960591133,4
Category_Wikipedia_sockpuppets_of_Promise_Pyakurel.csv,4,69875.0,2,2,1,1,0,21.0,56,34,24.5,15
Category_Wikipedia_sockpuppets_of_BosnianHolocaustSurvior.csv,307,3550095.0,114,193,86,28,0,57.241042345276874,200,50,20.019543973941367,5
Category_Wikipedia_sockpuppets_of_ComputerGeek3000.csv,1405,8057351.0,395,1010,343,52,0,44.00213523131673,255,54,15.0,4
Category_Wikipedia_sockpuppets_of_Fg.csv,917,134459847.0,266,651,266,0,0,30.03598691384951,214,62,18.235550708833152,4
Category_Wikipedia_sockpuppets_of_Angela_Criss.csv,21060,380176357.0,7563,13497,500,7063,0,43.03143399810067,500,90,21.769753086419755,2
Category_Wikipedia_sockpuppets_of_Barthateslisa.csv,5490,23252697.0,1805,3685,500,1305,0,48.44990892531876,255,67,17.014207650273224,4
Category_Wikipedia_sockpuppets_of_Rockhistoryking.csv,19,1303718.0,17,2,12,5,0,46.8421052631579,158,13,13.0,13
Category_Wikipedia_sockpuppets_of_Crazypredator.csv,11,99843.0,4,7,3,1,0,47.54545454545455,84,53,33.0,16
Category_Wikipedia_sockpuppets_of_Lekuma.csv,205,10041903.0,59,146,14,45,0,48.34634146341463,494,53,14.37560975609756,4
Category_Wikipedia_sockpuppets_of_Xx2ndformxx.csv,151,3267062.0,50,101,39,11,0,43.29139072847682,213,46,20.827814569536425,10
Category_Wikipedia_sockpuppets_of_Strasburg.csv,137,9857850.0,75,62,36,39,0,39.66423357664234,241,26,19.313868613138688,11
Category_Wikipedia_sockpuppets_of_Satoshlong.csv,47,358192.0,32,15,31,1,0,43.276595744680854,250,42,15.53191489361702,10
Category_Wikipedia_sockpuppets_of_DPeterson.csv,7357,339802371.0,2847,4510,500,2347,0,48.653663177925786,253,96,27.126410221557702,3
Category_Wikipedia_sockpuppets_of_Christopher_S_Murray.csv,6,81530.0,4,2,2,2,0,108.66666666666667,185,27,22.833333333333332,18
Category_Wikipedia_sockpuppets_of_Gurkiratvirk597.csv,544,115478743.0,216,328,203,13,0,25.727941176470587,273,48,28.814338235294116,13
Category_Wikipedia_sockpuppets_of_DollyDecadence.csv,1,0.0,1,0,1,0,23,23.0,23,18,18.0,18
Category_Wikipedia_sockpuppets_of_Anonymous1321.csv,6,238.0,2,4,2,0,0,79.33333333333333,190,13,10.333333333333334,5
Category_Wikipedia_sockpuppets_of_Choronzonclub.csv,2126,283050682.0,571,1555,500,71,0,56.498118532455315,254,69,16.80620884289746,4
Category_Wikipedia_sockpuppets_of_Tristan_Sterk.csv,84,431603454.0,26,58,26,0,0,52.392857142857146,222,53,27.88095238095238,12
Category_Wikipedia_sockpuppets_of_Ogset.csv,146,4353716.0,49,97,43,6,0,56.67123287671233,352,43,15.10958904109589,7
Category_Wikipedia_sockpuppets_of_Nagiosinc.csv,89,18939130.0,36,53,20,16,0,50.96629213483146,230,18,9.460674157303371,4
Category_Wikipedia_sockpuppets_of_AnZay1.csv,111,10325939.0,47,64,36,11,0,52.414414414414416,310,26,18.47747747747748,12
Category_Wikipedia_sockpuppets_of_Raithuwa.csv,1419,2350318.0,454,965,395,59,0,47.57293868921776,600,50,16.90415785764623,4
Category_Wikipedia_sockpuppets_of_Yeefy.csv,84,22484865.0,29,55,25,4,0,48.535714285714285,213,41,19.416666666666668,8
Category_Wikipedia_sockpuppets_of_Matthew_Wellington.csv,3055,183237.0,1000,2055,500,500,0,60.12602291325695,493,81,20.375122749590833,4
Category_Wikipedia_sockpuppets_of_R2dra.csv,2207,9525313.0,785,1422,372,413,0,50.47485274127775,500,72,19.737652922519256,4
Category_Wikipedia_sockpuppets_of_WorldCitizen2.csv,95,57860358.0,40,55,35,5,0,70.72631578947369,488,33,18.178947368421053,8
Category_Wikipedia_sockpuppets_of_BaahuPrabha.csv,822,3713151.0,251,571,160,91,0,38.132603406326034,255,37,19.465936739659366,6
Category_Wikipedia_sockpuppets_of_Jigsawnovich.csv,869,72207210.0,352,517,203,149,0,41.91139240506329,249,56,16.339470655926352,4
Category_Wikipedia_sockpuppets_of_ExtraMoldyCheese.csv,213,10219988.0,93,120,90,3,0,41.84976525821596,498,48,13.31924882629108,4
Category_Wikipedia_sockpuppets_of_Montgomericlift.csv,77,8439096.0,27,50,21,6,0,40.064935064935064,253,25,14.25974025974026,12
Category_Wikipedia_sockpuppets_of_Szm020730.csv,2768,87088424.0,703,2065,65,638,0,41.80238439306358,275,47,12.568641618497109,3
Category_Wikipedia_sockpuppets_of_NeuroZachary.csv,157,9444676.0,51,106,35,16,0,53.038216560509554,338,47,27.64968152866242,6
Category_Wikipedia_sockpuppets_of_Utpolra.csv,30,594792.0,18,12,11,7,13,64.06666666666666,255,19,14.666666666666666,7
Category_Wikipedia_sockpuppets_of_Shyamalangan.csv,31,275482791.0,7,24,6,1,0,32.83870967741935,230,28,23.64516129032258,13
Category_Wikipedia_sockpuppets_of_IMZahidIqbal.csv,3126,192771679.0,787,2339,179,608,0,47.51023672424824,500,67,16.523992322456813,4
Category_Wikipedia_sockpuppets_of_KarlKraft.csv,495,7270992.0,153,342,92,61,0,46.74545454545454,249,40,19.107070707070708,6
Category_Wikipedia_sockpuppets_of_Arya_Rajya_Maharashtra.csv,993,8987236.0,349,644,322,27,0,29.97583081570997,200,55,19.224572004028197,5
Category_Wikipedia_sockpuppets_of_Ta007ta.csv,11,126578.0,6,5,5,1,4,56.09090909090909,211,22,18.363636363636363,14
Category_Wikipedia_sockpuppets_of_Aesheticinfo.csv,189,25349164.0,85,104,68,17,0,36.142857142857146,203,48,25.693121693121693,11
Category_Wikipedia_sockpuppets_of_Kunalescortspune.csv,1,0.0,1,0,1,0,251,251.0,251,17,17.0,17
Category_Wikipedia_sockpuppets_of_Williamsburgland.csv,2169,51870184.0,579,1590,500,79,0,57.03964960811434,255,54,22.333333333333332,5
Category_Wikipedia_sockpuppets_of_Thecraperon.csv,8,2686.0,5,3,3,2,0,74.0,229,9,9.0,9
Category_Wikipedia_sockpuppets_of_Áª¥Âü∫‰∏≠‰∫åÁæ§‰Ωì‰ª£Ë°®.csv,915,58739159.0,313,602,120,193,0,61.10819672131147,462,60,24.650273224043715,3
Category_Wikipedia_sockpuppets_of_–®–∞–±–∞–Ω_–†–æ–º–∞–Ω_–ü–µ—Ç—Ä–æ–≤–∏—á.csv,118,2505852.0,33,85,21,12,0,68.97457627118644,496,48,23.703389830508474,9
Category_Wikipedia_sockpuppets_of_Ameerah1.csv,8,98813004.0,8,0,3,5,0,184.875,496,32,22.375,17
Category_Wikipedia_sockpuppets_of_Jose052892.csv,23,6922.0,10,13,4,6,0,44.43478260869565,170,30,20.434782608695652,10
Category_Wikipedia_sockpuppets_of_Hammadmustafapk.csv,366,22825178.0,236,130,141,95,0,36.4207650273224,492,39,24.368852459016395,4
Category_Wikipedia_sockpuppets_of_Kingjeff.csv,1300,580369408.0,527,773,500,27,0,36.37,496,61,18.88153846153846,8
Category_Wikipedia_sockpuppets_of_Remony.csv,144,748923.0,65,79,63,2,0,28.993055555555557,236,27,13.73611111111111,7
Category_Wikipedia_sockpuppets_of_Kartikabalaji.csv,75,808701.0,34,41,34,0,0,53.48,227,53,18.14666666666667,9
Category_Wikipedia_sockpuppets_of_Jjwilliams98.csv,640,120094791.0,303,337,261,42,0,34.8234375,250,37,29.4328125,24
Category_Wikipedia_sockpuppets_of_Zaydx.csv,1512,19613511.0,541,971,184,357,0,57.988756613756614,496,42,11.135582010582011,3
Category_Wikipedia_sockpuppets_of_Astrochemist.csv,2569,5761246.0,737,1832,500,237,0,43.23043985986765,259,54,17.12767613857532,4
Category_Wikipedia_sockpuppets_of_Barnham.csv,3907,57709354.0,1422,2485,500,922,0,45.54491937547991,216,61,15.365753775275147,3
Category_Wikipedia_sockpuppets_of_Girlishkim.csv,83,7772503.0,28,55,14,14,0,43.265060240963855,249,51,17.63855421686747,8
Category_Wikipedia_sockpuppets_of_Lazukshiplu.csv,912,26607010.0,528,384,500,28,0,35.40899122807018,255,53,23.24232456140351,5
Category_Wikipedia_sockpuppets_of_ScriptKKiddie.csv,558,125842604.0,147,411,120,27,0,54.263440860215056,500,126,25.74910394265233,4
Category_Wikipedia_sockpuppets_of_EddMakers.csv,192,23067810.0,45,147,40,5,0,25.526041666666668,199,42,20.427083333333332,6
Category_Wikipedia_sockpuppets_of_Hitoodesai.csv,150,14259561.0,49,101,33,16,0,39.473333333333336,468,53,23.713333333333335,13
Category_Wikipedia_sockpuppets_of_Kirisami.csv,455,8296952.0,146,309,130,16,0,75.34725274725275,500,60,26.138461538461538,3
Category_Wikipedia_sockpuppets_of_JohnLickor372.csv,571,10086907.0,132,439,122,10,0,52.97898423817863,500,36,12.823117338003502,4
Category_Wikipedia_sockpuppets_of_Scienceelectric.csv,21,346402.0,11,10,8,3,0,59.904761904761905,496,57,26.285714285714285,20
Category_Wikipedia_sockpuppets_of_Miszatomic.csv,1814,166541119.0,512,1302,500,12,0,51.93550165380375,255,74,20.774531422271224,4
Category_Wikipedia_sockpuppets_of_Jackagiletuyi.csv,110,14848.0,52,58,17,35,0,41.99090909090909,231,31,10.354545454545455,3
Category_Wikipedia_sockpuppets_of_Fraiche.csv,2,220.0,2,0,1,1,146,168.5,191,20,16.0,12
Category_Wikipedia_sockpuppets_of_Dafurf.csv,4,119.0,2,2,2,0,17,77.25,177,16,11.0,6
Category_Wikipedia_sockpuppets_of_Wrestlinglover420.csv,3781,37568380.0,1120,2661,426,694,0,26.221370007934407,250,54,19.983866701930705,4
Category_Wikipedia_sockpuppets_of_Ainur_Najwa.csv,6,924947.0,2,4,2,0,0,33.666666666666664,67,21,17.0,13
Category_Wikipedia_sockpuppets_of_Asfabutt2001.csv,69,3889391.0,25,44,24,1,0,35.85507246376812,227,53,29.942028985507246,17
Category_Wikipedia_sockpuppets_of_(help_me_choose)_(help_me_choose).csv,182,156397.0,47,135,36,11,0,56.66483516483517,270,54,21.10989010989011,8
Category_Wikipedia_sockpuppets_of_JusticeAdvocate1.csv,1465,187094280.0,472,993,458,14,0,56.98634812286689,337,49,20.980204778156995,8
Category_Wikipedia_sockpuppets_of_Chander.csv,5841,124260950.0,2132,3709,500,1632,0,51.65998972778634,255,66,17.399760315014554,1
Category_Wikipedia_sockpuppets_of_Josefm12.csv,294,96803734.0,73,221,61,12,0,70.99319727891157,500,59,17.687074829931973,9
Category_Wikipedia_sockpuppets_of_SentientContrarian.csv,2934,214991944.0,805,2129,500,305,0,40.88582140422631,249,64,17.61042944785276,6
Category_Wikipedia_sockpuppets_of_Istraight.csv,113,1630020.0,38,75,22,16,0,41.557522123893804,196,23,12.548672566371682,4
Category_Wikipedia_sockpuppets_of_Drbkmurali.csv,640,9042245.0,339,301,209,130,0,35.790625,255,78,23.18125,4
Category_Wikipedia_sockpuppets_of_Mahichowdhury20.csv,281,29895664.0,100,181,34,66,0,47.12811387900356,496,61,21.106761565836297,4
Category_Wikipedia_sockpuppets_of_Tikkunallambahertz.csv,33,8278624.0,11,22,7,4,0,76.36363636363636,227,18,8.606060606060606,7
Category_Wikipedia_sockpuppets_of_BISHNU_PRATAP_SINGH.csv,147,80970895.0,42,105,40,2,0,31.170068027210885,245,47,14.244897959183673,7
Category_Wikipedia_sockpuppets_of_Brookelsager.csv,4,1551710.0,3,1,1,2,28,89.25,178,11,11.0,11
Category_Wikipedia_sockpuppets_of_Cooldude_edits.csv,37,10008.0,11,26,7,4,0,70.94594594594595,377,38,18.0,1
Category_Wikipedia_sockpuppets_of_ARK_Aravind.csv,25,40232.0,9,16,9,0,0,53.64,255,28,16.48,5
Category_Wikipedia_sockpuppets_of_Lebronto23.csv,242,2718609.0,75,167,39,36,0,45.45867768595041,233,31,16.541322314049587,3
Category_Wikipedia_sockpuppets_of_Jagadeesh.sankaran.csv,26,821302.0,12,14,7,5,0,51.23076923076923,209,53,30.307692307692307,10
Category_Wikipedia_sockpuppets_of_Charlie_Brown_versus_Lucy_Van_Pelt...csv,2527,51164562.0,662,1865,474,188,0,37.00554016620499,496,62,22.413929560743966,4
Category_Wikipedia_sockpuppets_of_Symon_Sadik.csv,9423,188344014.0,3334,6089,500,2834,0,34.640241961158864,500,49,16.131380664331953,5
Category_Wikipedia_sockpuppets_of_EJGlobal.csv,80,15694241.0,25,55,25,0,0,43.4875,192,33,20.8875,9
Category_Wikipedia_sockpuppets_of_Iaaasi.csv,25263,362369693.0,9258,16005,500,8758,0,40.561611843407356,500,95,21.683173019831376,1
Category_Wikipedia_sockpuppets_of_Oriental_Aristocrat.csv,1046,30909614.0,345,701,240,105,0,46.7906309751434,496,68,27.753346080305928,6
Category_Wikipedia_sockpuppets_of_Zymaseman.csv,187,90207799.0,56,131,47,9,0,49.711229946524064,236,49,18.41176470588235,6
Category_Wikipedia_sockpuppets_of_Vishal_Kandassamy.csv,2009,92908185.0,654,1355,500,154,0,49.9497262319562,437,47,14.123942259830761,3
Category_Wikipedia_sockpuppets_of_Chamoquemas.csv,450,198699123.0,106,344,75,31,0,60.58444444444444,250,41,16.211111111111112,5
Category_Wikipedia_sockpuppets_of_Bleucheeses.csv,1759,4446740.0,561,1198,500,61,0,43.7072200113701,425,50,18.18646958499147,2
Category_Wikipedia_sockpuppets_of_Smilerslove.csv,1342,95963481.0,525,817,500,25,0,40.58345752608048,253,50,20.337555886736215,4
Category_Wikipedia_sockpuppets_of_Theblackphonefan22.csv,85,5356293.0,44,41,26,18,0,41.705882352941174,220,34,14.823529411764707,11
Category_Wikipedia_sockpuppets_of_Rlawrence12.csv,48,6559253.0,26,22,17,9,0,44.291666666666664,304,32,26.8125,21
Category_Wikipedia_sockpuppets_of_The_Negotiator.csv,3371,30234186.0,1013,2358,500,513,0,38.71551468407001,255,130,19.194897656481757,1
Category_Wikipedia_sockpuppets_of_Compfreak7.csv,2383,288402649.0,510,1873,500,10,0,53.34242551405791,499,65,20.590012589173313,3
Category_Wikipedia_sockpuppets_of_Liam20102195.csv,529,204596947.0,173,356,160,13,0,41.87334593572779,246,46,19.272211720226842,2
Category_Wikipedia_sockpuppets_of_Larbkai.csv,939,9275657.0,502,437,500,2,0,20.589989350372736,197,37,18.087326943556974,8
Category_Wikipedia_sockpuppets_of_Sunkwaina.csv,27,4638153.0,18,9,10,8,0,94.0,350,21,14.037037037037036,13
Category_Wikipedia_sockpuppets_of_AmeliaJung.csv,8,3968003.0,2,6,1,1,0,76.5,210,30,19.5,2
Category_Wikipedia_sockpuppets_of_Stringi8.csv,27,7349276.0,13,14,11,2,0,34.111111111111114,169,28,14.11111111111111,7
Category_Wikipedia_sockpuppets_of_JohnWhitehurst.csv,72,1222617.0,39,33,22,17,1,36.97222222222222,178,88,46.31944444444444,14
Category_Wikipedia_sockpuppets_of_Logeion.csv,257,80325132.0,99,158,60,39,0,45.53307392996109,243,46,15.43579766536965,5
Category_Wikipedia_sockpuppets_of_My_grandma_used_to_drive_a_'65_Catalina.csv,170,6700319.0,35,135,9,26,0,50.66470588235294,241,62,16.623529411764707,4
Category_Wikipedia_sockpuppets_of_VVPushkin.csv,1984,110336667.0,429,1555,406,23,0,40.32711693548387,250,47,18.029737903225808,4
Category_Wikipedia_sockpuppets_of_Wefewence_Fwame.csv,64,73556.0,24,40,24,0,0,42.921875,184,78,27.609375,15
Category_Wikipedia_sockpuppets_of_Kitami.csv,17,114175039.0,7,10,4,3,0,30.529411764705884,135,61,17.352941176470587,4
Category_Wikipedia_sockpuppets_of_Zaheebcz.csv,31,9733879.0,10,21,10,0,0,48.064516129032256,163,34,17.225806451612904,5
Category_Wikipedia_sockpuppets_of_Dolly_shine.csv,11,123063.0,6,5,5,1,0,36.81818181818182,224,21,15.181818181818182,13
Category_Wikipedia_sockpuppets_of_KharmaJoy.csv,138,17739185.0,32,106,12,20,0,55.94202898550725,255,58,15.13768115942029,7
Category_Wikipedia_sockpuppets_of_Iniced.csv,2161,253640972.0,726,1435,500,226,0,55.39565016196205,277,54,18.9074502545118,8
Category_Wikipedia_sockpuppets_of_Leon103102.csv,5089,222491249.0,1374,3715,500,874,0,43.76793083120456,413,64,22.744547062291215,4
Category_Wikipedia_sockpuppets_of_Bptbinch.csv,22,38740.0,13,9,10,3,0,40.22727272727273,205,13,6.7272727272727275,4
Category_Wikipedia_sockpuppets_of_LeTroy89.csv,11,102377.0,7,4,5,2,0,20.272727272727273,47,27,21.636363636363637,18
Category_Wikipedia_sockpuppets_of_Gyan234.csv,50,14188385.0,27,23,25,2,0,46.88,194,36,26.94,17
Category_Wikipedia_sockpuppets_of_Jin2794.csv,241,3214104.0,84,157,42,42,0,46.63900414937759,211,59,22.639004149377595,6
Category_Wikipedia_sockpuppets_of_FatTaffy01.csv,37,1543394.0,14,23,8,6,0,63.7027027027027,213,49,21.83783783783784,7
Category_Wikipedia_sockpuppets_of_Johnpallen.csv,122,12180748.0,46,76,39,7,0,20.516393442622952,152,63,30.508196721311474,13
Category_Wikipedia_sockpuppets_of_Hakantheguide.csv,279,34956072.0,79,200,33,46,0,46.505376344086024,355,41,14.620071684587813,5
Category_Wikipedia_sockpuppets_of_Camana2.csv,1355,7738839.0,414,941,123,291,0,44.14169741697417,495,73,18.05977859778598,3
Category_Wikipedia_sockpuppets_of_Adam.J.W.C..csv,2965,298507056.0,888,2077,500,388,0,52.76256323777403,261,91,22.772681281618887,5
Category_Wikipedia_sockpuppets_of_Tristan_albatross.csv,250,15111667.0,68,182,49,19,0,67.564,497,45,21.584,9
Category_Wikipedia_sockpuppets_of_MOot324.csv,66,7478.0,22,44,10,12,0,49.89393939393939,218,27,13.969696969696969,3
Category_Wikipedia_sockpuppets_of_Gallian.csv,5,23849.0,2,3,1,1,25,72.8,132,14,14.0,14
Category_Wikipedia_sockpuppets_of_Bluedogtn.csv,5222,126969733.0,2040,3182,500,1540,0,35.99099961700498,263,92,25.036767522022213,3
Category_Wikipedia_sockpuppets_of_Starsystems20.csv,27,410.0,8,19,4,4,0,69.44444444444444,266,25,13.814814814814815,10
Category_Wikipedia_sockpuppets_of_Damithmadhusanka.csv,59,1678403.0,27,32,9,18,0,41.067796610169495,146,57,23.796610169491526,11
Category_Wikipedia_sockpuppets_of_Asom_Barta.csv,17,4281074.0,7,10,6,1,0,39.705882352941174,130,30,21.823529411764707,18
Category_Wikipedia_sockpuppets_of_Ravinariya.csv,42,3504191.0,19,23,11,8,0,40.07142857142857,250,20,14.714285714285714,12
Category_Wikipedia_sockpuppets_of_Luke2509.csv,321,25507061.0,76,245,73,3,0,27.778816199376948,199,40,13.847352024922118,8
Category_Wikipedia_sockpuppets_of_Windows55.csv,1254,257996232.0,273,981,182,91,0,49.73524720893142,255,52,15.646730462519937,3
Category_Wikipedia_sockpuppets_of_Karesu12340.csv,1025,25429711.0,205,820,117,88,0,50.04780487804878,250,63,20.265365853658537,2
Category_Wikipedia_sockpuppets_of_Derek_Alexander.csv,31,145561.0,9,22,9,0,0,34.32258064516129,119,53,53.0,53
Category_Wikipedia_sockpuppets_of_Patricbromii105.csv,263,25607650.0,252,11,181,71,0,16.992395437262356,196,29,26.844106463878326,8
Category_Wikipedia_sockpuppets_of_GeneralZodBM.csv,9,1760881.0,8,1,5,3,0,24.11111111111111,81,15,15.0,15
Category_Wikipedia_sockpuppets_of_Sagar_panchasara.csv,43,598709.0,12,31,11,1,0,44.16279069767442,213,25,14.162790697674419,6
Category_Wikipedia_sockpuppets_of_Cagadhiig.csv,1648,42579271.0,578,1070,386,192,0,48.04550970873787,255,57,14.053398058252426,4
Category_Wikipedia_sockpuppets_of_HarveyCarter.csv,14612,532307564.0,3609,11003,219,3390,0,52.95359978100192,492,56,18.03750342184506,6
Category_Wikipedia_sockpuppets_of_SCN-32.csv,110,1314234.0,59,51,24,35,0,43.77272727272727,310,36,21.236363636363638,10
Category_Wikipedia_sockpuppets_of_Sahasu.csv,2134,63758395.0,782,1352,371,411,0,57.981724461105905,379,74,16.9058106841612,4
Category_Wikipedia_sockpuppets_of_Wikiequus210.csv,154,4062827.0,53,101,21,32,0,53.47402597402598,339,45,27.662337662337663,5
Category_Wikipedia_sockpuppets_of_RealEarthquake.csv,503,11435942.0,149,354,111,38,0,45.4572564612326,224,49,21.17693836978131,9
Category_Wikipedia_sockpuppets_of_Djedamrazuk.csv,228,382937249.0,78,150,37,41,0,35.43859649122807,239,54,31.37280701754386,3
Category_Wikipedia_sockpuppets_of_Premier.csv,815,117520220.0,299,516,222,77,0,33.04294478527607,209,55,21.700613496932515,11
Category_Wikipedia_sockpuppets_of_Helmsman_Tom_Paris.csv,59,7096312.0,17,42,7,10,0,62.898305084745765,233,32,17.677966101694917,8
Category_Wikipedia_sockpuppets_of_WarnerBrosLogoFanatic.csv,2085,8741047.0,500,1585,112,388,0,32.39568345323741,226,56,19.319424460431655,3
Category_Wikipedia_sockpuppets_of_Niaguru1968.csv,20,10853761.0,13,7,13,0,0,38.55,169,51,22.3,4
Category_Wikipedia_sockpuppets_of_Rymmen.csv,366,102102432.0,77,289,53,24,0,61.14207650273224,255,46,19.762295081967213,4
Category_Wikipedia_sockpuppets_of_Eternal_Realm.csv,294,90687.0,82,212,82,0,0,35.88775510204081,235,46,14.316326530612244,3
Category_Wikipedia_sockpuppets_of_Yiwentang.csv,332,81624154.0,139,193,91,48,0,41.91265060240964,215,49,17.231927710843372,5
Category_Wikipedia_sockpuppets_of_Brunswick_Green_Doesnt_Exist.csv,96,66612481.0,31,65,26,5,0,48.1875,492,38,22.989583333333332,17
Category_Wikipedia_sockpuppets_of_Samimukahhalofficial.csv,6,13238762.0,4,2,3,1,0,59.833333333333336,139,30,24.0,18
Category_Wikipedia_sockpuppets_of_NBA_FINALS.csv,58,502627.0,17,41,5,12,0,65.08620689655173,229,41,19.051724137931036,6
Category_Wikipedia_sockpuppets_of_Krusty111.csv,305,273017127.0,103,202,96,7,0,51.226229508196724,254,54,20.59672131147541,8
Category_Wikipedia_sockpuppets_of_BhushanSRT.csv,373,78402005.0,159,214,152,7,0,35.415549597855225,394,46,14.587131367292224,5
Category_Wikipedia_sockpuppets_of_Tree-and-tree.csv,2780,9896122.0,1059,1721,500,559,0,40.829856115107916,380,77,22.962230215827336,3
Category_Wikipedia_sockpuppets_of_OccultZone.csv,13552,268733666.0,4193,9359,500,3693,0,52.094672373081465,591,91,23.309327036599765,3
Category_Wikipedia_sockpuppets_of_Kha_tatti_kha.csv,126,22824812.0,48,78,5,43,0,71.54761904761905,500,30,16.22222222222222,12
Category_Wikipedia_sockpuppets_of_Youcantbannme.csv,34,179920.0,13,21,7,6,0,48.5,189,26,8.823529411764707,4
Category_Wikipedia_sockpuppets_of_WikkanWitch.csv,1624,58737793.0,584,1040,500,84,0,48.3442118226601,327,48,18.298029556650246,4
Category_Wikipedia_sockpuppets_of_RickSantorum69.csv,25,159538.0,8,17,7,1,0,67.48,221,54,42.16,13
Category_Wikipedia_sockpuppets_of_Muthalathu.csv,1699,318248355.0,522,1177,500,22,0,40.83225426721601,395,88,18.051795173631547,3
Category_Wikipedia_sockpuppets_of_Giorgoos.csv,795,61794112.0,400,395,311,89,0,39.38238993710692,250,36,13.442767295597484,5
Category_Wikipedia_sockpuppets_of_ReneClemmer.csv,2,7861.0,2,0,2,0,15,15.0,15,41,41.0,41
Category_Wikipedia_sockpuppets_of_Nemanjic.csv,100,37316927.0,43,57,33,10,0,49.47,199,36,26.13,7
Category_Wikipedia_sockpuppets_of_JayExperience.csv,4164,212165448.0,1012,3152,500,512,0,37.817483189241116,255,56,19.42819404418828,4
Category_Wikipedia_sockpuppets_of_Jamie200896.csv,88,3568550.0,44,44,40,4,0,34.65909090909091,196,44,17.625,4
Category_Wikipedia_sockpuppets_of_Pro_Game_Master87.csv,1147,6296484.0,264,883,262,2,0,44.33478639930253,200,50,17.832606800348735,4
Category_Wikipedia_sockpuppets_of_PrakashGollapalli007.csv,175,39230599.0,50,125,16,34,0,37.44,212,41,18.474285714285713,9
Category_Wikipedia_sockpuppets_of_Msreza24.csv,2,4993.0,2,0,2,0,0,84.0,168,25,19.0,13
Category_Wikipedia_sockpuppets_of_Jepp12.csv,1379,57716725.0,428,951,395,33,0,35.21972443799855,255,55,33.87599709934735,11
Category_Wikipedia_sockpuppets_of_Jitendra_Jitendra_Suryavanshi.csv,2,0.0,1,1,1,0,38,38.0,38,37,37.0,37
Category_Wikipedia_sockpuppets_of_Aboliri.csv,507,6327.0,177,330,20,157,0,34.15384615384615,236,39,17.670611439842208,4
Category_Wikipedia_sockpuppets_of_Creativitylove.csv,1924,87240552.0,786,1138,486,300,0,44.54781704781705,499,81,22.37162162162162,9
Category_Wikipedia_sockpuppets_of_King_Crimson_the_Third.csv,1984,11869118.0,650,1334,500,150,0,38.73286290322581,486,75,23.233366935483872,5
Category_Wikipedia_sockpuppets_of_Fatuouslemon.csv,75,12371367.0,40,35,11,29,0,59.6,246,7,7.0,7
Category_Wikipedia_sockpuppets_of_Wall20032.csv,31,1150879.0,13,18,6,7,0,44.58064516129032,196,64,29.225806451612904,11
Category_Wikipedia_sockpuppets_of_StolenLandsAmerica.csv,175,4632754.0,47,128,35,12,0,71.93714285714286,361,47,16.28,3
Category_Wikipedia_sockpuppets_of_Ali_Hassan_Supra.csv,137,165718.0,47,90,26,21,0,74.0948905109489,329,59,16.94160583941606,6
Category_Wikipedia_sockpuppets_of_TestSubjects.csv,39,89743.0,19,20,9,10,0,57.794871794871796,219,27,16.205128205128204,7
Category_Wikipedia_sockpuppets_of_SimpsonHomeron.csv,303,13171268.0,88,215,34,54,0,48.679867986798676,363,37,16.260726072607262,5
Category_Wikipedia_sockpuppets_of_Akila12345.csv,32,3004128.0,19,13,14,5,0,75.65625,302,19,15.75,15
Category_Wikipedia_sockpuppets_of_IshYoBoyVinay.csv,11,1555146.0,7,4,4,3,0,54.45454545454545,217,22,14.545454545454545,5
Category_Wikipedia_sockpuppets_of_Jpesch95.csv,5365,66111324.0,1758,3607,500,1258,0,52.21957129543336,500,103,23.662628145386766,4
Category_Wikipedia_sockpuppets_of_Andrewnageh123.csv,1450,86161142.0,442,1008,300,142,0,58.15172413793103,502,62,21.94137931034483,3
Category_Wikipedia_sockpuppets_of_Santosh_sikarwar.csv,24,2495977.0,9,15,6,3,0,24.75,172,26,19.708333333333332,17
Category_Wikipedia_sockpuppets_of_Omesh_wajiran.csv,11,1136764.0,7,4,5,2,0,37.45454545454545,196,23,21.181818181818183,18
Category_Wikipedia_sockpuppets_of_Meteorologist200.csv,242,101103248.0,79,163,79,0,0,56.053719008264466,269,47,20.888429752066116,6
Category_Wikipedia_sockpuppets_of_M4nish.cse.csv,8,13904.0,5,3,3,2,0,39.625,196,20,19.25,17
Category_Wikipedia_sockpuppets_of_Jlcruse.csv,608,83694074.0,210,398,156,54,0,32.12171052631579,234,63,21.49671052631579,7
Category_Wikipedia_sockpuppets_of_RajuOfficialKK.csv,6,89279.0,4,2,1,3,0,58.333333333333336,245,6,6.0,6
Category_Wikipedia_sockpuppets_of_Sneb_I_Sneba.csv,201,6069214.0,76,125,38,38,0,50.78109452736319,294,45,25.980099502487562,6
Category_Wikipedia_sockpuppets_of_Raselva2022.csv,158,35263908.0,50,108,20,30,0,60.58860759493671,322,51,27.253164556962027,10
Category_Wikipedia_sockpuppets_of_Alameda15.csv,1538,31257917.0,554,984,131,423,0,40.99609882964889,255,56,25.383615084525356,5
Category_Wikipedia_sockpuppets_of_Giver_grey568.csv,17,198309.0,11,6,9,2,0,2.8823529411764706,27,46,46.0,46
Category_Wikipedia_sockpuppets_of_Youssef353.csv,999,48616893.0,393,606,370,23,0,36.92392392392392,255,30,11.6996996996997,5
Category_Wikipedia_sockpuppets_of_Anderson_nj.csv,19,11611.0,10,9,9,1,0,61.473684210526315,218,30,20.36842105263158,10
Category_Wikipedia_sockpuppets_of_CitrisSquid.csv,416,2346001.0,335,81,332,3,0,29.954326923076923,253,57,25.723557692307693,15
Category_Wikipedia_sockpuppets_of_Anurosemk.csv,19,5007645.0,10,9,9,1,0,35.26315789473684,196,17,13.0,8
Category_Wikipedia_sockpuppets_of_Ahmedzeid.csv,436,41642844.0,137,299,114,23,0,37.56422018348624,275,36,14.284403669724771,5
Category_Wikipedia_sockpuppets_of_Srbs2504.csv,47,11932627.0,18,29,8,10,0,57.276595744680854,252,52,45.97872340425532,20
Category_Wikipedia_sockpuppets_of_Slava_Ukraini_Heroyam_Slava_123.csv,2210,60568374.0,715,1495,481,234,0,48.7420814479638,494,67,23.726696832579186,3
Category_Wikipedia_sockpuppets_of_DRenato_av.csv,289,39569715.0,70,219,37,33,0,41.98615916955017,310,39,17.60553633217993,6
Category_Wikipedia_sockpuppets_of_Wailbail.csv,115,775718.0,40,75,25,15,0,61.25217391304348,278,29,13.26086956521739,6
Category_Wikipedia_sockpuppets_of_Degacrowe9.csv,273,12972327.0,115,158,68,47,0,42.065934065934066,252,50,41.63003663003663,15
Category_Wikipedia_sockpuppets_of_Jim-Siduri.csv,2358,61151997.0,830,1528,252,578,0,59.8685326547922,255,73,23.070398642917727,4
Category_Wikipedia_sockpuppets_of_Abd_carnivore_dieter.csv,12,690.0,5,7,2,3,20,105.16666666666667,267,16,14.75,11
Category_Wikipedia_sockpuppets_of_FrenchPeople.csv,312,12870708.0,117,195,63,54,0,33.76923076923077,264,50,17.208333333333332,6
Category_Wikipedia_sockpuppets_of_HarryVJaffa.csv,122,9001925.0,52,70,35,17,0,56.40163934426229,255,44,17.081967213114755,10
Category_Wikipedia_sockpuppets_of_Jurrasic_kid.csv,560,60135111.0,155,405,55,100,0,57.025,311,57,19.130357142857143,3
Category_Wikipedia_sockpuppets_of_Dannybeesd.csv,66,4174151.0,24,42,20,4,0,54.45454545454545,172,29,17.28787878787879,8
Category_Wikipedia_sockpuppets_of_Flagators.csv,362,181786797.0,99,263,95,4,0,55.28176795580111,253,53,19.558011049723756,4
Category_Wikipedia_sockpuppets_of_ThailandFootball.csv,2126,50370727.0,732,1394,500,232,0,42.08090310442145,499,56,18.590780809031045,5
Category_Wikipedia_sockpuppets_of_LouisAragon.csv,2708,292245429.0,664,2044,500,164,0,56.15805022156573,500,72,15.18463810930576,4
Category_Wikipedia_sockpuppets_of_Starkco.csv,104,49257725.0,29,75,29,0,0,59.26923076923077,230,48,12.01923076923077,4
Category_Wikipedia_sockpuppets_of_Tony254trill.csv,3419,96705003.0,1182,2237,427,755,0,39.0979818660427,250,49,17.09242468558058,4
Category_Wikipedia_sockpuppets_of_Gomes000.csv,632,131828094.0,222,410,110,112,0,59.81803797468354,245,40,16.746835443037973,4
Category_Wikipedia_sockpuppets_of_Alidagger.csv,6,1473186.0,5,1,3,2,0,94.33333333333333,496,22,21.666666666666668,21
Category_Wikipedia_sockpuppets_of_Denimbabel.csv,557,23520107.0,180,377,159,21,0,50.281867145421906,253,41,19.31956912028725,3
Category_Wikipedia_sockpuppets_of_Aztegdude.csv,6975,78557041.0,2676,4299,500,2176,0,35.20931899641577,519,72,18.53347670250896,3
Category_Wikipedia_sockpuppets_of_Kevinandrewprudente16.csv,111,2827267.0,58,53,49,9,0,35.91891891891892,317,41,30.936936936936938,4
Category_Wikipedia_sockpuppets_of_Jennypear82.csv,2,14.0,2,0,2,0,28,112.0,196,21,21.0,21
Category_Wikipedia_sockpuppets_of_Wizkizayo.csv,1236,123717905.0,426,810,94,332,0,49.87540453074433,299,57,17.285598705501616,3
Category_Wikipedia_sockpuppets_of_Gospel_veracity.csv,265,216507534.0,88,177,51,37,0,37.87547169811321,239,54,24.807547169811322,16
Category_Wikipedia_sockpuppets_of_Dimyeow.csv,26,15944.0,17,9,14,3,0,44.76923076923077,200,41,30.53846153846154,17
Category_Wikipedia_sockpuppets_of_VGP_DA_BEST.csv,8,376.0,4,4,3,1,0,50.375,101,24,14.75,5
Category_Wikipedia_sockpuppets_of_WinnerWolf99.csv,566,5530771.0,262,304,171,91,0,54.95583038869258,418,113,26.514134275618375,4
Category_Wikipedia_sockpuppets_of_Antoinexv.csv,60,2074621.0,34,26,16,18,0,160.61666666666667,497,16,16.0,16
Category_Wikipedia_sockpuppets_of_ChiefRedThunder.csv,125,36388291.0,25,100,18,7,0,47.792,223,37,12.976,5
Category_Wikipedia_sockpuppets_of_Ninespilaf.csv,40,8882698.0,14,26,13,1,0,56.975,267,34,22.55,15
Category_Wikipedia_sockpuppets_of_Lane99.csv,400,137857481.0,139,261,130,9,0,51.0125,246,60,27.495,11
Category_Wikipedia_sockpuppets_of_Bitfirms.csv,27,1798409.0,17,10,10,7,16,73.51851851851852,135,45,40.18518518518518,19
Category_Wikipedia_sockpuppets_of_M4silent.csv,92,3277559.0,34,58,21,13,0,51.51086956521739,173,26,11.934782608695652,6
Category_Wikipedia_sockpuppets_of_AuthorityOfOne.csv,10,71632.0,7,3,7,0,0,65.3,199,46,32.7,19
Category_Wikipedia_sockpuppets_of_ArafatHassanWiKi.csv,57,87212169.0,17,40,9,8,0,52.92982456140351,202,53,27.859649122807017,8
Category_Wikipedia_sockpuppets_of_SnehaAkhilesh.csv,12,2239770.0,4,8,3,1,0,65.91666666666667,194,20,15.333333333333334,12
Category_Wikipedia_sockpuppets_of_ACM7.csv,399,145008121.0,156,243,109,47,0,44.18295739348371,227,53,23.771929824561404,12
Category_Wikipedia_sockpuppets_of_Improvingthepen.csv,2675,30876851.0,958,1717,500,458,0,37.89383177570093,255,45,14.411214953271028,4
Category_Wikipedia_sockpuppets_of_Jersay.csv,1726,18128255.0,759,967,500,259,0,34.672653534183084,249,65,27.97045191193511,6
Category_Wikipedia_sockpuppets_of_Haseeb_Ahmed_Malik_786.csv,1879,42837713.0,669,1210,268,401,0,34.57424161788185,255,66,24.08249068653539,8
Category_Wikipedia_sockpuppets_of_ImAWubbox1984.csv,1568,14411796.0,457,1111,311,146,0,60.609693877551024,496,61,20.883290816326532,3
Category_Wikipedia_sockpuppets_of_Belyny.csv,623,88529512.0,240,383,228,12,0,56.78491171749599,323,62,28.770465489566615,6
Category_Wikipedia_sockpuppets_of_AgustinSepulveda2004.csv,295,72579363.0,77,218,65,12,0,58.02033898305085,322,42,23.48813559322034,10
Category_Wikipedia_sockpuppets_of_Theblokedone.csv,2240,130152211.0,657,1583,459,198,0,43.375,491,77,25.17276785714286,5
Category_Wikipedia_sockpuppets_of_Stunning_it_Ventures.csv,82,1039182.0,42,40,16,26,0,46.5609756097561,290,44,19.536585365853657,8
Category_Wikipedia_sockpuppets_of_Weaponbb7.csv,1748,9837694.0,533,1215,500,33,0,53.02402745995423,250,79,29.12070938215103,3
Category_Wikipedia_sockpuppets_of_Nandinigoel.india.csv,89,130019216.0,34,55,12,22,0,39.53932584269663,192,59,23.0561797752809,4
Category_Wikipedia_sockpuppets_of_Paniccie.csv,22,68503.0,7,15,4,3,0,34.72727272727273,199,24,17.363636363636363,15
Category_Wikipedia_sockpuppets_of_Skyring.csv,3752,591370857.0,938,2814,500,438,0,47.409914712153515,362,101,23.246535181236673,4
Category_Wikipedia_sockpuppets_of_PoliceOfficer124.csv,56,23958784.0,13,43,7,6,0,70.14285714285714,347,33,19.392857142857142,11
Category_Wikipedia_sockpuppets_of_Jaymarturner74.csv,168,1223152.0,55,113,35,20,0,43.73809523809524,275,41,23.767857142857142,6
Category_Wikipedia_sockpuppets_of_TwinTurbo.csv,1415,25262830.0,585,830,500,85,0,45.36961130742049,351,74,20.96678445229682,3
Category_Wikipedia_sockpuppets_of_Lightbringer_(usurped_-_blocked).csv,5017,214986656.0,1884,3133,489,1395,0,48.25014949172812,251,70,18.824197727725732,1
Category_Wikipedia_sockpuppets_of_Medule.csv,1824,206518731.0,509,1315,500,9,0,37.9484649122807,255,81,18.65953947368421,4
Category_Wikipedia_sockpuppets_of_INDIAN_DUGS.csv,189,34415581.0,76,113,64,12,0,42.74074074074074,246,63,22.243386243386244,4
Category_Wikipedia_sockpuppets_of_Vrahomarinaner.csv,787,113655597.0,233,554,82,151,0,33.099110546378654,304,65,22.818297331639137,8
Category_Wikipedia_sockpuppets_of_MarcoMiller2.csv,82,2932052.0,39,43,26,13,4,85.76829268292683,498,47,27.76829268292683,16
Category_Wikipedia_sockpuppets_of_Manfred.ruzicka.csv,248,377673561.0,85,163,28,57,0,52.641129032258064,258,49,26.532258064516128,7
Category_Wikipedia_sockpuppets_of_AvinashCabral.csv,1444,83045041.0,387,1057,289,98,0,54.65997229916898,383,59,17.359418282548475,5
Category_Wikipedia_sockpuppets_of_Joeyjoejoeman.csv,274,17484762.0,94,180,73,21,0,42.083941605839414,231,41,27.78832116788321,13
Category_Wikipedia_sockpuppets_of_Historian19.csv,12074,75480089.0,2765,9309,500,2265,0,42.599884048368395,267,69,10.949064104687759,4
Category_Wikipedia_sockpuppets_of_Buhiod.csv,197,150804.0,75,122,36,39,0,41.56345177664975,210,31,19.527918781725887,10
Category_Wikipedia_sockpuppets_of_Dfnkgne.csv,60,4573.0,20,40,6,14,0,57.2,197,50,32.36666666666667,7
Category_Wikipedia_sockpuppets_of_Tek19.csv,2056,126025307.0,580,1476,171,409,0,44.68920233463035,425,66,24.63375486381323,3
Category_Wikipedia_sockpuppets_of_Benkeyz.csv,87,35370746.0,36,51,15,21,0,58.94252873563219,254,52,17.50574712643678,9
Category_Wikipedia_sockpuppets_of_Ankitdevarpan.csv,256,74420292.0,70,186,27,43,0,46.87890625,240,53,20.71484375,5
Category_Wikipedia_sockpuppets_of_RJASE1.csv,1196,1103667.0,503,693,500,3,0,66.11872909698997,250,59,34.22157190635451,5
Category_Wikipedia_sockpuppets_of_Lethweimaster.csv,15,4844779.0,6,9,4,2,0,67.53333333333333,255,19,11.133333333333333,10
Category_Wikipedia_sockpuppets_of_Guanna.csv,626,70508764.0,196,430,101,95,0,46.29073482428115,238,57,17.509584664536742,3
Category_Wikipedia_sockpuppets_of_Hexa2010.csv,144,8884971.0,76,68,71,5,0,34.333333333333336,248,18,14.395833333333334,7
Category_Wikipedia_sockpuppets_of_Oobi.csv,196,363325413.0,59,137,35,24,0,55.826530612244895,368,29,12.923469387755102,6
Category_Wikipedia_sockpuppets_of_Fnnmemewars.csv,78,6074.0,26,52,17,9,0,65.5,237,32,13.923076923076923,3
Category_Wikipedia_sockpuppets_of_Molvi333.csv,1161,208993351.0,502,659,299,203,0,38.761412575366066,255,59,10.559000861326442,4
Category_Wikipedia_sockpuppets_of_Starbuck6789.csv,1,0.0,1,0,1,0,0,0.0,0,20,20.0,20
Category_Wikipedia_sockpuppets_of_Knock-Off_Nigel.csv,3447,42797099.0,1307,2140,500,807,0,40.153756890049316,250,97,23.868291267769074,3
Category_Wikipedia_sockpuppets_of_CreatureKawa.csv,2097,20793539.0,531,1566,469,62,0,40.10443490701002,253,71,25.179780639008108,7
Category_Wikipedia_sockpuppets_of_Tyler_Durden.csv,1988,24720917.0,620,1368,500,120,0,66.21629778672032,255,67,21.379275653923543,5
Category_Wikipedia_sockpuppets_of_Cardicharts.csv,2950,31713917.0,809,2141,236,573,0,39.74440677966102,500,69,25.43491525423729,3
Category_Wikipedia_sockpuppets_of_SadhuVaswani.csv,475,258681874.0,284,191,149,135,0,34.38315789473684,279,45,15.701052631578948,11
Category_Wikipedia_sockpuppets_of_Miguel1369.csv,1967,74232755.0,824,1143,423,401,0,36.928825622775804,255,51,24.152516522623284,15
Category_Wikipedia_sockpuppets_of_nlfestival.csv,184,757533.0,69,115,67,2,0,42.58695652173913,251,72,43.17934782608695,14
Category_Wikipedia_sockpuppets_of_Dsnareofficial.csv,1,0.0,1,0,1,0,14,14.0,14,19,19.0,19
Category_Wikipedia_sockpuppets_of_Tofayel_ahmed_1.csv,23,25289794.0,12,11,9,3,0,61.04347826086956,237,26,23.391304347826086,18
Category_Wikipedia_sockpuppets_of_Prayerbeadstore.csv,33,1798235.0,16,17,16,0,0,48.15151515151515,189,12,8.030303030303031,6
Category_Wikipedia_sockpuppets_of_IllusionFinal.csv,487,90917126.0,106,381,101,5,0,53.72689938398357,250,53,15.301848049281315,4
Category_Wikipedia_sockpuppets_of_Dreamsheld.csv,691,13378833.0,218,473,65,153,0,45.77134587554269,349,66,15.507959479015918,4
Category_Wikipedia_sockpuppets_of_Sec4dr.csv,61,3276001.0,32,29,30,2,0,35.73770491803279,171,52,26.557377049180328,11
Category_Wikipedia_sockpuppets_of_Webapp.csv,7,51.0,3,4,3,0,24,75.0,138,66,42.285714285714285,21
Category_Wikipedia_sockpuppets_of_Wagemut.csv,762,10656528.0,300,462,169,131,0,32.45931758530184,253,49,15.539370078740157,6
Category_Wikipedia_sockpuppets_of_AlbertBikaj.csv,15,297654.0,9,6,9,0,0,42.666666666666664,158,24,15.8,10
Category_Wikipedia_sockpuppets_of_Viktory02.csv,2762,63673611.0,732,2030,275,457,0,61.1643736422882,500,119,19.413830557566982,3
Category_Wikipedia_sockpuppets_of_AimalCool.csv,211,4307153.0,69,142,65,4,0,46.24644549763033,265,44,16.554502369668246,4
Category_Wikipedia_sockpuppets_of_Mani_Esmaili.csv,7,795935.0,6,1,4,2,0,53.285714285714285,196,25,22.428571428571427,19
Category_Wikipedia_sockpuppets_of_Kabir_Vaghela.csv,2412,57940041.0,956,1456,264,692,0,35.17951907131012,255,81,15.516169154228855,4
Category_Wikipedia_sockpuppets_of_Brockhole.csv,69,95981.0,21,48,6,15,0,55.507246376811594,233,25,12.942028985507246,5
Category_Wikipedia_sockpuppets_of_CFPRO.csv,3,1033003.0,2,1,1,1,0,7.333333333333333,13,55,23.666666666666668,8
Category_Wikipedia_sockpuppets_of_Pezon_prem.csv,168,89472547.0,48,120,44,4,0,51.13095238095238,246,25,11.922619047619047,8
Category_Wikipedia_sockpuppets_of_Dompreston.csv,267,253510858.0,80,187,62,18,0,44.97752808988764,230,78,23.913857677902623,5
Category_Wikipedia_sockpuppets_of_Karthikesa.csv,57,134187668.0,27,30,25,2,0,39.24561403508772,224,24,16.56140350877193,12
Category_Wikipedia_sockpuppets_of_B3156094t.csv,601,64760627.0,177,424,126,51,0,48.11148086522463,214,86,20.452579034941763,4
Category_Wikipedia_sockpuppets_of_Dominic.persinger.csv,27,879658.0,19,8,19,0,10,52.370370370370374,221,34,22.22222222222222,8
Category_Wikipedia_sockpuppets_of_Alampallil_panikker.csv,75,11658077.0,33,42,17,16,0,40.666666666666664,142,29,16.12,4
Category_Wikipedia_sockpuppets_of_AbhinavPandeybinnakandi.csv,190,1498407.0,101,89,84,17,0,41.584210526315786,255,53,20.83684210526316,9
Category_Wikipedia_sockpuppets_of_Redunded101.csv,9,399.0,4,5,4,0,4,78.66666666666667,197,23,15.666666666666666,12
Category_Wikipedia_sockpuppets_of_Johnathan_Osorio.csv,307,38078320.0,140,167,68,72,0,32.68403908794788,248,50,25.019543973941367,3
Category_Wikipedia_sockpuppets_of_ArekSmith.csv,2181,17788972.0,659,1522,500,159,0,39.743695552498856,358,62,21.011004126547455,4
Category_Wikipedia_sockpuppets_of_Joseph_Fanai.csv,3820,153382195.0,1477,2343,500,977,0,32.36230366492146,255,51,23.141361256544503,4
Category_Wikipedia_sockpuppets_of_RBF_Production.csv,14,11711155.0,4,10,2,2,0,52.5,155,24,17.857142857142858,16
Category_Wikipedia_sockpuppets_of_Dashing_boy31.csv,402,327023338.0,136,266,60,76,0,46.56716417910448,227,101,22.039800995024876,4
Category_Wikipedia_sockpuppets_of_Starwars1955.csv,1684,25899691.0,693,991,172,521,0,44.02256532066508,200,56,18.739904988123516,5
Category_Wikipedia_sockpuppets_of_Oscareduardo10.csv,75,81184033.0,20,55,10,10,0,47.53333333333333,190,53,16.84,8
Category_Wikipedia_sockpuppets_of_TheCurrencyGuy.csv,1680,6426823.0,504,1176,500,4,0,48.144642857142856,448,102,22.685714285714287,3
Category_Wikipedia_sockpuppets_of_User20150924.csv,22,358320.0,17,5,8,9,0,110.22727272727273,246,23,14.818181818181818,13
Category_Wikipedia_sockpuppets_of_Surzo_Mojo_2000.csv,194,5009939.0,82,112,47,35,0,45.628865979381445,465,35,16.788659793814432,5
Category_Wikipedia_sockpuppets_of_Alwaysunpctruth.csv,19,114056.0,12,7,9,3,0,52.63157894736842,194,25,14.578947368421053,9
Category_Wikipedia_sockpuppets_of_Ruudtelemark.csv,130,142673401.0,61,69,28,33,0,41.184615384615384,236,24,16.76923076923077,6
Category_Wikipedia_sockpuppets_of_TerraByte20.csv,24,3075.0,14,10,12,2,0,28.125,175,22,19.208333333333332,6
Category_Wikipedia_sockpuppets_of_Mouauia_rafii.csv,1208,76932560.0,325,883,117,208,0,43.69867549668874,255,49,21.34933774834437,6
Category_Wikipedia_sockpuppets_of_Penguinluver1431.csv,406,47262990.0,102,304,99,3,0,41.90147783251231,244,50,22.482758620689655,6
Category_Wikipedia_sockpuppets_of_Smithonly1.csv,157,58758205.0,54,103,12,42,0,47.07643312101911,246,41,20.0828025477707,3
Category_Wikipedia_sockpuppets_of_AbuRuud.csv,969,48535621.0,382,587,359,23,0,49.80082559339525,255,58,21.883384932920535,3
Category_Wikipedia_sockpuppets_of_Eugene_m1999.csv,24,12008924.0,10,14,8,2,0,50.25,162,52,17.416666666666668,5
Category_Wikipedia_sockpuppets_of_Onlinebooks.asia.csv,79,7599051.0,27,52,16,11,0,59.49367088607595,200,27,17.39240506329114,11
Category_Wikipedia_sockpuppets_of_Edit_of_edit.csv,261,91430194.0,92,169,88,4,0,55.84674329501916,496,47,22.042145593869733,6
Category_Wikipedia_sockpuppets_of_Buenoma.csv,294,1319540.0,101,193,75,26,0,39.976190476190474,213,39,16.068027210884352,5
Category_Wikipedia_sockpuppets_of_Simulation12.csv,13319,425423797.0,4653,8666,500,4153,0,50.5881072152564,496,88,24.482243411667543,3
Category_Wikipedia_sockpuppets_of_Redandready.csv,958,395472342.0,343,615,285,58,0,50.733820459290186,464,70,22.719206680584552,4
Category_Wikipedia_sockpuppets_of_Pokerdance.csv,1784,5440357.0,649,1135,500,149,0,54.45683856502242,246,69,20.576793721973093,2
Category_Wikipedia_sockpuppets_of_JohnnyAB.csv,121,13174999.0,39,82,17,22,0,50.1900826446281,199,50,29.75206611570248,14
Category_Wikipedia_sockpuppets_of_PlatformWire.csv,51,638987.0,19,32,2,17,0,50.90196078431372,255,20,12.549019607843137,5
Category_Wikipedia_sockpuppets_of_Arsony.csv,89,86080694.0,24,65,18,6,0,51.80898876404494,215,58,17.528089887640448,6
Category_Wikipedia_sockpuppets_of_Sparklewand.csv,3320,49611259.0,1093,2227,266,827,0,35.732831325301206,245,49,20.443373493975905,4
Category_Wikipedia_sockpuppets_of_Masterofroblox.csv,1251,25046724.0,400,851,125,275,0,59.299760191846524,496,61,25.95363709032774,3
Category_Wikipedia_sockpuppets_of_Crazeone.csv,36,15076804.0,11,25,8,3,0,52.583333333333336,186,23,20.583333333333332,13
Category_Wikipedia_sockpuppets_of_Asbo23.csv,73,18303261.0,51,22,17,34,0,57.71232876712329,247,44,28.08219178082192,16
Category_Wikipedia_sockpuppets_of_ANMC001.csv,464,645502.0,187,277,153,34,0,61.202586206896555,500,36,14.984913793103448,5
Category_Wikipedia_sockpuppets_of_Quack_Hunter.csv,2832,53807721.0,1197,1635,500,697,0,44.380649717514125,255,69,16.702330508474578,4
Category_Wikipedia_sockpuppets_of_Imbris.csv,2414,18765346.0,737,1677,500,237,0,54.724937862468934,255,81,25.43744821872411,3
Category_Wikipedia_sockpuppets_of_Stayfi.csv,307,29519563.0,93,214,90,3,0,38.814332247557005,169,52,26.36156351791531,6
Category_Wikipedia_sockpuppets_of_HungNguyen19181945.csv,3811,37423046.0,963,2848,464,499,0,50.12017843085804,496,81,25.83888743112044,5
Category_Wikipedia_sockpuppets_of_HouseOfStasis.csv,33,8212591.0,7,26,6,1,10,52.45454545454545,142,47,40.515151515151516,9
Category_Wikipedia_sockpuppets_of_The_King349.csv,1032,9079683.0,409,623,49,360,0,42.55232558139535,376,47,17.449612403100776,4
Category_Wikipedia_sockpuppets_of_Greenboy210.csv,24,2357.0,11,13,11,0,0,66.5,192,22,17.125,4
Category_Wikipedia_sockpuppets_of_Donutsareverygood.csv,41,431253.0,18,23,8,10,0,45.75609756097561,237,23,14.24390243902439,6
Category_Wikipedia_sockpuppets_of_Zengar_Zombolt.csv,1569,114177767.0,548,1021,448,100,0,41.34225621414914,223,86,24.053537284894837,4
Category_Wikipedia_sockpuppets_of_Dhiyaa.2004.csv,2,574.0,2,0,2,0,0,0.0,0,53,53.0,53
Category_Wikipedia_sockpuppets_of_River-dawe.csv,5,249.0,2,3,2,0,0,83.0,140,54,54.0,54
Category_Wikipedia_sockpuppets_of_Bahameenballin.csv,958,39644863.0,319,639,121,198,0,40.823590814196244,228,46,16.647181628392484,2
Category_Wikipedia_sockpuppets_of_Sethie.csv,4420,578929189.0,1115,3305,500,615,0,58.34909502262443,477,86,20.4,1
Category_Wikipedia_sockpuppets_of_Georgesummer.csv,353,109724529.0,148,205,142,6,0,36.22096317280453,250,47,18.64589235127479,10
Category_Wikipedia_sockpuppets_of_Stayhomestaysafe.csv,39,2740465.0,26,13,15,11,0,38.05128205128205,286,63,25.666666666666668,10
Category_Wikipedia_sockpuppets_of_Haroldcoxley994.csv,332,8980014.0,107,225,55,52,0,41.54216867469879,219,33,15.367469879518072,9
Category_Wikipedia_sockpuppets_of_‡§™‡§Ç‡§ö‡§∞_‡§™‡•Å‡§§‡•ç‡§∞‡§Æ_‡§ï‡§≠‡•Ä_‡§®‡§æ_‡§Æ‡§ø‡§§‡•ç‡§∞‡§Æ.csv,153,1052052.0,59,94,49,10,0,41.41830065359477,258,20,12.869281045751634,6
Category_Wikipedia_sockpuppets_of_Wassermann.csv,1265,139413.0,464,801,464,0,0,31.401581027667984,200,51,16.16916996047431,3
Category_Wikipedia_sockpuppets_of_Megameeting.csv,114,2875523.0,26,88,26,0,0,41.40350877192982,188,37,18.24561403508772,9
Category_Wikipedia_sockpuppets_of_McBee_SC.csv,97,41007107.0,36,61,24,12,0,45.52577319587629,235,21,15.556701030927835,11
Category_Wikipedia_sockpuppets_of_Frog989238242.csv,109,882761.0,45,64,14,31,0,46.972477064220186,205,25,15.55045871559633,4
Category_Wikipedia_sockpuppets_of_Mian_raza_ahmad_khan.csv,7,67257.0,4,3,2,2,0,66.14285714285714,108,40,39.142857142857146,38
Category_Wikipedia_sockpuppets_of_Flaminka.csv,80,12574489.0,33,47,20,13,0,61.7375,273,55,17.6625,9
Category_Wikipedia_sockpuppets_of_Shevonsilva.csv,1007,7842584.0,517,490,500,17,0,49.89771598808342,309,74,23.90566037735849,3
Category_Wikipedia_sockpuppets_of_Contebragheonte.csv,204,15792490.0,82,122,59,23,0,40.09313725490196,257,36,24.82843137254902,11
Category_Wikipedia_sockpuppets_of_Beefcakeyt.csv,144,4244453.0,61,83,40,21,0,48.798611111111114,359,50,28.243055555555557,12
Category_Wikipedia_sockpuppets_of_Ladenmark.csv,79,5078030.0,28,51,16,12,0,39.43037974683544,195,28,17.569620253164558,5
Category_Wikipedia_sockpuppets_of_Nottedeluce.csv,1705,260807806.0,518,1187,500,18,0,46.44398826979472,376,42,15.882697947214076,6
Category_Wikipedia_sockpuppets_of_Zaltano.csv,31,8815590.0,17,14,6,11,0,90.6774193548387,243,16,16.0,16
Category_Wikipedia_sockpuppets_of_YLHamdani.csv,12,68117.0,4,8,4,0,0,26.5,105,51,43.333333333333336,28
Category_Wikipedia_sockpuppets_of_Samuelallsebrook.csv,76,7619878.0,22,54,20,2,0,48.828947368421055,221,15,8.486842105263158,5
Category_Wikipedia_sockpuppets_of_Scarlett7910.csv,91,5970077.0,27,64,27,0,0,60.879120879120876,269,45,21.32967032967033,5
Category_Wikipedia_sockpuppets_of_ÿ¨ŸàÿßÿØ_ÿ±ŸÖÿ∂ÿßŸÜ€å_ÿ¥Ÿàÿ±ÿßÿ®.csv,120,71520975.0,28,92,5,23,0,47.74166666666667,230,31,14.125,3
Category_Wikipedia_sockpuppets_of_ThatRockMetalGuy.csv,1963,2604967.0,612,1351,500,112,0,37.924605196128375,257,47,17.928680590932245,7
Category_Wikipedia_sockpuppets_of_Me_and_nobody_else.csv,7,2527.0,3,4,3,0,9,84.71428571428571,195,11,8.142857142857142,6
Category_Wikipedia_sockpuppets_of_Tailares.csv,89,6491345.0,23,66,9,14,0,48.8876404494382,214,25,18.56179775280899,13
Category_Wikipedia_sockpuppets_of_Neil_Edgar.csv,101,4100856.0,32,69,31,1,0,61.0,245,54,31.940594059405942,15
Category_Wikipedia_sockpuppets_of_Frank_Schouten.csv,32,441257.0,15,17,6,9,0,22.09375,142,22,17.34375,13
Category_Wikipedia_sockpuppets_of_YankeesGrey.csv,72,8817237.0,20,52,17,3,0,44.69444444444444,137,47,20.86111111111111,11
Category_Wikipedia_sockpuppets_of_Usaar33.csv,469,550663495.0,165,304,157,8,0,66.81236673773988,499,43,25.8272921108742,12
Category_Wikipedia_sockpuppets_of_Associated_Print.csv,29,4093136.0,15,14,12,3,0,53.6551724137931,243,12,12.0,12
Category_Wikipedia_sockpuppets_of_Khawmhuai98.csv,99,22481236.0,39,60,32,7,0,49.707070707070706,494,53,32.63636363636363,5
Category_Wikipedia_sockpuppets_of_Sivakn93.csv,13,424487.0,10,3,3,7,0,50.07692307692308,141,37,37.0,37
Category_Wikipedia_sockpuppets_of_Frostie_Jack.csv,23582,51598040.0,6665,16917,500,6165,0,41.93634975829022,260,84,18.05924009838012,1
Category_Wikipedia_sockpuppets_of_Samra_Suleman.csv,30,102681.0,14,16,13,1,0,34.166666666666664,171,27,20.2,13
Category_Wikipedia_sockpuppets_of_Martinphi.csv,1550,65160913.0,550,1000,500,50,0,48.13483870967742,217,72,31.718064516129033,7
Category_Wikipedia_sockpuppets_of_Th45623j.csv,75,263848.0,35,40,16,19,0,54.76,213,81,23.68,9
Category_Wikipedia_sockpuppets_of_Andrew_Lin.csv,80,21591643.0,23,57,11,12,0,20.5375,146,41,16.7375,1
Category_Wikipedia_sockpuppets_of_Trouble34.csv,1,0.0,1,0,1,0,13,13.0,13,32,32.0,32
Category_Wikipedia_sockpuppets_of_Cfiore1230.csv,121,9675017.0,54,67,19,35,0,42.63636363636363,222,42,18.223140495867767,7
Category_Wikipedia_sockpuppets_of_Mournful.csv,140,149799962.0,59,81,42,17,0,35.65,255,38,16.057142857142857,8
Category_Wikipedia_sockpuppets_of_Judae1.csv,2084,201487113.0,661,1423,500,161,0,49.99088291746641,255,66,18.108925143953936,4
Category_Wikipedia_sockpuppets_of_SSGSS2.csv,29,946275.0,9,20,6,3,0,59.62068965517241,179,30,12.551724137931034,4
Category_Wikipedia_sockpuppets_of_WBS1945.csv,1,0.0,1,0,1,0,34,34.0,34,20,20.0,20
Category_Wikipedia_sockpuppets_of_Lymphedemacorrection.csv,48,20449.0,16,32,12,4,0,65.5,194,30,15.1875,10
Category_Wikipedia_sockpuppets_of_Markomoreno0391.csv,1183,10786953.0,608,575,431,177,0,22.552831783601015,289,61,35.09805579036348,10
Category_Wikipedia_sockpuppets_of_EHartson.csv,8919,18965294.0,3158,5761,500,2658,0,49.23590088574952,500,53,14.845274133871511,4
Category_Wikipedia_sockpuppets_of_Unfriendly_Aliens.csv,493,2071678.0,147,346,126,21,0,51.78904665314402,403,38,24.66531440162272,8
Category_Wikipedia_sockpuppets_of_Aries009.csv,891,19444764.0,330,561,73,257,0,51.21661054994388,255,54,19.61840628507295,5
Category_Wikipedia_sockpuppets_of_Mukesh10.csv,16,3958554.0,5,11,3,2,0,56.6875,190,38,22.0,6
Category_Wikipedia_sockpuppets_of_DatebookDating.csv,17,969066.0,10,7,6,4,0,65.3529411764706,251,28,27.11764705882353,23
Category_Wikipedia_sockpuppets_of_Break_the_fucking_shit.csv,38,3042725.0,23,15,15,8,0,14.921052631578947,107,32,15.631578947368421,3
Category_Wikipedia_sockpuppets_of_AK56.csv,564,18806243.0,187,377,154,33,0,26.20212765957447,250,44,16.858156028368793,3
Category_Wikipedia_sockpuppets_of_Gorge_He.csv,2281,59183019.0,698,1583,427,271,0,47.8658483121438,247,59,21.409907935116177,3
Category_Wikipedia_sockpuppets_of_Rahulogy.csv,1974,350303108.0,710,1264,493,217,0,33.22948328267477,259,66,21.785207700101317,4
Category_Wikipedia_sockpuppets_of_Wesker220.csv,140,38833776.0,42,98,30,12,0,30.692857142857143,202,50,20.90714285714286,5
Category_Wikipedia_sockpuppets_of_Darko_Trifunovic.csv,321,83026192.0,119,202,69,50,0,46.691588785046726,215,54,23.02492211838006,13
Category_Wikipedia_sockpuppets_of_Raul7213.csv,108,77724843.0,49,59,48,1,0,46.19444444444444,229,26,21.75,14
Category_Wikipedia_sockpuppets_of_I-82-I.csv,1646,12583242.0,512,1134,500,12,0,53.025516403402186,443,79,23.888213851761847,5
Category_Wikipedia_sockpuppets_of_DesGar√ßon.csv,245,39302956.0,94,151,51,43,0,38.59183673469388,225,43,17.444897959183674,8
Category_Wikipedia_sockpuppets_of_I_am_going_to_be_edited_out.csv,29,13208.0,13,16,6,7,0,75.82758620689656,255,29,18.310344827586206,6
Category_Wikipedia_sockpuppets_of_HardCoreFactz.csv,95,4397886.0,19,76,7,12,0,67.98947368421052,229,38,16.526315789473685,9
Category_Wikipedia_sockpuppets_of_Brandon1222.csv,625,19016904.0,335,290,307,28,0,33.2048,251,36,24.3056,11
Category_Wikipedia_sockpuppets_of_Nickaang.csv,6502,254454552.0,2318,4184,500,1818,0,47.10350661334974,259,85,20.315902799138726,3
Category_Wikipedia_sockpuppets_of_Goelia.csv,937,102103667.0,320,617,138,182,0,51.252934898612594,255,73,19.801494130202776,5
Category_Wikipedia_sockpuppets_of_There-being.csv,519,16939513.0,237,282,181,56,0,63.41425818882466,491,82,30.109826589595375,13
Category_Wikipedia_sockpuppets_of_Humbert1.csv,167,2200907.0,57,110,35,22,0,47.78443113772455,230,51,22.53293413173653,8
Category_Wikipedia_sockpuppets_of_JesusJohnson7.csv,4212,130028141.0,1038,3174,500,538,0,49.13414055080722,494,65,21.13983855650522,4
Category_Wikipedia_sockpuppets_of_Azure1.csv,5265,198784078.0,1557,3708,500,1057,0,47.33656220322887,255,81,19.620892687559355,4
Category_Wikipedia_sockpuppets_of_Anjali00020010.csv,155,20232618.0,59,96,56,3,0,34.58709677419355,435,27,15.451612903225806,5
Category_Wikipedia_sockpuppets_of_Rurudawriter.csv,117,60042327.0,49,68,42,7,0,49.23931623931624,236,48,33.35042735042735,18
Category_Wikipedia_sockpuppets_of_Right_Hand_Drive.csv,475,18960979.0,148,327,134,14,0,61.50105263157895,253,59,29.45263157894737,15
Category_Wikipedia_sockpuppets_of_Albertpda.csv,7772,249958108.0,2143,5629,359,1784,0,43.82887287699434,500,54,20.968219248584663,4
Category_Wikipedia_sockpuppets_of_DJFryzy.csv,1107,27410313.0,406,701,295,111,0,54.70099367660343,255,56,18.290876242095756,6
Category_Wikipedia_sockpuppets_of_Fortnitegamer3432.csv,1613,9337107.0,579,1034,500,79,0,41.01487910725356,500,79,23.087414755114693,4
Category_Wikipedia_sockpuppets_of_Tyihk234.csv,45,251469.0,19,26,7,12,0,38.733333333333334,188,41,30.11111111111111,15
Category_Wikipedia_sockpuppets_of_Hemunarine.csv,250,44058424.0,76,174,64,12,0,62.088,255,38,27.456,6
Category_Wikipedia_sockpuppets_of_Astralyu.csv,378,21443928.0,128,250,100,28,0,42.05820105820106,493,58,23.333333333333332,8
Category_Wikipedia_sockpuppets_of_Best_known_for_IP.csv,1065,88296077.0,268,797,138,130,0,61.0018779342723,440,64,17.699530516431924,4
Category_Wikipedia_sockpuppets_of_MWill75.csv,629,46188011.0,212,417,180,32,0,43.53100158982512,264,58,19.251192368839426,7
Category_Wikipedia_sockpuppets_of_Derbyboy2890.csv,2024,46210638.0,539,1485,164,375,0,57.176383399209485,501,62,21.942193675889328,5
Category_Wikipedia_sockpuppets_of_Mugunthsboa.csv,409,542485472.0,90,319,87,3,0,49.163814180929094,316,54,28.660146699266505,7
Category_Wikipedia_sockpuppets_of_Nat_Christian.csv,98,76341649.0,95,3,45,50,0,7.918367346938775,189,23,18.20408163265306,18
Category_Wikipedia_sockpuppets_of_Nangparbat.csv,7242,486057265.0,2045,5197,142,1903,0,59.262910798122064,462,88,20.1969069317868,2
Category_Wikipedia_sockpuppets_of_Johan_Van_Der_Twizzleton.csv,8,1286.0,5,3,1,4,0,118.25,184,12,12.0,12
Category_Wikipedia_sockpuppets_of_Keitrt.csv,223,462845779.0,57,166,45,12,0,47.81614349775785,318,34,16.556053811659194,5
Category_Wikipedia_sockpuppets_of_Hardworking.csv,56,501422.0,26,30,26,0,0,29.767857142857142,177,24,17.839285714285715,8
Category_Wikipedia_sockpuppets_of_BucharestMan.csv,1,0.0,1,0,1,0,37,37.0,37,26,26.0,26
Category_Wikipedia_sockpuppets_of_Shauna_Glynn.csv,166,96748.0,97,69,28,69,0,46.86144578313253,196,49,26.89156626506024,10
Category_Wikipedia_sockpuppets_of_Are_you_a_meatpuppet_.csv,22,713.0,7,15,7,0,0,47.90909090909091,223,76,30.136363636363637,9
Category_Wikipedia_sockpuppets_of_Ah8007.csv,1401,272418655.0,300,1101,64,236,0,42.46324054246966,297,49,12.518201284796573,3
Category_Wikipedia_sockpuppets_of_Author.scoreline.01.csv,32,2905129.0,23,9,20,3,0,27.84375,168,29,20.625,16
Category_Wikipedia_sockpuppets_of_Misterjerkface.csv,21,17762.0,8,13,4,4,0,59.57142857142857,175,28,17.0,7
Category_Wikipedia_sockpuppets_of_Imaginationcolors.csv,273,5099079.0,106,167,48,58,0,43.40659340659341,224,62,24.652014652014653,7
Category_Wikipedia_sockpuppets_of_EddieSegoura.csv,6283,431019506.0,2180,4103,500,1680,0,45.6603533343944,260,80,22.18430685978036,1
Category_Wikipedia_sockpuppets_of_Internetguide.csv,132,22426252.0,31,101,31,0,0,23.886363636363637,142,37,21.03787878787879,9
Category_Wikipedia_sockpuppets_of_LogicalBrian.csv,80,414307.0,28,52,6,22,0,59.6375,165,54,21.575,10
Category_Wikipedia_sockpuppets_of_Glorious_Japan_Forever.csv,126,4961341.0,45,81,22,23,0,54.44444444444444,234,58,22.293650793650794,11
Category_Wikipedia_sockpuppets_of_Soutut.csv,2080,32667210.0,728,1352,500,228,0,48.79855769230769,494,68,19.515865384615385,5
Category_Wikipedia_sockpuppets_of_Musicalartist071.csv,2851,11938749.0,846,2005,360,486,0,54.21150473518064,488,54,17.190459487898984,2
Category_Wikipedia_sockpuppets_of_Enrico.cambiaso.csv,171,256794521.0,56,115,34,22,0,66.57309941520468,494,29,21.116959064327485,3
Category_Wikipedia_sockpuppets_of_K72_Music.csv,104,100718.0,35,69,21,14,0,37.05769230769231,395,28,18.85576923076923,14
Category_Wikipedia_sockpuppets_of_Adijkfaudf.csv,15,7214.0,8,7,7,1,0,30.466666666666665,126,21,17.133333333333333,11
Category_Wikipedia_sockpuppets_of_Neji56565onyoutube.csv,2998,13983330.0,844,2154,500,344,0,35.642428285523685,247,64,18.377251501000668,2
Category_Wikipedia_sockpuppets_of_ChelsiJ2919.csv,1016,15130028.0,259,757,126,133,0,57.35236220472441,500,28,13.733267716535433,4
Category_Wikipedia_sockpuppets_of_John_Kwiecinski.csv,5452,116500301.0,1468,3984,172,1296,0,43.15719002201027,376,55,12.814380044020544,3
Category_Wikipedia_sockpuppets_of_Jamminjimmy.csv,74,520002.0,33,41,27,6,3,56.648648648648646,234,60,34.37837837837838,10
Category_Wikipedia_sockpuppets_of_Sguiiuuuyasdd.csv,16,57711.0,7,9,4,3,0,73.4375,181,17,14.8125,13
Category_Wikipedia_sockpuppets_of_Awooooga22.csv,102,2179931.0,40,62,35,5,0,44.049019607843135,234,26,14.96078431372549,3
Category_Wikipedia_sockpuppets_of_HCUPData.csv,894,290927774.0,265,629,148,117,0,51.61297539149888,257,39,21.987695749440714,4
Category_Wikipedia_sockpuppets_of_Alligator_tamer.csv,10,2446.0,4,6,2,2,13,106.5,320,21,12.6,7
Category_Wikipedia_sockpuppets_of_Adishesha.csv,3709,367833352.0,1000,2709,500,500,0,40.050417902399566,455,58,16.027770288487464,3
Category_Wikipedia_sockpuppets_of_Padmalakshmisx.csv,80112,461733633.0,27934,52178,500,27434,0,37.00857549430797,500,84,17.431458458158577,3
Category_Wikipedia_sockpuppets_of_Allerla.csv,958,26040634.0,336,622,211,125,0,48.19937369519833,497,42,13.81732776617954,3
Category_Wikipedia_sockpuppets_of_Cyberwikied.csv,86,2164138.0,41,45,18,23,0,48.97674418604651,233,41,22.72093023255814,12
Category_Wikipedia_sockpuppets_of_Hissmas.csv,22,24364324.0,7,15,6,1,0,21.818181818181817,123,49,21.954545454545453,11
Category_Wikipedia_sockpuppets_of_Naidu999.csv,256,50938299.0,132,124,62,70,0,44.08984375,496,47,15.75390625,5
Category_Wikipedia_sockpuppets_of_Lucas_Duke.csv,3531,78733442.0,811,2720,438,373,0,39.6921551968281,255,61,20.131973945058057,3
Category_Wikipedia_sockpuppets_of_Clamorformore.csv,56,222049264.0,21,35,9,12,0,34.57142857142857,200,47,32.839285714285715,11
Category_Wikipedia_sockpuppets_of_Cindery.csv,2963,14859327.0,1061,1902,500,561,0,38.49949375632804,200,81,29.71852851839352,4
Category_Wikipedia_sockpuppets_of_MouseCatDog.csv,1058,28396786.0,279,779,245,34,0,41.51890359168242,490,69,22.430056710775048,4
Category_Wikipedia_sockpuppets_of_Konguboy.csv,766,3992304.0,286,480,277,9,0,38.75587467362924,225,50,16.218015665796344,2
Category_Wikipedia_sockpuppets_of_TechnoBladeSPX.csv,676,26251853.0,315,361,308,7,0,46.84319526627219,452,50,26.701183431952664,4
Category_Wikipedia_sockpuppets_of_Beteskilla.csv,104,1231873.0,28,76,15,13,0,28.03846153846154,150,23,17.278846153846153,9
Category_Wikipedia_sockpuppets_of_Artaria195.csv,774,40848896.0,341,433,340,1,0,40.208010335917315,250,46,20.2984496124031,6
Category_Wikipedia_sockpuppets_of_Mcollinscalz.csv,71,19865128.0,18,53,15,3,0,59.08450704225352,243,67,26.098591549295776,12
Category_Wikipedia_sockpuppets_of_Bonsairolex.csv,1247,4315759.0,462,785,414,48,0,58.59262229350441,250,55,18.360064153969528,5
Category_Wikipedia_sockpuppets_of_Mateogarcia310.csv,2,82.0,2,0,2,0,19,19.0,19,28,28.0,28
Category_Wikipedia_sockpuppets_of_Himesh84.csv,1249,32867261.0,508,741,500,8,0,52.947958366693356,255,81,25.395516413130505,6
Category_Wikipedia_sockpuppets_of_Bozzio.csv,3608,55659058.0,1042,2566,500,542,0,58.034368070953434,255,75,23.398558758314856,4
Category_Wikipedia_sockpuppets_of_Elesky2.csv,22,4019902.0,7,15,4,3,0,67.63636363636364,245,19,13.727272727272727,11
Category_Wikipedia_sockpuppets_of_Bebrasth.csv,8,86925.0,5,3,3,2,0,30.875,81,21,19.25,17
Category_Wikipedia_sockpuppets_of_WTillman29.csv,1600,259845552.0,378,1222,70,308,0,42.881875,484,71,24.135625,5
Category_Wikipedia_sockpuppets_of_WinnieThePoohFan2004.csv,1083,8218283.0,355,728,62,293,0,45.92059095106187,255,41,18.393351800554015,7
Category_Wikipedia_sockpuppets_of_Caod666.csv,11,303.0,7,4,7,0,0,38.27272727272727,212,20,15.545454545454545,7
Category_Wikipedia_sockpuppets_of_Myuser89.csv,272,3977254.0,84,188,43,41,0,41.143382352941174,233,39,13.3125,3
Category_Wikipedia_sockpuppets_of_Allenroyboy.csv,21535,427403270.0,8673,12862,500,8173,0,53.171999071279316,482,116,21.371348966798234,3
Category_Wikipedia_sockpuppets_of_Wizardbrad.csv,37,1410670.0,22,15,8,14,0,34.729729729729726,162,59,37.729729729729726,11
Category_Wikipedia_sockpuppets_of_Mkd111.csv,313,36658449.0,73,240,68,5,0,45.95846645367412,235,44,18.881789137380192,5
Category_Wikipedia_sockpuppets_of_RagnarsTrueSon.csv,31,79532.0,24,7,17,7,0,50.32258064516129,180,24,17.29032258064516,8
Category_Wikipedia_sockpuppets_of_Oekinawa_ninja.csv,323,6062803.0,111,212,40,71,0,43.80185758513932,499,52,16.739938080495357,6
Category_Wikipedia_sockpuppets_of_STSWYC.csv,13,2340.0,6,7,4,2,0,66.3076923076923,177,28,20.615384615384617,14
Category_Wikipedia_sockpuppets_of_CreativeMind38.csv,39,3955952.0,28,11,15,13,0,52.1025641025641,200,27,21.58974358974359,15
Category_Wikipedia_sockpuppets_of_Rio0601.csv,558,30934869.0,235,323,200,35,0,57.96774193548387,500,50,20.2831541218638,4
Category_Wikipedia_sockpuppets_of_Vertig63954.csv,249,37663382.0,156,93,112,44,0,26.923694779116467,241,26,17.03614457831325,5
Category_Wikipedia_sockpuppets_of_Instantnood.csv,13637,431357393.0,3897,9740,500,3397,0,40.33548434406394,428,133,24.834274400527974,2
Category_Wikipedia_sockpuppets_of_T00bd00d.csv,61,1035306.0,21,40,6,15,0,40.57377049180328,232,41,14.688524590163935,4
Category_Wikipedia_sockpuppets_of_GAIBANDHA_CRICKET_COACHING.csv,20,1009520.0,12,8,7,5,0,32.3,132,36,17.25,7
Category_Wikipedia_sockpuppets_of_Cheetothecat.csv,69,4914715.0,21,48,19,2,0,41.2463768115942,223,38,23.10144927536232,6
Category_Wikipedia_sockpuppets_of_Irfanafzal125.csv,29,207187.0,10,19,4,6,0,76.34482758620689,199,48,37.51724137931034,24
Category_Wikipedia_sockpuppets_of_HK30.csv,101,2251884.0,39,62,34,5,0,53.95049504950495,171,71,19.564356435643564,9
Category_Wikipedia_sockpuppets_of_Dkimal.csv,45,17724672.0,10,35,7,3,0,56.62222222222222,205,33,16.733333333333334,6
Category_Wikipedia_sockpuppets_of_PedroC6586.csv,12,179016.0,6,6,6,0,0,46.0,138,35,24.5,18
Category_Wikipedia_sockpuppets_of_Johnniestallions.csv,65,2314053.0,24,41,24,0,0,28.907692307692308,137,32,17.307692307692307,8
Category_Wikipedia_sockpuppets_of_Smokersforum.csv,28,4762374.0,16,12,11,5,7,47.142857142857146,174,24,14.071428571428571,10
Category_Wikipedia_sockpuppets_of_Jayscott478.csv,398,8474787.0,99,299,56,43,0,48.165829145728644,258,41,20.72110552763819,13
Category_Wikipedia_sockpuppets_of_Shred4jesus69.csv,10,700.0,4,6,4,0,0,66.3,232,17,15.8,15
Category_Wikipedia_sockpuppets_of_Cdswalkthrough.csv,2546,81550526.0,849,1697,212,637,0,48.23684210526316,255,34,13.42458758837392,3
Category_Wikipedia_sockpuppets_of_MadMans1019.csv,299,105220781.0,118,181,39,79,0,50.11036789297659,255,51,23.214046822742475,10
Category_Wikipedia_sockpuppets_of_SashiRolls.csv,1384,243174486.0,503,881,500,3,0,56.410404624277454,497,54,23.455202312138727,4
Category_Wikipedia_sockpuppets_of_Terryfirut.csv,564,77390939.0,184,380,181,3,0,40.558510638297875,285,47,20.395390070921987,7
Category_Wikipedia_sockpuppets_of_Kazemzad.csv,1047,14985998.0,354,693,264,90,0,48.8261700095511,250,69,19.313276026743075,4
Category_Wikipedia_sockpuppets_of_Dean1997.csv,460,238238368.0,103,357,102,1,0,45.426086956521736,244,27,17.8,10
Category_Wikipedia_sockpuppets_of_Mr_RD.csv,2127,338266798.0,645,1482,500,145,0,57.314527503526094,376,100,20.694405265632344,3
Category_Wikipedia_sockpuppets_of_Billhits.csv,2348,79752660.0,842,1506,500,342,0,30.43313458262351,249,59,19.532367972742758,3
Category_Wikipedia_sockpuppets_of_BelloWello.csv,1416,3956755.0,563,853,500,63,0,48.969632768361585,248,87,31.87641242937853,5
Category_Wikipedia_sockpuppets_of_1wikideb1.csv,5018,203836005.0,1943,3075,500,1443,0,45.67855719410124,395,65,20.780789159027503,4
Category_Wikipedia_sockpuppets_of_Fredmak2016.csv,53,530471.0,26,27,19,7,0,38.735849056603776,227,35,26.339622641509433,10
Category_Wikipedia_sockpuppets_of_Thebitsyboutique.csv,19,1396890.0,12,7,5,7,0,43.421052631578945,196,46,39.31578947368421,20
Category_Wikipedia_sockpuppets_of_The_Suix.csv,125,3285457.0,49,76,11,38,0,54.328,255,41,21.216,4
Category_Wikipedia_sockpuppets_of_Cangela88.csv,9,193801.0,3,6,2,1,10,58.111111111111114,168,13,9.333333333333334,6
Category_Wikipedia_sockpuppets_of_Chiranthchirusira.csv,52,30994633.0,18,34,18,0,0,60.15384615384615,496,53,22.48076923076923,13
Category_Wikipedia_sockpuppets_of_Aadit_kumar_misir.csv,1405,9808819.0,475,930,349,126,0,55.77224199288256,500,46,14.214946619217082,4
Category_Wikipedia_sockpuppets_of_Osrius.csv,767,227907888.0,206,561,194,12,0,64.61668839634942,268,53,16.037809647979138,6
Category_Wikipedia_sockpuppets_of_FabianCarpena.csv,845,93394261.0,233,612,109,124,0,54.16449704142012,387,66,31.58343195266272,9
Category_Wikipedia_sockpuppets_of_Mr.Monday_Night.csv,10,394870.0,6,4,4,2,0,104.2,198,25,15.6,11
Category_Wikipedia_sockpuppets_of_PsiEpsilon.csv,2625,61615340.0,649,1976,500,149,0,42.856,255,80,22.36952380952381,3
Category_Wikipedia_sockpuppets_of_Diogomauricio3.csv,1583,91751964.0,531,1052,66,465,0,40.180037902716364,255,63,30.331648768161717,4
Category_Wikipedia_sockpuppets_of_Breathtaker.csv,4110,67919994.0,1196,2914,500,696,0,40.481021897810216,234,72,17.243795620437957,4
Category_Wikipedia_sockpuppets_of_Intothelogos.csv,48,11670059.0,11,37,7,4,0,28.520833333333332,146,29,21.4375,9
Category_Wikipedia_sockpuppets_of_1940CStreet.csv,2083,6902554.0,988,1095,500,488,0,42.89726356216995,395,66,16.131541046567452,5
Category_Wikipedia_sockpuppets_of_MilesJ22.csv,33,2709058.0,8,25,6,2,12,55.39393939393939,140,53,23.939393939393938,12
Category_Wikipedia_sockpuppets_of_Afsane1369.csv,486,72882681.0,193,293,142,51,0,44.458847736625515,481,61,21.742798353909464,5
Category_Wikipedia_sockpuppets_of_DTLB.csv,12,62947.0,9,3,5,4,0,20.583333333333332,123,20,20.0,20
Category_Wikipedia_sockpuppets_of_Gabeman15.csv,31,1017266.0,19,12,16,3,0,37.806451612903224,194,28,24.741935483870968,23
Category_Wikipedia_sockpuppets_of_Dilli_vandana_B.csv,10,225255.0,10,0,1,9,90,91.8,92,29,20.7,15
Category_Wikipedia_sockpuppets_of_Jeiboul.csv,42,1382900.0,18,24,16,2,0,42.11904761904762,185,30,22.738095238095237,12
Category_Wikipedia_sockpuppets_of_Bigtalkworld.csv,283,22393439.0,107,176,46,61,0,42.13427561837456,249,64,14.056537102473499,5
Category_Wikipedia_sockpuppets_of_Nesmith74.csv,403,10004591.0,155,248,30,125,0,59.44665012406948,247,43,22.25062034739454,8
Category_Wikipedia_sockpuppets_of_OfficialPankajPatidar.csv,11856,171628975.0,4917,6939,500,4417,0,42.912618083670715,259,83,18.591008771929825,3
Category_Wikipedia_sockpuppets_of_Momo_Monitor.csv,1972,34483976.0,723,1249,382,341,0,47.18762677484787,255,55,20.030425963488845,3
Category_Wikipedia_sockpuppets_of_Magnabug.csv,28,360216.0,19,9,4,15,0,105.96428571428571,245,9,9.0,9
Category_Wikipedia_sockpuppets_of_Zoso98.csv,382,145375961.0,100,282,54,46,0,49.12565445026178,226,43,20.513089005235603,4
Category_Wikipedia_sockpuppets_of_Ratel.csv,6004,551349070.0,2004,4000,500,1504,0,55.58810792804797,493,70,21.558127914723517,4
Category_Wikipedia_sockpuppets_of_Three.onefourone.csv,37,92307.0,18,19,14,4,0,44.891891891891895,184,49,23.83783783783784,8
Category_Wikipedia_sockpuppets_of_NYCSlover.csv,6195,252117398.0,1614,4581,500,1114,0,36.15560936238902,433,66,22.646973365617434,4
Category_Wikipedia_sockpuppets_of_512theking.csv,2194,23665694.0,859,1335,395,464,0,23.539653600729263,206,54,21.896536007292617,10
Category_Wikipedia_sockpuppets_of_Mivoha5132.csv,26,6092.0,9,17,5,4,0,55.57692307692308,186,24,19.192307692307693,5
Category_Wikipedia_sockpuppets_of_SockmonkeyGee.csv,23,402417.0,11,12,10,1,0,52.608695652173914,192,34,28.130434782608695,18
Category_Wikipedia_sockpuppets_of_Rajeev.yasiru.csv,77,48131863.0,25,52,15,10,0,43.064935064935064,256,35,21.83116883116883,13
Category_Wikipedia_sockpuppets_of_Kaz.csv,1220,170630112.0,561,659,500,61,0,48.70983606557377,255,48,19.92950819672131,5
Category_Wikipedia_sockpuppets_of_Entertainment4Reality.csv,2687,56955301.0,1027,1660,500,527,0,32.02009676218832,507,52,20.976925939709712,6
Category_Wikipedia_sockpuppets_of_Naneu_Bags.csv,19,3014478.0,11,8,9,2,0,17.894736842105264,126,20,12.368421052631579,7
Category_Wikipedia_sockpuppets_of_Sccsiciidafrica.csv,165,927045.0,74,91,67,7,0,38.18787878787879,339,51,15.793939393939393,7
Category_Wikipedia_sockpuppets_of_ProfessorRehan.csv,3,291.0,2,1,2,0,0,41.333333333333336,124,11,11.0,11
Category_Wikipedia_sockpuppets_of_Mox11laz.csv,21,171606.0,6,15,1,5,0,48.285714285714285,186,26,15.428571428571429,4
Category_Wikipedia_sockpuppets_of_Smauritius.csv,2942,21327777.0,1079,1863,500,579,0,51.55608429639701,255,69,17.549626104690688,4
Category_Wikipedia_sockpuppets_of_Allotnap.csv,20,1594297.0,9,11,6,3,0,39.15,91,25,20.45,13
Category_Wikipedia_sockpuppets_of_√âtienne_Trudeau.csv,15,14312.0,9,6,6,3,0,63.93333333333333,188,20,11.2,9
Category_Wikipedia_sockpuppets_of_Strot.csv,1690,261236912.0,453,1237,327,126,0,49.0189349112426,255,74,18.076923076923077,3
Category_Wikipedia_sockpuppets_of_Milarepanoakhali.csv,479,988563.0,180,299,154,26,0,41.21503131524008,496,52,21.987473903966595,7
Category_Wikipedia_sockpuppets_of_Plouton2.csv,4616,81034593.0,1463,3153,248,1215,0,41.58795493934142,255,64,15.734835355285961,3
Category_Wikipedia_sockpuppets_of_WORLD_CHARITY_WEFARE_FOUNDATION.csv,2,0.0,1,1,1,0,19,19.0,19,23,23.0,23
Category_Wikipedia_sockpuppets_of_Elias_Disney.csv,857,165225095.0,315,542,113,202,0,52.787631271878645,314,65,18.323220536756125,11
Category_Wikipedia_sockpuppets_of_DavidWittas.csv,1712,80757303.0,483,1229,159,324,0,41.92114485981308,500,34,19.29264018691589,4
Category_Wikipedia_sockpuppets_of_Johanneskabin.csv,24,127599.0,9,15,4,5,0,63.708333333333336,221,22,14.25,8
Category_Wikipedia_sockpuppets_of_TheThankful.csv,397,1343091.0,191,206,179,12,0,45.06297229219144,217,47,22.26448362720403,5
Category_Wikipedia_sockpuppets_of_MykhayloNaumenko.csv,1327,121109642.0,512,815,491,21,0,39.242652599849286,255,52,16.40919366993218,4
Category_Wikipedia_sockpuppets_of_Biman1989.csv,95,171251.0,37,58,33,4,0,42.294736842105266,184,51,22.263157894736842,19
Category_Wikipedia_sockpuppets_of_Beautifulpeoplelikeyou.csv,566,14660243.0,237,329,162,75,0,56.8356890459364,255,69,30.042402826855124,7
Category_Wikipedia_sockpuppets_of_Lord_Kelvin_Jr.csv,106,67600104.0,57,49,55,2,0,48.83018867924528,295,61,27.68867924528302,9
Category_Wikipedia_sockpuppets_of_Thebytenews.csv,25,2084825.0,7,18,2,5,0,46.32,218,21,15.0,11
Category_Wikipedia_sockpuppets_of_Drlesmgolden.csv,1637,325638341.0,578,1059,343,235,0,51.946854001221745,282,57,20.811240073304827,3
Category_Wikipedia_sockpuppets_of_Uritol.csv,963,16231591.0,330,633,84,246,0,49.3717549325026,500,39,15.199376947040498,4
Category_Wikipedia_sockpuppets_of_Benbeezy.csv,270,76550586.0,104,166,59,45,0,49.1037037037037,284,35,18.733333333333334,3
Category_Wikipedia_sockpuppets_of_Malayedit.csv,2120,6327901.0,813,1307,500,313,0,38.66367924528302,255,46,14.740094339622642,5
Category_Wikipedia_sockpuppets_of_Shajidkhan.csv,86,16463816.0,39,47,39,0,0,29.430232558139537,213,43,14.627906976744185,6
Category_Wikipedia_sockpuppets_of_ThisDude62.csv,334,72561216.0,97,237,95,2,0,42.33233532934132,230,57,23.161676646706585,8
Category_Wikipedia_sockpuppets_of_Niyazib.csv,161,111618050.0,50,111,35,15,0,68.59006211180125,413,36,25.32919254658385,9
Category_Wikipedia_sockpuppets_of_Velocicaptor.csv,1832,14811814.0,637,1195,500,137,0,46.120087336244545,259,92,20.899563318777293,3
Category_Wikipedia_sockpuppets_of_The_Rage_Conspiracy.csv,161,8552686.0,70,91,70,0,0,46.11801242236025,199,47,27.13664596273292,12
Category_Wikipedia_sockpuppets_of_ImperatorPanda.csv,881,11737700.0,294,587,291,3,0,43.28376844494892,468,57,21.97048808172531,4
Category_Wikipedia_sockpuppets_of_Vinukin.csv,6922,29681132.0,2370,4552,500,1870,0,42.666281421554466,255,110,20.839063854377347,4
Category_Wikipedia_sockpuppets_of_Afrika_paprika.csv,9052,342148444.0,2716,6336,500,2216,0,36.64074237737517,254,53,16.241051701281485,3
Category_Wikipedia_sockpuppets_of_Rachel_Bensonen.csv,45,261436.0,13,32,5,8,0,25.711111111111112,170,50,23.666666666666668,13
Category_Wikipedia_sockpuppets_of_No-genius.csv,568,492678501.0,148,420,147,1,0,56.353873239436616,395,75,20.0,4
Category_Wikipedia_sockpuppets_of_MrEditor88.csv,74,2792968.0,39,35,39,0,0,33.25675675675676,233,23,18.31081081081081,9
Category_Wikipedia_sockpuppets_of_N5rh.csv,675,104252091.0,248,427,161,87,0,40.28888888888889,369,39,13.942222222222222,6
Category_Wikipedia_sockpuppets_of_Lukeming.csv,85,3452821.0,32,53,22,10,0,43.35294117647059,179,47,31.0,18
Category_Wikipedia_sockpuppets_of_Sohanpandey.csv,1171,70190235.0,647,524,500,147,0,27.2399658411614,234,36,17.247651579846284,5
Category_Wikipedia_sockpuppets_of_Abra1995.csv,4,754.0,2,2,1,1,1,56.5,115,18,17.0,14
Category_Wikipedia_sockpuppets_of_M28m2003.csv,5,442323.0,3,2,3,0,0,33.6,151,17,17.0,17
Category_Wikipedia_sockpuppets_of_Sumon07.csv,163,10810206.0,58,105,35,23,0,45.77300613496933,248,58,18.711656441717793,8
Category_Wikipedia_sockpuppets_of_JustYourImaginaryGuy.csv,1242,31516307.0,308,934,307,1,0,49.71819645732689,458,59,22.704508856682768,5
Category_Wikipedia_sockpuppets_of_MillyRolex.csv,10,224.0,5,5,5,0,0,51.8,160,26,21.2,20
Category_Wikipedia_sockpuppets_of_Cicero_Dog.csv,1159,137619221.0,449,710,348,101,0,32.9939603106126,249,70,24.18809318377912,7
Category_Wikipedia_sockpuppets_of_Abu_Musab_9.csv,288,69143850.0,139,149,51,88,0,38.489583333333336,218,34,19.104166666666668,6
Category_Wikipedia_sockpuppets_of_Lnaceri000.csv,439,4939036.0,112,327,102,10,0,55.22551252847381,293,32,14.366742596810933,4
Category_Wikipedia_sockpuppets_of_NS_Dibyojyoti.csv,5844,82940009.0,1886,3958,500,1386,0,51.138432580424364,500,70,22.25752908966461,4
Category_Wikipedia_sockpuppets_of_Apemonkey1.csv,386,29184828.0,133,253,94,39,0,61.424870466321245,470,72,28.43782383419689,10
Category_Wikipedia_sockpuppets_of_Riddyler.csv,27,86827.0,18,9,14,4,0,33.074074074074076,199,18,11.037037037037036,10
Category_Wikipedia_sockpuppets_of_Contextbb.csv,278,63573414.0,126,152,119,7,0,43.7410071942446,255,31,18.769784172661872,12
Category_Wikipedia_sockpuppets_of_Nafeby633.csv,1671,185868891.0,591,1080,143,448,0,42.23399162178336,504,54,23.02752842609216,6
Category_Wikipedia_sockpuppets_of_Dasrupak.csv,90,1333031.0,27,63,22,5,0,38.81111111111111,231,44,26.122222222222224,10
Category_Wikipedia_sockpuppets_of_Termezian_Beck.csv,49,4736784.0,18,31,10,8,0,46.51020408163265,264,23,13.673469387755102,6
Category_Wikipedia_sockpuppets_of_GarryWong.csv,50,357725.0,15,35,10,5,0,68.22,196,33,19.86,12
Category_Wikipedia_sockpuppets_of_Farid8868.csv,30,11134318.0,28,2,24,4,0,27.366666666666667,95,19,19.0,19
Category_Wikipedia_sockpuppets_of_Icundell.csv,2386,572439289.0,546,1840,500,46,0,46.65884325230511,363,82,18.75146689019279,4
Category_Wikipedia_sockpuppets_of_Calearm99.csv,3386,96523140.0,1080,2306,500,580,0,45.185174246898995,266,79,29.096278795038394,4
Category_Wikipedia_sockpuppets_of_London_Hall.csv,1386,7917119.0,506,880,500,6,0,48.083694083694084,256,78,23.22077922077922,2
Category_Wikipedia_sockpuppets_of_Majikalex32.csv,742,18818901.0,313,429,239,74,0,50.51617250673854,267,51,28.65633423180593,6
Category_Wikipedia_sockpuppets_of_Inshaanshah62.csv,1026,166009766.0,320,706,179,141,0,47.25243664717349,313,71,14.419103313840155,3
Category_Wikipedia_sockpuppets_of_JassenMarang17.csv,2274,35620628.0,938,1336,364,574,0,28.185576077396657,520,63,18.776165347405453,3
Category_Wikipedia_sockpuppets_of_Elnurso.csv,126,2951974.0,33,93,32,1,0,33.8968253968254,195,38,16.07936507936508,10
Category_Wikipedia_sockpuppets_of_Easy4me.csv,5543,36957807.0,1798,3745,500,1298,0,33.21522641169042,263,78,21.375428468338445,5
Category_Wikipedia_sockpuppets_of_Rasheduzzamanrafi.csv,89,50255767.0,22,67,12,10,0,31.764044943820224,201,22,16.685393258426966,12
Category_Wikipedia_sockpuppets_of_–ñ–æ–∑–µ—Ñ_–ö–æ–º–∞—Å—Ç.csv,6,793.0,5,1,5,0,52,63.333333333333336,67,34,28.166666666666668,14
Category_Wikipedia_sockpuppets_of_Leito.Cmj.csv,1289,28523024.0,586,703,500,86,0,46.552366175329716,500,46,28.072924747866562,7
Category_Wikipedia_sockpuppets_of_Scottishweather.csv,25,352473.0,20,5,13,7,0,76.2,245,51,11.0,8
Category_Wikipedia_sockpuppets_of_Dante8.csv,3122,219927384.0,901,2221,500,401,0,49.146380525304295,448,80,21.014734144778988,4
Category_Wikipedia_sockpuppets_of_Juro.csv,1527,17628904.0,544,983,500,44,0,32.783889980353635,200,52,18.64505566470203,4
Category_Wikipedia_sockpuppets_of_Wildblue68.csv,82,32152159.0,52,30,28,24,0,32.65853658536585,162,31,17.536585365853657,11
Category_Wikipedia_sockpuppets_of_Yasmo3333.csv,92,14226906.0,42,50,36,6,0,52.18478260869565,238,29,20.58695652173913,11
Category_Wikipedia_sockpuppets_of_Pharaoh496.csv,1697,17702283.0,506,1191,500,6,0,49.306423099587505,496,107,24.841484973482615,6
Category_Wikipedia_sockpuppets_of_Pilotbob.csv,1820,362552491.0,600,1220,500,100,0,51.11043956043956,255,92,27.92967032967033,5
Category_Wikipedia_sockpuppets_of_Milkshoes.csv,18,20415.0,8,10,5,3,0,25.055555555555557,83,48,48.0,48
Category_Wikipedia_sockpuppets_of_Simoanstrength.csv,58,699854.0,17,41,10,7,0,43.793103448275865,226,31,17.362068965517242,7
Category_Wikipedia_sockpuppets_of_Mrtvshow.csv,117,928230.0,45,72,34,11,0,51.427350427350426,233,56,29.41025641025641,5
Category_Wikipedia_sockpuppets_of_DenchArnold.csv,40,4062831.0,13,27,7,6,0,64.5,293,47,40.7,29
Category_Wikipedia_sockpuppets_of_Laxmi19.csv,40,30152965.0,8,32,6,2,0,89.025,208,17,11.225,7
Category_Wikipedia_sockpuppets_of_Osmanmir.csv,51,2424967.0,24,27,13,11,0,47.470588235294116,232,31,21.45098039215686,13
Category_Wikipedia_sockpuppets_of_Jaswanthvijay.csv,4371,130891014.0,1650,2721,456,1194,0,31.32921528254404,376,57,20.32212308396248,5
Category_Wikipedia_sockpuppets_of_A_very_important_hero.csv,177,1391127.0,66,111,15,51,0,28.06779661016949,195,50,20.084745762711865,8
Category_Wikipedia_sockpuppets_of_Borntobeanna.csv,70,6226902.0,35,35,23,12,0,41.0,494,58,30.614285714285714,5
Category_Wikipedia_sockpuppets_of_TheProSamurai.csv,882,32263838.0,284,598,221,63,0,40.997732426303855,253,41,15.334467120181406,7
Category_Wikipedia_sockpuppets_of_User009009009.csv,895,16121066.0,295,600,46,249,0,59.13296089385475,499,46,14.134078212290502,4
Category_Wikipedia_sockpuppets_of_Regisaurusjacobi.csv,580,13154624.0,272,308,243,29,0,42.224137931034484,228,52,21.61551724137931,8
Category_Wikipedia_sockpuppets_of_WackyWikiWoo.csv,1357,72425235.0,520,837,500,20,0,47.11348563006632,388,56,16.95431098010317,5
Category_Wikipedia_sockpuppets_of_Lazy-restless.csv,1864,127864288.0,583,1281,500,83,0,53.51716738197425,500,81,20.89324034334764,4
Category_Wikipedia_sockpuppets_of_SoulessShadow.csv,7132,61357797.0,1713,5419,500,1213,0,43.07122826696579,466,58,19.655496354458776,3
Category_Wikipedia_sockpuppets_of_JayyyTayyy.csv,118,3873867.0,35,83,17,18,0,41.02542372881356,242,31,11.194915254237289,4
Category_Wikipedia_sockpuppets_of_Gustavo1997.csv,554,5746234.0,278,276,157,121,0,25.568592057761734,243,42,19.31768953068592,5
Category_Wikipedia_sockpuppets_of_Homeboyharambe.csv,1,0.0,1,0,1,0,0,0.0,0,17,17.0,17
Category_Wikipedia_sockpuppets_of_Garyspivey2.csv,5,827.0,2,3,2,0,0,32.2,126,19,14.2,11
Category_Wikipedia_sockpuppets_of_NordVPN23.csv,58,27241934.0,21,37,14,7,0,41.05172413793103,206,27,16.06896551724138,7
Category_Wikipedia_sockpuppets_of_Sudhanshu6454.csv,177,107273511.0,44,133,34,10,0,41.836158192090394,221,29,14.536723163841808,4
Category_Wikipedia_sockpuppets_of_SuriyaCR7Fan.csv,712,44104566.0,255,457,208,47,0,56.60112359550562,495,49,14.575842696629213,4
Category_Wikipedia_sockpuppets_of_Scottperry.csv,4784,164274978.0,1567,3217,500,1067,0,60.153010033444815,477,66,18.972408026755854,3
Category_Wikipedia_sockpuppets_of_TheLibertyLover.csv,1141,19696274.0,365,776,263,102,0,51.29009640666082,255,69,30.476774758983346,5
Category_Wikipedia_sockpuppets_of_Mac11Mac13.csv,64,35039534.0,20,44,7,13,0,43.90625,201,29,12.859375,6
Category_Wikipedia_sockpuppets_of_Thunderbelch.csv,1923,37452157.0,508,1415,500,8,0,48.42953718148726,958,55,16.727509100364014,4
Category_Wikipedia_sockpuppets_of_Archsurfing.csv,132,204198142.0,46,86,46,0,0,42.32575757575758,227,47,21.62878787878788,11
Category_Wikipedia_sockpuppets_of_WikiLubber.csv,445,175087526.0,91,354,84,7,0,48.98426966292135,232,75,27.364044943820225,5
Category_Wikipedia_sockpuppets_of_PelicanBaySquad.csv,199,35045578.0,61,138,54,7,0,46.402010050251256,239,46,14.673366834170855,4
Category_Wikipedia_sockpuppets_of_Talentandbeyond.csv,9,32475.0,3,6,3,0,0,69.55555555555556,190,45,29.444444444444443,25
Category_Wikipedia_sockpuppets_of_Fonseca.cadu.csv,337,702179.0,272,65,265,7,0,35.4272997032641,263,44,35.38278931750742,11
Category_Wikipedia_sockpuppets_of_Kutanoor.csv,45,162239633.0,13,32,7,6,0,47.333333333333336,236,53,24.2,6
Category_Wikipedia_sockpuppets_of_Musfiq_Islam.csv,2,0.0,1,1,1,0,0,0.0,0,43,43.0,43
Category_Wikipedia_sockpuppets_of_Talonjay.csv,1161,90857555.0,390,771,143,247,0,34.857019810508184,494,53,19.022394487510766,5
Category_Wikipedia_sockpuppets_of_Sheetal_mayekar.csv,2,0.0,1,1,1,0,44,44.0,44,21,21.0,21
Category_Wikipedia_sockpuppets_of_Star767.csv,3234,5715859.0,1000,2234,500,500,0,50.33302411873841,250,54,18.84724799010513,3
Category_Wikipedia_sockpuppets_of_Rahul_Sankrityan_Rao.csv,2227,12448552.0,871,1356,500,371,0,28.58688819039066,498,29,15.07723394701392,5
Category_Wikipedia_sockpuppets_of_Autistic_Furry.csv,267,11911825.0,77,190,39,38,0,48.666666666666664,247,40,20.95131086142322,4
Category_Wikipedia_sockpuppets_of_Osilsby23.csv,11,4958.0,5,6,4,1,0,37.72727272727273,102,22,18.818181818181817,15
Category_Wikipedia_sockpuppets_of_Legalactionjackson.csv,33,17981.0,16,17,15,1,0,68.06060606060606,203,19,16.09090909090909,15
Category_Wikipedia_sockpuppets_of_Itsyousuf.csv,156,243393848.0,40,116,35,5,0,62.64102564102564,255,53,23.01923076923077,5
Category_Wikipedia_sockpuppets_of_Arkalochori.csv,3201,16607864.0,1092,2109,500,592,0,40.047172758512964,250,104,24.836925960637302,3
Category_Wikipedia_sockpuppets_of_Qatarihistorian.csv,1182,6777984.0,328,854,311,17,0,41.55922165820643,255,47,16.58714043993232,4
Category_Wikipedia_sockpuppets_of_DVDfan12.csv,2854,12533557.0,890,1964,500,390,0,28.028381219341277,255,76,21.125788367203924,3
Category_Wikipedia_sockpuppets_of_Nakesha7c.csv,105,120522075.0,21,84,7,14,0,38.36190476190476,223,35,20.20952380952381,6
Category_Wikipedia_sockpuppets_of_Silviabe333.csv,42,4660.0,17,25,9,8,0,83.33333333333333,233,20,16.214285714285715,14
Category_Wikipedia_sockpuppets_of_Gome_Riki_Tu.csv,34,16039812.0,11,23,10,1,0,62.705882352941174,178,39,24.705882352941178,13
Category_Wikipedia_sockpuppets_of_Ukpong1.csv,2097,97546950.0,1000,1097,500,500,0,57.61659513590844,373,65,20.855984740104912,3
Category_Wikipedia_sockpuppets_of_ADAMD2000.csv,155,67382.0,68,87,32,36,0,70.79354838709678,376,25,15.69032258064516,10
Category_Wikipedia_sockpuppets_of_Alvinlus.csv,309,4192782.0,124,185,56,68,0,54.75404530744336,500,49,17.100323624595468,4
Category_Wikipedia_sockpuppets_of_Cat5catandbear.csv,24,98583.0,13,11,5,8,0,60.125,239,20,15.583333333333334,11
Category_Wikipedia_sockpuppets_of_Silver_Master.csv,1198,2397058.0,629,569,500,129,0,49.44908180300501,255,57,19.168614357262104,4
Category_Wikipedia_sockpuppets_of_Lung_salad.csv,1577,9143624.0,627,950,500,127,0,44.05453392517438,250,68,19.63728598604946,5
Category_Wikipedia_sockpuppets_of_Psyfactory.csv,15,3034540.0,7,8,5,2,0,35.2,146,38,20.666666666666668,6
Category_Wikipedia_sockpuppets_of_Good_Old_Pete.csv,410,97582238.0,118,292,115,3,0,67.3390243902439,384,52,24.431707317073172,6
Category_Wikipedia_sockpuppets_of_Aditya_Mani_Tripathi.csv,272,37866289.0,112,160,98,14,0,52.025735294117645,269,53,22.841911764705884,8
Category_Wikipedia_sockpuppets_of_Deathlibrarian.csv,2289,531785839.0,773,1516,500,273,0,48.981651376146786,487,74,19.00698995194408,3
Category_Wikipedia_sockpuppets_of_SenseiArunava.csv,2438,11481868.0,959,1479,500,459,0,28.820344544708778,500,67,20.686218211648892,3
Category_Wikipedia_sockpuppets_of_Jaszen.csv,1046,67369054.0,428,618,347,81,0,56.44168260038241,496,35,20.565965583173995,12
Category_Wikipedia_sockpuppets_of_Wp.Ramesh_Auti.csv,17,27701421.0,14,3,12,2,0,22.235294117647058,65,24,23.41176470588235,19
Category_Wikipedia_sockpuppets_of_Islamisperfect.csv,5,62198.0,4,1,2,2,14,25.6,35,20,15.8,13
Category_Wikipedia_sockpuppets_of_JohnGotten.csv,2561,32698805.0,802,1759,500,302,0,53.73057399453339,497,67,20.05818039828192,3
Category_Wikipedia_sockpuppets_of_Kminiter.csv,237,405772603.0,79,158,47,32,0,52.85232067510549,216,44,19.0042194092827,11
Category_Wikipedia_sockpuppets_of_Dud299.csv,50,79647.0,48,2,30,18,0,9.52,137,18,17.56,16
Category_Wikipedia_sockpuppets_of_Ninenine99.csv,3334,70324303.0,898,2436,500,398,0,39.31853629274145,446,71,19.258248350329936,3
Category_Wikipedia_sockpuppets_of_Noface1.csv,1975,90465396.0,554,1421,500,54,0,37.255696202531645,239,48,18.152911392405063,4
Category_Wikipedia_sockpuppets_of_FisayorMontana.csv,65,767470.0,39,26,24,15,0,23.923076923076923,210,52,27.415384615384614,4
Category_Wikipedia_sockpuppets_of_Frankdaves.csv,26,2498034.0,7,19,4,3,0,68.07692307692308,195,20,13.615384615384615,11
Category_Wikipedia_sockpuppets_of_Efgsdrthdty.csv,485,7007789.0,128,357,36,92,0,39.684536082474224,221,44,17.83917525773196,9
Category_Wikipedia_sockpuppets_of_Christinemyers17.csv,346,52194223.0,107,239,28,79,0,60.12138728323699,255,60,14.170520231213873,4
Category_Wikipedia_sockpuppets_of_Alvrix3104.csv,561,7548379.0,188,373,178,10,0,42.63458110516934,472,46,19.570409982174688,6
Category_Wikipedia_sockpuppets_of_Niyskho.csv,656,21217390.0,219,437,174,45,0,51.16006097560975,450,47,22.208841463414632,4
Category_Wikipedia_sockpuppets_of_Rohanpednekar38.csv,60,30668222.0,27,33,16,11,0,41.38333333333333,207,60,21.233333333333334,10
Category_Wikipedia_sockpuppets_of_Krishnayvsvamsi.csv,19,173305042.0,7,12,4,3,0,83.05263157894737,255,28,22.05263157894737,16
Category_Wikipedia_sockpuppets_of_Swapnik03.csv,1,0.0,1,0,1,0,87,87.0,87,16,16.0,16
Category_Wikipedia_sockpuppets_of_Janzenh.csv,142,29795578.0,46,96,28,18,0,29.52112676056338,199,33,16.760563380281692,6
Category_Wikipedia_sockpuppets_of_BigBoyzz1006.csv,200,93155794.0,67,133,21,46,0,58.05,379,47,27.63,11
Category_Wikipedia_sockpuppets_of_Global_corporate_law.csv,2,0.0,1,1,1,0,55,55.0,55,37,37.0,37
Category_Wikipedia_sockpuppets_of_Abrah4125.csv,1259,209597712.0,365,894,291,74,0,36.65528196981732,496,39,15.273232724384432,2
Category_Wikipedia_sockpuppets_of_Darrenmong.csv,312,322268598.0,89,223,62,27,0,51.6474358974359,237,41,16.458333333333332,5
Category_Wikipedia_sockpuppets_of_PlusPlusDave.csv,1089,7577916.0,361,728,77,284,0,43.282828282828284,237,80,17.399449035812673,5
Category_Wikipedia_sockpuppets_of_Carliantonio1.csv,81,77733508.0,28,53,19,9,0,50.32098765432099,370,44,18.037037037037038,6
Category_Wikipedia_sockpuppets_of_Khornloke.csv,103,9596923.0,43,60,43,0,0,60.601941747572816,212,52,15.990291262135923,7
Category_Wikipedia_sockpuppets_of_Mkbdtu.csv,1385,8785490.0,500,885,84,416,0,43.47653429602888,237,34,14.027436823104694,4
Category_Wikipedia_sockpuppets_of_WaseemAbbaass.csv,569,16494933.0,194,375,149,45,0,53.110720562390156,496,45,25.08787346221441,10
Category_Wikipedia_sockpuppets_of_EarCareCenter.csv,17,443091.0,14,3,8,6,0,56.76470588235294,200,29,29.0,29
Category_Wikipedia_sockpuppets_of_Workitworkdude.csv,144,11154575.0,40,104,18,22,0,44.361111111111114,389,55,19.27777777777778,8
Category_Wikipedia_sockpuppets_of_Franz310k97.csv,1915,63266446.0,567,1348,500,67,0,45.111227154047,500,59,22.80626631853786,5
Category_Wikipedia_sockpuppets_of_Popsmokes38.csv,3293,59610045.0,1129,2164,500,629,0,44.15912541755238,463,64,18.557849984816276,3
Category_Wikipedia_sockpuppets_of_Pr0pulsion_123.csv,3145,75485608.0,994,2151,500,494,0,51.620349761526235,500,76,22.456597774244834,4
Category_Wikipedia_sockpuppets_of_Tbyo_Saint.csv,7,42715989.0,2,5,1,1,0,82.71428571428571,165,29,26.428571428571427,20
Category_Wikipedia_sockpuppets_of_Babobabobabo2.csv,24,29690.0,13,11,12,1,0,58.666666666666664,197,28,20.416666666666668,11
Category_Wikipedia_sockpuppets_of_Sandesh9822.csv,2362,97736400.0,720,1642,500,220,0,41.994072819644366,320,83,22.57874682472481,4
Category_Wikipedia_sockpuppets_of_Liveintheforests.csv,1365,2345032.0,646,719,500,146,0,47.371428571428574,251,55,21.521611721611723,5
Category_Wikipedia_sockpuppets_of_Monkeyman1992.csv,12,973.0,7,5,7,0,0,67.91666666666667,139,20,20.0,20
Category_Wikipedia_sockpuppets_of_Priyansh207V.csv,459,15816416.0,185,274,143,42,0,46.01742919389978,298,37,11.843137254901961,6
Category_Wikipedia_sockpuppets_of_LA2002.csv,674,3261541.0,319,355,259,60,0,43.90652818991098,381,42,21.655786350148368,6
Category_Wikipedia_sockpuppets_of_Kurzon.csv,2474,247794643.0,1036,1438,500,536,0,50.30072756669362,484,47,18.78334680679062,4
Category_Wikipedia_sockpuppets_of_ColouredSpots.csv,130,3905254.0,33,97,14,19,0,48.823076923076925,233,47,26.615384615384617,4
Category_Wikipedia_sockpuppets_of_Petersantos.csv,337,75576700.0,131,206,68,63,0,43.11275964391692,214,35,13.646884272997033,11
Category_Wikipedia_sockpuppets_of_Lindenhurst_Liberty.csv,2854,40263913.0,610,2244,500,110,0,47.353889278206026,255,54,12.717939733707079,4
Category_Wikipedia_sockpuppets_of_Oaktreebay.csv,405,3275995.0,196,209,195,1,0,31.723456790123457,231,50,20.82962962962963,11
Category_Wikipedia_sockpuppets_of_Albbbbeeeennnnoooo.csv,606,3366552.0,206,400,103,103,0,32.603960396039604,224,42,17.224422442244226,2
Category_Wikipedia_sockpuppets_of_DhakadJyotish.csv,122,31207508.0,41,81,33,8,0,63.459016393442624,417,40,14.491803278688524,5
Category_Wikipedia_sockpuppets_of_ARCHjunkie.csv,73,3368454.0,35,38,28,7,0,36.273972602739725,195,55,22.753424657534246,6
Category_Wikipedia_sockpuppets_of_Vanderpumpstan.csv,5751,65545642.0,2019,3732,481,1538,0,33.36567553468962,500,68,19.736915319074942,6
Category_Wikipedia_sockpuppets_of_Hotmail1234.csv,73,16583667.0,21,52,12,9,0,41.63013698630137,202,53,28.0,9
Category_Wikipedia_sockpuppets_of_Nildvuf.csv,4,339994.0,2,2,1,1,22,50.0,102,19,18.25,18
Category_Wikipedia_sockpuppets_of_Suhaibqadri121.csv,27,2413150.0,18,9,9,9,0,24.703703703703702,149,30,19.11111111111111,12
Category_Wikipedia_sockpuppets_of_Okiloma.csv,1024,25983187.0,502,522,500,2,0,50.9892578125,499,71,22.1982421875,10
Category_Wikipedia_sockpuppets_of_Rockxd.csv,157,1212873.0,56,101,36,20,0,56.318471337579616,390,60,22.337579617834393,4
Category_Wikipedia_sockpuppets_of_Philipandrew.csv,2820,88306609.0,1083,1737,500,583,0,42.89929078014185,255,65,22.26595744680851,4
Category_Wikipedia_sockpuppets_of_Rabhola.csv,58,8233892.0,19,39,5,14,0,39.55172413793103,136,44,24.29310344827586,12
Category_Wikipedia_sockpuppets_of_Bigweezyfan1.csv,584,10676204.0,212,372,147,65,0,33.33390410958904,214,32,17.811643835616437,8
Category_Wikipedia_sockpuppets_of_Rannar.csv,15,196079.0,7,8,5,2,0,40.333333333333336,186,23,20.866666666666667,15
Category_Wikipedia_sockpuppets_of_Melofors.csv,1671,126365198.0,542,1129,500,42,0,52.867145421903054,496,68,20.345302214242967,2
Category_Wikipedia_sockpuppets_of_Suyash_Talks.csv,158,2949222.0,61,97,32,29,0,49.4873417721519,496,50,22.664556962025316,10
Category_Wikipedia_sockpuppets_of_Teabing-Leigh.csv,804,55645465.0,304,500,176,128,0,30.8818407960199,255,77,23.48507462686567,6
Category_Wikipedia_sockpuppets_of_L8incoub3rt.csv,81,2356688.0,22,59,14,8,0,51.382716049382715,196,51,26.11111111111111,15
Category_Wikipedia_sockpuppets_of_Mangoeater1000.csv,27737,189122045.0,9714,18023,500,9214,0,44.716515845260844,386,99,24.24919782240329,3
Category_Wikipedia_sockpuppets_of_Desathuti_Pathanamthitta.csv,21,116630.0,9,12,4,5,0,42.714285714285715,196,34,22.19047619047619,7
Category_Wikipedia_sockpuppets_of_Lam312321321.csv,11738,330981852.0,3559,8179,500,3059,0,50.99829613222014,500,65,19.19926733685466,4
Category_Wikipedia_sockpuppets_of_6ife05.csv,774,12581947.0,267,507,165,102,0,42.43927648578811,477,35,14.29328165374677,6
Category_Wikipedia_sockpuppets_of_Kr345.csv,4,28390.0,3,1,2,1,0,48.75,119,17,15.75,12
Category_Wikipedia_sockpuppets_of_Double_Hi.csv,8,338609.0,7,1,5,2,43,58.75,61,23,23.0,23
Category_Wikipedia_sockpuppets_of_Littleboyblue2000.csv,1308,12533503.0,557,751,500,57,0,38.670489296636084,496,62,23.54434250764526,6
Category_Wikipedia_sockpuppets_of_MKS_Harsha.csv,969,42234900.0,375,594,197,178,0,46.473684210526315,500,33,9.922600619195046,4
Category_Wikipedia_sockpuppets_of_ToxicWasteGrounds.csv,1040,10182433.0,427,613,414,13,0,53.83461538461538,220,74,29.7375,7
Category_Wikipedia_sockpuppets_of_Âåó‰∫¨ÂäûËØÅÁîµËØù.csv,8,1581.0,4,4,4,0,22,59.625,110,23,16.75,14
Category_Wikipedia_sockpuppets_of_Viraj_sivanandan.csv,31,1362908.0,17,14,14,3,0,35.70967741935484,175,44,30.193548387096776,12
Category_Wikipedia_sockpuppets_of_Prasooncalicut.csv,54,48667950.0,20,34,20,0,0,37.25925925925926,208,56,16.40740740740741,11
Category_Wikipedia_sockpuppets_of_DoggieRunning.csv,94,433291.0,36,58,36,0,0,42.11702127659574,229,37,20.680851063829788,6
Category_Wikipedia_sockpuppets_of_Azadzulfi.csv,32,68346398.0,8,24,8,0,0,58.25,172,33,29.28125,19
Category_Wikipedia_sockpuppets_of_WikiGuyde10.csv,79,744520.0,39,40,36,3,0,68.59493670886076,499,35,19.632911392405063,11
Category_Wikipedia_sockpuppets_of_Devianttheart2.csv,326,47093854.0,117,209,73,44,0,43.644171779141104,340,32,15.371165644171779,4
Category_Wikipedia_sockpuppets_of_Jehonathan.csv,2597,10539295.0,794,1803,500,294,0,45.44012321909896,250,75,19.269541778975743,3
Category_Wikipedia_sockpuppets_of_Cmckain.csv,3517,56336966.0,1137,2380,500,637,0,52.3156098947967,250,88,27.184247938584022,4
Category_Wikipedia_sockpuppets_of_50mMidas.csv,1076,35703374.0,311,765,190,121,0,51.73884758364312,315,57,16.94609665427509,4
Category_Wikipedia_sockpuppets_of_Daniel575.csv,4405,40400519.0,1632,2773,500,1132,0,40.76367763904654,248,90,19.643586833144155,2
Category_Wikipedia_sockpuppets_of_Mr.6523.csv,246,3145088.0,125,121,41,84,0,50.886178861788615,481,37,23.609756097560975,12
Category_Wikipedia_sockpuppets_of_Sickdearkorat.csv,1419,70693777.0,516,903,454,62,0,42.76250880902044,496,55,17.133192389006343,4
Category_Wikipedia_sockpuppets_of_K_scream.csv,33,21855246.0,16,17,5,11,0,71.66666666666667,196,18,11.393939393939394,6
Category_Wikipedia_sockpuppets_of_Swimming978.csv,66,84572.0,25,41,25,0,0,51.39393939393939,202,21,14.484848484848484,12
Category_Wikipedia_sockpuppets_of_Benezzee.csv,13,502045.0,10,3,5,5,0,10.615384615384615,40,18,12.692307692307692,6
Category_Wikipedia_sockpuppets_of_777executionprocess777.csv,226,4446619.0,64,162,49,15,0,50.74778761061947,251,47,17.06637168141593,4
Category_Wikipedia_sockpuppets_of_Findiii.csv,55,3885856.0,16,39,7,9,0,74.81818181818181,500,21,6.654545454545454,4
Category_Wikipedia_sockpuppets_of_Carpetright.csv,5,259310.0,4,1,3,1,12,41.0,123,11,11.0,11
Category_Wikipedia_sockpuppets_of_David_damsel.csv,23,4676.0,7,16,2,5,0,50.69565217391305,157,25,21.130434782608695,18
Category_Wikipedia_sockpuppets_of_Drsjpdc.csv,1591,135311424.0,609,982,500,109,0,44.5311125078567,255,58,21.575109993714644,2
Category_Wikipedia_sockpuppets_of_JayPritchett.csv,333,27212832.0,76,257,25,51,0,54.68168168168168,254,43,16.0990990990991,4
Category_Wikipedia_sockpuppets_of_Everwill.csv,350,6042239.0,134,216,82,52,0,42.59142857142857,199,33,21.942857142857143,6
Category_Wikipedia_sockpuppets_of_WikiBulova.csv,3400,35415743.0,1116,2284,500,616,0,43.61941176470588,255,63,18.191176470588236,4
Category_Wikipedia_sockpuppets_of_SyntaxErrors098.csv,1864,44557792.0,704,1160,243,461,0,32.341738197424895,495,59,20.28862660944206,5
Category_Wikipedia_sockpuppets_of_Srodgers1701.csv,2694,31785646.0,947,1747,500,447,0,47.56867112100965,500,74,18.43689680772086,3
"Category_Wikipedia_sockpuppets_of_Ron_Wells,_MDiv..csv",48,342517.0,26,22,24,2,0,50.958333333333336,277,51,21.479166666666668,13
Category_Wikipedia_sockpuppets_of_Kschar.csv,190,28669883.0,71,119,47,24,0,47.89473684210526,242,42,16.36315789473684,12
Category_Wikipedia_sockpuppets_of_InfoSum.csv,1,0.0,1,0,1,0,0,0.0,0,8,8.0,8
Category_Wikipedia_sockpuppets_of_Thecheeseistalking99.csv,2093,3720184.0,843,1250,500,343,0,51.66650740563784,509,73,22.51887243191591,4
Category_Wikipedia_sockpuppets_of_Influence_Music.csv,3,678.0,3,0,3,0,7,41.666666666666664,94,22,18.666666666666668,17
Category_Wikipedia_sockpuppets_of_Rosanacurso.csv,2566,34294766.0,550,2016,15,535,0,22.498441153546377,235,92,17.59353078721746,5
Category_Wikipedia_sockpuppets_of_AmberMoytoy.csv,305,1395513.0,97,208,61,36,0,54.80327868852459,496,53,18.714754098360658,5
Category_Wikipedia_sockpuppets_of_ZariakAC.csv,33,2348892.0,28,5,20,8,0,27.636363636363637,196,47,21.96969696969697,14
Category_Wikipedia_sockpuppets_of_Ohare415.csv,183,3519471.0,65,118,47,18,0,41.22950819672131,254,53,23.34426229508197,7
Category_Wikipedia_sockpuppets_of_Tiny_chunguss.csv,43,21001.0,16,27,9,7,0,72.3953488372093,500,24,16.41860465116279,11
Category_Wikipedia_sockpuppets_of_Necroshine95.csv,1581,40117318.0,626,955,258,368,0,31.93991144845035,254,47,20.157495256166982,6
Category_Wikipedia_sockpuppets_of_GranvilleHouston.csv,619,5962065.0,206,413,192,14,0,46.17609046849758,203,63,20.45395799676898,10
Category_Wikipedia_sockpuppets_of_Mrkoww.csv,1,0.0,1,0,1,0,36,36.0,36,44,44.0,44
Category_Wikipedia_sockpuppets_of_Aboujawdeh.csv,6,2870.0,5,1,2,3,0,9.0,26,46,31.833333333333332,15
Category_Wikipedia_sockpuppets_of_ColeisABoss.csv,23,2187233.0,5,18,3,2,0,80.0,225,13,9.826086956521738,4
Category_Wikipedia_sockpuppets_of_Roarkp.csv,1222,55271492.0,344,878,93,251,0,45.720949263502455,261,55,19.759410801963995,2
Category_Wikipedia_sockpuppets_of_MyeraMishra.csv,171,7628610.0,65,106,40,25,0,44.40350877192982,255,52,27.84795321637427,13
Category_Wikipedia_sockpuppets_of_Jimarey.csv,12484,103437292.0,3390,9094,500,2890,0,30.7556071771868,250,58,17.11254405639218,3
Category_Wikipedia_sockpuppets_of_Lslavin13.csv,31,1198623.0,15,16,10,5,0,26.032258064516128,158,48,29.096774193548388,8
Category_Wikipedia_sockpuppets_of_Alaingarner.csv,710,193750690.0,363,347,233,130,0,32.91830985915493,246,47,12.680281690140845,5
Category_Wikipedia_sockpuppets_of_XxTrollMeister69.csv,8,1345.0,5,3,5,0,0,29.375,138,16,13.75,10
Category_Wikipedia_sockpuppets_of_BitBee555.csv,211,59695737.0,54,157,32,22,0,68.88151658767772,290,35,19.061611374407583,7
Category_Wikipedia_sockpuppets_of_Nam3witha3init.csv,49,2418261.0,20,29,20,0,0,42.3469387755102,176,31,16.510204081632654,6
Category_Wikipedia_sockpuppets_of_Parvej096388.csv,473,92463503.0,185,288,72,113,0,42.52431289640592,292,79,20.175475687103596,6
Category_Wikipedia_sockpuppets_of_Grumpanelli.csv,1024,188369146.0,220,804,162,58,0,38.7529296875,249,56,16.4169921875,5
Category_Wikipedia_sockpuppets_of_Hemanshu.csv,2095,410116186.0,541,1554,500,41,0,46.69689737470167,387,53,16.527923627684963,4
Category_Wikipedia_sockpuppets_of_SAMBLAman.csv,1330,42424991.0,373,957,366,7,0,54.597744360902254,407,85,21.652631578947368,4
Category_Wikipedia_sockpuppets_of_Jimbreeman3.csv,616,7765446.0,185,431,65,120,0,60.13474025974026,493,48,19.530844155844157,7
Category_Wikipedia_sockpuppets_of_Sanjay_Kumar_Tiwari20.csv,2842,61335215.0,1267,1575,241,1026,0,40.96868402533427,448,62,15.599929627023224,5
Category_Wikipedia_sockpuppets_of_Kellyhernandez01.csv,1674,12785501.0,455,1219,195,260,0,46.17861409796894,255,56,16.778375149342892,4
Category_Wikipedia_sockpuppets_of_FuBiuC.csv,2666,35061629.0,1000,1666,500,500,0,50.04613653413353,331,72,15.372468117029257,4
Category_Wikipedia_sockpuppets_of_Xenen1970.csv,2381,37757098.0,952,1429,250,702,0,45.07265854682906,500,63,16.170516589668207,5
Category_Wikipedia_sockpuppets_of_SivramK.csv,187,21003198.0,165,22,65,100,0,16.737967914438503,496,43,28.97860962566845,17
Category_Wikipedia_sockpuppets_of_Royalty_clothing.csv,15,265855.0,4,11,2,2,0,35.2,138,53,34.6,11
Category_Wikipedia_sockpuppets_of_PrinceValiant99.csv,25,67873.0,10,15,5,5,0,44.04,197,17,15.32,14
Category_Wikipedia_sockpuppets_of_Vvv321.csv,134,28087425.0,85,49,37,48,0,24.007462686567163,225,32,19.5,12
Category_Wikipedia_sockpuppets_of_Kjp007.csv,473,169215201.0,132,341,107,25,0,47.520084566596196,255,48,14.268498942917548,5
Category_Wikipedia_sockpuppets_of_Metaxtech.csv,135,1769757.0,50,85,47,3,0,52.34074074074074,486,66,16.896296296296295,6
Category_Wikipedia_sockpuppets_of_Smellytap.csv,2144,151215082.0,868,1276,500,368,0,52.25,496,91,26.140391791044777,4
Category_Wikipedia_sockpuppets_of_Kenosplit.csv,53,7617180.0,29,24,28,1,0,39.77358490566038,195,21,16.830188679245282,12
Category_Wikipedia_sockpuppets_of_Consist.csv,220,1726013.0,102,118,101,1,0,42.86363636363637,216,22,14.222727272727273,5
Category_Wikipedia_sockpuppets_of_Sophiabekele.csv,8,6794.0,4,4,3,1,16,91.25,255,21,17.875,16
Category_Wikipedia_sockpuppets_of_DarthZantetsuken.csv,663,103216233.0,207,456,205,2,0,40.77828054298642,214,50,19.352941176470587,4
Category_Wikipedia_sockpuppets_of_Kagoz.csv,74,8100630.0,24,50,10,14,0,54.7972972972973,200,53,31.89189189189189,13
Category_Wikipedia_sockpuppets_of_Homerfan12.csv,1276,16369107.0,513,763,500,13,0,35.626175548589345,322,49,22.679467084639498,8
Category_Wikipedia_sockpuppets_of_XxICHABODXx.csv,30,11760464.0,6,24,5,1,0,81.23333333333333,196,24,14.066666666666666,10
Category_Wikipedia_sockpuppets_of_Mashrafiantu.csv,189,174105038.0,99,90,99,0,0,44.78835978835979,496,45,19.857142857142858,4
Category_Wikipedia_sockpuppets_of_Tealover2.csv,289,137870400.0,60,229,17,43,0,35.121107266435985,220,56,17.930795847750865,8
Category_Wikipedia_sockpuppets_of_Factivists.csv,8,1278420.0,3,5,1,2,3,34.5,69,22,21.0,20
Category_Wikipedia_sockpuppets_of_ByteOr.csv,1067,51580046.0,385,682,60,325,0,59.035613870665415,497,62,15.850046860356139,4
Category_Wikipedia_sockpuppets_of_Nitishkumartn.csv,7721,99560650.0,2298,5423,500,1798,0,36.11177308638777,255,68,18.57298277425204,2
Category_Wikipedia_sockpuppets_of_Editor652.csv,769,19268976.0,226,543,115,111,0,45.34980494148245,214,43,21.080624187256177,5
Category_Wikipedia_sockpuppets_of_Khajaniyaz123.csv,28,298564.0,11,17,6,5,0,65.53571428571429,234,21,15.607142857142858,11
Category_Wikipedia_sockpuppets_of_Stingman85.csv,542,441691.0,205,337,193,12,0,30.525830258302584,232,31,17.861623616236162,4
Category_Wikipedia_sockpuppets_of_Hamivlogs.csv,19,159199.0,13,6,10,3,0,20.789473684210527,85,19,15.578947368421053,10
Category_Wikipedia_sockpuppets_of_Nattymorris.csv,20,54903.0,18,2,14,4,0,7.45,137,18,18.0,18
Category_Wikipedia_sockpuppets_of_Arshiya.Arab369.csv,44,1919654.0,18,26,15,3,0,43.47727272727273,198,33,21.318181818181817,12
Category_Wikipedia_sockpuppets_of_Cistiano.csv,7,910.0,4,3,4,0,0,64.0,196,34,34.0,34
Category_Wikipedia_sockpuppets_of_Vicpumu.csv,1543,2662855.0,594,949,500,94,0,53.72650680492547,500,50,19.91250810110175,5
Category_Wikipedia_sockpuppets_of_Sonnykim9873.csv,95,1729311.0,33,62,15,18,0,55.34736842105263,250,33,12.68421052631579,6
Category_Wikipedia_sockpuppets_of_Devatha34.csv,385,24303402.0,185,200,91,94,0,23.56103896103896,500,24,14.212987012987012,12
Category_Wikipedia_sockpuppets_of_Marleyforlife.csv,109,27838353.0,25,84,17,8,0,32.88073394495413,255,46,20.98165137614679,11
Category_Wikipedia_sockpuppets_of_Lucas_Cruikshank_Official.csv,8,15040.0,6,2,1,5,23,150.0,172,30,19.875,13
Category_Wikipedia_sockpuppets_of_√âric_Gagnier.csv,518,53429083.0,185,333,72,113,0,47.62934362934363,249,43,18.8030888030888,4
Category_Wikipedia_sockpuppets_of_RazaHispanic2019.csv,449,17663534.0,403,46,258,145,0,7.4231625835189305,277,36,19.311804008908688,6
Category_Wikipedia_sockpuppets_of_–ù–∏–∫–∏—Ç–∞-–†–æ–¥–∏–Ω-2002.csv,10590,290837796.0,3801,6789,500,3301,0,43.644287063267235,500,73,23.010009442870633,2
Category_Wikipedia_sockpuppets_of_Fatin_are_roses.csv,22,71338.0,16,6,14,2,0,23.0,182,32,11.545454545454545,7
Category_Wikipedia_sockpuppets_of_BazzaHarp.csv,171,43705006.0,40,131,37,3,0,50.44444444444444,255,82,20.292397660818715,7
Category_Wikipedia_sockpuppets_of_Erictheprince.csv,69,200673.0,31,38,30,1,0,35.44927536231884,143,49,35.56521739130435,19
Category_Wikipedia_sockpuppets_of_EnglandIslas.csv,100,1885607.0,45,55,11,34,0,35.26,187,42,19.95,10
Category_Wikipedia_sockpuppets_of_HENRY_APPLEGATE.csv,132,132039932.0,62,70,16,46,0,40.015151515151516,230,41,25.477272727272727,16
Category_Wikipedia_sockpuppets_of_Zenminded.csv,189,161544795.0,53,136,28,25,0,38.4973544973545,245,41,15.894179894179894,4
Category_Wikipedia_sockpuppets_of_Hassan_Guy.csv,803,35010287.0,304,499,268,36,0,52.96388542963886,255,73,27.63138231631382,6
Category_Wikipedia_sockpuppets_of_Artworldwiki.csv,45,62716710.0,18,27,12,6,0,37.53333333333333,330,14,14.0,14
Category_Wikipedia_sockpuppets_of_Barry_Fukyu.csv,11,19281.0,6,5,3,3,0,70.36363636363636,166,40,37.72727272727273,35
Category_Wikipedia_sockpuppets_of_Goddon8202.csv,340,4692811.0,116,224,103,13,0,33.6,267,41,16.611764705882354,7
Category_Wikipedia_sockpuppets_of_Trincomanb.csv,2169,13833331.0,1000,1169,500,500,0,36.40571692023974,200,75,32.481788842784695,8
Category_Wikipedia_sockpuppets_of_Zerki_Karakiron.csv,264,1390761.0,127,137,60,67,0,44.56060606060606,228,75,29.636363636363637,9
Category_Wikipedia_sockpuppets_of_Staterecords.csv,135,5958317.0,30,105,16,14,0,67.28148148148148,254,42,18.02962962962963,5
Category_Wikipedia_sockpuppets_of_Sumittech123.csv,12,186405.0,7,5,3,4,0,70.91666666666667,137,13,13.0,13
Category_Wikipedia_sockpuppets_of_Aziz1005.csv,4188,469095466.0,1118,3070,500,618,0,41.79083094555874,500,69,16.20606494746896,2
Category_Wikipedia_sockpuppets_of_Ran_kadda.csv,38,1291089.0,9,29,7,2,0,49.89473684210526,196,53,22.657894736842106,5
Category_Wikipedia_sockpuppets_of_Chloe.pecorino.csv,6,79310992.0,2,4,2,0,0,56.666666666666664,117,53,36.5,20
Category_Wikipedia_sockpuppets_of_AgentZeroHelper.csv,405,3830271.0,191,214,69,122,0,44.51358024691358,239,63,24.960493827160494,14
Category_Wikipedia_sockpuppets_of_ALL2ALLA.csv,2318,12009484.0,697,1621,434,263,0,47.68248490077653,446,47,17.750647109577223,4
Category_Wikipedia_sockpuppets_of_Speedy_X_77.csv,178,1731766.0,62,116,59,3,0,45.69662921348315,242,23,15.539325842696629,5
Category_Wikipedia_sockpuppets_of_RejsHajredini95.csv,481,16779010.0,190,291,110,80,0,49.17255717255717,502,35,15.112266112266113,3
Category_Wikipedia_sockpuppets_of_Rajesh_nandan.csv,110,7472288.0,35,75,16,19,0,32.30909090909091,245,21,14.754545454545454,9
Category_Wikipedia_sockpuppets_of_J173299999.csv,63,82999.0,17,46,6,11,0,53.65079365079365,240,46,22.53968253968254,9
Category_Wikipedia_sockpuppets_of_Uni3993.csv,2215,21890825.0,639,1576,500,139,0,62.44018058690745,500,53,19.441083521444696,3
Category_Wikipedia_sockpuppets_of_Biscuit-in-Chief.csv,1974,190438292.0,502,1472,500,2,0,56.12462006079027,500,76,18.48581560283688,4
Category_Wikipedia_sockpuppets_of_Azukimonaka.csv,5021,502368341.0,1227,3794,500,727,0,44.123879705238004,332,77,15.140211113324039,3
Category_Wikipedia_sockpuppets_of_StevenMario.csv,1761,3040656.0,500,1261,500,0,0,42.75468483816014,250,70,22.09596819988643,3
Category_Wikipedia_sockpuppets_of_Ashkan1399.csv,1603,30596207.0,647,956,164,483,0,41.588895820336866,499,68,19.27386150966937,3
Category_Wikipedia_sockpuppets_of_Legalife103.csv,276,155608066.0,75,201,43,32,0,60.007246376811594,375,44,18.170289855072465,5
Category_Wikipedia_sockpuppets_of_Oschaper.csv,220,137527901.0,63,157,60,3,0,35.231818181818184,215,45,26.40909090909091,7
Category_Wikipedia_sockpuppets_of_House_xChurch.csv,2998,17970475.0,1050,1948,308,742,0,33.83555703802535,487,59,21.13675783855904,4
Category_Wikipedia_sockpuppets_of_Floranew.csv,12,4478.0,7,5,4,3,0,96.75,167,17,17.0,17
Category_Wikipedia_sockpuppets_of_Thesafepony.csv,435,5168290.0,174,261,84,90,0,39.32873563218391,228,65,37.291954022988506,16
Category_Wikipedia_sockpuppets_of_Champrock524.csv,13,4562796.0,5,8,3,2,0,45.15384615384615,144,18,15.23076923076923,14
Category_Wikipedia_sockpuppets_of_Zmccarthy.csv,112,62353722.0,28,84,28,0,0,46.955357142857146,266,47,38.42857142857143,25
Category_Wikipedia_sockpuppets_of_Macdonald5122.csv,677,31025647.0,255,422,25,230,0,45.0546528803545,489,47,18.3397341211226,4
Category_Wikipedia_sockpuppets_of_Kamen_Rider_(es).csv,724,15764430.0,201,523,122,79,0,30.18232044198895,261,46,18.443370165745858,5
Category_Wikipedia_sockpuppets_of_Djakil.csv,82,6500611.0,25,57,16,9,0,49.69512195121951,163,57,26.78048780487805,7
Category_Wikipedia_sockpuppets_of_SNIyer12.csv,1755,86278367.0,520,1235,500,20,0,48.0034188034188,255,58,24.017663817663816,6
Category_Wikipedia_sockpuppets_of_We233ws.csv,231,3418655.0,89,142,39,50,0,61.37229437229437,250,32,11.601731601731602,3
Category_Wikipedia_sockpuppets_of_Lukerevelation.csv,7,24447.0,5,2,3,2,0,57.42857142857143,193,22,14.285714285714286,13
Category_Wikipedia_sockpuppets_of_Lamplighter98.csv,17,29375240.0,4,13,3,1,0,53.94117647058823,255,23,15.588235294117647,14
Category_Wikipedia_sockpuppets_of_Adnanmuf.csv,1244,99963317.0,339,905,259,80,0,49.40836012861736,250,47,15.05225080385852,4
Category_Wikipedia_sockpuppets_of_Ravidhang.csv,6,5871.0,6,0,6,0,0,32.333333333333336,194,17,16.5,14
Category_Wikipedia_sockpuppets_of_DrATEasy.csv,128,26781566.0,46,82,39,7,0,38.6328125,199,41,21.8359375,7
Category_Wikipedia_sockpuppets_of_Abad9099.csv,1,0.0,1,0,1,0,23,23.0,23,17,17.0,17
Category_Wikipedia_sockpuppets_of_Newzealand123.csv,2203,295126694.0,850,1353,219,631,0,42.03404448479346,255,56,18.76577394462097,4
Category_Wikipedia_sockpuppets_of_Operahome.csv,58,38954507.0,18,40,6,12,0,57.37931034482759,152,48,24.25862068965517,11
Category_Wikipedia_sockpuppets_of_Cinefilestudio.csv,568,14692839.0,194,374,182,12,0,48.20070422535211,387,62,20.450704225352112,4
Category_Wikipedia_sockpuppets_of_Sdfghyu.csv,5,345.0,3,2,3,0,0,47.6,140,12,12.0,12
Category_Wikipedia_sockpuppets_of_Barbequeue.csv,5028,41657347.0,1509,3519,500,1009,0,41.637231503579955,255,86,18.47354813046937,3
Category_Wikipedia_sockpuppets_of_Moretonian.csv,264,36393259.0,138,126,136,2,0,78.2159090909091,499,40,26.03030303030303,15
Category_Wikipedia_sockpuppets_of_Kakkay_Abbasi.csv,661,24070690.0,193,468,135,58,0,57.1089258698941,500,53,17.697428139183057,6
Category_Wikipedia_sockpuppets_of_Therahulmarketing.csv,9,309198.0,8,1,6,2,10,37.333333333333336,153,14,14.0,14
Category_Wikipedia_sockpuppets_of_Heliosphere.csv,1438,12851423.0,544,894,392,152,0,44.578581363004176,246,47,20.145340751043115,3
Category_Wikipedia_sockpuppets_of_Squirepants101.csv,1467,182217196.0,502,965,500,2,0,54.2733469665985,250,66,31.591002044989775,3
Category_Wikipedia_sockpuppets_of_Nezi1111.csv,3084,13380044.0,950,2134,500,450,0,51.47373540856031,255,66,22.05479896238651,6
Category_Wikipedia_sockpuppets_of_Exactamente.csv,857,29025885.0,367,490,142,225,0,43.775962660443405,368,47,18.72345390898483,8
Category_Wikipedia_sockpuppets_of_Wikimindless.csv,475,21690510.0,140,335,125,15,0,25.349473684210526,182,99,20.722105263157896,4
Category_Wikipedia_sockpuppets_of_Kanhaiyakumarr.csv,79,11896179.0,17,62,10,7,0,68.9113924050633,229,32,16.164556962025316,5
Category_Wikipedia_sockpuppets_of_Alexdanw.csv,107,26461011.0,34,73,30,4,0,36.10280373831776,203,38,16.401869158878505,6
Category_Wikipedia_sockpuppets_of_Whenoby.csv,727,1053054.0,251,476,251,0,0,25.088033012379643,214,45,21.15130674002751,3
Category_Wikipedia_sockpuppets_of_Keycard1Slot.csv,1563,33550551.0,562,1001,384,178,0,56.91746641074856,350,55,19.530390275111966,3
Category_Wikipedia_sockpuppets_of_Gugaantony.csv,957,192270557.0,234,723,233,1,0,50.797283176593524,496,50,19.792058516196448,4
Category_Wikipedia_sockpuppets_of_Greatvictor999.csv,1679,215111078.0,627,1052,498,129,0,46.04705181655748,333,68,22.95473496128648,4
Category_Wikipedia_sockpuppets_of_Engineer_Saddam_Hussain.csv,2,0.0,1,1,1,0,504,504.0,504,28,28.0,28
Category_Wikipedia_sockpuppets_of_FI96FI1091FI5000FI506672.csv,13,184557.0,8,5,3,5,29,64.38461538461539,130,27,19.384615384615383,18
Category_Wikipedia_sockpuppets_of_Amish12.csv,6,5655123.0,3,3,3,0,0,35.0,126,20,14.166666666666666,13
Category_Wikipedia_sockpuppets_of_AllegroMastermind.csv,1616,73309609.0,446,1170,406,40,0,43.6509900990099,489,56,21.38799504950495,5
Category_Wikipedia_sockpuppets_of_JOHN_COLTRANE_CHURCH.csv,35,5717.0,15,20,8,7,10,68.51428571428572,181,49,23.771428571428572,10
Category_Wikipedia_sockpuppets_of_Homoeuropeean.csv,132,1418106.0,39,93,30,9,0,71.72727272727273,255,41,26.53787878787879,10
Category_Wikipedia_sockpuppets_of_S.S._Miami.csv,4567,22906160.0,1771,2796,500,1271,0,37.72016641121086,265,64,21.22837749069411,6
Category_Wikipedia_sockpuppets_of_Truthforlife.csv,442,9119897.0,171,271,70,101,0,58.425339366515836,226,54,17.41628959276018,5
Category_Wikipedia_sockpuppets_of_Wario7936.csv,24,106145.0,19,5,13,6,0,73.25,236,21,13.791666666666666,9
Category_Wikipedia_sockpuppets_of_Attasarana.csv,630,37673806.0,234,396,219,15,0,36.574603174603176,196,27,13.014285714285714,6
Category_Wikipedia_sockpuppets_of_Janejo59.csv,306,2454791.0,111,195,106,5,0,51.529411764705884,500,26,13.568627450980392,5
Category_Wikipedia_sockpuppets_of_Freddie6.csv,122,340628.0,41,81,26,15,0,49.86065573770492,251,61,18.549180327868854,6
Category_Wikipedia_sockpuppets_of_Tunebroker.csv,1550,127071380.0,581,969,500,81,0,44.818709677419356,291,40,15.313548387096775,4
Category_Wikipedia_sockpuppets_of_ISuportSchool.csv,86,686256.0,39,47,11,28,0,48.45348837209303,230,37,19.837209302325583,13
Category_Wikipedia_sockpuppets_of_SPWTulsaOK1213.csv,7098,107138711.0,2363,4735,394,1969,0,40.80135249366018,427,76,14.628346012961398,3
Category_Wikipedia_sockpuppets_of_Smallmouthbassboost.csv,1183,190368373.0,278,905,26,252,0,40.31699070160609,989,37,18.433643279797128,3
Category_Wikipedia_sockpuppets_of_ReemaHO.csv,36,949717.0,11,25,6,5,3,71.75,350,23,18.333333333333332,9
Category_Wikipedia_sockpuppets_of_Romeparis.csv,185,10154013.0,51,134,48,3,0,50.74054054054054,255,45,17.724324324324325,5
Category_Wikipedia_sockpuppets_of_Jatin1219.csv,575,33148186.0,171,404,151,20,0,57.012173913043476,494,71,29.377391304347825,5
Category_Wikipedia_sockpuppets_of_Wikichumki.csv,175,95233702.0,82,93,67,15,0,49.308571428571426,294,36,20.451428571428572,11
Category_Wikipedia_sockpuppets_of_Razinatorr.csv,375,3806576.0,201,174,201,0,0,29.448,263,36,20.370666666666665,10
Category_Wikipedia_sockpuppets_of_AGuy271.csv,902,15476610.0,207,695,180,27,0,84.95011086474501,433,56,17.990022172949,4
Category_Wikipedia_sockpuppets_of_The_Egyptian_army.csv,2626,27155113.0,1073,1553,97,976,0,66.3012185833968,506,53,20.32939832444783,11
Category_Wikipedia_sockpuppets_of_BakhtyarAziiz.csv,12,36309288.0,4,8,3,1,0,57.166666666666664,155,37,29.0,25
Category_Wikipedia_sockpuppets_of_Odafa.csv,1656,127974300.0,765,891,413,352,0,26.5006038647343,300,50,16.18719806763285,9
Category_Wikipedia_sockpuppets_of_Alex_West.csv,2237,142274242.0,651,1586,292,359,0,30.648636566830575,244,46,15.81940098345999,4
Category_Wikipedia_sockpuppets_of_Dxeebolit.csv,3213,56077195.0,952,2261,500,452,0,41.39900404606287,500,47,13.692187986305633,3
Category_Wikipedia_sockpuppets_of_Ceylobo.csv,317,222812319.0,93,224,44,49,0,46.81072555205047,232,46,17.94006309148265,11
Category_Wikipedia_sockpuppets_of_Greatprizes.csv,134,15545395.0,38,96,13,25,0,66.32089552238806,299,69,22.66417910447761,10
Category_Wikipedia_sockpuppets_of_Musicbyavishek.csv,16,29340.0,9,7,7,2,0,21.0625,154,23,13.0,9
Category_Wikipedia_sockpuppets_of_TXttx4xttXT.csv,534,607720.0,518,16,500,18,0,1.147940074906367,128,17,15.765917602996256,12
Category_Wikipedia_sockpuppets_of_Maldoror2.csv,149,789780.0,69,80,29,40,0,40.36241610738255,217,130,42.40939597315436,14
Category_Wikipedia_sockpuppets_of_SamuelBurckhalter.csv,1107,31795294.0,468,639,197,271,0,53.37127371273713,446,56,20.345076784101174,3
Category_Wikipedia_sockpuppets_of_Beaumontproject.csv,1224,16424468.0,449,775,430,19,0,31.966503267973856,255,69,21.02532679738562,4
Category_Wikipedia_sockpuppets_of_Rescarpment.csv,256,7982874.0,88,168,41,47,0,51.78125,233,48,21.5390625,12
Category_Wikipedia_sockpuppets_of_LanguageXpert.csv,13195,182649499.0,4157,9038,500,3657,0,49.0706328154604,326,74,17.18044713906783,3
Category_Wikipedia_sockpuppets_of_Timpatalpostma.csv,547,6418597.0,186,361,68,118,0,52.97623400365631,316,33,15.418647166361975,4
Category_Wikipedia_sockpuppets_of_Lletinsk.csv,53,314582551.0,21,32,15,6,0,40.9622641509434,175,21,14.981132075471699,13
Category_Wikipedia_sockpuppets_of_Lanadelb1th.csv,25,33653.0,14,11,8,6,0,46.68,189,43,34.28,18
Category_Wikipedia_sockpuppets_of_Tripple-ddd.csv,2231,193005874.0,1023,1208,500,523,0,44.54415060510981,496,47,18.835051546391753,4
Category_Wikipedia_sockpuppets_of_NoMoreHate.csv,205,6625123.0,67,138,27,40,0,48.24878048780488,255,45,18.926829268292682,3
Category_Wikipedia_sockpuppets_of_JuliaHavey.csv,471,33151340.0,186,285,186,0,0,36.309978768577494,199,58,16.870488322717623,7
Category_Wikipedia_sockpuppets_of_Ean0919191.csv,32,180511.0,26,6,26,0,0,38.03125,496,21,14.0625,11
Category_Wikipedia_sockpuppets_of_Bilalrahal.csv,47,3812714.0,18,29,16,2,0,48.08510638297872,197,49,20.404255319148938,12
Category_Wikipedia_sockpuppets_of_Insaanhuok.csv,1950,15040618.0,786,1164,500,286,0,16.532820512820514,496,59,21.025641025641026,4
Category_Wikipedia_sockpuppets_of_Cstanfie.csv,26,48020.0,8,18,4,4,0,32.19230769230769,199,50,27.192307692307693,17
Category_Wikipedia_sockpuppets_of_ChubbyTeam.csv,5,500058.0,4,1,3,1,0,39.4,133,17,17.0,17
Category_Wikipedia_sockpuppets_of_NotWildDaisy.csv,607,12289208.0,170,437,19,151,0,54.94563426688632,255,44,16.685337726523887,4
Category_Wikipedia_sockpuppets_of_Izaan_Haider.csv,742,7066853.0,258,484,99,159,0,45.97708894878706,491,31,15.192722371967655,3
Category_Wikipedia_sockpuppets_of_Isuzu.tf.csv,39107,80086693.0,8891,30216,500,8391,0,40.31730892167643,500,71,14.98977165213389,2
Category_Wikipedia_sockpuppets_of_Rowdypup.csv,701,44125098.0,202,499,165,37,0,53.2339514978602,255,44,17.835948644793152,7
Category_Wikipedia_sockpuppets_of_Ex-Homey.csv,300,1040019.0,122,178,113,9,0,35.5,196,75,34.47666666666667,13
Category_Wikipedia_sockpuppets_of_TSLcrazier.csv,998,1204357.0,500,498,500,0,0,38.43787575150301,202,50,29.29058116232465,9
Category_Wikipedia_sockpuppets_of_Timothyhouse1.csv,3346,57721796.0,1000,2346,500,500,0,36.666168559474,255,60,22.07112970711297,2
Category_Wikipedia_sockpuppets_of_Maiwenn88.csv,10,205039.0,7,3,4,3,18,69.7,179,15,15.0,15
Category_Wikipedia_sockpuppets_of_Kushalmoharaz.csv,357,38634620.0,92,265,25,67,0,34.675070028011206,342,41,18.518207282913167,12
Category_Wikipedia_sockpuppets_of_Drchuckwilliams.csv,33,13730681.0,12,21,11,1,0,49.18181818181818,199,25,16.09090909090909,13
Category_Wikipedia_sockpuppets_of_Suess56.csv,149,4415234.0,65,84,65,0,0,56.61744966442953,218,58,20.93288590604027,13
Category_Wikipedia_sockpuppets_of_Rosadewit016.csv,26,5629290.0,10,16,9,1,0,72.1923076923077,206,24,15.26923076923077,8
Category_Wikipedia_sockpuppets_of_Flix11.csv,8413,40203118.0,3569,4844,500,3069,0,31.29359324854392,495,73,25.270771425175322,6
Category_Wikipedia_sockpuppets_of_Crisspy.csv,1845,6468631.0,724,1121,500,224,0,23.2840108401084,234,50,17.168563685636855,4
Category_Wikipedia_sockpuppets_of_Benjamin_G._Saxe.csv,2,0.0,1,1,1,0,36,36.0,36,21,21.0,21
Category_Wikipedia_sockpuppets_of_FireDrake.csv,92,8518325.0,43,49,22,21,0,64.59782608695652,239,71,24.565217391304348,12
Category_Wikipedia_sockpuppets_of_Sergioca369.csv,146,8909919.0,47,99,45,2,0,59.16438356164384,255,59,23.97945205479452,9
Category_Wikipedia_sockpuppets_of_VALIDALTguy.csv,209,162240.0,89,120,32,57,0,49.0622009569378,274,54,35.26794258373206,14
Category_Wikipedia_sockpuppets_of_Joey_Joe_Joe_Junior_Shabadoo.csv,583,40332572.0,143,440,75,68,0,40.83190394511149,224,81,23.065180102915953,5
Category_Wikipedia_sockpuppets_of_Kupraios.csv,721,40620775.0,188,533,182,6,0,48.963938973647714,255,44,15.30235783633842,4
Category_Wikipedia_sockpuppets_of_Mar11.csv,3137,38195591.0,1081,2056,500,581,0,55.52789289129742,384,64,20.84666879183934,3
Category_Wikipedia_sockpuppets_of_Apacheco13.csv,149,45084620.0,35,114,27,8,0,40.288590604026844,218,25,12.838926174496644,7
Category_Wikipedia_sockpuppets_of_Kingfudge1.csv,139,6048675.0,51,88,32,19,0,47.97841726618705,254,27,15.474820143884893,3
Category_Wikipedia_sockpuppets_of_Marianwolfe86.csv,271,35364132.0,72,199,15,57,0,53.23247232472325,238,55,21.14760147601476,4
Category_Wikipedia_sockpuppets_of_Ssnnll12.csv,5,38931.0,3,2,1,2,23,82.2,173,10,10.0,10
Category_Wikipedia_sockpuppets_of_BoysGetHigh.csv,70,248219.0,51,19,51,0,0,24.614285714285714,250,18,6.3428571428571425,6
Category_Wikipedia_sockpuppets_of_Factwritertoor.csv,4,2957503.0,3,1,3,0,0,9.75,24,34,21.5,14
Category_Wikipedia_sockpuppets_of_Windsir.csv,166,15640766.0,54,112,17,37,0,33.01204819277108,164,46,28.00602409638554,14
Category_Wikipedia_sockpuppets_of_AkashNanda_bio.csv,10,2830393.0,7,3,6,1,0,22.1,73,24,23.8,22
Category_Wikipedia_sockpuppets_of_Charmainegiuri.csv,11,2242128.0,4,7,2,2,0,47.90909090909091,226,30,17.636363636363637,13
Category_Wikipedia_sockpuppets_of_Shez_15.csv,2666,153300283.0,777,1889,500,277,0,41.591147786946735,247,62,19.683795948987246,4
Category_Wikipedia_sockpuppets_of_2006_December.csv,762,165174594.0,290,472,95,195,0,43.13779527559055,255,42,19.89501312335958,4
Category_Wikipedia_sockpuppets_of_Sexually_Active.csv,195,6909947.0,48,147,13,35,0,57.83589743589744,250,47,17.753846153846155,5
Category_Wikipedia_sockpuppets_of_LachlanTansey.csv,789,132693448.0,216,573,128,88,0,49.56400506970849,323,62,25.978453738910012,12
Category_Wikipedia_sockpuppets_of_Devanday01.csv,26,9179652.0,12,14,12,0,0,28.115384615384617,160,23,13.692307692307692,7
Category_Wikipedia_sockpuppets_of_Orman1.csv,37,1825818.0,15,22,9,6,0,48.054054054054056,193,34,20.216216216216218,11
Category_Wikipedia_sockpuppets_of_Dutchboyhimself.csv,32,26539.0,11,21,9,2,0,42.3125,192,25,12.03125,3
Category_Wikipedia_sockpuppets_of_RisingIcons.csv,1,0.0,1,0,1,0,28,28.0,28,21,21.0,21
Category_Wikipedia_sockpuppets_of_ImtheMars.csv,272,45310605.0,105,167,59,46,0,48.68382352941177,235,28,16.511029411764707,6
Category_Wikipedia_sockpuppets_of_ChicagoHistory1.csv,1241,74726728.0,455,786,389,66,0,38.58904109589041,250,45,24.968573730862207,5
Category_Wikipedia_sockpuppets_of_WikiManUser21.csv,1243,52792691.0,378,865,265,113,0,57.795655671761864,499,68,29.023330651649236,4
Category_Wikipedia_sockpuppets_of_Rif.Rifat.csv,13,5449116.0,5,8,3,2,0,34.61538461538461,133,26,17.0,5
Category_Wikipedia_sockpuppets_of_Ireadbooks12.csv,344,30693809.0,107,237,106,1,0,56.770348837209305,289,62,20.267441860465116,3
Category_Wikipedia_sockpuppets_of_IrishDynamo9.csv,176,10557215.0,60,116,18,42,0,41.03977272727273,199,71,21.329545454545453,8
Category_Wikipedia_sockpuppets_of_PSOILFHJFHFDF.csv,83,141785.0,37,46,23,14,0,48.98795180722892,199,67,38.28915662650602,16
Category_Wikipedia_sockpuppets_of_12Pinguins.csv,33,244767.0,13,20,9,4,0,27.09090909090909,86,53,44.06060606060606,18
Category_Wikipedia_sockpuppets_of_Jehowahyereh.csv,1181,45436535.0,500,681,500,0,0,43.839119390347165,496,63,19.926333615580017,5
Category_Wikipedia_sockpuppets_of_Bsrboy.csv,4212,11744761.0,1494,2718,500,994,0,46.639363722697055,250,76,21.574786324786324,3
Category_Wikipedia_sockpuppets_of_Jediknight15.csv,1956,80226478.0,532,1424,494,38,0,44.236196319018404,361,85,21.192229038854805,6
Category_Wikipedia_sockpuppets_of_Handarotarykiln.csv,105,20483550.0,60,45,15,45,0,38.80952380952381,225,23,12.104761904761904,9
Category_Wikipedia_sockpuppets_of_Xnzyrp.csv,32,2061.0,13,19,7,6,0,48.90625,193,23,17.09375,8
Category_Wikipedia_sockpuppets_of_Alex_dimis.csv,2,0.0,1,1,1,0,0,0.0,0,20,20.0,20
Category_Wikipedia_sockpuppets_of_BryanFromPalatine.csv,11870,620658758.0,4072,7798,500,3572,0,47.17278854254423,473,100,24.345998315080035,3
Category_Wikipedia_sockpuppets_of_Adbhaskar.csv,115,54987579.0,50,65,26,24,0,57.208695652173915,241,43,16.017391304347825,10
Category_Wikipedia_sockpuppets_of_Wtcsurvivor.csv,488,37058681.0,256,232,190,66,0,48.20286885245902,200,54,16.883196721311474,6
Category_Wikipedia_sockpuppets_of_Molobo.csv,1768,21467461.0,601,1167,500,101,0,37.828054298642535,240,82,28.3710407239819,4
Category_Wikipedia_sockpuppets_of_Shagnikghosh1.csv,52,2609898.0,23,29,14,9,0,50.59615384615385,230,31,17.53846153846154,14
Category_Wikipedia_sockpuppets_of_Hinayath_Karadan.csv,14,261144.0,8,6,8,0,0,29.857142857142858,139,44,27.714285714285715,18
Category_Wikipedia_sockpuppets_of_Georgiafreak72.csv,421,131002.0,112,309,13,99,0,37.05938242280285,226,44,18.133016627078383,3
Category_Wikipedia_sockpuppets_of_OldFairhoper.csv,86,10764513.0,39,47,20,19,0,41.848837209302324,199,23,17.25581395348837,15
Category_Wikipedia_sockpuppets_of_James_Corden.csv,28,339872.0,10,18,10,0,0,76.71428571428571,188,23,17.25,11
Category_Wikipedia_sockpuppets_of_Technepoiesis.csv,814,132776923.0,260,554,124,136,0,51.229729729729726,374,35,15.084766584766585,6
Category_Wikipedia_sockpuppets_of_ArtistForum.csv,2,4359.0,2,0,2,0,0,0.0,0,53,53.0,53
Category_Wikipedia_sockpuppets_of_Metalvayne.csv,2744,38488837.0,1012,1732,500,512,0,43.29992711370262,264,64,18.564504373177844,4
Category_Wikipedia_sockpuppets_of_Ram_Ji_290.csv,720,3793933.0,275,445,263,12,0,44.856944444444444,368,40,16.72222222222222,5
Category_Wikipedia_sockpuppets_of_Easy4all.csv,494,46455423.0,164,330,120,44,0,34.91093117408907,200,50,18.101214574898787,6
Category_Wikipedia_sockpuppets_of_Gauravar.csv,6,35074099.0,2,4,2,0,0,61.833333333333336,161,41,21.833333333333332,18
Category_Wikipedia_sockpuppets_of_Èöê‰∏ñÈ´ò‰∫∫.csv,4342,129227079.0,1667,2675,500,1167,0,42.902809765085216,497,82,27.755181943804697,4
Category_Wikipedia_sockpuppets_of_AllwynImmanuel.csv,14,15817259.0,7,7,6,1,0,52.142857142857146,169,47,25.142857142857142,19
Category_Wikipedia_sockpuppets_of_Queen_Noble.csv,62,19512703.0,17,45,9,8,0,54.274193548387096,500,59,15.209677419354838,13
Category_Wikipedia_sockpuppets_of_Banzaiblitz.csv,1097,275374666.0,384,713,382,2,0,59.65451230628988,494,48,19.594348222424795,6
Category_Wikipedia_sockpuppets_of_Thakurjiofficial.csv,452,5349620.0,168,284,153,15,0,46.03761061946903,262,44,13.679203539823009,4
Category_Wikipedia_sockpuppets_of_JasonReal2021.csv,11,83717.0,4,7,2,2,0,74.81818181818181,200,19,11.181818181818182,5
Category_Wikipedia_sockpuppets_of_Jayraj2022.csv,20,84313.0,6,14,2,4,0,55.75,209,25,15.0,7
Category_Wikipedia_sockpuppets_of_Wazirinbida.csv,1544,13023795.0,676,868,500,176,0,36.57448186528497,413,69,18.458549222797927,4
Category_Wikipedia_sockpuppets_of_Racepacket.csv,1553,128332029.0,566,987,500,66,0,42.656149388280745,250,76,24.51062459755312,6
Category_Wikipedia_sockpuppets_of_MeraAwaaz.csv,2828,71510367.0,995,1833,489,506,0,44.027934936350775,496,62,13.595827439886845,4
Category_Wikipedia_sockpuppets_of_≈ûappur_≈ûuppur.csv,52,2004509.0,21,31,14,7,0,56.76923076923077,296,19,13.365384615384615,7
Category_Wikipedia_sockpuppets_of_Bandagharka.csv,231,5347781.0,75,156,61,14,0,52.688311688311686,245,47,23.00865800865801,16
Category_Wikipedia_sockpuppets_of_LGfatcat.csv,37,113568.0,14,23,8,6,0,49.027027027027025,162,51,18.783783783783782,10
Category_Wikipedia_sockpuppets_of_SHEELA_PANDIT_PARJAPATI.csv,45,36196487.0,30,15,16,14,0,42.333333333333336,182,33,19.622222222222224,14
Category_Wikipedia_sockpuppets_of_Teasereds.csv,820,32962773.0,372,448,116,256,0,39.50243902439024,208,61,20.87560975609756,6
Category_Wikipedia_sockpuppets_of_TheRealAlanStubbs.csv,2,130.0,2,0,2,0,13,13.0,13,14,14.0,14
Category_Wikipedia_sockpuppets_of_Altutmir.csv,680,117892290.0,226,454,134,92,0,47.80735294117647,498,71,16.88529411764706,3
Category_Wikipedia_sockpuppets_of_Excel23.csv,1747,137979510.0,570,1177,500,70,0,49.57012020606754,491,96,22.041213508872353,3
Category_Wikipedia_sockpuppets_of_Fenopy.csv,830,258182614.0,291,539,273,18,0,48.56867469879518,257,96,27.395180722891567,6
Category_Wikipedia_sockpuppets_of_Qayyum_Ansari.csv,61,55761074.0,30,31,21,9,0,31.24590163934426,177,23,20.508196721311474,11
Category_Wikipedia_sockpuppets_of_Manikganj_Road_504.csv,51,17043782.0,17,34,16,1,0,45.03921568627451,279,44,21.15686274509804,9
Category_Wikipedia_sockpuppets_of_Davidbuddy9.csv,1455,257206359.0,575,880,500,75,0,54.53127147766323,500,107,24.403436426116837,5
Category_Wikipedia_sockpuppets_of_Martyjmch.csv,397,113987269.0,84,313,79,5,0,49.2191435768262,216,44,19.974811083123427,3
Category_Wikipedia_sockpuppets_of_Ggrks.csv,103,1358887.0,27,76,11,16,0,47.37864077669903,226,37,17.825242718446603,5
Category_Wikipedia_sockpuppets_of_Jrs50.csv,283,22907361.0,145,138,49,96,0,49.169611307420496,220,39,8.02826855123675,6
Category_Wikipedia_sockpuppets_of_Idarsthage.csv,42,929116.0,19,23,6,13,0,50.23809523809524,218,32,19.571428571428573,7
Category_Wikipedia_sockpuppets_of_Gregorybritt.csv,107,8671978.0,36,71,21,15,0,59.345794392523366,255,41,28.0,15
Category_Wikipedia_sockpuppets_of_WelcometoJurassicPark.csv,2892,116760352.0,768,2124,500,268,0,58.08679114799447,419,51,17.113762102351313,4
Category_Wikipedia_sockpuppets_of_Group_Lightshine.csv,43,270282.0,31,12,24,7,0,35.093023255813954,496,31,28.976744186046513,22
Category_Wikipedia_sockpuppets_of_1028.csv,843,10115278.0,239,604,238,1,0,23.651245551601424,199,87,19.488730723606167,3
Category_Wikipedia_sockpuppets_of_Saurabhstamhanefilms.csv,5,19869493.0,2,3,1,1,14,33.8,53,25,20.2,19
Category_Wikipedia_sockpuppets_of_Gejos.csv,73,4247497.0,30,43,13,17,0,47.24657534246575,254,16,11.438356164383562,3
Category_Wikipedia_sockpuppets_of_Poetlister_Runcorn.csv,17346,232456057.0,5700,11646,500,5200,0,39.44644298397325,255,125,21.6338060647988,2
Category_Wikipedia_sockpuppets_of_Lcavinder4848.csv,34,165979644.0,20,14,15,5,0,42.38235294117647,254,28,24.529411764705884,19
Category_Wikipedia_sockpuppets_of_Sigmaboy123.csv,7,87096.0,6,1,4,2,0,19.285714285714285,135,11,11.0,11
Category_Wikipedia_sockpuppets_of_Andrewart.csv,128,90658942.0,34,94,22,12,0,52.7109375,249,39,20.28125,16
Category_Wikipedia_sockpuppets_of_Jsb394.csv,219,46358878.0,91,128,53,38,0,34.73972602739726,199,39,13.657534246575343,7
Category_Wikipedia_sockpuppets_of_Rhinotate.csv,76,344154.0,44,32,42,2,0,20.342105263157894,114,52,21.223684210526315,19
Category_Wikipedia_sockpuppets_of_Snakeskinsam.csv,3142,4051625.0,1000,2142,500,500,0,42.91788669637174,255,84,21.495544239338003,8
Category_Wikipedia_sockpuppets_of_Bkleinberg.csv,876,202823240.0,282,594,116,166,0,47.43949771689498,249,48,18.595890410958905,4
Category_Wikipedia_sockpuppets_of_Mdelnegro12.csv,1326,10131100.0,515,811,500,15,0,35.31674208144796,495,55,20.598793363499247,5
Category_Wikipedia_sockpuppets_of_Jitazg.csv,1784,19382950.0,577,1207,500,77,0,38.44226457399103,376,48,18.516816143497756,4
Category_Wikipedia_sockpuppets_of_Ikumansuma.csv,107,61937401.0,40,67,21,19,0,40.54205607476636,226,41,18.88785046728972,12
Category_Wikipedia_sockpuppets_of_Blaine2025.csv,400,951324.0,125,275,119,6,0,49.4425,497,63,19.06,4
Category_Wikipedia_sockpuppets_of_Nkupad.csv,1693,49601229.0,510,1183,413,97,0,41.89899586532782,395,54,15.40992321323095,4
Category_Wikipedia_sockpuppets_of_Protecting.csv,340,3437453.0,124,216,99,25,0,36.608823529411765,211,32,14.279411764705882,5
Category_Wikipedia_sockpuppets_of_Phillywho113.csv,3,27924.0,2,1,2,0,0,87.33333333333333,149,33,33.0,33
Category_Wikipedia_sockpuppets_of_FlyingHarshk.csv,2413,33613954.0,802,1611,329,473,0,40.38789888106092,313,72,18.617074181516784,4
Category_Wikipedia_sockpuppets_of_Mclamchop.csv,79,7813502.0,23,56,12,11,0,63.18987341772152,219,43,13.645569620253164,7
Category_Wikipedia_sockpuppets_of_John_Sikty.csv,537,5409160.0,200,337,137,63,0,43.33147113594041,492,54,17.374301675977655,4
Category_Wikipedia_sockpuppets_of_NWO_Ghost.csv,11,1379197.0,6,5,5,1,0,67.72727272727273,153,20,10.909090909090908,6
Category_Wikipedia_sockpuppets_of_God_please_help_us.csv,190,13987287.0,66,124,46,20,0,46.4,253,44,20.352631578947367,8
Category_Wikipedia_sockpuppets_of_Fayeduzzaman_Tamim.csv,132,95878597.0,47,85,36,11,0,39.09848484848485,233,29,23.0,16
Category_Wikipedia_sockpuppets_of_Finealt.csv,4061,40151385.0,1166,2895,500,666,0,46.85570056636296,255,106,28.083723220881556,3
Category_Wikipedia_sockpuppets_of_Rabia99.csv,71,5733829.0,19,52,13,6,0,58.971830985915496,322,44,18.985915492957748,6
Category_Wikipedia_sockpuppets_of_Dmrjay.csv,8,264.0,5,3,3,2,13,60.375,203,16,16.0,16
Category_Wikipedia_sockpuppets_of_Leozitchus.csv,8,2984.0,4,4,2,2,22,48.875,97,48,41.0,20
Category_Wikipedia_sockpuppets_of_St.FrankieandtheRetardlyGang.csv,639,3370877.0,233,406,124,109,0,39.40845070422535,236,47,21.859154929577464,7
Category_Wikipedia_sockpuppets_of_Tbuckingham.csv,4,885.0,3,1,3,0,0,5.25,21,38,20.5,3
Category_Wikipedia_sockpuppets_of_Timmy_Appo.csv,1762,32816211.0,466,1296,448,18,0,37.67480136208854,221,68,22.164018161180476,3
Category_Wikipedia_sockpuppets_of_Fortnite_life_420.csv,16,659514.0,5,11,4,1,0,84.3125,235,53,42.6875,20
Category_Wikipedia_sockpuppets_of_Tngah.csv,745,23813818.0,229,516,110,119,0,51.4241610738255,229,49,12.033557046979865,6
Category_Wikipedia_sockpuppets_of_MrSparksMusic.csv,12,146805.0,6,6,4,2,0,42.666666666666664,174,23,18.5,17
Category_Wikipedia_sockpuppets_of_Shadowdude55.csv,154,15789.0,51,103,29,22,0,65.51948051948052,200,49,20.12987012987013,9
Category_Wikipedia_sockpuppets_of_10alatham.csv,4023,370530556.0,1030,2993,98,932,0,34.09719115088242,493,51,21.352224707929405,6
Category_Wikipedia_sockpuppets_of_Detroit_Joseph.csv,1069,48726142.0,374,695,107,267,0,44.67259120673527,255,81,24.53133769878391,5
Category_Wikipedia_sockpuppets_of_Kookface.csv,1912,432607099.0,503,1409,500,3,0,44.53294979079498,264,60,18.631799163179917,6
Category_Wikipedia_sockpuppets_of_Green108.csv,1209,44075534.0,531,678,464,67,0,39.01240694789082,200,72,17.751033912324235,4
Category_Wikipedia_sockpuppets_of_Veronikadeleva18.csv,11,1750993.0,11,0,6,5,0,19.818181818181817,148,29,21.727272727272727,21
Category_Wikipedia_sockpuppets_of_Red_Icarus_of_Jakarta.csv,1981,44562352.0,524,1457,469,55,0,55.03432609793034,255,69,14.87279151943463,4
Category_Wikipedia_sockpuppets_of_DavidBiga.csv,59,104357018.0,23,36,20,3,0,45.3728813559322,196,33,26.406779661016948,14
Category_Wikipedia_sockpuppets_of_CD_-32_9396SSE.csv,666,29740499.0,202,464,62,140,0,57.132132132132135,496,54,24.15765765765766,6
Category_Wikipedia_sockpuppets_of_Firegazer101.csv,910,8824140.0,380,530,377,3,0,42.28241758241758,250,67,37.71868131868132,17
Category_Wikipedia_sockpuppets_of_WHY_HASNT_JESUS_RETURNED_YET!!_.csv,2,0.0,1,1,1,0,72,72.0,72,68,68.0,68
Category_Wikipedia_sockpuppets_of_Bsktblldn619.csv,270,60825683.0,96,174,50,46,0,37.24074074074074,219,56,16.24074074074074,5
Category_Wikipedia_sockpuppets_of_Squad.csv,56,3088588.0,15,41,12,3,0,30.071428571428573,162,32,14.982142857142858,6
Category_Wikipedia_sockpuppets_of_Areej_saud.csv,2,0.0,1,1,1,0,0,0.0,0,20,20.0,20
Category_Wikipedia_sockpuppets_of_Yashas_T.csv,1026,4278507.0,363,663,169,194,0,43.94541910331384,244,74,21.32261208576998,3
Category_Wikipedia_sockpuppets_of_PhilippineMaster.csv,860,18752912.0,385,475,133,252,0,32.705813953488374,253,56,29.76279069767442,10
Category_Wikipedia_sockpuppets_of_Grandma_Dottie.csv,1739,58335196.0,552,1187,500,52,0,39.9401955146636,232,86,20.1943645773433,2
Category_Wikipedia_sockpuppets_of_Customerexperience.csv,12,358417.0,10,2,10,0,16,53.0,235,19,19.0,19
Category_Wikipedia_sockpuppets_of_jamesdaviddiamond.csv,297,86303831.0,92,205,77,15,0,46.36700336700337,237,53,15.56902356902357,4
Category_Wikipedia_sockpuppets_of_S√∏ren.csv,1287,101109357.0,507,780,500,7,0,41.763791763791765,260,50,17.36985236985237,5
Category_Wikipedia_sockpuppets_of_DanielTom.csv,1484,5898411.0,554,930,500,54,0,51.2722371967655,255,62,25.899595687331537,3
Category_Wikipedia_sockpuppets_of_Namit_Nagar.csv,2036,36800592.0,531,1505,500,31,0,35.10510805500982,395,46,14.766699410609037,4
Category_Wikipedia_sockpuppets_of_Jeebaslol.csv,11,1120260.0,5,6,4,1,0,57.72727272727273,221,14,7.909090909090909,5
Category_Wikipedia_sockpuppets_of_Revanth_Yadav_9959.csv,2906,154745058.0,1000,1906,500,500,0,36.82140399174123,493,68,15.21954576737784,5
Category_Wikipedia_sockpuppets_of_Dr.Bhatta.csv,229,11098.0,61,168,21,40,0,44.419213973799124,184,31,7.890829694323144,3
Category_Wikipedia_sockpuppets_of_WalkerThrough.csv,679,8515043.0,280,399,277,3,0,53.25625920471281,248,55,20.412371134020617,5
Category_Wikipedia_sockpuppets_of_User_Eddstonham.csv,136,2915760.0,51,85,39,12,0,38.294117647058826,160,50,21.74264705882353,5
Category_Wikipedia_sockpuppets_of_Ebeing.csv,488,363549191.0,119,369,119,0,0,56.57172131147541,263,42,14.651639344262295,6
Category_Wikipedia_sockpuppets_of_Musisince1989.csv,61,66058634.0,22,39,8,14,0,37.50819672131148,207,20,10.934426229508198,7
Category_Wikipedia_sockpuppets_of_Shulinjiang.csv,394,79128305.0,110,284,104,6,0,53.62690355329949,255,53,23.119289340101524,5
Category_Wikipedia_sockpuppets_of_Olik8.csv,51,30184586.0,26,25,20,6,0,33.88235294117647,199,53,30.235294117647058,13
Category_Wikipedia_sockpuppets_of_Karkeixa.csv,97,1239775.0,54,43,53,1,0,42.865979381443296,199,47,20.484536082474225,13
Category_Wikipedia_sockpuppets_of_Ratan375.csv,2690,6591740.0,791,1899,500,291,0,42.36133828996282,500,42,14.573234200743494,3
Category_Wikipedia_sockpuppets_of_Aximilli_Isthill.csv,369,329151422.0,98,271,55,43,0,47.22222222222222,250,56,20.368563685636857,4
Category_Wikipedia_sockpuppets_of_Navnl√∏s.csv,1870,180636581.0,561,1309,500,61,0,51.12620320855615,255,71,17.303208556149734,5
Category_Wikipedia_sockpuppets_of_Mersey57.csv,475,35679318.0,139,336,26,113,0,46.53052631578947,200,41,16.806315789473683,9
Category_Wikipedia_sockpuppets_of_Reallydudes.csv,52,3776888.0,19,33,8,11,0,48.03846153846154,150,34,29.923076923076923,16
Category_Wikipedia_sockpuppets_of_Armaghan_Muawiyah.csv,2746,104009689.0,674,2072,500,174,0,42.78477785870357,352,67,22.780043699927166,4
Category_Wikipedia_sockpuppets_of_IMA_Griz.csv,157,35658835.0,53,104,31,22,0,42.49044585987261,209,41,14.229299363057326,7
Category_Wikipedia_sockpuppets_of_Monte_Melkonian.csv,690,2072956.0,244,446,239,5,0,48.75797101449275,226,50,26.420289855072465,4
Category_Wikipedia_sockpuppets_of_Polo1990.csv,9,234832.0,7,2,4,3,0,31.666666666666668,145,17,13.88888888888889,10
Category_Wikipedia_sockpuppets_of_Goyakar501.csv,34,2003787.0,21,13,11,10,0,60.14705882352941,199,24,12.558823529411764,6
Category_Wikipedia_sockpuppets_of_Virg38.csv,150,39347246.0,70,80,55,15,0,39.38,196,44,17.593333333333334,5
Category_Wikipedia_sockpuppets_of_21canyoudosomeforme.csv,7,450978.0,5,2,3,2,0,48.142857142857146,190,28,28.0,28
Category_Wikipedia_sockpuppets_of_Ronosen.csv,2208,28052266.0,870,1338,374,496,0,36.914855072463766,200,71,17.701992753623188,4
Category_Wikipedia_sockpuppets_of_FLPTrainor.csv,8428,21265013.0,2688,5740,500,2188,0,51.57570004746084,260,93,23.637280493592787,1
Category_Wikipedia_sockpuppets_of_Peaceatlife1.csv,24,7957.0,8,16,5,3,0,36.583333333333336,130,46,31.458333333333332,25
Category_Wikipedia_sockpuppets_of_Edit5001.csv,1432,20632213.0,575,857,500,75,0,52.65782122905028,360,59,25.9231843575419,8
Category_Wikipedia_sockpuppets_of_Special_Cases.csv,7039,60140286.0,2278,4761,500,1778,0,59.73859923284557,266,98,21.423639721551357,2
Category_Wikipedia_sockpuppets_of_Fellytone.csv,1375,34079366.0,374,1001,354,20,0,47.31854545454546,221,65,22.68509090909091,3
Category_Wikipedia_sockpuppets_of_RedJulianG40.csv,1367,278838766.0,547,820,500,47,0,48.7037307973665,278,62,20.25603511338698,4
Category_Wikipedia_sockpuppets_of_StealBoy.csv,49,22908154.0,11,38,6,5,0,44.36734693877551,199,48,27.306122448979593,10
Category_Wikipedia_sockpuppets_of_Super2510LOL.csv,128,10306701.0,33,95,13,20,0,58.8984375,249,29,15.515625,5
Category_Wikipedia_sockpuppets_of_Tlacui76.csv,1419,7764511.0,513,906,225,288,0,45.27343199436223,405,66,20.91120507399577,5
Category_Wikipedia_sockpuppets_of_Gabrielsimon.csv,2782,12955042.0,1134,1648,500,634,0,29.312724658519052,200,61,24.34471603163192,3
Category_Wikipedia_sockpuppets_of_MG2020DTC.csv,80,4426068.0,37,43,32,5,0,57.1125,457,50,18.3125,5
Category_Wikipedia_sockpuppets_of_Minhajian.csv,820,282663982.0,230,590,203,27,0,37.63048780487805,255,57,19.135365853658538,4
Category_Wikipedia_sockpuppets_of_Mets1237.csv,196,2416850.0,68,128,52,16,0,44.91326530612245,235,29,17.479591836734695,11
Category_Wikipedia_sockpuppets_of_Jarreeeid.csv,75,38034540.0,27,48,26,1,0,50.8,297,70,17.466666666666665,3
Category_Wikipedia_sockpuppets_of_Voiceoftamil.csv,457,103081422.0,173,284,165,8,0,45.44201312910285,255,38,12.468271334792123,5
Category_Wikipedia_sockpuppets_of_Tochi_Clement.csv,221,26532291.0,75,146,26,49,0,47.53846153846154,246,60,16.41176470588235,5
Category_Wikipedia_sockpuppets_of_Udit_Bhanu.csv,38,90242880.0,14,24,10,4,0,49.68421052631579,191,53,33.473684210526315,14
Category_Wikipedia_sockpuppets_of_Disagreeable_entity.csv,131,5494982.0,84,47,44,40,0,58.98473282442748,336,29,16.328244274809162,6
Category_Wikipedia_sockpuppets_of_Basitmalik71500.csv,1,0.0,1,0,1,0,29,29.0,29,25,25.0,25
Category_Wikipedia_sockpuppets_of_Anon551055.csv,383,10657520.0,158,225,142,16,0,55.63185378590078,255,67,22.95822454308094,4
Category_Wikipedia_sockpuppets_of_Mekalos.csv,1619,8991541.0,537,1082,231,306,0,44.171093267449045,496,83,15.785670166769611,3
Category_Wikipedia_sockpuppets_of_Berberlegend.csv,93,1719931.0,39,54,31,8,0,36.516129032258064,233,21,11.849462365591398,6
Category_Wikipedia_sockpuppets_of_Laplace_Architecture.csv,18,4063363.0,10,8,8,2,0,39.55555555555556,357,30,28.666666666666668,24
Category_Wikipedia_sockpuppets_of_Calore123.csv,691,89344722.0,187,504,184,3,0,58.62807525325615,494,80,22.904486251808972,4
Category_Wikipedia_sockpuppets_of_Zerolandteam385.csv,7260,137890108.0,2105,5155,500,1605,0,44.63415977961432,502,51,14.113223140495867,3
Category_Wikipedia_sockpuppets_of_SHOMRATz.csv,3,5436884.0,2,1,1,1,36,125.33333333333333,196,21,19.0,18
Category_Wikipedia_sockpuppets_of_Enriquecardova.csv,2139,20603755.0,910,1229,500,410,0,38.26367461430575,265,67,26.47872837774661,5
Category_Wikipedia_sockpuppets_of_Vinujadhav.csv,1185,59829936.0,391,794,137,254,0,36.11645569620253,258,49,15.743459915611814,4
Category_Wikipedia_sockpuppets_of_Deedeedee_Steven.csv,175,379644025.0,48,127,13,35,0,58.38857142857143,227,63,18.65714285714286,4
Category_Wikipedia_sockpuppets_of_Snodgrassbradley389.csv,349,3451416.0,120,229,62,58,0,40.30945558739255,330,42,21.759312320916905,5
Category_Wikipedia_sockpuppets_of_RoboShutter.csv,418,7708875.0,140,278,71,69,0,36.61483253588517,269,72,22.45933014354067,11
Category_Wikipedia_sockpuppets_of_Araboud.csv,73,1388159.0,50,23,39,11,0,94.21917808219177,289,30,21.10958904109589,6
Category_Wikipedia_sockpuppets_of_AslamMurmu.csv,171,1382457.0,61,110,51,10,0,43.74269005847953,207,50,13.900584795321638,5
Category_Wikipedia_sockpuppets_of_Brandon03.csv,2501,11846885.0,843,1658,500,343,0,28.860855657736906,200,68,20.329868052778888,3
Category_Wikipedia_sockpuppets_of_Sherwoodoj.csv,34,428393.0,18,16,16,2,0,35.64705882352941,185,24,18.705882352941178,11
Category_Wikipedia_sockpuppets_of_Najaf_ali_bhayo.csv,6249,274160262.0,2205,4044,260,1945,0,49.88766202592415,500,59,15.619459113458154,3
Category_Wikipedia_sockpuppets_of_SwaggyTits23.csv,22,522881.0,20,2,8,12,0,13.727272727272727,128,21,20.227272727272727,20
Category_Wikipedia_sockpuppets_of_Philip_Dunne.csv,7,170642.0,5,2,5,0,0,29.857142857142858,153,17,14.714285714285714,13
Category_Wikipedia_sockpuppets_of_Kashkumar16.csv,531,5268336.0,316,215,234,82,0,30.252354048964218,242,50,13.497175141242938,6
Category_Wikipedia_sockpuppets_of_Artaxiad.csv,7506,26958720.0,2133,5373,500,1633,0,37.02278177458034,246,76,19.66986410871303,1
Category_Wikipedia_sockpuppets_of_IVANDRAGOPETROVICH.csv,72,1831647.0,23,49,22,1,0,36.5,175,53,32.25,17
Category_Wikipedia_sockpuppets_of_JONNY89P.csv,50,598183.0,23,27,10,13,0,43.78,199,18,11.42,8
Category_Wikipedia_sockpuppets_of_Peshkin.csv,125,11219664.0,58,67,20,38,0,44.04,241,38,28.96,16
Category_Wikipedia_sockpuppets_of_Alice_Mudgarden.csv,3580,86766738.0,1000,2580,500,500,0,42.13770949720671,255,79,20.2,3
Category_Wikipedia_sockpuppets_of_Apel_Park..csv,327,7264373.0,95,232,59,36,0,52.293577981651374,438,64,20.201834862385322,6
Category_Wikipedia_sockpuppets_of_1-2-3-4-5-6-7-8-9-urmum.csv,1,0.0,1,0,1,0,20,20.0,20,13,13.0,13
Category_Wikipedia_sockpuppets_of_KaafiThota.csv,329,60528433.0,185,144,99,86,0,27.775075987841944,395,50,19.851063829787233,7
Category_Wikipedia_sockpuppets_of_Peytonweth.csv,369,20762949.0,124,245,52,72,0,44.289972899728994,243,48,23.67208672086721,6
Category_Wikipedia_sockpuppets_of_September_1967.csv,107,2898455.0,30,77,21,9,0,53.13084112149533,241,54,13.757009345794392,4
Category_Wikipedia_sockpuppets_of_MiamiD69.csv,38,7322348.0,17,21,7,10,0,35.78947368421053,221,33,17.92105263157895,8
Category_Wikipedia_sockpuppets_of_KingNothing1234.csv,55,1828619.0,16,39,16,0,0,37.90909090909091,199,29,23.854545454545455,11
Category_Wikipedia_sockpuppets_of_Harrysigma.csv,1140,34309578.0,334,806,94,240,0,49.920175438596495,474,43,15.860526315789473,3
Category_Wikipedia_sockpuppets_of_TrainTown2002.csv,163,17971225.0,75,88,54,21,0,45.61349693251534,254,28,19.34355828220859,10
Category_Wikipedia_sockpuppets_of_CityOfSails.csv,2498,8647624.0,805,1693,500,305,0,54.22938350680545,382,61,19.518014411529222,3
Category_Wikipedia_sockpuppets_of_Rovoam.csv,18,1612967.0,7,11,7,0,0,58.55555555555556,143,24,15.666666666666666,2
Category_Wikipedia_sockpuppets_of_Ferociouslettuce.csv,985,326874368.0,341,644,331,10,0,55.61725888324873,265,55,22.640609137055836,5
Category_Wikipedia_sockpuppets_of_JB196.csv,11022,85788363.0,2929,8093,500,2429,0,36.640537107602974,251,141,20.23870440936309,2
Category_Wikipedia_sockpuppets_of_Leona_campbell.csv,164,18230505.0,41,123,11,30,0,36.40243902439025,233,41,24.121951219512194,9
Category_Wikipedia_sockpuppets_of_Runnerguy.csv,239,27758420.0,89,150,52,37,0,51.57322175732217,206,32,15.138075313807532,5
Category_Wikipedia_sockpuppets_of_Drug_Addicts_Anonymous.csv,140,210159618.0,47,93,27,20,0,52.35,176,71,28.707142857142856,11
Category_Wikipedia_sockpuppets_of_Sajlus.csv,1624,1669619.0,519,1105,500,19,0,46.44211822660098,296,54,16.014162561576356,4
Category_Wikipedia_sockpuppets_of_RUSSIANEMPIREwwone.csv,395,57668222.0,140,255,120,20,0,40.88860759493671,255,43,15.055696202531646,5
Category_Wikipedia_sockpuppets_of_Anup_Rajbanshi.csv,4518,44571491.0,1742,2776,196,1546,0,44.322045152722445,496,73,21.779769809650286,5
Category_Wikipedia_sockpuppets_of_Regional_Hotel_Chain_LLC.csv,2,0.0,1,1,1,0,42,42.0,42,34,34.0,34
Category_Wikipedia_sockpuppets_of_Khanjabir.csv,27,11491190.0,8,19,3,5,0,61.629629629629626,196,41,23.666666666666668,10
Category_Wikipedia_sockpuppets_of_BarryBenson.csv,2274,11653791.0,805,1469,500,305,0,35.150395778364114,253,65,29.638082673702726,6
Category_Wikipedia_sockpuppets_of_Yash_gawli.csv,393,122260058.0,100,293,30,70,0,49.06361323155216,232,45,19.206106870229007,4
Category_Wikipedia_sockpuppets_of_Deef.csv,65,102295301.0,22,43,19,3,0,21.661538461538463,199,50,22.06153846153846,10
Category_Wikipedia_sockpuppets_of_King_rath.csv,236,1552515.0,100,136,49,51,0,31.46186440677966,276,38,24.161016949152543,12
Category_Wikipedia_sockpuppets_of_Trenton_1214.csv,5073,64276900.0,1844,3229,500,1344,0,41.41592745909718,499,75,34.715552927261975,9
Category_Wikipedia_sockpuppets_of_Harubo26.csv,112,150567910.0,26,86,24,2,0,55.973214285714285,245,30,15.9375,8
Category_Wikipedia_sockpuppets_of_Annoimot.csv,49,5538027.0,20,29,11,9,0,33.224489795918366,173,51,19.428571428571427,13
Category_Wikipedia_sockpuppets_of_Rowanis12.csv,801,5373575.0,251,550,204,47,0,43.70536828963795,255,28,18.79525593008739,5
Category_Wikipedia_sockpuppets_of_Luminary69.csv,229,55123768.0,79,150,59,20,0,54.38427947598253,496,38,19.995633187772924,8
Category_Wikipedia_sockpuppets_of_Abdalllah.eiid.csv,1,0.0,1,0,1,0,0,0.0,0,17,17.0,17
Category_Wikipedia_sockpuppets_of_Thenazgullord.csv,44,1364422.0,24,20,14,10,0,58.70454545454545,224,24,9.113636363636363,6
Category_Wikipedia_sockpuppets_of_Disconstantinople.csv,155,455617.0,52,103,30,22,0,65.46451612903226,468,42,20.87741935483871,6
Category_Wikipedia_sockpuppets_of_Ami.bangali.csv,931,67459843.0,276,655,221,55,0,38.91514500537057,255,49,15.455424274973147,4
Category_Wikipedia_sockpuppets_of_Lerabogdan.csv,292,5304929.0,120,172,13,107,0,28.318493150684933,230,46,20.664383561643834,6
Category_Wikipedia_sockpuppets_of_Coder1702.csv,26,1000577.0,18,8,11,7,0,53.61538461538461,164,46,25.46153846153846,9
Category_Wikipedia_sockpuppets_of_Rampo17.csv,47,202018411.0,21,26,14,7,0,52.659574468085104,495,51,16.25531914893617,12
Category_Wikipedia_sockpuppets_of_InternationalCenterForClimate.csv,32,2352949.0,12,20,8,4,0,79.3125,254,25,23.34375,20
Category_Wikipedia_sockpuppets_of_Nikosathens31.csv,34,5786391.0,14,20,7,7,0,32.205882352941174,127,53,35.85294117647059,15
Category_Wikipedia_sockpuppets_of_Krabs502.csv,734,21074575.0,190,544,190,0,0,18.185286103542236,187,62,19.48773841961853,3
Category_Wikipedia_sockpuppets_of_Google_Boys_Arimalam_GBA.csv,784,15702402.0,287,497,43,244,0,41.50127551020408,255,48,16.0140306122449,2
Category_Wikipedia_sockpuppets_of_Jpsorts.csv,2995,102440190.0,904,2091,500,404,0,47.29449081803005,398,89,28.39532554257095,5
Category_Wikipedia_sockpuppets_of_Boblarazzi.csv,39,130680.0,19,20,12,7,0,60.30769230769231,222,21,13.974358974358974,1
Category_Wikipedia_sockpuppets_of_CmdrClow.csv,2077,493418359.0,524,1553,500,24,0,46.740972556571975,319,65,20.610977371208474,5
Category_Wikipedia_sockpuppets_of_Tellyuer1.csv,609,5518953.0,220,389,200,20,0,47.28243021346469,235,65,26.14614121510673,12
Category_Wikipedia_sockpuppets_of_Comictruth.csv,16,975436.0,7,9,5,2,0,81.0,162,31,26.625,26
Category_Wikipedia_sockpuppets_of_Ramskq.csv,172,19537750.0,99,73,30,69,0,43.924418604651166,284,54,16.651162790697676,11
Category_Wikipedia_sockpuppets_of_Ehr1Ros2.csv,3319,337719851.0,957,2362,500,457,0,50.3597469117204,500,85,18.34287435974691,4
Category_Wikipedia_sockpuppets_of_Ronanattili.csv,17,2323960.0,10,7,10,0,0,69.70588235294117,255,47,25.823529411764707,8
Category_Wikipedia_sockpuppets_of_Larrylooneytunes.csv,90,261866.0,24,66,11,13,0,49.05555555555556,250,32,17.61111111111111,10
Category_Wikipedia_sockpuppets_of_–ò–≤–∞–Ω_–¢—Ä—É—Ö–Ω–∏—Ü–∫–∏–π.csv,38,2598348.0,16,22,7,9,0,38.86842105263158,185,30,18.31578947368421,5
Category_Wikipedia_sockpuppets_of_OGreenLockInBlock.csv,13,1074.0,9,4,7,2,0,37.92307692307692,166,28,18.307692307692307,7
Category_Wikipedia_sockpuppets_of_SesameStreetCred.csv,3494,49300146.0,1008,2486,500,508,0,52.6078992558672,508,80,23.179736691471092,3
Category_Wikipedia_sockpuppets_of_Rktect.csv,1920,248324837.0,599,1321,500,99,0,44.14375,246,57,18.836979166666666,4
Category_Wikipedia_sockpuppets_of_The_Determinator.csv,1249,72291311.0,504,745,500,4,0,63.43074459567654,255,78,25.481184947958365,5
Category_Wikipedia_sockpuppets_of_Alia_Raisinghania.csv,298,1328274.0,112,186,89,23,0,31.05704697986577,280,27,13.731543624161073,7
Category_Wikipedia_sockpuppets_of_Jschitt634.csv,40,764935.0,11,29,6,5,0,55.65,194,47,24.75,13
Category_Wikipedia_sockpuppets_of_Dannyabood23.csv,10,354045.0,6,4,3,3,0,67.5,296,13,13.0,13
Category_Wikipedia_sockpuppets_of_Peppermint_Chills.csv,4296,36473075.0,1433,2863,500,933,0,55.75837988826816,250,60,21.390130353817504,1
Category_Wikipedia_sockpuppets_of_Cowboy_Caboose.csv,13,1744.0,6,7,6,0,0,28.692307692307693,84,16,16.0,16
Category_Wikipedia_sockpuppets_of_Aryanshukla9936.csv,128,61913619.0,40,88,17,23,0,47.2265625,240,53,20.6796875,9
Category_Wikipedia_sockpuppets_of_Hzpjxewy.csv,1316,1662880.0,499,817,374,125,0,45.91565349544073,500,58,17.137537993920972,4
Category_Wikipedia_sockpuppets_of_Sh.eshmuradov.csv,48,2166243.0,12,36,8,4,0,63.5625,212,25,11.458333333333334,7
Category_Wikipedia_sockpuppets_of_Deepaknarwal003.csv,56,978136.0,18,38,12,6,0,58.660714285714285,241,53,33.410714285714285,11
Category_Wikipedia_sockpuppets_of_Ram_tx.csv,41,7960888.0,20,21,13,7,0,45.829268292682926,204,47,14.21951219512195,5
Category_Wikipedia_sockpuppets_of_Everedux.csv,2347,48054865.0,728,1619,500,228,0,69.65828717511717,500,57,21.282914358755857,3
Category_Wikipedia_sockpuppets_of_Netabcd123456.csv,23,169214.0,18,5,15,3,0,71.04347826086956,364,29,23.17391304347826,16
Category_Wikipedia_sockpuppets_of_HappyTwoBEE.csv,164,2759195.0,80,84,80,0,0,41.457317073170735,196,47,24.4390243902439,10
Category_Wikipedia_sockpuppets_of_Temperz.csv,20,354362.0,7,13,6,1,0,27.25,123,12,9.7,8
Category_Wikipedia_sockpuppets_of_Siam12367.csv,126,12206708.0,48,78,46,2,0,40.34920634920635,294,32,19.103174603174605,9
Category_Wikipedia_sockpuppets_of_Dimitri_Lokhonia.csv,257,304729769.0,116,141,86,30,0,58.43579766536965,253,56,17.595330739299612,6
Category_Wikipedia_sockpuppets_of_Syed_Hasan_mehdi.csv,80,59965742.0,41,39,33,8,0,48.975,255,63,21.025,13
Category_Wikipedia_sockpuppets_of_Nick_Saunders.csv,143,16845148.0,37,106,15,22,0,36.95804195804196,213,39,17.454545454545453,6
Category_Wikipedia_sockpuppets_of_Letgobig.csv,1,0.0,1,0,1,0,196,196.0,196,23,23.0,23
Category_Wikipedia_sockpuppets_of_Mariamad89.csv,35,1594314.0,14,21,13,1,0,30.514285714285716,191,21,11.514285714285714,9
Category_Wikipedia_sockpuppets_of_INAYAT_KARIM.csv,70,2436773.0,46,24,33,13,0,26.885714285714286,222,22,7.5285714285714285,6
Category_Wikipedia_sockpuppets_of_SouthcottC.csv,1211,37067573.0,510,701,500,10,0,39.76465730800991,322,72,25.41453344343518,6
Category_Wikipedia_sockpuppets_of_Ianfielding.csv,556,10374144.0,208,348,117,91,0,37.33453237410072,252,57,18.595323741007196,7
Category_Wikipedia_sockpuppets_of_Skymhnty.csv,5082,401892912.0,1533,3549,500,1033,0,42.469106650924836,445,78,20.31404958677686,3
Category_Wikipedia_sockpuppets_of_Illumanati_lol.csv,90,707922.0,39,51,37,2,0,34.544444444444444,196,52,17.666666666666668,12
Category_Wikipedia_sockpuppets_of_MCBOB.csv,105,24585251.0,22,83,16,6,0,45.476190476190474,199,32,17.123809523809523,8
Category_Wikipedia_sockpuppets_of_Sherifianhdr.csv,50,5992355.0,25,25,21,4,0,43.48,253,24,16.04,9
Category_Wikipedia_sockpuppets_of_Haratunder.csv,2933,13709354.0,872,2061,500,372,0,46.32628707807705,430,69,24.755199454483463,6
Category_Wikipedia_sockpuppets_of_Sportsnation213.csv,126,47677202.0,33,93,24,9,0,40.904761904761905,253,52,20.72222222222222,2
Category_Wikipedia_sockpuppets_of_Anne_Teedham.csv,3559,37405354.0,1550,2009,500,1050,0,44.7215509974712,254,68,21.67547063781961,6
Category_Wikipedia_sockpuppets_of_Peter_zhou.csv,549,43180695.0,160,389,80,80,0,50.11293260473588,186,34,18.26775956284153,5
"Category_Wikipedia_sockpuppets_of_Wasabi,the,one.csv",2183,49353466.0,751,1432,500,251,0,43.3957856161246,325,83,23.104443426477324,3
Category_Wikipedia_sockpuppets_of_RandoUsername.csv,153,71516470.0,48,105,30,18,0,99.359477124183,500,54,29.470588235294116,13
Category_Wikipedia_sockpuppets_of_DrSandop.csv,48,5888353.0,35,13,28,7,0,65.3125,233,45,20.125,14
Category_Wikipedia_sockpuppets_of_SuperDeng.csv,3879,36674760.0,1026,2853,500,526,0,37.90693477700438,213,57,18.538540861046663,3
Category_Wikipedia_sockpuppets_of_Pnranjith.csv,316,152021338.0,112,204,87,25,0,42.28481012658228,224,42,12.10126582278481,6
Category_Wikipedia_sockpuppets_of_Modern_Fire.csv,1878,22190771.0,605,1273,140,465,0,43.438764643237484,261,48,16.62779552715655,2
Category_Wikipedia_sockpuppets_of_Mathew_Munna.csv,174,1771279.0,77,97,74,3,0,35.5632183908046,231,32,25.10919540229885,17
Category_Wikipedia_sockpuppets_of_JacksonViking.csv,946,254340955.0,301,645,219,82,0,56.676532769556026,314,55,21.607822410147993,7
Category_Wikipedia_sockpuppets_of_Stanleytux.csv,2000,275784248.0,742,1258,500,242,0,51.6445,385,72,20.49,3
Category_Wikipedia_sockpuppets_of_Gatutsi.csv,78,1380107.0,24,54,11,13,0,40.43589743589744,253,27,16.115384615384617,10
Category_Wikipedia_sockpuppets_of_Llelouar.csv,34,40938044.0,16,18,11,5,0,57.26470588235294,221,25,20.41176470588235,13
Category_Wikipedia_sockpuppets_of_Huz_828.csv,360,3343989.0,145,215,145,0,0,34.02777777777778,306,49,32.03888888888889,10
Category_Wikipedia_sockpuppets_of_Maira_ich.csv,38,33268623.0,10,28,7,3,0,43.63157894736842,164,50,19.526315789473685,13
Category_Wikipedia_sockpuppets_of_Trinder1.csv,345,196323987.0,155,190,83,72,0,45.09275362318841,255,44,23.701449275362318,13
Category_Wikipedia_sockpuppets_of_Northwest1202.csv,1247,56613802.0,261,986,106,155,0,41.22293504410585,249,47,24.79791499599038,5
Category_Wikipedia_sockpuppets_of_Happi913.csv,16,72946.0,16,0,12,4,0,2.0,16,21,21.0,21
Category_Wikipedia_sockpuppets_of_Hookeman.csv,61,8527005.0,13,48,5,8,0,50.278688524590166,225,35,15.688524590163935,7
Category_Wikipedia_sockpuppets_of_Xuan98xuan.csv,8,256019.0,4,4,4,0,0,56.375,163,43,37.0,31
Category_Wikipedia_sockpuppets_of_PankhilSen.csv,3487,177549552.0,1253,2234,500,753,0,46.382563808431314,459,49,19.73243475767135,5
Category_Wikipedia_sockpuppets_of_BSanders46.csv,3260,9396598.0,836,2424,399,437,0,78.02730061349693,500,56,21.86196319018405,3
Category_Wikipedia_sockpuppets_of_Bandar_perda.csv,1815,37506202.0,677,1138,500,177,0,38.525619834710746,496,52,17.637465564738292,5
Category_Wikipedia_sockpuppets_of_PositiveEM.csv,2443,55481113.0,842,1601,304,538,0,40.8923454768727,255,53,18.665984445354074,3
Category_Wikipedia_sockpuppets_of_HanselJolteon.csv,294,44712110.0,89,205,47,42,0,56.57823129251701,255,63,15.319727891156463,3
Category_Wikipedia_sockpuppets_of_Puto_servos_fugitivos_esse.csv,17,1146154.0,9,8,9,0,0,30.88235294117647,230,18,18.0,18
Category_Wikipedia_sockpuppets_of_Kauffner.csv,16965,278938143.0,5794,11171,500,5294,0,48.919834954317714,500,90,21.238432066018273,3
Category_Wikipedia_sockpuppets_of_Deathwatch2006.csv,1517,10630692.0,658,859,315,343,0,27.548450889914303,243,51,20.54515491100857,3
Category_Wikipedia_sockpuppets_of_Angelyn.Joanne.csv,67,935469.0,19,48,15,4,0,49.83582089552239,179,29,13.776119402985074,9
Category_Wikipedia_sockpuppets_of_Lucideus15.csv,11,9327349.0,6,5,4,2,0,50.27272727272727,154,10,10.0,10
Category_Wikipedia_sockpuppets_of_Gareth.csv,3268,10643210.0,982,2286,500,482,0,40.508873929008566,406,71,21.886168910648713,3
Category_Wikipedia_sockpuppets_of_Fingerswet.csv,6,1979684.0,4,2,2,2,0,104.33333333333333,200,15,15.0,15
Category_Wikipedia_sockpuppets_of_Agnelvishal.csv,279,201581017.0,58,221,58,0,0,65.63082437275986,283,56,18.64516129032258,5
Category_Wikipedia_sockpuppets_of_Ivo_mark_1.csv,194,9695401.0,51,143,14,37,0,68.11855670103093,220,37,20.036082474226806,8
Category_Wikipedia_sockpuppets_of_Zangyapsong.csv,370,18846368.0,120,250,69,51,0,48.20810810810811,371,39,17.135135135135137,6
Category_Wikipedia_sockpuppets_of_Aild1996.csv,15,26936435.0,5,10,3,2,0,44.2,197,23,15.2,6
Category_Wikipedia_sockpuppets_of_Iamseba.csv,1399,154958030.0,532,867,500,32,0,35.515368120085775,255,46,20.2566118656183,4
Category_Wikipedia_sockpuppets_of_Jackson883941.csv,542,37213598.0,166,376,108,58,0,68.24354243542436,466,61,23.081180811808117,5
Category_Wikipedia_sockpuppets_of_RGayboy.csv,7,72701.0,4,3,2,2,0,55.42857142857143,137,41,41.0,41
Category_Wikipedia_sockpuppets_of_TZ56060.csv,1099,156127507.0,426,673,426,0,0,28.820746132848043,409,70,16.010919017288444,5
Category_Wikipedia_sockpuppets_of_Dmonda.csv,613,331257800.0,263,350,67,196,0,42.49592169657423,376,87,28.420880913539968,4
Category_Wikipedia_sockpuppets_of_Richeaglenoble.csv,210,2025198.0,87,123,71,16,0,54.37619047619047,255,47,18.514285714285716,8
Category_Wikipedia_sockpuppets_of_General_Waste.csv,37,7279666.0,18,19,13,5,0,24.62162162162162,96,35,23.89189189189189,10
Category_Wikipedia_sockpuppets_of_Marthaerin1888.csv,2706,26970419.0,1021,1685,296,725,0,41.374353288987436,224,52,18.594235033259423,3
Category_Wikipedia_sockpuppets_of_Londo06.csv,7069,60746796.0,2369,4700,500,1869,0,38.200311217994056,252,66,18.258876785966898,6
Category_Wikipedia_sockpuppets_of_EntertainmentWatchdog.csv,164,62383785.0,64,100,62,2,0,62.798780487804876,496,54,19.609756097560975,8
Category_Wikipedia_sockpuppets_of_Cleo22.csv,361,70849797.0,109,252,100,9,0,29.257617728531855,206,26,11.66759002770083,6
Category_Wikipedia_sockpuppets_of_ASEOR2.csv,508,21375732.0,173,335,170,3,0,47.91338582677165,204,46,14.210629921259843,5
Category_Wikipedia_sockpuppets_of_Darkest-Link33.csv,226,1247551.0,89,137,39,50,0,51.26106194690266,213,57,45.63274336283186,17
Category_Wikipedia_sockpuppets_of_Duffycharles.csv,200,195381048.0,61,139,61,0,0,46.29,225,46,23.415,3
Category_Wikipedia_sockpuppets_of_BeaglePower.csv,998,103771571.0,385,613,161,224,0,53.31963927855711,288,68,17.475951903807616,4
Category_Wikipedia_sockpuppets_of_Volcom2015.csv,33,104296318.0,12,21,10,2,0,76.0909090909091,462,47,27.696969696969695,18
Category_Wikipedia_sockpuppets_of_Nicolas42155.csv,14,10288597.0,10,4,10,0,0,36.0,172,31,21.571428571428573,17
Category_Wikipedia_sockpuppets_of_Philp_the_Moose.csv,171,2917490.0,36,135,18,18,0,29.146198830409357,179,32,15.970760233918128,3
Category_Wikipedia_sockpuppets_of_Chanpara.csv,83,158923.0,56,27,44,12,0,40.674698795180724,499,53,29.57831325301205,13
Category_Wikipedia_sockpuppets_of_Hallerworld.csv,2772,211574695.0,804,1968,149,655,0,39.7994227994228,310,55,20.632756132756132,4
Category_Wikipedia_sockpuppets_of_SuperTroll69.csv,8,1213.0,6,2,6,0,7,40.0,192,13,11.625,11
Category_Wikipedia_sockpuppets_of_Fixmark2.csv,91,17511609.0,38,53,34,4,0,28.54945054945055,253,27,15.505494505494505,4
Category_Wikipedia_sockpuppets_of_George_Elokobi.csv,175,334410.0,64,111,10,54,0,48.22857142857143,210,54,31.897142857142857,10
Category_Wikipedia_sockpuppets_of_Iamobjective.csv,51,200107.0,17,34,13,4,0,72.50980392156863,234,48,15.03921568627451,3
Category_Wikipedia_sockpuppets_of_Femmina.csv,1524,264474008.0,504,1020,500,4,0,42.99015748031496,253,83,20.560367454068242,4
Category_Wikipedia_sockpuppets_of_OCsmileyeiiiiiiieeeedcxxxc.csv,1056,2148149.0,749,307,293,456,0,26.144886363636363,224,62,33.160037878787875,10
Category_Wikipedia_sockpuppets_of_Trumpkin.csv,1501,156241278.0,441,1060,244,197,0,44.25716189207195,250,66,23.675549633577614,4
Category_Wikipedia_sockpuppets_of_Spud1002016.csv,4083,200053970.0,1194,2889,500,694,0,44.65956404604457,496,76,18.83908890521675,3
Category_Wikipedia_sockpuppets_of_BadBeast.OFF.csv,1165,4790735.0,455,710,411,44,0,33.35364806866953,496,37,16.349356223175967,6
Category_Wikipedia_sockpuppets_of_Pro-Lick.csv,3007,89163891.0,873,2134,500,373,0,50.59328234120386,226,63,19.085467243099433,4
Category_Wikipedia_sockpuppets_of_DrJoseV.csv,444,54321308.0,100,344,57,43,0,71.22747747747748,496,26,12.932432432432432,4
Category_Wikipedia_sockpuppets_of_Tranpdonard.csv,321,26357720.0,147,174,68,79,0,57.99065420560748,496,30,18.978193146417446,5
Category_Wikipedia_sockpuppets_of_HilalAouam.csv,1967,123968135.0,583,1384,500,83,0,43.38840874428063,500,65,17.51906456532791,4
Category_Wikipedia_sockpuppets_of_DA_AWESOME_BOI.csv,545,34141349.0,185,360,162,23,0,42.56697247706422,245,75,26.08256880733945,7
Category_Wikipedia_sockpuppets_of_Morningtv13.csv,398,11822809.0,163,235,107,56,0,61.53266331658291,255,54,28.507537688442213,6
Category_Wikipedia_sockpuppets_of_Fafszilla.csv,76,24470771.0,34,42,33,1,0,38.85526315789474,204,45,19.19736842105263,12
Category_Wikipedia_sockpuppets_of_Asharidu.csv,4185,366924199.0,1098,3087,500,598,0,47.229390681003586,255,74,17.801911589008363,3
Category_Wikipedia_sockpuppets_of_Noonien_Soong.csv,593,2759829.0,262,331,62,200,0,49.92580101180438,216,37,16.715008431703204,5
Category_Wikipedia_sockpuppets_of_Marcelo842.csv,1774,36544687.0,617,1157,235,382,0,40.159526493799326,515,92,22.73055242390079,4
Category_Wikipedia_sockpuppets_of_Aucaman.csv,1697,21852290.0,520,1177,500,20,0,35.461402474955804,200,91,19.463170300530347,4
Category_Wikipedia_sockpuppets_of_Mohombi_Nzasi_Moupondo.csv,200,642754.0,56,144,35,21,0,63.265,255,47,23.655,3
Category_Wikipedia_sockpuppets_of_Nileshradiancevision.csv,286,2411848.0,109,177,9,100,0,46.43006993006993,244,44,16.821678321678323,5
Category_Wikipedia_sockpuppets_of_Bluesman2001.csv,197,17118616.0,58,139,38,20,0,33.786802030456855,242,36,16.13705583756345,9
Category_Wikipedia_sockpuppets_of_MilanVuko1.csv,236,6227734.0,77,159,33,44,0,76.73728813559322,363,40,17.758474576271187,3
Category_Wikipedia_sockpuppets_of_Waterjuice.csv,1734,34427483.0,445,1289,427,18,0,56.798731257208765,250,84,17.798154555940023,4
Category_Wikipedia_sockpuppets_of_Nirmal_kumar_1991.csv,299,34027198.0,95,204,93,2,0,48.96321070234114,251,48,21.040133779264213,6
Category_Wikipedia_sockpuppets_of_Krzyzowiec.csv,1712,161421563.0,531,1181,500,31,0,51.3802570093458,250,72,22.622079439252335,6
Category_Wikipedia_sockpuppets_of_Whodatttt.csv,909,29455424.0,220,689,168,52,0,66.36193619361936,500,52,14.807480748074807,4
Category_Wikipedia_sockpuppets_of_Bostbart.csv,453,70510534.0,92,361,70,22,0,48.675496688741724,207,37,16.600441501103752,9
Category_Wikipedia_sockpuppets_of_Langesam1234.csv,78,7861070.0,21,57,13,8,0,33.44871794871795,228,41,16.17948717948718,9
Category_Wikipedia_sockpuppets_of_Melody_Federer.csv,2,0.0,1,1,1,0,47,47.0,47,24,24.0,24
Category_Wikipedia_sockpuppets_of_Zare_.csv,59,15725565.0,29,30,29,0,0,29.508474576271187,144,24,14.711864406779661,7
Category_Wikipedia_sockpuppets_of_Seekthetruth-weigh_the_benefits_and_risks.csv,221,107050901.0,69,152,38,31,0,66.63800904977376,389,53,26.488687782805428,9
Category_Wikipedia_sockpuppets_of_Mariocipoletti.csv,696,134342923.0,167,529,130,37,0,41.05890804597701,255,57,20.158045977011493,5
Category_Wikipedia_sockpuppets_of_Contributor00001.csv,115,2414308.0,40,75,33,7,0,57.573913043478264,249,44,22.921739130434784,11
Category_Wikipedia_sockpuppets_of_Raniagitta.csv,10,79529.0,4,6,4,0,0,40.4,133,31,14.8,6
Category_Wikipedia_sockpuppets_of_Narniawang.csv,251,490406.0,55,196,14,41,0,41.98406374501992,255,34,12.872509960159363,2
Category_Wikipedia_sockpuppets_of_Robertsteadman.csv,1692,70754557.0,503,1189,500,3,0,33.319148936170215,202,71,19.14657210401891,2
Category_Wikipedia_sockpuppets_of_WorknoiseAlbania.csv,884,11562863.0,287,597,42,245,0,33.633484162895925,248,67,19.537330316742082,4
Category_Wikipedia_sockpuppets_of_Skhandelwal0608.csv,423,86258867.0,143,280,121,22,0,40.931442080378254,339,43,21.88179669030733,7
Category_Wikipedia_sockpuppets_of_Ptrainor.csv,33,294160.0,13,20,9,4,0,44.24242424242424,217,51,30.696969696969695,13
Category_Wikipedia_sockpuppets_of_Andy.w.sparks.csv,1982,150504728.0,729,1253,453,276,0,34.30827447023209,261,61,21.197780020181636,5
Category_Wikipedia_sockpuppets_of_DesiKindInMahMind.csv,137,96535715.0,50,87,43,7,0,48.22627737226277,252,29,8.087591240875913,4
Category_Wikipedia_sockpuppets_of_AnggaPrat24.csv,377,13480455.0,118,259,36,82,0,56.83289124668435,300,41,15.60212201591512,6
Category_Wikipedia_sockpuppets_of_Amandamarionsequeira.csv,75,5871937.0,38,37,16,22,0,33.373333333333335,232,34,13.2,8
Category_Wikipedia_sockpuppets_of_Akbar_Bhuniya.csv,62,39802324.0,23,39,13,10,0,58.516129032258064,248,72,25.661290322580644,8
Category_Wikipedia_sockpuppets_of_BabyWhale.csv,20,67719.0,8,12,7,1,0,38.65,79,53,34.5,14
Category_Wikipedia_sockpuppets_of_Squidward674.csv,377,1815276.0,201,176,200,1,0,34.84880636604775,251,46,25.79840848806366,11
Category_Wikipedia_sockpuppets_of_Stubes99.csv,19423,496670359.0,6042,13381,500,5542,0,50.167636307470524,688,56,18.018225814755702,4
Category_Wikipedia_sockpuppets_of_D4rkeRR9.csv,5363,61261682.0,1607,3756,500,1107,0,57.33600596680962,496,97,21.940331903785196,3
Category_Wikipedia_sockpuppets_of_Shane1261994.csv,328,405727356.0,107,221,102,5,0,48.2530487804878,233,46,20.228658536585368,6
Category_Wikipedia_sockpuppets_of_AmlanDas.csv,623,44212066.0,286,337,200,86,0,42.66131621187801,255,47,14.492776886035314,7
Category_Wikipedia_sockpuppets_of_Finderskey.csv,357,63511242.0,140,217,75,65,0,31.476190476190474,250,45,15.680672268907562,8
Category_Wikipedia_sockpuppets_of_Hot_JJ.csv,464,684726.0,113,351,15,98,0,35.72198275862069,200,40,32.678879310344826,11
Category_Wikipedia_sockpuppets_of_Xxnlndkqweh123athorz.csv,3,61.0,2,1,2,0,28,61.333333333333336,78,27,27.0,27
Category_Wikipedia_sockpuppets_of_PatsOwn117.csv,211,11863736.0,74,137,60,14,0,48.70616113744076,244,45,21.127962085308056,4
Category_Wikipedia_sockpuppets_of_Freetibet84.csv,544,2220017.0,148,396,120,28,0,53.716911764705884,226,65,21.71875,3
Category_Wikipedia_sockpuppets_of_Larry_Lawrence.csv,1035,21682484.0,243,792,107,136,0,34.82415458937198,253,46,13.420289855072463,3
Category_Wikipedia_sockpuppets_of_RestoreTheEmpireSociety.csv,187,3616550.0,62,125,61,1,0,43.79679144385027,193,47,21.668449197860962,5
Category_Wikipedia_sockpuppets_of_Madden_NFL_21.csv,733,127199967.0,210,523,60,150,0,56.41473396998636,224,38,17.15825375170532,1
Category_Wikipedia_sockpuppets_of_Danglc.csv,84,222600875.0,18,66,15,3,0,71.10714285714286,233,16,3.630952380952381,3
Category_Wikipedia_sockpuppets_of_FallandSpringOlympics.csv,5323,58991627.0,1697,3626,500,1197,0,34.306781889911704,255,75,24.71764042832989,4
Category_Wikipedia_sockpuppets_of_Masu7.csv,1770,122134344.0,670,1100,500,170,0,52.97457627118644,257,56,24.158757062146893,9
Category_Wikipedia_sockpuppets_of_Arpierson1993.csv,2408,10876717.0,654,1754,164,490,0,38.16486710963455,221,78,15.148671096345515,2
Category_Wikipedia_sockpuppets_of_Boobom.csv,26,4159976.0,6,20,3,3,0,47.65384615384615,226,29,23.26923076923077,18
Category_Wikipedia_sockpuppets_of_Mdanman2.csv,291,148504621.0,83,208,37,46,0,53.24054982817869,298,37,18.34020618556701,10
Category_Wikipedia_sockpuppets_of_Sirat.wiki.csv,46,4096787.0,35,11,34,1,0,15.804347826086957,196,20,18.23913043478261,12
Category_Wikipedia_sockpuppets_of_Noda297.csv,19,45309.0,14,5,9,5,12,55.73684210526316,151,20,17.157894736842106,12
Category_Wikipedia_sockpuppets_of_Shiaryuhuhu.csv,145,24939055.0,45,100,37,8,0,55.97241379310345,250,65,20.648275862068967,4
Category_Wikipedia_sockpuppets_of_CloudFarr3r.csv,4093,42834270.0,1799,2294,500,1299,0,49.81285120938187,496,72,22.402882970925972,4
Category_Wikipedia_sockpuppets_of_Szdxfcgvhyjul.csv,5,365.0,2,3,2,0,0,64.2,189,8,6.8,6
Category_Wikipedia_sockpuppets_of_Beefyted69.csv,166,2114043.0,51,115,14,37,0,60.0722891566265,238,54,20.662650602409638,10
Category_Wikipedia_sockpuppets_of_Brad_Lambert.csv,12,58666.0,5,7,3,2,0,22.916666666666668,116,53,41.416666666666664,17
Category_Wikipedia_sockpuppets_of_McClellandRA.csv,712,6401053.0,310,402,301,9,0,39.73876404494382,249,42,8.933988764044944,4
Category_Wikipedia_sockpuppets_of_Jonaxgold.csv,1002,27399322.0,521,481,396,125,0,32.12375249500998,239,55,18.0249500998004,4
Category_Wikipedia_sockpuppets_of_AnnieKalou.csv,196,4324369.0,87,109,77,10,0,51.535714285714285,201,51,33.4030612244898,12
Category_Wikipedia_sockpuppets_of_Jimdavies2012.csv,6,177728.0,4,2,3,1,0,46.0,138,9,9.0,9
Category_Wikipedia_sockpuppets_of_Star-in-law.csv,79,1019325.0,33,46,27,6,0,37.64556962025316,205,37,18.303797468354432,10
Category_Wikipedia_sockpuppets_of_Nana222222.csv,1636,165475129.0,638,998,500,138,0,42.941931540342296,496,65,17.594132029339853,3
Category_Wikipedia_sockpuppets_of_Justason.csv,66,1243359.0,32,34,18,14,0,46.95454545454545,225,38,31.303030303030305,19
Category_Wikipedia_sockpuppets_of_DanFlippingDoherty.csv,178,610215.0,110,68,39,71,0,82.20224719101124,255,40,29.471910112359552,4
Category_Wikipedia_sockpuppets_of_Malieek.csv,17,91194.0,6,11,2,4,0,49.588235294117645,152,32,16.58823529411765,8
Category_Wikipedia_sockpuppets_of_Encyclopedist.csv,2105,108391102.0,705,1400,500,205,0,38.36294536817102,246,221,26.723990498812352,3
Category_Wikipedia_sockpuppets_of_TwoHorned.csv,2865,170800913.0,1020,1845,500,520,0,52.624432809773126,255,58,18.038743455497382,5
Category_Wikipedia_sockpuppets_of_Look4light.csv,529,161223503.0,195,334,168,27,0,52.455576559546316,255,51,18.446124763705104,6
Category_Wikipedia_sockpuppets_of_YuShuoxin.csv,19,357369.0,17,2,10,7,13,27.0,66,7,7.0,7
Category_Wikipedia_sockpuppets_of_–Ø—Ä–æ—Å–ª–∞–≤_–¢—Ä—É—Ö–∏–Ω.csv,370,58389477.0,110,260,78,32,0,42.810810810810814,255,37,21.1,8
Category_Wikipedia_sockpuppets_of_Howzzat1.csv,8,174641.0,2,6,1,1,0,66.0,138,18,10.5,8
Category_Wikipedia_sockpuppets_of_Che_burger_1.csv,124,9908047.0,31,93,17,14,0,60.475806451612904,232,47,24.120967741935484,6
Category_Wikipedia_sockpuppets_of_Daniel_Tee_2010.csv,654,10204634.0,159,495,37,122,0,38.98776758409786,220,42,18.75840978593272,5
Category_Wikipedia_sockpuppets_of_JoseUlloor.csv,42,23143588.0,28,14,28,0,0,19.88095238095238,178,12,9.761904761904763,6
Category_Wikipedia_sockpuppets_of_Biomimix.csv,114,23072520.0,75,39,37,38,0,40.42982456140351,167,23,22.605263157894736,18
Category_Wikipedia_sockpuppets_of_Labonce2021.csv,15,73767.0,13,2,8,5,0,11.0,151,13,13.0,13
Category_Wikipedia_sockpuppets_of_ExRockx08.csv,49,2765052.0,24,25,17,7,0,50.142857142857146,210,29,17.367346938775512,8
Category_Wikipedia_sockpuppets_of_Birgitfaa.csv,50,2502430.0,43,7,15,28,0,41.3,164,30,17.58,16
Category_Wikipedia_sockpuppets_of_PalestineRemembered.csv,5265,143549990.0,1622,3643,500,1122,0,46.32649572649573,250,82,23.795821462488128,2
Category_Wikipedia_sockpuppets_of_Fabish_Boaitey.csv,2326,15761447.0,662,1664,500,162,0,33.27644024075666,250,43,13.50816852966466,3
Category_Wikipedia_sockpuppets_of_Jeffreythe1st.csv,71,1049381.0,60,11,29,31,0,9.140845070422536,117,23,12.704225352112676,11
Category_Wikipedia_sockpuppets_of_SiphoB.csv,79,133444796.0,17,62,10,7,0,62.64556962025316,214,54,34.77215189873418,19
Category_Wikipedia_sockpuppets_of_Bhtpbank.csv,3180,89180210.0,1118,2062,500,618,0,50.19119496855346,255,82,27.719811320754715,4
Category_Wikipedia_sockpuppets_of_Judy_P._Bush.csv,223,16148952.0,101,122,31,70,0,54.83408071748879,255,87,23.201793721973093,12
Category_Wikipedia_sockpuppets_of_PrivateMasterHD.csv,7588,68420608.0,1771,5817,500,1271,0,43.8962836056932,255,62,16.809699525566685,3
Category_Wikipedia_sockpuppets_of_Duckgo111.csv,31,225715563.0,7,24,4,3,0,61.38709677419355,242,56,18.967741935483872,9
Category_Wikipedia_sockpuppets_of_Rub√©n_Mar.csv,792,65837130.0,320,472,299,21,0,52.77651515151515,245,73,28.717171717171716,5
Category_Wikipedia_sockpuppets_of_ABDEVILLIERS0007.csv,552,8884879.0,184,368,117,67,0,62.08876811594203,241,78,18.36231884057971,7
Category_Wikipedia_sockpuppets_of_Islimfit.csv,116,25890613.0,29,87,24,5,0,52.189655172413794,226,53,33.14655172413793,11
Category_Wikipedia_sockpuppets_of_Bharatiyamohit.csv,6,891364.0,2,4,1,1,21,45.333333333333336,62,24,16.666666666666668,13
Category_Wikipedia_sockpuppets_of_Pojitibu.csv,259,21466006.0,91,168,59,32,0,55.62162162162162,271,31,18.49034749034749,5
Category_Wikipedia_sockpuppets_of_Goalguy222.csv,5,697.0,4,1,2,2,12,25.4,71,25,17.0,5
Category_Wikipedia_sockpuppets_of_Ejikela.csv,1656,44811947.0,571,1085,500,71,0,41.11171497584541,482,63,13.717995169082126,3
Category_Wikipedia_sockpuppets_of_Dravenfrost1.csv,7,85963.0,5,2,4,1,0,88.28571428571429,196,26,22.0,16
Category_Wikipedia_sockpuppets_of_CL90CHI.csv,12,1659481.0,10,2,9,1,0,48.083333333333336,183,17,17.0,17
Category_Wikipedia_sockpuppets_of_Martin_Koolhoven.csv,796,475817592.0,241,555,115,126,0,43.12311557788945,298,43,20.81281407035176,7
Category_Wikipedia_sockpuppets_of_Finalpoint.csv,217,275510.0,50,167,23,27,0,57.49308755760369,254,51,14.175115207373272,3
Category_Wikipedia_sockpuppets_of_Kjc21793.csv,74,3573218.0,30,44,23,7,0,41.36486486486486,185,32,16.743243243243242,9
Category_Wikipedia_sockpuppets_of_Techwriter2B.csv,2447,31196354.0,731,1716,500,231,0,51.40416836943196,238,67,20.529628116060483,4
Category_Wikipedia_sockpuppets_of_Abhishek9779.csv,1132,27911001.0,364,768,174,190,0,59.83922261484099,349,63,23.780918727915193,7
Category_Wikipedia_sockpuppets_of_The_consultant_who_had_previously.csv,90,96324.0,31,59,22,9,0,47.666666666666664,220,59,27.466666666666665,7
Category_Wikipedia_sockpuppets_of_Rushil_Dilawar_Ibrahim_kaskar.csv,59,238668.0,33,26,16,17,0,63.50847457627118,255,39,14.694915254237289,9
Category_Wikipedia_sockpuppets_of_Katch_Pole_Piker.csv,107,9537871.0,32,75,26,6,0,38.00934579439252,192,47,20.16822429906542,6
Category_Wikipedia_sockpuppets_of_Apriljackson.csv,799,18919868.0,212,587,174,38,0,28.737171464330412,255,37,17.15894868585732,7
Category_Wikipedia_sockpuppets_of_Uncheo.csv,10,695966.0,8,2,6,2,0,55.4,99,15,12.5,10
Category_Wikipedia_sockpuppets_of_Dedy_Tisna_Amijaya.csv,319,36118906.0,132,187,31,101,0,61.28526645768025,367,37,15.184952978056426,5
Category_Wikipedia_sockpuppets_of_Truthteller42069.csv,15,1813.0,9,6,6,3,0,34.46666666666667,125,27,22.0,19
Category_Wikipedia_sockpuppets_of_Soriv.csv,1,0.0,1,0,1,0,0,0.0,0,15,15.0,15
Category_Wikipedia_sockpuppets_of_Bdemenil.csv,1000,580932411.0,263,737,194,69,0,51.9,316,45,16.408,5
Category_Wikipedia_sockpuppets_of_Cyber_Warrior.csv,775,3618785.0,249,526,183,66,0,39.68516129032258,255,56,18.628387096774194,5
Category_Wikipedia_sockpuppets_of_Valery_Surkoff.csv,201,990111.0,85,116,83,2,0,39.81592039800995,255,50,32.81094527363184,18
Category_Wikipedia_sockpuppets_of_Christinam.csv,1822,5549029.0,456,1366,207,249,0,40.823271130625685,239,73,15.88913282107574,4
Category_Wikipedia_sockpuppets_of_Giovannigiulio.csv,4164,100760418.0,1032,3132,500,532,0,38.37968299711815,255,78,20.78962536023055,4
Category_Wikipedia_sockpuppets_of_Trittya_Yelane.csv,20,35186548.0,10,10,9,1,0,50.25,135,23,20.75,18
Category_Wikipedia_sockpuppets_of_GTNO6.csv,1372,24095180.0,389,983,348,41,0,64.44825072886297,496,88,21.126822157434404,4
Category_Wikipedia_sockpuppets_of_Villagethings.csv,976,47245982.0,329,647,160,169,0,52.21311475409836,419,56,16.414959016393443,4
Category_Wikipedia_sockpuppets_of_Truthfortruth.csv,28,2045034.0,10,18,4,6,0,78.78571428571429,217,19,14.464285714285714,11
Category_Wikipedia_sockpuppets_of_Fran3klin_Doy4le.csv,885,20840969.0,261,624,125,136,0,52.563841807909604,254,85,20.93220338983051,4
Category_Wikipedia_sockpuppets_of_Sadaan_Shah.csv,31,92779809.0,10,21,10,0,0,62.483870967741936,196,54,21.838709677419356,10
Category_Wikipedia_sockpuppets_of_Christiankkk.csv,117,2353739.0,112,5,85,27,0,11.341880341880342,196,11,11.0,11
Category_Wikipedia_sockpuppets_of_Boaznb.csv,310,626966.0,92,218,44,48,0,46.483870967741936,197,45,16.870967741935484,5
Category_Wikipedia_sockpuppets_of_MichaelCastaneda721.csv,85,5502526.0,28,57,12,16,0,40.705882352941174,175,46,26.50588235294118,4
Category_Wikipedia_sockpuppets_of_Raphael1256.csv,2577,166915144.0,617,1960,500,117,0,43.3546759798215,357,53,14.006208769887467,2
Category_Wikipedia_sockpuppets_of_Bzazaian11.csv,256,7051902.0,100,156,94,6,0,47.75390625,255,58,21.3671875,6
Category_Wikipedia_sockpuppets_of_Fegtret.csv,34,1224510.0,12,22,9,3,0,23.88235294117647,116,30,27.88235294117647,12
Category_Wikipedia_sockpuppets_of_Monarawila.csv,5050,255100097.0,1688,3362,500,1188,0,44.02356435643564,263,57,19.873465346534655,6
Category_Wikipedia_sockpuppets_of_Derman85.csv,69,484587.0,15,54,15,0,0,32.05797101449275,179,32,15.376811594202898,5
Category_Wikipedia_sockpuppets_of_Kuqak.csv,151,125093096.0,57,94,33,24,0,30.986754966887418,196,46,29.960264900662253,9
Category_Wikipedia_sockpuppets_of_The_Terminator_is_better_than_you.csv,41,1211015.0,12,29,10,2,0,69.4390243902439,236,44,16.926829268292682,8
Category_Wikipedia_sockpuppets_of_Jeanratelle.csv,377,64557472.0,113,264,31,82,0,53.40318302387268,246,50,10.962864721485412,4
Category_Wikipedia_sockpuppets_of_Bobabobabo.csv,7243,62138410.0,2139,5104,500,1639,0,32.40328593124396,254,76,23.157807538312852,3
Category_Wikipedia_sockpuppets_of_Dylan37.csv,828,14216626.0,278,550,96,182,0,40.40700483091788,247,45,18.55072463768116,4
Category_Wikipedia_sockpuppets_of_OohLaBeLaBeLa.csv,1,0.0,1,0,1,0,0,0.0,0,14,14.0,14
Category_Wikipedia_sockpuppets_of_Shubham_Dongare.csv,51,13049394.0,30,21,25,5,0,30.45098039215686,207,25,14.705882352941176,5
Category_Wikipedia_sockpuppets_of_Andrewzimney.csv,16,330165.0,10,6,6,4,0,26.75,145,12,12.0,12
Category_Wikipedia_sockpuppets_of_Information_Masters.csv,57,309066.0,22,35,11,11,0,56.94736842105263,259,19,16.94736842105263,12
Category_Wikipedia_sockpuppets_of_Elizabethhope89.csv,631,125381890.0,257,374,54,203,0,56.38034865293186,496,45,19.851030110935024,6
Category_Wikipedia_sockpuppets_of_87rohit.sharma.csv,386,241068307.0,107,279,79,28,0,57.20984455958549,259,31,17.033678756476682,8
Category_Wikipedia_sockpuppets_of_Sparhelt.csv,590,102639641.0,169,421,41,128,0,58.052542372881355,298,65,21.559322033898304,3
Category_Wikipedia_sockpuppets_of_Raph_kid.csv,110,28201908.0,29,81,15,14,0,54.29090909090909,257,53,14.363636363636363,5
Category_Wikipedia_sockpuppets_of_Mhazard9.csv,4367,286884489.0,1500,2867,500,1000,0,64.91023585985802,448,53,16.704831692237235,3
Category_Wikipedia_sockpuppets_of_Reallygoodeditor.csv,17,70256.0,14,3,10,4,0,35.11764705882353,140,8,8.0,8
Category_Wikipedia_sockpuppets_of_Osvaldo_Valdes_Lopez.csv,1518,272759455.0,870,648,500,370,0,32.66205533596838,500,49,18.634387351778656,6
Category_Wikipedia_sockpuppets_of_DevourerOfBooks.csv,20,682696.0,12,8,8,4,0,85.4,187,34,34.0,34
Category_Wikipedia_sockpuppets_of_Ramiro_Helmeyer.csv,10,613869.0,5,5,2,3,11,42.2,178,29,29.0,29
Category_Wikipedia_sockpuppets_of_Deltadealer.csv,5,174883.0,3,2,2,1,0,77.0,148,6,6.0,6
Category_Wikipedia_sockpuppets_of_Nintenchris5963.csv,584,70360885.0,180,404,166,14,0,40.31678082191781,247,48,20.518835616438356,5
Category_Wikipedia_sockpuppets_of_InellectualThinker.csv,666,6755522.0,188,478,160,28,0,63.96546546546546,473,44,23.906906906906908,4
Category_Wikipedia_sockpuppets_of_URBAN_MEDIA_INC..csv,89,440786.0,60,29,34,26,0,7.359550561797753,119,26,8.325842696629213,4
Category_Wikipedia_sockpuppets_of_Rajiv_Khanna44.csv,44,19902472.0,15,29,9,6,0,56.09090909090909,176,19,12.204545454545455,7
Category_Wikipedia_sockpuppets_of_Deeptrivia.csv,3319,494063940.0,679,2640,500,179,0,50.205483579391384,329,62,17.23350406749021,1
Category_Wikipedia_sockpuppets_of_Salmaemadfared.csv,10,1805808.0,6,4,5,1,0,44.7,128,15,15.0,15
Category_Wikipedia_sockpuppets_of_Cowboycaleb1.csv,5576,167473864.0,1392,4184,500,892,0,41.28461262553802,255,83,20.914634146341463,3
Category_Wikipedia_sockpuppets_of_Wittgenstein123.csv,757,51298249.0,201,556,145,56,0,59.689564068692206,259,59,15.093791281373845,4
Category_Wikipedia_sockpuppets_of_Rodolfootoya12.csv,2481,360243814.0,558,1923,76,482,0,40.104393389762194,440,59,19.640467553405884,5
Category_Wikipedia_sockpuppets_of_Sonderbro.csv,4312,205649820.0,943,3369,330,613,0,46.0071892393321,255,83,15.704545454545455,3
Category_Wikipedia_sockpuppets_of_SuperExtra446.csv,22,1093784.0,11,11,2,9,0,62.04545454545455,219,10,7.2727272727272725,4
Category_Wikipedia_sockpuppets_of_Mjo0414.csv,155,17375770.0,72,83,50,22,0,60.883870967741935,500,57,20.258064516129032,5
Category_Wikipedia_sockpuppets_of_Kankor123.csv,27,78503638.0,6,21,3,3,0,32.592592592592595,126,33,27.25925925925926,18
Category_Wikipedia_sockpuppets_of_Sandeep_kumar7676.csv,86,6049525.0,39,47,7,32,0,44.895348837209305,253,33,12.837209302325581,8
Category_Wikipedia_sockpuppets_of_K-bomb260.csv,228,34890718.0,76,152,37,39,0,39.10526315789474,199,41,20.728070175438596,5
Category_Wikipedia_sockpuppets_of_MaikoltheGangale.csv,1995,103546214.0,824,1171,223,601,0,44.608521303258144,475,51,18.936340852130325,4
Category_Wikipedia_sockpuppets_of_Ÿæÿßÿ±ÿ≥ÿß_ÿ¢ŸÖŸÑ€å.csv,15080,355546946.0,5377,9703,500,4877,0,34.66724137931035,438,77,21.131962864721487,3
Category_Wikipedia_sockpuppets_of_Palringowiki.csv,21,353308.0,13,8,5,8,0,50.142857142857146,124,20,15.952380952380953,15
Category_Wikipedia_sockpuppets_of_F6Coloratura80.csv,1031,18922824.0,381,650,212,169,0,54.322017458777886,239,36,12.736178467507274,7
Category_Wikipedia_sockpuppets_of_Jayleecincinnati.csv,309,58597175.0,109,200,87,22,0,56.92556634304207,499,35,21.80906148867314,11
Category_Wikipedia_sockpuppets_of_AHEJJWILEMAMALIDGED.csv,288,6506936.0,138,150,133,5,0,42.47222222222222,338,46,29.04861111111111,9
Category_Wikipedia_sockpuppets_of_LordStarscream100.csv,1146,77079791.0,370,776,293,77,0,45.50610820244328,252,65,28.7478184991274,7
Category_Wikipedia_sockpuppets_of_Pitarobertz.csv,1104,357433757.0,374,730,374,0,0,38.453804347826086,395,55,15.516304347826088,5
Category_Wikipedia_sockpuppets_of_Bubblegumcrunch.csv,162,3481175.0,90,72,77,13,0,40.53086419753087,247,46,35.45679012345679,17
Category_Wikipedia_sockpuppets_of_AARSOMEONE.csv,164,2319624.0,56,108,27,29,0,64.6951219512195,483,46,23.225609756097562,6
Category_Wikipedia_sockpuppets_of_Horrifico.csv,2848,250228929.0,1049,1799,500,549,0,48.0126404494382,255,67,21.51193820224719,2
Category_Wikipedia_sockpuppets_of_Bradley026258.csv,7391,132277106.0,1837,5554,500,1337,0,44.27235827357597,500,61,21.32187795968069,3
Category_Wikipedia_sockpuppets_of_Durkc.csv,371,74571820.0,156,215,150,6,0,29.61185983827493,234,44,20.032345013477087,4
Category_Wikipedia_sockpuppets_of_Jannej.csv,290,158357091.0,89,201,63,26,0,45.87931034482759,212,57,19.606896551724137,3
Category_Wikipedia_sockpuppets_of_Matarumal_Collection.csv,194,16668294.0,67,127,37,30,0,56.80927835051546,366,49,22.00515463917526,4
Category_Wikipedia_sockpuppets_of_UBaiD_nela_chk.csv,2,0.0,1,1,1,0,59,59.0,59,19,19.0,19
Category_Wikipedia_sockpuppets_of_Mishal_Kanoo.csv,57,257293020.0,18,39,10,8,0,58.03508771929825,250,39,22.92982456140351,18
Category_Wikipedia_sockpuppets_of_Elizabethmartinez22.csv,113,56950910.0,83,30,35,48,0,37.67256637168141,193,32,17.646017699115045,14
Category_Wikipedia_sockpuppets_of_Walterlan_Papetti.csv,84,262904.0,25,59,9,16,0,38.45238095238095,227,49,21.273809523809526,5
Category_Wikipedia_sockpuppets_of_OscarrrrMmm.csv,832,28352817.0,269,563,156,113,0,69.98677884615384,513,43,16.03846153846154,3
Category_Wikipedia_sockpuppets_of_Yage_Wu.csv,141,29652508.0,52,89,26,26,0,62.312056737588655,262,26,11.5177304964539,3
Category_Wikipedia_sockpuppets_of_SlayerXT.csv,7517,30505055.0,2062,5455,500,1562,0,25.553279233736863,272,67,15.906611680191565,4
Category_Wikipedia_sockpuppets_of_Waheed_Challa.csv,437,55200029.0,149,288,36,113,0,46.49199084668192,248,43,20.327231121281464,5
Category_Wikipedia_sockpuppets_of_Spidey251.csv,1893,31023753.0,647,1246,381,266,0,40.06920232435288,469,56,20.804543053354465,3
Category_Wikipedia_sockpuppets_of_Ivan4234234.csv,71,1220961.0,47,24,21,26,0,20.0,175,40,12.915492957746478,10
Category_Wikipedia_sockpuppets_of_Jesusman101.csv,26,150378.0,16,10,16,0,0,59.57692307692308,204,22,18.384615384615383,1
Category_Wikipedia_sockpuppets_of_Tubaman2015.csv,199,10697948.0,68,131,58,10,0,47.48743718592965,308,79,23.753768844221106,3
Category_Wikipedia_sockpuppets_of_Frider443.csv,808,3435979.0,306,502,232,74,0,44.90965346534654,357,56,17.622524752475247,3
Category_Wikipedia_sockpuppets_of_Evlekis.csv,35010,335603216.0,10707,24303,500,10207,0,49.615881176806624,949,104,19.809454441588116,1
Category_Wikipedia_sockpuppets_of_Dgtdddsx123.csv,144,111660366.0,36,108,32,4,0,64.97916666666667,271,47,28.9375,16
Category_Wikipedia_sockpuppets_of_LiyahKay.csv,21,2049452.0,14,7,11,3,0,53.333333333333336,115,20,19.333333333333332,19
Category_Wikipedia_sockpuppets_of_Pantsaklanos.csv,1407,49867295.0,385,1022,256,129,0,31.312011371712863,250,51,23.604832977967305,6
Category_Wikipedia_sockpuppets_of_Armyguy11.csv,5511,36191024.0,1699,3812,500,1199,0,42.97858827798947,250,58,29.0148793322446,4
Category_Wikipedia_sockpuppets_of_Electricsoupie.csv,20,631886.0,9,11,4,5,0,43.65,167,46,22.0,14
Category_Wikipedia_sockpuppets_of_Hydrozen1.csv,43,22541854.0,34,9,18,16,0,25.069767441860463,196,28,21.46511627906977,17
Category_Wikipedia_sockpuppets_of_Srobak.csv,1872,38629436.0,618,1254,500,118,0,64.97168803418803,255,55,17.84241452991453,2
Category_Wikipedia_sockpuppets_of_Bhuvannalla.csv,1130,537133729.0,434,696,433,1,0,62.17610619469026,486,49,29.986725663716815,3
Category_Wikipedia_sockpuppets_of_Username20299765.csv,204,11914989.0,96,108,61,35,0,42.13235294117647,496,44,23.063725490196077,5
Category_Wikipedia_sockpuppets_of_V2burger.csv,126,9887401.0,53,73,27,26,0,43.34920634920635,241,40,15.587301587301587,5
Category_Wikipedia_sockpuppets_of_Musclejam.csv,23,88013.0,14,9,8,6,0,51.43478260869565,184,22,15.304347826086957,11
Category_Wikipedia_sockpuppets_of_Donald1972.csv,2221,292060449.0,874,1347,500,374,0,54.31112111661414,502,56,20.9914452949122,6
Category_Wikipedia_sockpuppets_of_Facibimus.csv,289,26195307.0,96,193,22,74,0,60.35640138408304,349,40,15.55363321799308,4
Category_Wikipedia_sockpuppets_of_Garbera_levente.csv,628,48034750.0,156,472,58,98,0,49.74044585987261,255,97,18.802547770700638,4
Category_Wikipedia_sockpuppets_of_Alex1977-1.csv,70,3652796.0,19,51,10,9,0,74.45714285714286,250,22,13.4,3
Category_Wikipedia_sockpuppets_of_Australianfootballrules.csv,332,756085.0,114,218,91,23,0,42.06325301204819,255,52,35.204819277108435,7
Category_Wikipedia_sockpuppets_of_Movie_Burner_Entertainment.csv,1,0.0,1,0,1,0,32,32.0,32,23,23.0,23
Category_Wikipedia_sockpuppets_of_AliShah786.csv,520,17270652.0,181,339,172,9,0,36.18846153846154,253,39,17.036538461538463,6
Category_Wikipedia_sockpuppets_of_HelloThereNow.csv,725,7928142.0,299,426,261,38,0,40.995862068965515,210,32,14.557241379310344,8
Category_Wikipedia_sockpuppets_of_Unlocking1900.csv,66,1948763.0,36,30,28,8,0,70.12121212121212,381,33,16.136363636363637,12
Category_Wikipedia_sockpuppets_of_Lidaz.csv,635,224221036.0,260,375,87,173,0,55.40944881889764,459,54,17.930708661417324,6
Category_Wikipedia_sockpuppets_of_Wikkimedia.csv,170,107955477.0,69,101,60,9,0,48.28823529411765,255,19,13.523529411764706,10
Category_Wikipedia_sockpuppets_of_Xxxaintlovegrand.csv,26,7096705.0,16,10,10,6,0,6.230769230769231,98,21,21.0,21
Category_Wikipedia_sockpuppets_of_MetroManMelbourne2003.csv,127,10374623.0,40,87,13,27,0,59.25984251968504,243,49,18.283464566929133,5
Category_Wikipedia_sockpuppets_of_PapiLombardo.csv,847,60278878.0,313,534,110,203,0,36.01180637544274,255,42,15.544273907910272,6
Category_Wikipedia_sockpuppets_of_Kilokari.csv,104,160586756.0,37,67,22,15,0,37.33653846153846,288,30,15.076923076923077,8
Category_Wikipedia_sockpuppets_of_DramaSchoolGeek.csv,469,101904392.0,166,303,134,32,0,44.63326226012793,254,63,24.633262260127932,4
Category_Wikipedia_sockpuppets_of_Ranker_fox.csv,20,160200.0,7,13,7,0,0,38.55,131,37,26.5,13
Category_Wikipedia_sockpuppets_of_Mr_Deactler.csv,8,11790986.0,7,1,6,1,0,32.875,183,20,18.375,15
Category_Wikipedia_sockpuppets_of_Robertrajeswaran.csv,1,0.0,1,0,1,0,23,23.0,23,49,49.0,49
Category_Wikipedia_sockpuppets_of_Narg333.csv,7,370.0,3,4,3,0,0,60.285714285714285,115,8,8.0,8
Category_Wikipedia_sockpuppets_of_Celusaal.csv,175,10304861.0,58,117,15,43,0,43.54857142857143,255,40,18.65142857142857,8
Category_Wikipedia_sockpuppets_of_Sri_Lanka_Elle.csv,67,3048469.0,27,40,13,14,0,49.940298507462686,187,33,17.98507462686567,4
Category_Wikipedia_sockpuppets_of_Oliverdrinkstars57.csv,278,25987426.0,98,180,25,73,0,46.66187050359712,372,53,23.154676258992804,5
Category_Wikipedia_sockpuppets_of_Egodarchar.csv,210,19082609.0,90,120,54,36,0,42.09047619047619,189,65,27.19047619047619,8
Category_Wikipedia_sockpuppets_of_Ibaranoff24.csv,17,1059.0,10,7,10,0,0,19.823529411764707,137,23,17.0,11
Category_Wikipedia_sockpuppets_of_PetSematary182.csv,1156,14557404.0,505,651,500,5,0,51.503460207612456,481,91,24.74567474048443,5
Category_Wikipedia_sockpuppets_of_Slowking4.csv,49059,346206000.0,20399,28660,500,19899,0,50.20509998165474,511,149,18.266943883894903,3
Category_Wikipedia_sockpuppets_of_Pepdonald.csv,774,188698232.0,338,436,336,2,0,34.30878552971576,255,55,11.454780361757106,6
Category_Wikipedia_sockpuppets_of_Omer123hussain.csv,1543,408350253.0,572,971,500,72,0,53.51069345430979,470,68,17.027219701879456,5
Category_Wikipedia_sockpuppets_of_BillCaxton.csv,542,79382218.0,215,327,168,47,0,71.95940959409594,464,81,24.123616236162363,10
Category_Wikipedia_sockpuppets_of_Mittybark111.csv,1372,10810214.0,390,982,35,355,0,55.8301749271137,255,73,18.45991253644315,2
Category_Wikipedia_sockpuppets_of_11341134a.csv,553,266697987.0,188,365,183,5,0,46.952983725135624,255,41,16.401446654611213,4
Category_Wikipedia_sockpuppets_of_Bellandris.csv,36,438366.0,17,19,15,2,0,30.13888888888889,81,66,36.361111111111114,10
Category_Wikipedia_sockpuppets_of_Okinawadato.csv,173,187092040.0,60,113,31,29,0,61.52023121387283,234,54,27.427745664739884,5
Category_Wikipedia_sockpuppets_of_Innocent_Paki.csv,1709,124470327.0,510,1199,500,10,0,48.39847864248098,489,67,22.29139847864248,2
Category_Wikipedia_sockpuppets_of_Vanilabar.csv,77,16102569.0,34,43,25,9,0,71.54545454545455,253,47,19.493506493506494,12
Category_Wikipedia_sockpuppets_of_Nbaka_is_a_joke.csv,96,1329089.0,33,63,33,0,0,46.020833333333336,232,38,18.927083333333332,8
Category_Wikipedia_sockpuppets_of_Alexanderolotu51.csv,209,815083.0,98,111,81,17,0,47.03349282296651,255,36,18.363636363636363,10
Category_Wikipedia_sockpuppets_of_Powerfultample.csv,1612,60146974.0,545,1067,383,162,0,43.076302729528535,494,74,12.443548387096774,3
Category_Wikipedia_sockpuppets_of_Bookworm8899.csv,1835,103754622.0,685,1150,500,185,0,44.36675749318801,500,47,14.53841961852861,4
Category_Wikipedia_sockpuppets_of_Showtime2009.csv,5966,33440287.0,1491,4475,500,991,0,50.237177338250085,255,86,20.797351659403287,4
Category_Wikipedia_sockpuppets_of_WarpedMask4801.csv,579,4906060.0,211,368,182,29,0,51.200345423143354,305,54,20.483592400690846,4
Category_Wikipedia_sockpuppets_of_Veesicle.csv,2009,23052421.0,607,1402,500,107,0,45.45495271279243,259,123,25.042309606769535,3
Category_Wikipedia_sockpuppets_of_Arb√®r_Prekazi.csv,455,9727220.0,177,278,61,116,0,29.015384615384615,255,30,12.551648351648351,9
Category_Wikipedia_sockpuppets_of_Cadeken.csv,7946,127365274.0,2393,5553,500,1893,0,49.471054618676064,500,73,27.925119557009815,3
Category_Wikipedia_sockpuppets_of_Matthew1416.csv,144,58021528.0,49,95,20,29,0,54.4375,255,46,19.95138888888889,9
Category_Wikipedia_sockpuppets_of_Jaimeaymerich.csv,2,0.0,1,1,1,0,0,0.0,0,17,17.0,17
Category_Wikipedia_sockpuppets_of_AlpShabaz.csv,1,0.0,1,0,1,0,77,77.0,77,19,19.0,19
Category_Wikipedia_sockpuppets_of_BusriderSF2015.csv,2763,68971717.0,1042,1721,500,542,0,45.131378935939196,357,75,26.911690191820487,7
Category_Wikipedia_sockpuppets_of_Soda_drinker.csv,1364,24682043.0,357,1007,256,101,0,26.339442815249267,245,49,18.39809384164223,4
Category_Wikipedia_sockpuppets_of_Informed_analysis.csv,1852,22070635.0,519,1333,500,19,0,59.807235421166304,495,47,17.401187904967603,4
Category_Wikipedia_sockpuppets_of_Mahabali_varma.csv,86,10423329.0,53,33,52,1,0,50.383720930232556,191,24,9.36046511627907,4
Category_Wikipedia_sockpuppets_of_Aroramohit0917.csv,105,140760248.0,21,84,13,8,0,49.142857142857146,215,76,28.066666666666666,3
Category_Wikipedia_sockpuppets_of_Dreamoutloud19.csv,39,777399.0,16,23,11,5,0,44.61538461538461,162,53,30.41025641025641,11
Category_Wikipedia_sockpuppets_of_Xawq.csv,77,1238045.0,38,39,28,10,0,43.01298701298701,254,28,22.038961038961038,1
Category_Wikipedia_sockpuppets_of_PKHilliam.csv,1779,145411294.0,516,1263,415,101,0,72.27318718381113,374,58,21.672287802136033,4
Category_Wikipedia_sockpuppets_of_PanoramaMedic.csv,62,261986.0,20,42,8,12,0,53.403225806451616,217,27,17.548387096774192,11
Category_Wikipedia_sockpuppets_of_Vesuvius_Dogg.csv,3784,17176041.0,822,2962,500,322,0,62.794133192389005,499,70,16.92468287526427,2
Category_Wikipedia_sockpuppets_of_Jumpin4jamie.csv,34,70104054.0,9,25,8,1,0,22.970588235294116,205,47,20.058823529411764,9
Category_Wikipedia_sockpuppets_of_Redrabbitiam.csv,12,6757.0,3,9,3,0,16,56.75,127,25,20.5,16
Category_Wikipedia_sockpuppets_of_Tishoteles.csv,421,210295203.0,166,255,93,73,0,45.757719714964374,249,49,17.850356294536816,4
Category_Wikipedia_sockpuppets_of_Ttgrcr25.csv,327,8374144.0,127,200,118,9,0,42.62996941896024,322,53,17.648318042813457,4
Category_Wikipedia_sockpuppets_of_Sahrdayacas.csv,56,116301997.0,17,39,16,1,0,43.75,190,56,34.839285714285715,8
Category_Wikipedia_sockpuppets_of_Taha_Khattabi.csv,595,3975516.0,169,426,150,19,0,56.42016806722689,457,47,23.3781512605042,5
Category_Wikipedia_sockpuppets_of_Joyowijoyo12.csv,419,40788072.0,127,292,33,94,0,22.43675417661098,196,64,20.973747016706444,10
Category_Wikipedia_sockpuppets_of_Waterface2020.csv,107,46184483.0,77,30,71,6,0,26.80373831775701,240,17,14.69158878504673,13
Category_Wikipedia_sockpuppets_of_The_Rolling_Camel.csv,1270,6587561.0,544,726,500,44,0,38.12047244094488,227,82,22.937007874015748,3
Category_Wikipedia_sockpuppets_of_Milko_Zec.csv,67,10288077.0,17,50,16,1,0,48.223880597014926,241,32,15.194029850746269,5
Category_Wikipedia_sockpuppets_of_Teenentrepreneursmeet.csv,5,4667.0,3,2,2,1,0,42.2,167,31,22.6,17
Category_Wikipedia_sockpuppets_of_Batka83.csv,77,760900.0,36,41,33,3,0,34.96103896103896,211,52,25.792207792207794,9
Category_Wikipedia_sockpuppets_of_Hurricanealma200.csv,112,224260.0,57,55,40,17,0,46.839285714285715,496,46,24.964285714285715,12
Category_Wikipedia_sockpuppets_of_PythonSwarm.csv,1903,11075104.0,511,1392,487,24,0,60.020493956910144,500,62,25.39831844456122,3
Category_Wikipedia_sockpuppets_of_Rahul_Kumar_Si.csv,276,150739338.0,90,186,53,37,0,45.55797101449275,301,60,15.47463768115942,5
Category_Wikipedia_sockpuppets_of_Rajasthankabiryatra.csv,3,178165.0,2,1,2,0,21,29.0,36,23,23.0,23
Category_Wikipedia_sockpuppets_of_Kalaua.csv,3230,34204668.0,1050,2180,384,666,0,32.29876160990712,250,72,14.99969040247678,3
Category_Wikipedia_sockpuppets_of_Neetschool.csv,452,5516122.0,147,305,20,127,0,41.3783185840708,255,84,32.69469026548673,4
Category_Wikipedia_sockpuppets_of_Prescotte.csv,190,19785704.0,80,110,58,22,0,33.82631578947368,243,34,15.178947368421053,8
Category_Wikipedia_sockpuppets_of_Arsenii_Ivanov.csv,77,4014525.0,40,37,10,30,0,63.77922077922078,258,46,21.194805194805195,10
Category_Wikipedia_sockpuppets_of_Iheartwikiedits.csv,548,56349994.0,138,410,27,111,0,62.18613138686131,500,63,23.202554744525546,3
Category_Wikipedia_sockpuppets_of_Dabadeeda5.csv,46,4486207.0,28,18,4,24,0,39.15217391304348,135,39,16.76086956521739,3
Category_Wikipedia_sockpuppets_of_Tamer_Gunner.csv,1056,134273086.0,516,540,500,16,0,27.112689393939394,467,37,23.888257575757574,10
Category_Wikipedia_sockpuppets_of_TheBlackVulture.csv,50,9773144.0,16,34,14,2,0,72.2,305,39,20.3,7
Category_Wikipedia_sockpuppets_of_Dico_Calingal.csv,726,57546108.0,254,472,206,48,0,35.67906336088154,232,52,15.685950413223141,5
Category_Wikipedia_sockpuppets_of_PopperPeachesCoconut2022.csv,536,32996808.0,194,342,148,46,0,63.38619402985075,369,50,21.25,3
Category_Wikipedia_sockpuppets_of_Venomlegions666.csv,53,1736737.0,25,28,15,10,0,69.30188679245283,384,25,18.471698113207548,11
Category_Wikipedia_sockpuppets_of_Coldplay48.csv,3037,43020543.0,790,2247,500,290,0,41.98057293381627,500,70,19.85577872900889,7
Category_Wikipedia_sockpuppets_of_Piet.delaney.csv,134,214484042.0,50,84,48,2,0,56.1865671641791,198,59,30.05223880597015,12
Category_Wikipedia_sockpuppets_of_–ö.–¢–µ—Ä–µ–Ω—Ç—å–µ–≤.csv,34,935993.0,18,16,14,4,0,66.08823529411765,485,64,23.823529411764707,14
Category_Wikipedia_sockpuppets_of_Hrishi_Pandey.csv,15,28560141.0,9,6,8,1,0,35.13333333333333,123,23,21.333333333333332,18
Category_Wikipedia_sockpuppets_of_Charlston_Choo.csv,43,69456.0,23,20,17,6,0,49.02325581395349,243,24,13.465116279069768,5
Category_Wikipedia_sockpuppets_of_Boss_RA.csv,4370,177366278.0,1609,2761,500,1109,0,40.451716247139586,510,98,25.428146453089244,4
Category_Wikipedia_sockpuppets_of_Xerton.csv,2454,162172743.0,934,1520,494,440,0,56.19722901385493,495,92,21.80643846780766,4
Category_Wikipedia_sockpuppets_of_Umangdevshukla78.csv,35,3186970.0,12,23,9,3,0,27.885714285714286,189,23,15.571428571428571,5
Category_Wikipedia_sockpuppets_of_Francbellise.csv,146,91404571.0,53,93,12,41,0,55.41095890410959,269,22,17.171232876712327,15
Category_Wikipedia_sockpuppets_of_Nialong82.csv,90,1724465.0,32,58,22,10,0,44.17777777777778,215,25,17.8,12
Category_Wikipedia_sockpuppets_of_Oppo212.csv,487,129934365.0,217,270,110,107,0,46.591375770020534,220,47,17.79671457905544,13
Category_Wikipedia_sockpuppets_of_Szabethpritchett.csv,1,0.0,1,0,1,0,0,0.0,0,20,20.0,20
Category_Wikipedia_sockpuppets_of_Isaacatm.csv,305,8938055.0,95,210,33,62,0,44.734426229508195,226,50,17.38360655737705,3
Category_Wikipedia_sockpuppets_of_Sarah_Toppertoy.csv,83,5634723.0,26,57,25,1,0,57.71084337349398,241,27,10.578313253012048,4
Category_Wikipedia_sockpuppets_of_Philly2166.csv,734,4761151.0,228,506,175,53,0,50.97683923705722,296,29,13.82425068119891,3
Category_Wikipedia_sockpuppets_of_KennethECasey.csv,56,5061697.0,12,44,11,1,0,49.017857142857146,259,34,18.410714285714285,9
Category_Wikipedia_sockpuppets_of_Wss2015n.csv,1,0.0,1,0,1,0,38,38.0,38,18,18.0,18
Category_Wikipedia_sockpuppets_of_JHON_YOLO.csv,10,85244.0,5,5,4,1,13,39.4,120,19,10.6,7
Category_Wikipedia_sockpuppets_of_Dinopainter.csv,107,44216837.0,32,75,25,7,0,50.981308411214954,250,21,14.411214953271028,4
Category_Wikipedia_sockpuppets_of_Gooby_The_Dolan.csv,26,6471.0,11,15,6,5,10,57.80769230769231,248,26,17.692307692307693,4
Category_Wikipedia_sockpuppets_of_K_V_Venkatesh.csv,333,5392040.0,133,200,88,45,0,61.77777777777778,273,44,16.165165165165167,4
Category_Wikipedia_sockpuppets_of_Abbasmilani.csv,126,7863277.0,95,31,63,32,0,29.563492063492063,213,36,15.976190476190476,11
Category_Wikipedia_sockpuppets_of_Sivadanasds.csv,59,84317002.0,14,45,9,5,0,17.796610169491526,111,36,16.627118644067796,14
Category_Wikipedia_sockpuppets_of_Topdog2014.csv,217,17647285.0,102,115,23,79,0,28.552995391705068,208,71,27.668202764976957,9
Category_Wikipedia_sockpuppets_of_Rbanner92498.csv,26,432603.0,15,11,6,9,0,59.23076923076923,196,58,13.73076923076923,7
Category_Wikipedia_sockpuppets_of_OWSLAjosh666.csv,2863,134562863.0,1027,1836,500,527,0,38.03946908836885,500,41,18.306322039818372,3
Category_Wikipedia_sockpuppets_of_Aquarian0218.csv,3273,15026758.0,1500,1773,500,1000,0,37.729911396272534,500,69,39.43140849373663,8
Category_Wikipedia_sockpuppets_of_Susandevere.csv,14,935866.0,11,3,10,1,0,83.0,205,36,32.42857142857143,31
Category_Wikipedia_sockpuppets_of_Amandabilliot.csv,509,50595360.0,191,318,61,130,0,35.68958742632613,222,23,14.12770137524558,9
Category_Wikipedia_sockpuppets_of_Billy_Ego.csv,9319,28496369.0,3484,5835,500,2984,0,39.27481489430196,255,77,20.93969310011804,6
Category_Wikipedia_sockpuppets_of_Abangmacho.csv,46,90865.0,19,27,9,10,0,61.93478260869565,221,44,15.5,5
Category_Wikipedia_sockpuppets_of_Edwardfieldhouse.csv,61,4795.0,28,33,26,2,0,60.967213114754095,275,27,22.131147540983605,13
Category_Wikipedia_sockpuppets_of_Eric.mintae.kim.csv,48,588851.0,13,35,6,7,0,45.3125,137,27,20.0625,18
Category_Wikipedia_sockpuppets_of_A8v.csv,2511,16183590.0,731,1780,500,231,0,53.34169653524492,255,86,21.62126642771804,2
Category_Wikipedia_sockpuppets_of_SupDawgs.csv,85,8378103.0,18,67,17,1,0,44.31764705882353,199,30,13.270588235294118,6
Category_Wikipedia_sockpuppets_of_Clooneymark.csv,32,279320.0,14,18,14,0,0,78.28125,226,47,20.15625,12
Category_Wikipedia_sockpuppets_of_Heythere9456.csv,48,5375095.0,15,33,10,5,0,46.166666666666664,230,45,22.916666666666668,14
Category_Wikipedia_sockpuppets_of_Kiyshore.csv,49,33692984.0,23,26,17,6,0,30.489795918367346,166,41,18.367346938775512,3
Category_Wikipedia_sockpuppets_of_The_Guy_from_Germany.csv,27,18141236.0,10,17,9,1,0,45.407407407407405,228,19,14.25925925925926,8
Category_Wikipedia_sockpuppets_of_Tan_Sohal.csv,42,355789.0,16,26,10,6,0,46.476190476190474,183,40,17.976190476190474,7
Category_Wikipedia_sockpuppets_of_ŸÖŸäŸÜÿß_ÿ¨ŸÖÿßŸÑ_ÿµÿ®ÿ≠Ÿä.csv,368,57277062.0,103,265,52,51,0,38.80978260869565,358,42,16.38586956521739,6
Category_Wikipedia_sockpuppets_of_Fursecution_vandal.csv,107,7866640.0,29,78,22,7,0,55.18691588785047,218,19,12.074766355140186,5
Category_Wikipedia_sockpuppets_of_Jimmybobissick.csv,67,21188621.0,21,46,11,10,0,65.43283582089552,234,28,11.805970149253731,3
Category_Wikipedia_sockpuppets_of_HillyBilly69.csv,9,1146.0,5,4,3,2,9,86.55555555555556,257,11,8.777777777777779,7
Category_Wikipedia_sockpuppets_of_Juliett_Tango_Papa.csv,72,17151293.0,30,42,24,6,0,53.97222222222222,492,51,24.416666666666668,7
Category_Wikipedia_sockpuppets_of_Technoapple42.csv,1846,13844990.0,636,1210,500,136,0,34.55037919826652,255,68,16.345070422535212,3
Category_Wikipedia_sockpuppets_of_Rishabisajakepauler.csv,2496,165533667.0,859,1637,369,490,0,38.96153846153846,496,65,17.745192307692307,3
Category_Wikipedia_sockpuppets_of_Fishup2008.csv,76,5009276.0,16,60,10,6,0,58.81578947368421,188,22,14.552631578947368,3
Category_Wikipedia_sockpuppets_of_Chickenguy12.csv,4008,9024500.0,1164,2844,500,664,0,29.772205588822356,250,57,19.49925149700599,4
Category_Wikipedia_sockpuppets_of_Kashmirwindow.csv,182,115572809.0,65,117,28,37,0,47.17032967032967,259,53,18.48901098901099,9
Category_Wikipedia_sockpuppets_of_PONDHEEPANKAR.csv,3515,549651121.0,1197,2318,500,697,0,43.00825035561878,424,46,13.37923186344239,4
Category_Wikipedia_sockpuppets_of_MichalWiedenski0000.csv,13,59952.0,7,6,4,3,0,46.69230769230769,173,19,14.153846153846153,12
Category_Wikipedia_sockpuppets_of_JessStevens1.csv,2,0.0,1,1,1,0,9,9.0,9,34,34.0,34
Category_Wikipedia_sockpuppets_of_Caleb_David_Smith.csv,431,4759041.0,186,245,89,97,0,47.11136890951276,226,54,21.1368909512761,5
Category_Wikipedia_sockpuppets_of_Stylized_as__stylized__currently;_formerly__stylizeD_.csv,4722,52748174.0,1280,3442,251,1029,0,52.667725540025415,255,89,18.045108005082593,3
Category_Wikipedia_sockpuppets_of_codyfinke.csv,527,685111.0,159,368,159,0,0,26.648956356736242,203,35,12.01518026565465,4
Category_Wikipedia_sockpuppets_of_MOHAMMED_Zameer_Engar_Carvelo_786.csv,27,702227.0,9,18,8,1,0,47.370370370370374,216,38,15.62962962962963,7
Category_Wikipedia_sockpuppets_of_OriginalMousetrap101.csv,3547,33771973.0,759,2788,302,457,0,55.15111361714125,492,62,17.977727657175077,3
Category_Wikipedia_sockpuppets_of_Toma646.csv,332,41889062.0,156,176,103,53,0,37.876506024096386,196,49,17.66867469879518,4
Category_Wikipedia_sockpuppets_of_San2011.csv,12,2077687.0,4,8,1,3,12,61.083333333333336,232,39,25.0,15
Category_Wikipedia_sockpuppets_of_WorldIsNice112.csv,128,5445483.0,58,70,32,26,0,29.4453125,281,25,21.1796875,9
Category_Wikipedia_sockpuppets_of_Joohnny_braavoo1.csv,1394,154754040.0,390,1004,251,139,0,44.28048780487805,489,55,16.410329985652798,4
Category_Wikipedia_sockpuppets_of_Avinashreddy3208.csv,157,175957.0,92,65,74,18,0,69.03821656050955,244,52,19.222929936305732,7
Category_Wikipedia_sockpuppets_of_Ben6776.csv,406,4490462.0,107,299,18,89,0,49.820197044334975,243,38,17.275862068965516,5
Category_Wikipedia_sockpuppets_of_RAPO23.csv,2263,97041019.0,821,1442,197,624,0,35.4365885992046,494,40,14.990278391515687,2
Category_Wikipedia_sockpuppets_of_DEBORAH1111.csv,141,126622267.0,45,96,31,14,0,37.241134751773046,230,29,18.77304964539007,13
Category_Wikipedia_sockpuppets_of_Sayedadnanshah4.csv,2777,39244585.0,857,1920,500,357,0,40.56499819949586,377,55,20.014043932301043,4
Category_Wikipedia_sockpuppets_of_LoganTheWatermelon.csv,980,10090092.0,335,645,253,82,0,77.95204081632653,445,60,25.680612244897958,4
Category_Wikipedia_sockpuppets_of_Rooghu.csv,144,1796650.0,48,96,25,23,0,52.40277777777778,494,53,20.09722222222222,4
Category_Wikipedia_sockpuppets_of_Paul_sachudhanandam.csv,374,12964080.0,120,254,103,17,0,51.975935828877006,248,39,15.47860962566845,5
Category_Wikipedia_sockpuppets_of_Lil_durk_fanboy.csv,62,153306.0,19,43,13,6,0,55.33870967741935,307,59,22.838709677419356,6
Category_Wikipedia_sockpuppets_of_John2697.csv,2,70.0,2,0,2,0,0,14.5,29,33,33.0,33
Category_Wikipedia_sockpuppets_of_Jackrobert007.csv,75,32166733.0,26,49,24,2,0,50.08,297,63,26.36,16
Category_Wikipedia_sockpuppets_of_Thejinlee.csv,7,514258.0,6,1,5,1,0,4.857142857142857,26,16,16.0,16
Category_Wikipedia_sockpuppets_of_Ishuworld.1234.csv,103,10290191.0,45,58,20,25,0,29.74757281553398,328,31,16.009708737864077,11
Category_Wikipedia_sockpuppets_of_Edwinakmartin.csv,13,1737.0,5,8,5,0,0,48.38461538461539,143,47,33.38461538461539,24
Category_Wikipedia_sockpuppets_of_Sebi_wj.csv,2114,148800300.0,718,1396,500,218,0,28.521286660359507,252,53,16.889782403027436,9
Category_Wikipedia_sockpuppets_of_Yarmohammadi.sadegh.csv,48,73359.0,17,31,7,10,4,74.125,225,32,19.208333333333332,8
Category_Wikipedia_sockpuppets_of_Ray_Joe_(Singer).csv,42,21125327.0,19,23,14,5,0,41.38095238095238,195,23,18.476190476190474,12
Category_Wikipedia_sockpuppets_of_Red4tribe.csv,2057,476746341.0,572,1485,500,72,0,52.2586290714633,500,67,19.55809431210501,4
Category_Wikipedia_sockpuppets_of_Gabi838r.csv,2123,39385358.0,847,1276,156,691,0,49.59397079604334,500,38,14.910975035327366,4
Category_Wikipedia_sockpuppets_of_RidjalA.csv,1127,146760242.0,490,637,478,12,0,66.70984915705412,255,47,22.395740905057675,12
Category_Wikipedia_sockpuppets_of_Singh6.csv,2538,69105524.0,822,1716,500,322,0,55.85500394011032,250,83,19.763593380614658,4
Category_Wikipedia_sockpuppets_of_Bauersucks.csv,8,373.0,3,5,2,1,0,81.25,195,19,16.25,8
Category_Wikipedia_sockpuppets_of_Princek2019.csv,1860,80323406.0,749,1111,500,249,0,48.01451612903226,496,82,16.3252688172043,4
Category_Wikipedia_sockpuppets_of_Pagemoney.csv,33,24099.0,20,13,8,12,0,31.454545454545453,156,45,10.909090909090908,3
Category_Wikipedia_sockpuppets_of_Astore_Malik.csv,2516,27493094.0,905,1611,500,405,0,47.65659777424483,500,54,16.196343402225754,5
Category_Wikipedia_sockpuppets_of_Steveengelhardt.csv,222,176290716.0,75,147,43,32,0,60.333333333333336,255,47,25.26126126126126,8
Category_Wikipedia_sockpuppets_of_Yekhai.csv,172,2620143.0,63,109,18,45,0,46.21511627906977,250,49,18.88953488372093,6
Category_Wikipedia_sockpuppets_of_AiRo_Digital_Labs.csv,20,4757.0,20,0,20,0,0,0.0,0,7,7.0,7
Category_Wikipedia_sockpuppets_of_Jamelia.csv,350,307692780.0,155,195,154,1,0,31.78857142857143,264,50,16.931428571428572,9
Category_Wikipedia_sockpuppets_of_Factual80man.csv,480,12176229.0,120,360,70,50,0,28.354166666666668,201,61,17.714583333333334,4
Category_Wikipedia_sockpuppets_of_Tcfwikiaccount.csv,115,43021843.0,75,40,74,1,0,22.878260869565217,253,11,10.843478260869565,10
Category_Wikipedia_sockpuppets_of_OSU80.csv,1769,172350149.0,505,1264,500,5,0,40.105709440361785,250,75,22.71170152628604,3
Category_Wikipedia_sockpuppets_of_Josher8a.csv,1051,261177240.0,408,643,143,265,0,42.868696479543296,354,51,19.162702188392007,4
Category_Wikipedia_sockpuppets_of_Duan05.csv,1262,23190949.0,432,830,234,198,0,31.483359746434232,255,44,16.044374009508715,7
Category_Wikipedia_sockpuppets_of_Vasquito.csv,231,413025180.0,65,166,56,9,0,51.15584415584416,254,48,15.484848484848484,4
Category_Wikipedia_sockpuppets_of_Alpha2002.csv,6,1177.0,5,1,5,0,0,22.333333333333332,82,20,20.0,20
Category_Wikipedia_sockpuppets_of_Icedbinariz.csv,140,36387098.0,30,110,30,0,0,60.47142857142857,458,33,12.521428571428572,3
Category_Wikipedia_sockpuppets_of_ChadBrunner.csv,124,3972474.0,41,83,5,36,0,74.29838709677419,241,54,32.03225806451613,10
Category_Wikipedia_sockpuppets_of_WildlyAccurate.csv,187,7034841.0,84,103,32,52,0,80.44385026737967,497,51,27.149732620320854,12
Category_Wikipedia_sockpuppets_of_Mokado123.csv,106,7678868.0,45,61,25,20,0,45.35849056603774,295,30,11.349056603773585,5
Category_Wikipedia_sockpuppets_of_Wasimkhanofficial.csv,11,48802.0,4,7,4,0,0,49.18181818181818,196,53,45.90909090909091,27
Category_Wikipedia_sockpuppets_of_Tibetfox001.csv,37,444289.0,20,17,10,10,0,56.21621621621622,165,47,22.972972972972972,13
Category_Wikipedia_sockpuppets_of_TylerSmith3415.csv,5,365.0,3,2,3,0,0,65.6,198,32,32.0,32
Category_Wikipedia_sockpuppets_of_Vyadav7636.csv,94,54096227.0,45,49,26,19,0,45.43617021276596,196,48,23.414893617021278,13
Category_Wikipedia_sockpuppets_of_Erchongyee.csv,66,70889004.0,25,41,25,0,0,46.75757575757576,243,33,22.37878787878788,12
Category_Wikipedia_sockpuppets_of_Shreyaskabadi.csv,33,2335063.0,18,15,11,7,0,39.696969696969695,196,27,15.696969696969697,10
Category_Wikipedia_sockpuppets_of_Mrigendra_Ranjan.csv,447,20286133.0,163,284,122,41,0,32.25279642058165,208,39,17.176733780760625,7
Category_Wikipedia_sockpuppets_of_Bradswanson2010.csv,463,151463076.0,222,241,208,14,0,81.39308855291577,248,40,26.818574514038875,12
Category_Wikipedia_sockpuppets_of_ResearcherStudierIam.csv,69,757034.0,41,28,21,20,0,66.0,495,31,21.82608695652174,10
Category_Wikipedia_sockpuppets_of_Enigmatic666.csv,42,351804.0,18,24,13,5,0,86.21428571428571,252,22,9.642857142857142,4
Category_Wikipedia_sockpuppets_of_GreenCKE.csv,351,128137508.0,108,243,108,0,0,41.27350427350427,234,47,20.21937321937322,3
Category_Wikipedia_sockpuppets_of_Freddiefrodo.csv,24,780780.0,18,6,14,4,0,30.0,156,22,17.666666666666668,14
Category_Wikipedia_sockpuppets_of_Wikicircuit.csv,632,145505735.0,167,465,79,88,0,47.359177215189874,386,51,19.680379746835442,7
Category_Wikipedia_sockpuppets_of_Norluap.csv,13,7003571.0,7,6,1,6,0,66.76923076923077,200,31,25.76923076923077,15
Category_Wikipedia_sockpuppets_of_ShahChirag.csv,289,295538219.0,105,184,99,6,0,45.588235294117645,230,65,27.913494809688583,13
Category_Wikipedia_sockpuppets_of_Anish1121.csv,1225,158542255.0,412,813,412,0,0,46.32489795918367,516,45,14.791836734693877,3
Category_Wikipedia_sockpuppets_of_Hillbillyholiday.csv,5438,153996918.0,1390,4048,500,890,0,54.620080912100036,383,101,18.475726369988966,3
Category_Wikipedia_sockpuppets_of_Pierce51.csv,143,435128.0,44,99,39,5,0,38.83916083916084,197,21,13.552447552447552,4
Category_Wikipedia_sockpuppets_of_PakePakwan.csv,332,202982.0,89,243,64,25,0,52.623493975903614,255,34,11.102409638554217,4
Category_Wikipedia_sockpuppets_of_Nazcheema.csv,1340,1177156.0,638,702,500,138,0,50.9044776119403,255,77,26.894776119402984,5
Category_Wikipedia_sockpuppets_of_Marylucygril.csv,72,19360948.0,35,37,10,25,0,51.208333333333336,224,20,11.652777777777779,7
Category_Wikipedia_sockpuppets_of_Romerophilip3.csv,43,605833.0,17,26,2,15,0,55.83720930232558,201,29,18.837209302325583,11
Category_Wikipedia_sockpuppets_of_Poeticbent.csv,4542,440349838.0,1347,3195,500,847,0,60.97710259797446,500,77,22.662043152796127,3
Category_Wikipedia_sockpuppets_of_Armand_Cucciniello.csv,782,9341409.0,279,503,198,81,0,45.452685421994886,255,59,18.226342710997443,5
Category_Wikipedia_sockpuppets_of_SCWA_Ladies_Champion.csv,2598,21505048.0,1000,1598,500,500,0,32.463818321785986,252,61,16.074672825250193,7
Category_Wikipedia_sockpuppets_of_Acevonjohnson.csv,36,309772910.0,11,25,10,1,0,56.638888888888886,223,24,16.38888888888889,13
Category_Wikipedia_sockpuppets_of_No2vndlsm.csv,271,798176.0,123,148,118,5,0,35.22140221402214,214,34,15.793357933579335,6
Category_Wikipedia_sockpuppets_of_Misterkimono.csv,34,9072852.0,19,15,11,8,0,60.73529411764706,254,13,13.0,13
Category_Wikipedia_sockpuppets_of_Masoom_shafi.csv,612,38376412.0,154,458,34,120,0,51.97712418300654,453,43,15.761437908496733,6
Category_Wikipedia_sockpuppets_of_Koolx.csv,385,92599861.0,77,308,67,10,0,48.28051948051948,250,43,13.8987012987013,5
Category_Wikipedia_sockpuppets_of_Bismatrimony.csv,124,14928446.0,36,88,12,24,0,46.306451612903224,241,44,22.241935483870968,12
Category_Wikipedia_sockpuppets_of_AayatS.csv,1925,5558983.0,768,1157,500,268,0,37.130389610389614,416,56,15.57974025974026,4
Category_Wikipedia_sockpuppets_of_Texankudiya.csv,125,125878442.0,25,100,22,3,0,56.496,239,31,13.568,9
Category_Wikipedia_sockpuppets_of_Biggmic.csv,37,38056053.0,12,25,8,4,0,69.08108108108108,230,22,12.621621621621621,3
Category_Wikipedia_sockpuppets_of_Blindname.csv,35,422655.0,12,23,10,2,0,52.142857142857146,160,38,20.742857142857144,16
Category_Wikipedia_sockpuppets_of_Tellthetruth1234434.csv,22,933292.0,14,8,11,3,0,62.54545454545455,191,38,31.363636363636363,18
Category_Wikipedia_sockpuppets_of_Tom01111.csv,35,123020.0,13,22,7,6,0,33.22857142857143,228,26,15.485714285714286,10
Category_Wikipedia_sockpuppets_of_George-Washington-did-9-11.csv,47,14883.0,25,22,14,11,0,44.12765957446808,205,41,21.872340425531913,6
Category_Wikipedia_sockpuppets_of_Guido_den_Broeder.csv,4130,348489686.0,1468,2662,500,968,0,53.5230024213075,283,89,29.178450363196127,2
Category_Wikipedia_sockpuppets_of_Webineering.csv,1,0.0,1,0,1,0,196,196.0,196,22,22.0,22
Category_Wikipedia_sockpuppets_of_InfiLaw.csv,132,15663125.0,62,70,54,8,0,65.51515151515152,255,70,40.78030303030303,14
Category_Wikipedia_sockpuppets_of_Thbronze.csv,2,3849.0,2,0,1,1,87,92.0,97,13,13.0,13
Category_Wikipedia_sockpuppets_of_Cavinmorris.csv,18,8029913.0,15,3,11,4,0,43.44444444444444,196,18,16.333333333333332,13
Category_Wikipedia_sockpuppets_of_Dingbat2007.csv,3235,114123392.0,1053,2182,182,871,0,27.424420401854714,238,59,10.76321483771252,4
Category_Wikipedia_sockpuppets_of_Swagrid420.csv,16,1845.0,6,10,5,1,0,66.3125,219,25,14.5,13
Category_Wikipedia_sockpuppets_of_HVJAIN.csv,312,75083503.0,121,191,77,44,0,46.58974358974359,194,51,19.233974358974358,11
Category_Wikipedia_sockpuppets_of_Art&Design3000.csv,281,63271389.0,113,168,62,51,0,47.29181494661922,255,40,18.918149466192173,10
Category_Wikipedia_sockpuppets_of_Oscar1994alex1999.csv,2583,186220366.0,795,1788,435,360,0,50.46806039488966,382,59,17.398373983739837,3
Category_Wikipedia_sockpuppets_of_TessKatz1.csv,10,2093.0,7,3,4,3,0,131.3,413,14,13.9,13
Category_Wikipedia_sockpuppets_of_Rrrr5.csv,1095,140135946.0,281,814,176,105,0,44.48310502283105,241,59,18.68310502283105,3
Category_Wikipedia_sockpuppets_of_Realkrishna.mishranepal.csv,131,2844994.0,69,62,63,6,0,33.20610687022901,195,36,17.633587786259543,2
Category_Wikipedia_sockpuppets_of_Gouzo135.csv,10,12911918.0,5,5,3,2,10,45.5,196,14,9.4,5
Category_Wikipedia_sockpuppets_of_Sikander_Warsi.csv,47,206216889.0,23,24,7,16,0,59.744680851063826,220,40,18.27659574468085,5
Category_Wikipedia_sockpuppets_of_Josh24B.csv,1842,146954932.0,730,1112,215,515,0,39.72801302931596,255,69,19.004885993485342,3
Category_Wikipedia_sockpuppets_of_PhoenixPhan.csv,56,206101.0,19,37,12,7,0,49.07142857142857,181,47,36.839285714285715,16
Category_Wikipedia_sockpuppets_of_Aloyne.csv,723,13407191.0,244,479,232,12,0,26.85200553250346,255,36,17.66390041493776,6
Category_Wikipedia_sockpuppets_of_Neutralizer.csv,2166,70143485.0,782,1384,404,378,0,37.38319482917821,211,99,26.93582640812558,7
Category_Wikipedia_sockpuppets_of_Redsky89.csv,4201,224247786.0,1000,3201,500,500,0,52.09592954058557,496,54,12.95191621042609,4
Category_Wikipedia_sockpuppets_of_Indahkhusnul.csv,76,11685218.0,24,52,20,4,0,47.14473684210526,275,47,19.736842105263158,9
Category_Wikipedia_sockpuppets_of_Onelifefreak2007.csv,2053,96332026.0,557,1496,500,57,0,33.92498782269849,261,50,23.396005845104725,2
Category_Wikipedia_sockpuppets_of_Unreal_Engine_5.csv,28,12611.0,10,18,8,2,0,51.142857142857146,175,47,28.142857142857142,10
Category_Wikipedia_sockpuppets_of_A112484011388.csv,253,245849846.0,69,184,40,29,0,55.69960474308301,255,60,20.723320158102766,5
Category_Wikipedia_sockpuppets_of_Urstrulybobthebuilder101.csv,1,0.0,1,0,1,0,0,0.0,0,26,26.0,26
Category_Wikipedia_sockpuppets_of_LooneyTunerIan.csv,2029,310417487.0,531,1498,500,31,0,44.2971907343519,350,77,25.294726466239528,4
Category_Wikipedia_sockpuppets_of_Pro_bono.csv,180,52089765.0,111,69,76,35,0,47.48888888888889,283,55,22.75,7
Category_Wikipedia_sockpuppets_of_Tomtom.csv,2790,426355088.0,730,2060,500,230,0,51.89856630824373,496,56,23.156989247311827,3
Category_Wikipedia_sockpuppets_of_Hawkeye75.csv,542,15452930.0,185,357,185,0,0,43.32472324723247,255,57,20.74907749077491,7
Category_Wikipedia_sockpuppets_of_Ddaniel2009.csv,1629,13058642.0,470,1159,329,141,0,33.608348680171886,239,54,18.226519337016576,3
Category_Wikipedia_sockpuppets_of_Rule_Outed.csv,554,83800949.0,114,440,52,62,0,42.77797833935018,245,45,15.467509025270758,3
Category_Wikipedia_sockpuppets_of_Ron_liebman.csv,2003,368294520.0,516,1487,134,382,0,51.130304543185225,246,62,17.937094358462307,4
Category_Wikipedia_sockpuppets_of_Bestchest160713.csv,112,5363415.0,34,78,23,11,0,56.625,287,26,16.892857142857142,12
Category_Wikipedia_sockpuppets_of_SwingfastKitkat.csv,21,125921.0,6,15,3,3,15,53.523809523809526,139,42,24.666666666666668,16
Category_Wikipedia_sockpuppets_of_ThanhPeters.csv,190,58239460.0,62,128,51,11,0,30.86315789473684,260,24,15.457894736842105,7
Category_Wikipedia_sockpuppets_of_Timothycrice.csv,1831,10292139.0,969,862,500,469,0,35.95248498088476,255,56,18.550518842162752,5
Category_Wikipedia_sockpuppets_of_Eddysocial.csv,333,8740969.0,119,214,72,47,0,47.573573573573576,261,51,15.717717717717719,4
Category_Wikipedia_sockpuppets_of_Heartruptured.csv,29,309461.0,11,18,6,5,0,71.24137931034483,309,54,34.6551724137931,11
Category_Wikipedia_sockpuppets_of_Sikmir.csv,108,267012129.0,36,72,20,16,0,35.379629629629626,224,41,21.055555555555557,5
Category_Wikipedia_sockpuppets_of_Jeeshmam.csv,1,0.0,1,0,1,0,10,10.0,10,21,21.0,21
Category_Wikipedia_sockpuppets_of_21bkyonseieng.csv,101,4223474.0,74,27,72,2,0,50.227722772277225,494,28,12.742574257425742,9
Category_Wikipedia_sockpuppets_of_Amagency.csv,729,150691213.0,269,460,155,114,0,58.03155006858711,294,47,19.8079561042524,10
Category_Wikipedia_sockpuppets_of_TreCoolGuy.csv,8632,116759419.0,2460,6172,500,1960,0,41.49119555143651,255,65,20.472659870250233,3
Category_Wikipedia_sockpuppets_of_Rough_User.csv,22,2083.0,14,8,14,0,0,0.0,0,23,23.0,23
Category_Wikipedia_sockpuppets_of_AndrewLinRozario.csv,15,1492804.0,8,7,6,2,0,26.666666666666668,132,19,16.6,15
Category_Wikipedia_sockpuppets_of_Samthemaniloveut.csv,304,24460607.0,96,208,28,68,0,39.8453947368421,199,58,17.92105263157895,7
Category_Wikipedia_sockpuppets_of_WikipediaSleeperCell1.csv,291,2492685.0,88,203,24,64,0,35.30584192439863,200,54,24.333333333333332,4
Category_Wikipedia_sockpuppets_of_TreekoTerror.csv,84,4255955.0,32,52,12,20,0,41.44047619047619,221,22,9.69047619047619,5
Category_Wikipedia_sockpuppets_of_TheFirstEditEver29.csv,171,11664311.0,58,113,37,21,0,58.45029239766082,255,48,23.198830409356724,4
Category_Wikipedia_sockpuppets_of_Ecoleetage.csv,8745,123529869.0,3177,5568,500,2677,0,42.077758719268154,263,181,26.920640365923386,4
Category_Wikipedia_sockpuppets_of_Duke81.csv,34,1668358.0,15,19,5,10,0,37.88235294117647,178,42,35.911764705882355,10
Category_Wikipedia_sockpuppets_of_I_dont_care_what_my_name_is_anymore.csv,87,7168704.0,20,67,9,11,0,59.3448275862069,242,33,8.045977011494253,4
Category_Wikipedia_sockpuppets_of_Ezidishingali.csv,516,135124119.0,159,357,40,119,0,45.42829457364341,346,26,11.571705426356589,5
Category_Wikipedia_sockpuppets_of_Leolaria1997.csv,7,541981.0,5,2,5,0,3,50.285714285714285,67,22,22.0,22
Category_Wikipedia_sockpuppets_of_Words_Australia.csv,30,13405.0,14,16,6,8,0,43.46666666666667,162,47,32.6,18
Category_Wikipedia_sockpuppets_of_Mark_us_street.csv,1287,3804057.0,580,707,500,80,0,35.48640248640249,200,55,17.653457653457654,4
Category_Wikipedia_sockpuppets_of_Jamesbrazil.csv,66,64016315.0,23,43,14,9,0,69.68181818181819,245,22,17.78787878787879,14
Category_Wikipedia_sockpuppets_of_Atlia.csv,601,95291227.0,172,429,132,40,0,45.35440931780366,500,51,23.85524126455907,5
Category_Wikipedia_sockpuppets_of_Bhramadamunisa.csv,47,57261.0,20,27,16,4,0,43.234042553191486,184,64,39.361702127659576,25
Category_Wikipedia_sockpuppets_of_Akhilrajendra.csv,61,52065780.0,38,23,17,21,0,36.622950819672134,135,46,33.34426229508197,20
Category_Wikipedia_sockpuppets_of_Pawansharma04.csv,6,1348401.0,4,2,4,0,30,88.33333333333333,150,28,16.333333333333332,14
Category_Wikipedia_sockpuppets_of_AlexanderHovanec.csv,2108,31482306.0,899,1209,500,399,0,46.056451612903224,395,53,21.34819734345351,5
Category_Wikipedia_sockpuppets_of_Chimney_Sweepa.csv,211,6997147.0,117,94,100,17,0,52.03791469194313,415,50,25.080568720379148,8
Category_Wikipedia_sockpuppets_of_Nickjohn1234.csv,74,13712200.0,25,49,20,5,0,62.851351351351354,299,40,18.35135135135135,6
Category_Wikipedia_sockpuppets_of_Halaqah.csv,2028,152263020.0,569,1459,500,69,0,53.2120315581854,236,69,17.981755424063117,4
Category_Wikipedia_sockpuppets_of_Manda_1993.csv,1962,75848685.0,605,1357,101,504,0,47.203363914373085,298,54,17.63302752293578,3
Category_Wikipedia_sockpuppets_of_LilyAndZari.csv,307,19550940.0,77,230,47,30,0,49.28990228013029,294,61,16.28013029315961,8
Category_Wikipedia_sockpuppets_of_Alitahaorg.csv,19,1787423.0,7,12,7,0,0,37.8421052631579,131,36,21.31578947368421,17
Category_Wikipedia_sockpuppets_of_Price0125.csv,77,5199352.0,28,49,14,14,0,43.18181818181818,255,67,30.142857142857142,6
Category_Wikipedia_sockpuppets_of_English_Singh.csv,240,3438413.0,87,153,65,22,0,50.77916666666667,264,40,17.808333333333334,4
Category_Wikipedia_sockpuppets_of_Matt_Zjack.csv,150,245303642.0,47,103,47,0,0,40.64666666666667,229,39,18.386666666666667,9
Category_Wikipedia_sockpuppets_of_Biochemical_Mind.csv,52,23815102.0,15,37,14,1,0,33.23076923076923,199,28,19.03846153846154,8
Category_Wikipedia_sockpuppets_of_Bruins2321140.csv,13,575.0,3,10,3,0,0,93.15384615384616,274,11,10.153846153846153,10
Category_Wikipedia_sockpuppets_of_Jnanayogi_Shri_Siddeswara_Swamiji.csv,16,42806.0,8,8,8,0,0,48.6875,207,54,16.9375,7
Category_Wikipedia_sockpuppets_of_Maniiminhas.csv,37,188420283.0,8,29,8,0,0,56.32432432432432,196,20,17.864864864864863,12
Category_Wikipedia_sockpuppets_of_Sentinalofire34.csv,37,5954886.0,20,17,11,9,0,58.24324324324324,219,50,13.18918918918919,9
Category_Wikipedia_sockpuppets_of_Windows_XP_Unicode_CPTM_5050.csv,13,1314.0,6,7,3,3,0,59.76923076923077,199,20,17.846153846153847,15
Category_Wikipedia_sockpuppets_of_Rajkumar_Mishra_Films.csv,2,0.0,1,1,1,0,39,39.0,39,31,31.0,31
Category_Wikipedia_sockpuppets_of_CORN1223.csv,4,457206.0,4,0,3,1,8,18.5,33,19,13.75,12
Category_Wikipedia_sockpuppets_of_TVNEWS11.csv,204,21390147.0,100,104,61,39,0,49.681372549019606,245,26,11.818627450980392,11
Category_Wikipedia_sockpuppets_of_Lir.csv,1621,112306441.0,502,1119,500,2,0,29.74706971005552,213,103,24.007402837754473,8
Category_Wikipedia_sockpuppets_of_WWEJobber.csv,1540,12086942.0,532,1008,500,32,0,32.717532467532465,255,57,18.503246753246753,7
Category_Wikipedia_sockpuppets_of_Pong3SouthFrieza34.csv,1803,73323439.0,420,1383,371,49,0,43.074875207986686,500,74,27.480310593455354,4
Category_Wikipedia_sockpuppets_of_Landscape_walker.csv,105,198202193.0,42,63,25,17,0,77.26666666666667,403,40,22.61904761904762,9
Category_Wikipedia_sockpuppets_of_Setyawanary.csv,1167,4559004.0,389,778,382,7,0,39.38731790916881,263,69,15.320479862896315,4
Category_Wikipedia_sockpuppets_of_Universaladdress.csv,7473,273683529.0,1746,5727,500,1246,0,57.922253445737994,494,60,17.613809714973907,3
Category_Wikipedia_sockpuppets_of_Kara_Umi.csv,503,29489673.0,132,371,125,7,0,37.14910536779324,249,50,18.26441351888668,3
Category_Wikipedia_sockpuppets_of_Johnlovestvchannels.csv,45,12277677.0,16,29,10,6,0,37.2,214,34,28.57777777777778,13
Category_Wikipedia_sockpuppets_of_Artistforpresident.csv,10,7005375.0,5,5,5,0,7,42.1,120,28,24.1,21
Category_Wikipedia_sockpuppets_of_Dreisar20.csv,8829,37581111.0,2795,6034,500,2295,0,39.5293917770982,496,57,14.533922301506399,4
Category_Wikipedia_sockpuppets_of_SquishyBoi.csv,44,7205205.0,13,31,9,4,0,43.02272727272727,255,23,15.590909090909092,11
Category_Wikipedia_sockpuppets_of_RailheadDA.csv,13,68939.0,10,3,7,3,19,37.46153846153846,152,20,20.0,20
Category_Wikipedia_sockpuppets_of_I-HONG-LOW.csv,52,603805.0,45,7,16,29,0,30.115384615384617,157,35,21.403846153846153,15
Category_Wikipedia_sockpuppets_of_Zayya.csv,1344,306702605.0,546,798,500,46,0,45.60267857142857,255,52,19.877232142857142,4
Category_Wikipedia_sockpuppets_of_Sevgilerde.csv,1029,3397256.0,497,532,292,205,0,44.184645286686106,496,28,14.465500485908649,3
Category_Wikipedia_sockpuppets_of_Barisha2011.csv,1,0.0,1,0,1,0,140,140.0,140,15,15.0,15
Category_Wikipedia_sockpuppets_of_Vittoria_Zheng.csv,325,8213783.0,97,228,11,86,0,52.28923076923077,500,35,15.56,5
Category_Wikipedia_sockpuppets_of_AshleyBird1.csv,122,17725458.0,72,50,26,46,0,57.49180327868852,224,26,14.12295081967213,6
Category_Wikipedia_sockpuppets_of_Deneuve15.csv,409,76210329.0,158,251,157,1,0,51.31784841075795,254,47,18.91442542787286,5
Category_Wikipedia_sockpuppets_of_Donald_Brash.csv,2,0.0,1,1,1,0,0,0.0,0,11,11.0,11
Category_Wikipedia_sockpuppets_of_Wiki_Jokes.csv,68,4620455.0,29,39,16,13,0,29.83823529411765,196,39,21.794117647058822,14
Category_Wikipedia_sockpuppets_of_Orsahnses.csv,3736,19303048.0,1212,2524,346,866,0,35.2004817987152,250,54,16.7093147751606,3
Category_Wikipedia_sockpuppets_of_DesireeDorothyMishoe.csv,3,4400.0,2,1,2,0,0,84.33333333333333,192,25,21.0,19
Category_Wikipedia_sockpuppets_of_Buffalo8wiki.csv,88,21777562.0,22,66,19,3,0,64.8409090909091,224,48,25.431818181818183,12
Category_Wikipedia_sockpuppets_of_Liz_de_Quebec.csv,1609,56505757.0,506,1103,500,6,0,43.8508390304537,254,78,21.22063393412057,4
Category_Wikipedia_sockpuppets_of_Armando_AZ.csv,1470,65144781.0,513,957,426,87,0,60.7469387755102,500,51,25.468707482993196,3
Category_Wikipedia_sockpuppets_of_Boyhere.csv,495,7696686.0,135,360,122,13,0,39.32727272727273,208,56,21.288888888888888,3
Category_Wikipedia_sockpuppets_of_MediaTribe.csv,295,115709999.0,85,210,29,56,0,49.24406779661017,286,38,16.325423728813558,5
Category_Wikipedia_sockpuppets_of_Susan_alexa.csv,129,12636967.0,36,93,31,5,0,56.17829457364341,328,56,24.94573643410853,6
Category_Wikipedia_sockpuppets_of_Abdullah_Ayub_Wiki.csv,586,19530993.0,131,455,52,79,0,60.96928327645051,311,56,17.24914675767918,4
Category_Wikipedia_sockpuppets_of_Guitarstrings10.csv,46,99483.0,15,31,3,12,0,51.108695652173914,221,35,19.17391304347826,8
Category_Wikipedia_sockpuppets_of_Ilyafosho.csv,1,0.0,1,0,1,0,38,38.0,38,25,25.0,25
Category_Wikipedia_sockpuppets_of_Raymondlaw.csv,124,6141696.0,55,69,42,13,0,26.330645161290324,199,51,17.45967741935484,8
Category_Wikipedia_sockpuppets_of_Rubyyty.csv,11,175480.0,6,5,3,3,0,12.454545454545455,58,22,19.727272727272727,17
Category_Wikipedia_sockpuppets_of_Php2000.csv,2159,8693162.0,701,1458,500,201,0,63.49884205650764,484,61,20.81982399258916,5
Category_Wikipedia_sockpuppets_of_Clairtonboy.csv,60,262528.0,27,33,16,11,0,43.1,188,36,20.8,14
Category_Wikipedia_sockpuppets_of_Ilikeapie.csv,2214,11412481.0,1484,730,500,984,0,33.613369467028,250,37,16.23170731707317,8
Category_Wikipedia_sockpuppets_of_AlexVegaEsquire.csv,795,118784553.0,296,499,141,155,0,61.17987421383648,293,50,20.59622641509434,10
Category_Wikipedia_sockpuppets_of_Mharvey188.csv,23,182639.0,10,13,6,4,0,39.65217391304348,136,20,17.130434782608695,17
Category_Wikipedia_sockpuppets_of_Alan1234567.csv,33,182729.0,10,23,4,6,0,58.54545454545455,222,23,17.060606060606062,1
Category_Wikipedia_sockpuppets_of_Dr_Patrick_O'Crowley.csv,49,7550058.0,17,32,10,7,0,65.61224489795919,500,33,21.102040816326532,13
Category_Wikipedia_sockpuppets_of_Mw0001.csv,57,34358599.0,12,45,11,1,0,47.719298245614034,223,43,20.0,8
Category_Wikipedia_sockpuppets_of_Bald_Eeagle.csv,148,15039342.0,46,102,27,19,0,52.222972972972975,199,37,13.682432432432432,3
Category_Wikipedia_sockpuppets_of_Phadendra.csv,575,104991701.0,191,384,76,115,0,45.35130434782609,496,67,18.561739130434784,4
Category_Wikipedia_sockpuppets_of_VinceRoshelDoming.csv,66,3950060.0,39,27,36,3,0,31.5,213,44,28.21212121212121,23
Category_Wikipedia_sockpuppets_of_Ambel20.csv,98,1141031.0,59,39,45,14,0,34.95918367346939,214,49,32.755102040816325,9
Category_Wikipedia_sockpuppets_of_DMGUSA.csv,808,45551191.0,283,525,266,17,0,53.40346534653465,255,75,15.459158415841584,7
Category_Wikipedia_sockpuppets_of_Sonya_Olifirova.csv,59,16264875.0,17,42,16,1,0,64.10169491525424,226,44,33.644067796610166,20
Category_Wikipedia_sockpuppets_of_Aamir_Naik_Ixa.csv,239,48343104.0,91,148,32,59,0,41.75732217573222,404,63,23.552301255230127,11
Category_Wikipedia_sockpuppets_of_Sharafuhere.csv,198,38400119.0,78,120,40,38,0,40.156565656565654,376,47,20.47979797979798,7
Category_Wikipedia_sockpuppets_of_Aidan_Work.csv,2228,55863866.0,854,1374,500,354,0,37.687163375224415,225,74,24.355026929982046,2
Category_Wikipedia_sockpuppets_of_De_percy.csv,156,2952525.0,60,96,56,4,0,36.10897435897436,175,39,19.166666666666668,11
Category_Wikipedia_sockpuppets_of_Rated_Jigog.csv,393,791647.0,210,183,142,68,0,41.29262086513995,351,54,14.353689567430026,7
Category_Wikipedia_sockpuppets_of_Westoe.csv,54,9164744.0,12,42,10,2,0,46.074074074074076,168,33,20.796296296296298,8
Category_Wikipedia_sockpuppets_of_Krish_Gyawali.csv,76,11511806.0,40,36,21,19,0,48.26315789473684,387,28,19.907894736842106,8
Category_Wikipedia_sockpuppets_of_PlayOnSports.csv,155,789044.0,48,107,34,14,0,68.36129032258064,238,61,30.767741935483873,17
Category_Wikipedia_sockpuppets_of_Dewan357.csv,9340,229461333.0,2602,6738,500,2102,0,34.863597430406855,250,60,16.720877944325483,4
Category_Wikipedia_sockpuppets_of_TruckCard.csv,1146,956821.0,503,643,500,3,0,59.853403141361255,253,56,26.80017452006981,4
Category_Wikipedia_sockpuppets_of_CJ337.csv,211,10422857.0,85,126,51,34,0,52.87677725118483,500,53,25.37440758293839,11
Category_Wikipedia_sockpuppets_of_Greaterneworleans.csv,31,11650332.0,22,9,12,10,0,46.516129032258064,222,10,10.0,10
Category_Wikipedia_sockpuppets_of_Sneasel99.csv,60,93403.0,29,31,29,0,0,24.566666666666666,250,43,21.55,11
Category_Wikipedia_sockpuppets_of_Rawatschool.csv,41,3781832.0,14,27,14,0,0,94.07317073170732,254,49,26.75609756097561,6
Category_Wikipedia_sockpuppets_of_Peterjack1.csv,3937,54944264.0,1352,2585,500,852,0,47.12954025908052,486,65,35.50266700533401,6
Category_Wikipedia_sockpuppets_of_ArthurCurry70.csv,2258,49850273.0,656,1602,96,560,0,44.45748449955713,500,78,18.37245349867139,4
Category_Wikipedia_sockpuppets_of_Ctx1.csv,720,52229964.0,236,484,44,192,0,28.819444444444443,199,60,17.743055555555557,4
Category_Wikipedia_sockpuppets_of_Mamka_Laiina.csv,42,1671.0,13,29,7,6,0,69.04761904761905,219,35,12.80952380952381,8
Category_Wikipedia_sockpuppets_of_TjinHGek.csv,2118,38497391.0,567,1551,401,166,0,39.26062322946176,441,50,18.52360717658168,5
Category_Wikipedia_sockpuppets_of_Budster0.csv,1,0.0,1,0,1,0,15,15.0,15,7,7.0,7
Category_Wikipedia_sockpuppets_of_MichaelForman68.csv,58,1176576.0,19,39,10,9,0,33.827586206896555,164,26,14.206896551724139,4
Category_Wikipedia_sockpuppets_of_Guputa1111.csv,52,39398518.0,15,37,8,7,0,42.26923076923077,160,54,20.96153846153846,12
Category_Wikipedia_sockpuppets_of_Rugile.za5.csv,32,3960559.0,17,15,10,7,0,35.59375,171,24,20.9375,18
Category_Wikipedia_sockpuppets_of_Brendar_1214.csv,331,6031427.0,91,240,90,1,0,48.314199395770395,254,68,17.82477341389728,4
Category_Wikipedia_sockpuppets_of_Ishan87.csv,1468,5142642.0,512,956,500,12,0,47.53882833787466,403,41,16.33991825613079,4
Category_Wikipedia_sockpuppets_of_Nickjohnn.csv,10,68323.0,4,6,4,0,0,58.7,203,30,25.5,10
Category_Wikipedia_sockpuppets_of_WyomingAirBase.csv,3,725.0,3,0,1,2,16,35.666666666666664,53,29,29.0,29
Category_Wikipedia_sockpuppets_of_Cathron.csv,26,83725214.0,7,19,4,3,0,50.07692307692308,247,46,14.076923076923077,4
Category_Wikipedia_sockpuppets_of_Mcgraham_giyan.csv,287,134055713.0,104,183,49,55,0,42.63414634146341,207,53,19.51567944250871,8
Category_Wikipedia_sockpuppets_of_Ddjjo.csv,61,14247144.0,29,32,19,10,0,40.377049180327866,207,32,19.983606557377048,10
Category_Wikipedia_sockpuppets_of_Sonamain801.csv,21,460.0,8,13,3,5,0,66.80952380952381,225,19,7.9523809523809526,3
Category_Wikipedia_sockpuppets_of_Rajagopalvk.csv,812,238136793.0,207,605,167,40,0,44.76477832512315,253,56,21.003694581280786,4
Category_Wikipedia_sockpuppets_of_Zenomonoz.csv,1737,175414367.0,521,1216,500,21,0,76.03396660909614,496,67,21.328151986183073,4
Category_Wikipedia_sockpuppets_of_Randyortan799.csv,215,1724240.0,70,145,27,43,0,77.38139534883722,500,50,21.94418604651163,7
Category_Wikipedia_sockpuppets_of_TheGracefulSlick.csv,4153,131070712.0,1295,2858,500,795,0,50.48182037081628,416,83,21.99494341439923,3
Category_Wikipedia_sockpuppets_of_Blammersky.csv,69,49258636.0,58,11,30,28,0,32.91304347826087,198,16,11.797101449275363,11
Category_Wikipedia_sockpuppets_of_BeeRunner.csv,182,171102.0,55,127,38,17,0,48.08791208791209,200,42,16.78021978021978,3
Category_Wikipedia_sockpuppets_of_Mural19.csv,33,16072620.0,12,21,6,6,0,43.878787878787875,196,30,18.96969696969697,5
Category_Wikipedia_sockpuppets_of_Hummerstatus.csv,5,15651.0,4,1,2,2,15,30.6,59,20,14.6,11
Category_Wikipedia_sockpuppets_of_Allancurtisedemons.csv,30,399063.0,30,0,16,14,14,33.06666666666667,57,28,24.133333333333333,15
Category_Wikipedia_sockpuppets_of_Smartprice99.csv,13,1124576.0,10,3,7,3,0,58.46153846153846,143,15,15.0,15
Category_Wikipedia_sockpuppets_of_Rahul_Lama.csv,33,163018.0,24,9,13,11,1,22.303030303030305,48,38,19.181818181818183,14
Category_Wikipedia_sockpuppets_of_Mg3942.csv,307,658141.0,100,207,74,26,0,55.755700325732896,255,42,24.423452768729643,7
Category_Wikipedia_sockpuppets_of_Doviman1.csv,6,65873.0,3,3,1,2,22,71.0,210,56,56.0,56
Category_Wikipedia_sockpuppets_of_Jacobnatali.csv,31,621471.0,21,10,11,10,0,41.645161290322584,178,18,14.64516129032258,12
Category_Wikipedia_sockpuppets_of_Cairo1229.csv,5,12960.0,4,1,4,0,34,37.4,51,33,33.0,33
Category_Wikipedia_sockpuppets_of_Wikiwetwo.csv,1,0.0,1,0,1,0,0,0.0,0,27,27.0,27
Category_Wikipedia_sockpuppets_of_Bahanaboy.csv,1385,43162087.0,277,1108,158,119,0,42.42166064981949,255,56,15.220216606498195,3
Category_Wikipedia_sockpuppets_of_Baytown_Historical_Preservation_Association.csv,29,210025.0,22,7,16,6,10,72.6896551724138,248,42,42.0,42
Category_Wikipedia_sockpuppets_of_Mrpontiac1.csv,21152,278420360.0,5729,15423,500,5229,0,39.95693078668684,255,79,16.158141074130107,3
Category_Wikipedia_sockpuppets_of_TaylorJones44.csv,276,85916593.0,75,201,31,44,0,56.48913043478261,292,37,15.641304347826088,6
Category_Wikipedia_sockpuppets_of_DinDjarin08.csv,144,7090893.0,45,99,15,30,0,46.56944444444444,272,32,17.291666666666668,5
Category_Wikipedia_sockpuppets_of_Akul94.csv,54,102212144.0,11,43,6,5,0,47.5,227,25,12.88888888888889,9
Category_Wikipedia_sockpuppets_of_Ianjones1900.csv,5642,60072274.0,1360,4282,500,860,0,25.693016660758595,217,63,15.583126550868487,3
Category_Wikipedia_sockpuppets_of_Sophiedub.csv,9,4749.0,8,1,8,0,5,66.88888888888889,152,23,15.444444444444445,12
Category_Wikipedia_sockpuppets_of_Aditeegokhale.csv,32,556486.0,11,21,11,0,0,46.5625,176,33,13.78125,3
Category_Wikipedia_sockpuppets_of_User409220.csv,100,84080780.0,37,63,13,24,0,31.03,394,47,31.02,13
Category_Wikipedia_sockpuppets_of_Mitchell_Haynes.csv,79,839742.0,27,52,8,19,0,52.25316455696203,315,37,17.0126582278481,5
Category_Wikipedia_sockpuppets_of_WokCity.csv,18,9763787.0,6,12,4,2,0,65.44444444444444,210,18,10.555555555555555,3
Category_Wikipedia_sockpuppets_of_Lou_franklin.csv,1324,24186798.0,563,761,500,63,0,35.48716012084592,255,70,29.398036253776436,7
Category_Wikipedia_sockpuppets_of_VigneshSiva.csv,4,3675517.0,2,2,1,1,0,60.75,126,30,25.0,20
Category_Wikipedia_sockpuppets_of_AMRozil.csv,1293,10294432.0,656,637,500,156,0,44.835266821345705,344,24,16.081206496519723,4
Category_Wikipedia_sockpuppets_of_Apteva.csv,3219,122776356.0,1000,2219,500,500,0,49.04224914569742,255,56,21.89251320285803,4
Category_Wikipedia_sockpuppets_of_PIETASG.csv,5,263466.0,2,3,2,0,0,9.8,35,30,24.4,16
Category_Wikipedia_sockpuppets_of_Albertawiki123.csv,54,21075099.0,30,24,25,5,0,83.68518518518519,284,24,17.22222222222222,16
Category_Wikipedia_sockpuppets_of_Olga311.csv,549,131443746.0,127,422,82,45,0,51.619307832422585,496,63,27.896174863387976,6
Category_Wikipedia_sockpuppets_of_Noah_lafreni√®re.csv,15,7095.0,10,5,9,1,0,25.066666666666666,138,20,11.466666666666667,4
Category_Wikipedia_sockpuppets_of_Samadeyemi2000.csv,4,33484.0,3,1,2,1,16,40.5,59,24,23.75,23
Category_Wikipedia_sockpuppets_of_OllyHowcroft.csv,301,12550783.0,112,189,74,38,0,42.12956810631229,245,55,16.614617940199334,4
Category_Wikipedia_sockpuppets_of_Anonymous13938.csv,19,6796082.0,15,4,8,7,0,33.89473684210526,230,10,10.0,10
Category_Wikipedia_sockpuppets_of_Wanishahrukh.csv,3846,95225170.0,1009,2837,500,509,0,45.31097243889756,255,59,17.557722308892355,4
Category_Wikipedia_sockpuppets_of_Ulughu_Khan.csv,273,7191459.0,117,156,93,24,0,60.095238095238095,465,39,11.91941391941392,4
Category_Wikipedia_sockpuppets_of_Placeographer77.csv,774,348095046.0,292,482,154,138,0,55.428940568475454,255,54,28.877260981912144,12
Category_Wikipedia_sockpuppets_of_Trueman31.csv,1590,531230547.0,491,1099,38,453,0,58.467924528301886,272,54,16.22830188679245,7
Category_Wikipedia_sockpuppets_of_Junkrak.csv,2189,20149038.0,731,1458,378,353,0,41.220191868433076,345,52,15.11694837825491,4
Category_Wikipedia_sockpuppets_of_Newboyreloaded.csv,1318,78879171.0,457,861,336,121,0,44.010622154779966,255,59,17.79135053110774,3
Category_Wikipedia_sockpuppets_of_TheLastRealOne.csv,17,4990.0,11,6,8,3,14,110.29411764705883,199,26,21.058823529411764,19
Category_Wikipedia_sockpuppets_of_Apple_A13_Bionic.csv,191,6736584.0,62,129,25,37,0,53.16230366492147,310,43,15.073298429319372,6
Category_Wikipedia_sockpuppets_of_SilentRevisions.csv,1174,150930795.0,388,786,387,1,0,51.35093696763203,449,63,19.271720613287904,3
Category_Wikipedia_sockpuppets_of_Kuyi123w.csv,1551,18102747.0,556,995,500,56,0,45.845905867182466,255,43,14.918117343649259,3
Category_Wikipedia_sockpuppets_of_Egorg13.csv,522,24351681.0,187,335,166,21,0,33.469348659003835,255,39,19.67241379310345,9
Category_Wikipedia_sockpuppets_of_Alorkalabahi.csv,37,3177428.0,9,28,5,4,0,71.83783783783784,243,42,21.72972972972973,8
Category_Wikipedia_sockpuppets_of_LibreTW.csv,19,459225.0,15,4,13,2,0,83.89473684210526,258,18,16.473684210526315,11
Category_Wikipedia_sockpuppets_of_MerrieMelodian.csv,89,24016346.0,31,58,28,3,0,61.168539325842694,362,71,24.191011235955056,12
Category_Wikipedia_sockpuppets_of_Midnight_In_Zoho.csv,2235,24798010.0,991,1244,486,505,0,42.25413870246085,496,69,21.98255033557047,3
Category_Wikipedia_sockpuppets_of_TiggerDisney.csv,733,1623561.0,257,476,120,137,0,39.53615279672579,254,40,22.919508867667123,11
Category_Wikipedia_sockpuppets_of_Dattaprakash.csv,12,1802455.0,4,8,2,2,0,32.666666666666664,78,22,18.25,17
Category_Wikipedia_sockpuppets_of_Jajadelera.csv,3906,125782669.0,978,2928,500,478,0,37.355862775217616,255,63,15.27547363031234,3
Category_Wikipedia_sockpuppets_of_Cchow2.csv,1878,74585785.0,502,1376,500,2,0,50.14217252396166,255,75,24.621938232161874,2
Category_Wikipedia_sockpuppets_of_Jarongohfkurself.csv,8,486.0,7,1,6,1,0,18.875,61,29,28.75,28
Category_Wikipedia_sockpuppets_of_Ernauna.csv,592,12115195.0,178,414,16,162,0,57.663851351351354,272,55,17.80743243243243,4
Category_Wikipedia_sockpuppets_of_Jason_CTY.csv,75,2075724.0,24,51,19,5,0,40.14666666666667,237,19,12.16,7
Category_Wikipedia_sockpuppets_of_Kingstarmedia.csv,954,5793640.0,292,662,81,211,0,46.397274633123686,500,58,14.675052410901468,3
Category_Wikipedia_sockpuppets_of_Cre8iveSkill.csv,28,56765072.0,6,22,2,4,0,63.892857142857146,218,33,17.785714285714285,10
Category_Wikipedia_sockpuppets_of_Abudabanas.csv,1275,161370314.0,501,774,500,1,0,40.061960784313726,499,54,25.15607843137255,7
Category_Wikipedia_sockpuppets_of_Aterian.csv,474,61163035.0,127,347,59,68,0,57.30801687763713,499,48,18.78481012658228,4
Category_Wikipedia_sockpuppets_of_Marxistanarchistcapitalistyogi69.csv,168,171947486.0,52,116,31,21,0,76.41071428571429,389,42,16.851190476190474,7
Category_Wikipedia_sockpuppets_of_Peter181.csv,1206,31480549.0,494,712,205,289,0,31.134328358208954,432,47,13.683250414593699,5
Category_Wikipedia_sockpuppets_of_PBSR_QCRSDBSR0199.csv,2,0.0,1,1,1,0,22,22.0,22,17,17.0,17
Category_Wikipedia_sockpuppets_of_Reverson_Entertainment.csv,193,3184596.0,68,125,23,45,0,27.264248704663213,202,45,16.735751295336787,8
Category_Wikipedia_sockpuppets_of_HayaKhanam.csv,189,17976559.0,64,125,39,25,0,55.65079365079365,310,26,13.82010582010582,4
Category_Wikipedia_sockpuppets_of_James135789.csv,17,4048347.0,6,11,4,2,0,35.76470588235294,187,24,17.705882352941178,6
Category_Wikipedia_sockpuppets_of_Chhatrapati_Shinde.csv,2392,15219310.0,1026,1366,390,636,0,8.066471571906355,272,44,26.419314381270905,9
Category_Wikipedia_sockpuppets_of_Randikasyap.csv,90,7417686.0,24,66,8,16,0,52.333333333333336,255,54,16.72222222222222,9
Category_Wikipedia_sockpuppets_of_Zero_sharp.csv,3908,400223221.0,1020,2888,500,520,0,52.14918116683726,370,75,19.40813715455476,3
"Category_Wikipedia_sockpuppets_of_993,583,087_edits.csv",34,1888041.0,15,19,5,10,0,69.6470588235294,239,29,16.735294117647058,6
Category_Wikipedia_sockpuppets_of_Awesomenessluigi.csv,177,718101.0,49,128,24,25,0,53.2090395480226,233,59,26.0225988700565,10
Category_Wikipedia_sockpuppets_of_Zuperxiddig1996.csv,437,7313446.0,158,279,137,21,0,51.30892448512586,256,53,22.382151029748282,4
Category_Wikipedia_sockpuppets_of_TzarN64.csv,3171,72771099.0,1077,2094,500,577,0,54.75275938189846,496,78,21.96152633238726,1
Category_Wikipedia_sockpuppets_of_Dibosh_Chakma.csv,3666,24703811.0,1897,1769,500,1397,0,40.38243316966721,500,54,27.48390616475723,5
Category_Wikipedia_sockpuppets_of_Qomcity1993.csv,1515,1382902.0,654,861,500,154,0,26.416501650165017,255,71,19.59009900990099,9
Category_Wikipedia_sockpuppets_of_Angelayne.csv,202,275805640.0,56,146,49,7,0,45.024752475247524,254,21,10.514851485148515,8
Category_Wikipedia_sockpuppets_of_Nandana_Lokuwithana.csv,127,13106209.0,57,70,25,32,0,38.83464566929134,203,58,26.393700787401574,15
Category_Wikipedia_sockpuppets_of_Weareme234.csv,5145,70066100.0,1395,3750,500,895,0,45.01360544217687,498,72,15.979397473275025,3
Category_Wikipedia_sockpuppets_of_God=nocioni1.csv,17,85131.0,11,6,5,6,0,56.8235294117647,220,43,29.823529411764707,19
Category_Wikipedia_sockpuppets_of_KANYABIGEGA_Silas.csv,56,28358611.0,23,33,9,14,0,53.910714285714285,196,52,30.214285714285715,17
Category_Wikipedia_sockpuppets_of_Partyison.csv,22,523277.0,16,6,12,4,0,42.40909090909091,136,22,21.09090909090909,21
Category_Wikipedia_sockpuppets_of_Kart2409.csv,81,1038152.0,30,51,23,7,0,58.04938271604938,232,81,21.85185185185185,10
Category_Wikipedia_sockpuppets_of_Shubhamvermasd.csv,46,35473135.0,12,34,5,7,0,44.369565217391305,206,30,24.97826086956522,19
Category_Wikipedia_sockpuppets_of_Clamstein.csv,274,63672615.0,108,166,61,47,0,46.51094890510949,494,51,16.445255474452555,3
Category_Wikipedia_sockpuppets_of_Libdolittle.csv,81,35930924.0,35,46,28,7,0,44.48148148148148,196,24,14.62962962962963,9
Category_Wikipedia_sockpuppets_of_Shooting_Spirit_007.csv,2826,8998607.0,1049,1777,500,549,0,42.89879688605803,499,62,24.758669497523,7
Category_Wikipedia_sockpuppets_of_MahendraPrajapatKhejarla.csv,1166,90030421.0,383,783,134,249,0,44.5377358490566,496,59,18.66466552315609,4
Category_Wikipedia_sockpuppets_of_Lawline.csv,2373,223253004.0,899,1474,290,609,0,36.62368310155921,250,63,22.670459334176147,4
"Category_Wikipedia_sockpuppets_of_N.Y.U.Club_Co.,Ltd..csv",2,0.0,1,1,1,0,0,0.0,0,17,17.0,17
Category_Wikipedia_sockpuppets_of_Deathson10.csv,1,0.0,1,0,1,0,0,0.0,0,13,13.0,13
Category_Wikipedia_sockpuppets_of_Redzemp.csv,1598,9327043.0,544,1054,500,44,0,52.94806007509387,255,50,20.775344180225282,4
Category_Wikipedia_sockpuppets_of_AstronomerOfSpace.csv,76,1540765.0,26,50,20,6,0,38.78947368421053,196,47,28.11842105263158,18
Category_Wikipedia_sockpuppets_of_Sinani_milaim.csv,275,261519518.0,133,142,110,23,0,37.92,254,23,9.712727272727273,5
Category_Wikipedia_sockpuppets_of_Pumkinhead23.csv,99,2517294.0,50,49,33,17,0,35.85858585858586,241,38,13.424242424242424,7
Category_Wikipedia_sockpuppets_of_Scrumhalf9!!.csv,49,2680962.0,16,33,8,8,0,47.40816326530612,228,15,10.448979591836734,10
Category_Wikipedia_sockpuppets_of_Malber.csv,4132,70766032.0,1064,3068,500,564,0,41.93852855759923,215,105,20.559293320425944,2
Category_Wikipedia_sockpuppets_of_General_Tojo.csv,5019,266229926.0,1563,3456,280,1283,0,47.67184698147041,255,75,19.28690974297669,4
Category_Wikipedia_sockpuppets_of_Semiramiscan.csv,484,10062582.0,116,368,81,35,0,36.675619834710744,249,51,25.671487603305785,3
Category_Wikipedia_sockpuppets_of_Kefas_yahaya.csv,186,50064008.0,77,109,30,47,0,45.59139784946237,400,31,21.236559139784948,6
Category_Wikipedia_sockpuppets_of_Netaab.csv,87,1804841.0,20,67,12,8,0,67.49425287356321,201,40,16.39080459770115,11
Category_Wikipedia_sockpuppets_of_Yossilev.csv,269,19020389.0,143,126,100,43,0,37.20817843866171,496,33,16.156133828996282,11
Category_Wikipedia_sockpuppets_of_Asicfinder.csv,2,895.0,2,0,2,0,0,0.0,0,34,34.0,34
Category_Wikipedia_sockpuppets_of_Pinoybandwagon.csv,1779,22448195.0,720,1059,254,466,0,33.8336143901068,200,60,16.740865654862283,4
Category_Wikipedia_sockpuppets_of_Uebelhoer.csv,13,1544.0,7,6,7,0,0,40.69230769230769,196,34,15.76923076923077,10
Category_Wikipedia_sockpuppets_of_LordAssRash.csv,1,0.0,1,0,1,0,13,13.0,13,16,16.0,16
Category_Wikipedia_sockpuppets_of_Venuja_Shehan.csv,31,7861422.0,13,18,8,5,0,22.322580645161292,192,23,19.548387096774192,17
Category_Wikipedia_sockpuppets_of_Zekarya.csv,70,114854547.0,14,56,13,1,0,45.785714285714285,211,19,13.0,10
Category_Wikipedia_sockpuppets_of_Mughal_Lohar.csv,8218,140914503.0,2414,5804,500,1914,0,44.907276709661716,255,80,14.688975419810173,3
Category_Wikipedia_sockpuppets_of_Alanpattinson.csv,49,2515990.0,19,30,9,10,0,61.08163265306123,211,27,17.306122448979593,8
Category_Wikipedia_sockpuppets_of_Jdgerrara.csv,84,213685.0,71,13,46,25,0,34.976190476190474,300,27,16.928571428571427,13
Category_Wikipedia_sockpuppets_of_Muktar_allebbey.csv,1583,119140843.0,613,970,444,169,0,42.305748578648135,255,51,16.25584333543904,4
Category_Wikipedia_sockpuppets_of_JonnyBonesJones.csv,2750,30060844.0,1000,1750,500,500,0,43.07745454545454,255,71,25.573090909090908,5
Category_Wikipedia_sockpuppets_of_Barrister568.csv,20,2553395.0,6,14,5,1,12,36.95,106,51,34.35,19
Category_Wikipedia_sockpuppets_of_Mikhail_Kyrah.csv,1420,5103696.0,552,868,307,245,0,39.44929577464789,407,96,23.152112676056337,4
Category_Wikipedia_sockpuppets_of_Wanad.csv,30,1043824.0,14,16,11,3,0,64.6,184,18,12.4,11
Category_Wikipedia_sockpuppets_of_LordHood2552.csv,1307,16129253.0,613,694,500,113,0,38.46212700841622,366,64,23.362662586074983,8
Category_Wikipedia_sockpuppets_of_Allthingsscotlanddecdide98uk.csv,1,0.0,1,0,1,0,23,23.0,23,29,29.0,29
Category_Wikipedia_sockpuppets_of_Seddon15.csv,26,189981.0,14,12,7,7,0,48.07692307692308,199,31,20.192307692307693,18
Category_Wikipedia_sockpuppets_of_Culminatio.csv,193,41496611.0,56,137,48,8,0,67.38860103626943,497,51,19.38860103626943,7
Category_Wikipedia_sockpuppets_of_Kmoakley.csv,6,2161.0,5,1,3,2,14,51.833333333333336,115,20,8.333333333333334,6
Category_Wikipedia_sockpuppets_of_Regulus_marzo4103.csv,1942,11394742.0,503,1439,500,3,0,33.80123583934088,231,43,11.934088568486096,4
Category_Wikipedia_sockpuppets_of_Tenchwood_Pie.csv,68,971837.0,25,43,14,11,0,29.941176470588236,158,30,18.63235294117647,9
Category_Wikipedia_sockpuppets_of_DrubsplayMobile.csv,728,58579876.0,282,446,178,104,0,54.24175824175824,255,60,22.32967032967033,12
Category_Wikipedia_sockpuppets_of_Luke_de_paul.csv,357,32992907.0,112,245,110,2,0,41.38095238095238,207,50,19.198879551820728,3
Category_Wikipedia_sockpuppets_of_SEGA.csv,8880,101753379.0,2952,5928,500,2452,0,31.151126126126126,271,82,18.35990990990991,3
Category_Wikipedia_sockpuppets_of_Willrocks10.csv,1366,72416112.0,501,865,500,1,0,36.348462664714496,234,78,21.83528550512445,6
Category_Wikipedia_sockpuppets_of_Congru.csv,354,5621596.0,110,244,57,53,0,52.03107344632768,249,47,26.545197740112993,8
Category_Wikipedia_sockpuppets_of_Mosool.csv,81,2609259.0,29,52,17,12,0,49.80246913580247,228,33,15.654320987654321,5
Category_Wikipedia_sockpuppets_of_Fact_reporter.csv,98,52354191.0,34,64,18,16,0,46.92857142857143,250,54,17.20408163265306,13
Category_Wikipedia_sockpuppets_of_Toruh.csv,55,1295895.0,41,14,34,7,0,38.945454545454545,134,15,15.0,15
Category_Wikipedia_sockpuppets_of_Dmurawski.csv,1162,126705811.0,320,842,288,32,0,33.55938037865749,250,51,17.609294320137693,5
Category_Wikipedia_sockpuppets_of_Modder123.csv,28,1075.0,9,19,9,0,0,63.607142857142854,254,19,14.714285714285714,13
Category_Wikipedia_sockpuppets_of_MichiganWolverines2015.csv,206,2894740.0,68,138,54,14,0,49.05825242718446,255,59,23.20873786407767,7
Category_Wikipedia_sockpuppets_of_Joshua_Salda√±a.csv,755,155803798.0,183,572,56,127,0,45.59470198675497,265,39,6.340397350993378,4
Category_Wikipedia_sockpuppets_of_Abd_boubacar.csv,130,5848097.0,59,71,31,28,0,51.353846153846156,215,49,24.23076923076923,6
Category_Wikipedia_sockpuppets_of_Tha.wave.csv,228,8123269.0,98,130,95,3,0,40.46491228070175,268,59,21.842105263157894,8
Category_Wikipedia_sockpuppets_of_C.Gesualdo.csv,2169,96659251.0,679,1490,468,211,0,52.25680036883357,993,64,23.4536652835408,4
Category_Wikipedia_sockpuppets_of_Hari7773.csv,225,288454.0,80,145,34,46,0,49.82222222222222,326,46,17.95111111111111,6
Category_Wikipedia_sockpuppets_of_Chyah.csv,1497,46685881.0,592,905,500,92,0,44.816967267869074,255,64,19.62391449565798,4
Category_Wikipedia_sockpuppets_of_Sophisticat.femme.csv,29,84763.0,16,13,13,3,6,48.96551724137931,155,28,15.310344827586206,10
Category_Wikipedia_sockpuppets_of_Gaussisaprick.csv,19,6747.0,6,13,5,1,0,50.89473684210526,147,36,22.31578947368421,20
Category_Wikipedia_sockpuppets_of_Internodeuser.csv,2994,401330011.0,1099,1895,500,599,0,47.79926519706079,255,92,26.051436205744825,4
Category_Wikipedia_sockpuppets_of_ZHU_Yeyi.csv,101,3608603.0,34,67,34,0,0,36.73267326732673,213,83,24.425742574257427,7
Category_Wikipedia_sockpuppets_of_Dani2300.csv,17,273064.0,14,3,12,2,0,53.35294117647059,214,18,11.882352941176471,10
Category_Wikipedia_sockpuppets_of_Soccerumors.csv,413,53595303.0,128,285,32,96,0,49.832929782082324,255,55,17.670702179176754,3
Category_Wikipedia_sockpuppets_of_Muneeb_Bashir_Wani.csv,556,58755346.0,181,375,92,89,0,48.04136690647482,494,55,18.27517985611511,6
Category_Wikipedia_sockpuppets_of_Schmeetman101.csv,1,0.0,1,0,1,0,7,7.0,7,23,23.0,23
Category_Wikipedia_sockpuppets_of_Wikiusername02.csv,3,547.0,2,1,2,0,0,7.0,21,47,33.333333333333336,6
Category_Wikipedia_sockpuppets_of_Dodgerman99.csv,79,1596039.0,37,42,34,3,0,36.721518987341774,250,42,22.40506329113924,6
Category_Wikipedia_sockpuppets_of_Swedishtail.csv,45,303662.0,28,17,24,4,0,43.355555555555554,235,23,14.333333333333334,11
Category_Wikipedia_sockpuppets_of_Cibomatto007.csv,281,96271925.0,119,162,70,49,0,65.76512455516014,255,29,14.487544483985765,11
Category_Wikipedia_sockpuppets_of_Evidence-based.csv,5178,37949670.0,1926,3252,500,1426,0,38.302626496716876,255,71,19.665314793356508,3
Category_Wikipedia_sockpuppets_of_Yusuf.Abdullah.csv,1569,19469158.0,532,1037,461,71,0,33.31867431485022,230,50,14.639260675589547,4
Category_Wikipedia_sockpuppets_of_Evleigh.csv,292,99049304.0,104,188,80,24,0,46.195205479452056,281,86,15.969178082191782,5
Category_Wikipedia_sockpuppets_of_Nikoslick.csv,19,8645.0,7,12,6,1,0,66.52631578947368,185,31,18.05263157894737,7
Category_Wikipedia_sockpuppets_of_TruthTellerBoom.csv,23,71251.0,19,4,9,10,0,37.82608695652174,232,38,22.130434782608695,17
Category_Wikipedia_sockpuppets_of_Mukkulam.csv,144,1034190.0,43,101,43,0,0,37.15277777777778,199,44,19.97222222222222,11
Category_Wikipedia_sockpuppets_of_Ladgy.csv,736,105372765.0,276,460,269,7,0,39.4375,264,69,24.782608695652176,9
Category_Wikipedia_sockpuppets_of_Joeperez69.csv,1012,8356614.0,518,494,472,46,0,33.82608695652174,216,74,24.459486166007906,7
Category_Wikipedia_sockpuppets_of_Brooktwn.csv,10,248.0,7,3,2,5,41,62.0,124,15,15.0,15
Category_Wikipedia_sockpuppets_of_WhoWatches.csv,293,5129711.0,126,167,83,43,0,42.996587030716725,200,47,24.501706484641637,15
Category_Wikipedia_sockpuppets_of_Gcra265.csv,3,5159.0,2,1,2,0,0,19.0,57,17,17.0,17
Category_Wikipedia_sockpuppets_of_Turan22.csv,541,2573330.0,211,330,107,104,0,45.195933456561924,253,22,10.275415896487985,5
Category_Wikipedia_sockpuppets_of_Ts4221.csv,846,1415057.0,227,619,57,170,0,53.44444444444444,489,46,17.25531914893617,4
Category_Wikipedia_sockpuppets_of_Wptfe.csv,1052,3925481.0,473,579,385,88,0,34.2148288973384,208,42,18.826045627376427,7
Category_Wikipedia_sockpuppets_of_Pascotam.csv,57,2589401.0,44,13,25,19,0,36.8421052631579,283,44,23.087719298245613,12
Category_Wikipedia_sockpuppets_of_Rouoetyjsjabdb.csv,858,72137165.0,290,568,86,204,0,53.21911421911422,252,55,19.376456876456878,3
Category_Wikipedia_sockpuppets_of_WaheedRathore.csv,286,230265537.0,109,177,69,40,0,61.15384615384615,240,53,18.88111888111888,4
Category_Wikipedia_sockpuppets_of_Walter55000.csv,833,8584967.0,353,480,186,167,0,37.72268907563025,247,49,24.168067226890756,11
Category_Wikipedia_sockpuppets_of_Limkimkeong.csv,98,444240370.0,31,67,29,2,0,48.89795918367347,224,35,10.551020408163266,4
Category_Wikipedia_sockpuppets_of_2020visionintl.csv,93,26919435.0,29,64,19,10,0,39.98924731182796,161,24,16.967741935483872,8
Category_Wikipedia_sockpuppets_of_Sharadraj_Aryal.csv,23,9134853.0,5,18,3,2,0,59.608695652173914,236,26,18.26086956521739,7
Category_Wikipedia_sockpuppets_of_John_Vaselyne.csv,69,42079545.0,31,38,20,11,0,32.91304347826087,254,23,15.579710144927537,13
Category_Wikipedia_sockpuppets_of_Eses2692.csv,26,1067216.0,15,11,6,9,0,47.07692307692308,192,22,17.884615384615383,12
Category_Wikipedia_sockpuppets_of_VideoGamer123456.csv,204,18152804.0,58,146,38,20,0,60.80392156862745,496,52,22.044117647058822,8
Category_Wikipedia_sockpuppets_of_GdzieSiePodzialyTamtePrywatki.csv,457,363451.0,105,352,38,67,0,53.31947483588621,269,59,18.49671772428884,3
Category_Wikipedia_sockpuppets_of_CheezDeez.csv,155,14501104.0,63,92,57,6,0,40.193548387096776,269,54,24.974193548387095,6
Category_Wikipedia_sockpuppets_of_AZAL_QSC.csv,185,92490790.0,79,106,35,44,0,46.61081081081081,255,24,17.88108108108108,17
Category_Wikipedia_sockpuppets_of_Christianjoseph89.csv,662,3624581.0,282,380,214,68,0,37.25075528700906,255,56,21.880664652567976,4
Category_Wikipedia_sockpuppets_of_Andrewreecenaylor25.csv,29,4860.0,14,15,14,0,0,77.06896551724138,216,29,20.0,12
Category_Wikipedia_sockpuppets_of_Asep_Saifuddin.csv,20,335988.0,6,14,3,3,0,23.8,85,33,30.3,24
Category_Wikipedia_sockpuppets_of_Aoac20.csv,62,1418273.0,43,19,43,0,0,14.0,151,23,13.580645161290322,6
Category_Wikipedia_sockpuppets_of_Wikiedituti.csv,216,45019536.0,91,125,44,47,0,44.44444444444444,304,50,15.939814814814815,5
Category_Wikipedia_sockpuppets_of_Jknutson1978.csv,72,294612566.0,19,53,10,9,0,57.625,239,50,32.125,22
Category_Wikipedia_sockpuppets_of_Cymonah2.csv,296,5349299.0,157,139,107,50,0,52.439189189189186,240,53,19.72635135135135,13
Category_Wikipedia_sockpuppets_of_Mohamed_Shifat.csv,151,22454768.0,60,91,16,44,0,63.370860927152314,462,49,25.397350993377483,10
Category_Wikipedia_sockpuppets_of_Armanu211.csv,360,2872384.0,287,73,216,71,0,16.886111111111113,249,29,12.725,3
Category_Wikipedia_sockpuppets_of_Jacksonlikesacousticguitar.csv,92,1779196.0,34,58,12,22,0,50.53260869565217,230,43,19.98913043478261,10
Category_Wikipedia_sockpuppets_of_Fashion_Asian.csv,28,3204628.0,11,17,9,2,0,49.57142857142857,244,29,19.535714285714285,6
Category_Wikipedia_sockpuppets_of_Eipviongll.csv,1122,9568567.0,516,606,500,16,0,58.515151515151516,255,52,17.902852049910873,5
Category_Wikipedia_sockpuppets_of_MAYUR_RATANAPARA.csv,24,34022.0,12,12,11,1,0,17.958333333333332,164,29,16.666666666666668,9
Category_Wikipedia_sockpuppets_of_Chinese-proti.csv,202,175591747.0,73,129,34,39,0,49.381188118811885,255,32,24.143564356435643,15
Category_Wikipedia_sockpuppets_of_Prekyap.csv,42,61434557.0,13,29,12,1,0,53.26190476190476,194,29,24.928571428571427,17
Category_Wikipedia_sockpuppets_of_Ashishpoudel5.csv,14,2925530.0,5,9,5,0,0,44.285714285714285,120,26,18.142857142857142,9
Category_Wikipedia_sockpuppets_of_Christendom2.csv,168,22669206.0,54,114,29,25,0,48.44642857142857,231,52,24.285714285714285,5
Category_Wikipedia_sockpuppets_of_Rambabutejaswi.csv,1443,115603961.0,522,921,500,22,0,45.88981288981289,345,40,14.38946638946639,4
Category_Wikipedia_sockpuppets_of_Ilovetowikiallthetime.csv,13,1037.0,5,8,5,0,0,55.76923076923077,238,15,11.76923076923077,10
Category_Wikipedia_sockpuppets_of_BillJohnson0003.csv,3063,36482445.0,1273,1790,500,773,0,49.809990205680705,250,53,15.612797910545217,3
Category_Wikipedia_sockpuppets_of_Firnasz.csv,1,0.0,1,0,1,0,56,56.0,56,12,12.0,12
Category_Wikipedia_sockpuppets_of_Shinca.csv,836,271958346.0,312,524,60,252,0,35.711722488038276,255,48,17.29066985645933,3
Category_Wikipedia_sockpuppets_of_Fenetrejones.csv,4677,36901696.0,1363,3314,500,863,0,44.583066067992306,500,77,31.44387427838358,5
Category_Wikipedia_sockpuppets_of_Charliee123.csv,86,4274920.0,27,59,16,11,0,46.80232558139535,196,53,23.75581395348837,15
Category_Wikipedia_sockpuppets_of_Eggloff.csv,1037,145789634.0,387,650,244,143,0,49.83220829315333,253,91,24.644165863066537,5
Category_Wikipedia_sockpuppets_of_Elarapeme.csv,35,845434.0,20,15,17,3,0,46.8,127,35,27.142857142857142,17
Category_Wikipedia_sockpuppets_of_Son_of_Zorn.csv,4594,81668915.0,1392,3202,500,892,0,48.078363082281236,456,77,29.95080539834567,6
Category_Wikipedia_sockpuppets_of_Jkxyz.csv,228,76980688.0,81,147,80,1,0,42.175438596491226,187,47,15.285087719298245,11
Category_Wikipedia_sockpuppets_of_Tikendra_Singh_Dhami.csv,94,13053867.0,32,62,14,18,0,45.4468085106383,221,41,19.72340425531915,9
Category_Wikipedia_sockpuppets_of_Piriczki.csv,2175,299576538.0,506,1669,500,6,0,54.5848275862069,255,75,21.85609195402299,8
Category_Wikipedia_sockpuppets_of_Freestylefrappe.csv,7958,52294477.0,2841,5117,500,2341,0,36.478889168132696,249,177,22.5878361397336,3
Category_Wikipedia_sockpuppets_of_Hisham.sherif.csv,2,5353.0,2,0,2,0,0,14.0,28,23,23.0,23
Category_Wikipedia_sockpuppets_of_L'Aquotique.csv,1791,4069833.0,591,1200,151,440,0,50.48967057509771,255,78,22.271915131211614,4
Category_Wikipedia_sockpuppets_of_Nitin_418.csv,70,32738197.0,23,47,15,8,0,47.371428571428574,187,53,24.97142857142857,9
Category_Wikipedia_sockpuppets_of_LM1998.csv,144,1307325.0,40,104,28,12,0,29.95138888888889,177,38,20.40972222222222,9
Category_Wikipedia_sockpuppets_of_Cambria_Math.csv,8618,47163321.0,2917,5701,500,2417,0,55.59723833836157,496,80,20.173009979113484,2
Category_Wikipedia_sockpuppets_of_Sleepgift.csv,30,23922.0,11,19,8,3,0,89.43333333333334,294,36,25.666666666666668,3
Category_Wikipedia_sockpuppets_of_Whaterss.csv,2883,108486536.0,924,1959,500,424,0,50.583766909469304,253,61,20.329171002428026,2
Category_Wikipedia_sockpuppets_of_Critic11.csv,2445,147605897.0,812,1633,500,312,0,48.351738241308794,255,47,16.893660531697343,4
Category_Wikipedia_sockpuppets_of_Red_Emperor.csv,733,55386589.0,245,488,240,5,0,28.09549795361528,266,37,20.552523874488404,14
Category_Wikipedia_sockpuppets_of_XDirtyDuck.csv,74,2597425.0,30,44,28,2,0,36.189189189189186,193,38,23.33783783783784,11
Category_Wikipedia_sockpuppets_of_HashMicro.csv,33,496895.0,10,23,10,0,0,49.45454545454545,251,29,15.0,7
Category_Wikipedia_sockpuppets_of_HistoiredeFrance.csv,14,2841091.0,4,10,3,1,0,42.285714285714285,126,33,21.785714285714285,14
Category_Wikipedia_sockpuppets_of_LegitimateProfit.csv,760,54717090.0,275,485,151,124,0,58.97631578947368,444,45,23.08815789473684,6
Category_Wikipedia_sockpuppets_of_Remenu.csv,1091,79904086.0,510,581,500,10,0,40.11549037580202,254,33,11.580201649862511,6
Category_Wikipedia_sockpuppets_of_Sheikhkhan123.csv,71,1848027.0,20,51,11,9,0,63.605633802816904,159,53,28.95774647887324,15
Category_Wikipedia_sockpuppets_of_SecretChiefs3.csv,1259,55115951.0,508,751,361,147,0,36.594122319301036,200,54,14.89515488482923,3
Category_Wikipedia_sockpuppets_of_Funnynick2590.csv,410,13644387.0,132,278,102,30,0,53.07073170731707,383,47,30.682926829268293,13
Category_Wikipedia_sockpuppets_of_JohnEricHiggs.csv,1003,11925038.0,271,732,263,8,0,51.45762711864407,376,59,18.48853439680957,1
Category_Wikipedia_sockpuppets_of_Nonamemv.csv,202,2256782.0,198,4,151,47,0,10.0,144,21,19.22772277227723,16
Category_Wikipedia_sockpuppets_of_Anshsaini0304.csv,1432,17194399.0,559,873,494,65,0,46.23184357541899,468,54,18.4231843575419,5
Category_Wikipedia_sockpuppets_of_Toronto2503.csv,2263,16953209.0,1250,1013,500,750,0,34.59787892178524,234,55,20.196641626159966,5
Category_Wikipedia_sockpuppets_of_Jessica_.D._Smith.csv,91,8200924.0,56,35,41,15,0,37.10989010989011,251,42,29.439560439560438,23
Category_Wikipedia_sockpuppets_of_Bondme7.csv,347,12108125.0,123,224,75,48,0,40.70317002881844,234,43,14.55043227665706,10
Category_Wikipedia_sockpuppets_of_Katherinemansfield.csv,1,0.0,1,0,1,0,16,16.0,16,19,19.0,19
Category_Wikipedia_sockpuppets_of_TimySmidge.csv,1061,150874676.0,360,701,309,51,0,33.788878416588126,228,65,20.807728557964186,5
Category_Wikipedia_sockpuppets_of_Megamile.csv,58,1369046.0,31,27,21,10,0,45.53448275862069,187,24,13.586206896551724,9
Category_Wikipedia_sockpuppets_of_Ng1234567.csv,454,19080051.0,126,328,99,27,0,49.1431718061674,494,49,18.938325991189426,7
Category_Wikipedia_sockpuppets_of_Lapitavenator.csv,6592,76900425.0,2611,3981,361,2250,0,47.33950242718446,500,55,14.312348300970873,4
Category_Wikipedia_sockpuppets_of_Radartoothth.csv,4044,31552542.0,1280,2764,500,780,0,34.07121661721068,255,62,17.938674579624134,4
Category_Wikipedia_sockpuppets_of_JohnDenverWilson.csv,4,281.0,3,1,3,0,0,57.5,196,48,44.25,43
Category_Wikipedia_sockpuppets_of_LukeTheSpook.csv,2965,1532847.0,593,2372,500,93,0,42.05193929173693,271,67,22.026306913996628,3
Category_Wikipedia_sockpuppets_of_Roland_Postma.csv,42,31053.0,21,21,21,0,3,60.73809523809524,226,38,15.285714285714286,7
Category_Wikipedia_sockpuppets_of_Wikiwdos.csv,791,25244935.0,256,535,255,1,0,38.13653603034134,237,42,19.012642225031605,3
Category_Wikipedia_sockpuppets_of_Wikitotalmesser.csv,16,1008.0,7,9,7,0,0,39.9375,222,25,22.9375,14
Category_Wikipedia_sockpuppets_of_Borey955.csv,378,56005193.0,112,266,58,54,0,42.63492063492063,500,24,15.12962962962963,8
Category_Wikipedia_sockpuppets_of_Zoyeb_Ahmad.csv,52,16159440.0,27,25,19,8,0,40.23076923076923,196,29,18.73076923076923,5
Category_Wikipedia_sockpuppets_of_Zoynal_Abedin.csv,4,284688.0,2,2,1,1,0,281.75,496,29,25.5,22
Category_Wikipedia_sockpuppets_of_SarahBill1.csv,39,3392235.0,15,24,15,0,0,36.05128205128205,159,51,14.0,7
Category_Wikipedia_sockpuppets_of_KingsOfHearts.csv,2267,32574514.0,635,1632,309,326,0,39.8089986766652,255,90,26.216144684605204,3
Category_Wikipedia_sockpuppets_of_Eiskrahablo.csv,11520,101399814.0,4330,7190,500,3830,0,38.51493055555556,491,59,14.427604166666667,4
Category_Wikipedia_sockpuppets_of_Zenzzz.csv,7,1256.0,6,1,5,1,7,71.71428571428571,156,20,15.571428571428571,12
Category_Wikipedia_sockpuppets_of_Famousv.csv,309,60235359.0,115,194,38,77,0,45.61812297734628,254,53,17.537216828478964,5
Category_Wikipedia_sockpuppets_of_JamesBrierl.csv,2207,5942380.0,961,1246,354,607,0,38.18894426823743,492,66,26.17444494789307,4
Category_Wikipedia_sockpuppets_of_DolphinOfJustice.csv,140,5374910.0,69,71,39,30,0,56.56428571428572,231,51,28.014285714285716,4
Category_Wikipedia_sockpuppets_of_Muhammad_khan23.csv,458,2700209.0,166,292,100,66,0,42.61353711790393,496,49,23.77947598253275,9
Category_Wikipedia_sockpuppets_of_Marutiswift.csv,44,2505094.0,36,8,21,15,0,10.204545454545455,123,19,19.0,19
Category_Wikipedia_sockpuppets_of_Silly_Steve_youtube.csv,40,174736.0,15,25,11,4,0,46.025,219,25,21.8,13
Category_Wikipedia_sockpuppets_of_GeordieWikiEditor.csv,2405,34148392.0,632,1773,287,345,0,45.572557172557175,250,42,14.992099792099792,5
Category_Wikipedia_sockpuppets_of_Winelover22.csv,137,43181335.0,40,97,16,24,0,45.416058394160586,195,51,27.248175182481752,9
Category_Wikipedia_sockpuppets_of_CBDrunkerson.csv,328,3973817.0,115,213,21,94,0,37.00609756097561,199,66,26.11280487804878,6
Category_Wikipedia_sockpuppets_of_Ameertha.csv,15,416468.0,15,0,10,5,0,22.333333333333332,78,27,12.066666666666666,11
Category_Wikipedia_sockpuppets_of_Druge.csv,44,1513.0,20,24,20,0,0,39.27272727272727,196,44,14.681818181818182,7
Category_Wikipedia_sockpuppets_of_Willll4.csv,544,55117989.0,142,402,138,4,0,39.029411764705884,223,99,18.941176470588236,8
Category_Wikipedia_sockpuppets_of_Sarah_Carvalho.csv,4462,57916488.0,1188,3274,500,688,0,46.69654863290005,489,74,24.017705064993276,4
Category_Wikipedia_sockpuppets_of_Yodhheya56.csv,287,20602556.0,90,197,38,52,0,55.926829268292686,465,42,13.564459930313589,4
Category_Wikipedia_sockpuppets_of_M.V.E.i..csv,8056,35769626.0,2882,5174,500,2382,0,33.64014399205561,247,83,21.144116186693147,3
Category_Wikipedia_sockpuppets_of_TadjHolmes.csv,266,1471920.0,98,168,75,23,0,47.890977443609025,243,46,20.353383458646615,8
Category_Wikipedia_sockpuppets_of_Nimbley6.csv,6128,198209965.0,1797,4331,350,1447,0,42.03557441253264,271,53,16.048466057441253,4
Category_Wikipedia_sockpuppets_of_AlfredoEditor.csv,1271,24003777.0,443,828,159,284,0,42.78914240755311,496,60,21.840283241542092,9
Category_Wikipedia_sockpuppets_of_Muhammadusmann.csv,6,8788186.0,2,4,2,0,0,21.0,35,24,22.0,20
Category_Wikipedia_sockpuppets_of_Khattana.csv,894,357142690.0,323,571,152,171,0,37.29642058165548,260,60,19.24384787472036,3
Category_Wikipedia_sockpuppets_of_Ericka120.csv,34,341721.0,16,18,6,10,0,26.529411764705884,163,21,15.294117647058824,11
Category_Wikipedia_sockpuppets_of_BangaloreNorth.csv,2945,57525208.0,1144,1801,500,644,0,45.94125636672326,495,56,19.715110356536503,5
Category_Wikipedia_sockpuppets_of_Cmfoundation.csv,29,197178.0,20,9,11,9,0,43.206896551724135,199,43,27.655172413793103,6
Category_Wikipedia_sockpuppets_of_Prodirman.csv,75,105900162.0,49,26,17,32,0,42.266666666666666,228,20,14.08,14
Category_Wikipedia_sockpuppets_of_KPopHtr.csv,207,7282599.0,101,106,45,56,0,41.04830917874396,247,51,25.468599033816425,14
Category_Wikipedia_sockpuppets_of_Pickleboy47.csv,19,1554553.0,8,11,6,2,0,67.42105263157895,211,17,8.947368421052632,6
Category_Wikipedia_sockpuppets_of_ShaneTrizzy.csv,7,1922097.0,6,1,3,3,0,4.142857142857143,16,21,20.142857142857142,19
Category_Wikipedia_sockpuppets_of_AlertonUSA.csv,9,528222.0,2,7,2,0,0,51.666666666666664,146,27,23.666666666666668,21
Category_Wikipedia_sockpuppets_of_FixingOld.csv,12,2563558.0,5,7,1,4,0,128.91666666666666,496,13,9.666666666666666,9
Category_Wikipedia_sockpuppets_of_EK728.csv,948,12067241.0,499,449,411,88,0,29.332278481012658,255,62,23.39240506329114,6
Category_Wikipedia_sockpuppets_of_Ted_Wilkes.csv,3873,167707285.0,1111,2762,500,611,0,25.836560805577072,217,78,18.21766072811774,4
Category_Wikipedia_sockpuppets_of_Yipperpoodle.csv,19,262769.0,10,9,9,1,0,48.31578947368421,127,27,24.894736842105264,22
Category_Wikipedia_sockpuppets_of_Alexwonderwayne.csv,8,1085.0,4,4,3,1,0,55.625,130,25,21.875,10
Category_Wikipedia_sockpuppets_of_Dr._P_Shyama_Raju.csv,28,453370.0,12,16,11,1,0,43.42857142857143,223,19,12.75,11
Category_Wikipedia_sockpuppets_of_Yauheni_moskov.csv,266,13406683.0,127,139,50,77,0,57.357142857142854,297,44,17.661654135338345,12
Category_Wikipedia_sockpuppets_of_Lovelessgirl35.csv,58,1455557.0,18,40,8,10,0,50.37931034482759,205,47,18.362068965517242,7
Category_Wikipedia_sockpuppets_of_Nigel_Sy.csv,913,976877.0,342,571,131,211,0,47.12924424972618,304,60,21.387732749178532,4
Category_Wikipedia_sockpuppets_of_Toqeer_malik.csv,12,249296.0,6,6,4,2,0,93.0,199,18,14.666666666666666,11
Category_Wikipedia_sockpuppets_of_Clancy60.csv,1887,4477266.0,480,1407,187,293,0,33.02066772655008,200,40,18.020137784843666,5
Category_Wikipedia_sockpuppets_of_Kangkungkap.csv,770,19999233.0,263,507,203,60,0,43.972727272727276,373,27,12.638961038961039,5
Category_Wikipedia_sockpuppets_of_Iluvrihanna24.csv,2110,224048642.0,701,1409,263,438,0,41.05450236966825,245,60,17.84644549763033,3
Category_Wikipedia_sockpuppets_of_1_chisper.csv,103,76657132.0,26,77,6,20,0,39.74757281553398,221,41,17.466019417475728,10
Category_Wikipedia_sockpuppets_of_Winetype.csv,790,44788520.0,195,595,165,30,0,50.860759493670884,211,70,14.530379746835443,4
Category_Wikipedia_sockpuppets_of_PigeonFootball.csv,133,20627247.0,43,90,12,31,0,63.097744360902254,228,50,22.330827067669173,9
Category_Wikipedia_sockpuppets_of_Pillow4.csv,2584,3634742.0,851,1733,440,411,0,45.5812693498452,500,43,12.269736842105264,3
Category_Wikipedia_sockpuppets_of_Sascha_Kreiger.csv,1361,45073739.0,505,856,410,95,0,46.360029390154295,248,122,31.706833210874358,4
Category_Wikipedia_sockpuppets_of_Calgo.csv,102,3628090.0,51,51,45,6,0,62.11764705882353,201,25,24.03921568627451,11
Category_Wikipedia_sockpuppets_of_Kolkataemedia6.csv,19,9615.0,10,9,7,3,0,27.94736842105263,101,44,33.526315789473685,13
Category_Wikipedia_sockpuppets_of_AOKuneff.csv,331,15295884.0,102,229,57,45,0,62.779456193353475,353,50,21.68580060422961,12
Category_Wikipedia_sockpuppets_of_Slothhunter.csv,30,85503.0,9,21,5,4,0,85.3,255,30,16.566666666666666,7
Category_Wikipedia_sockpuppets_of_DrTork.csv,17,896153.0,9,8,8,1,0,34.8235294117647,152,23,17.11764705882353,10
Category_Wikipedia_sockpuppets_of_Zinzoo01.csv,554,5667591.0,185,369,95,90,0,50.805054151624546,365,78,25.55956678700361,5
Category_Wikipedia_sockpuppets_of_We_are_the_ZOOperstars!.csv,56,24634879.0,22,34,17,5,0,63.839285714285715,196,34,32.517857142857146,24
Category_Wikipedia_sockpuppets_of_Cambrian_Enterprises.csv,23,166373.0,9,14,2,7,0,52.78260869565217,232,55,16.17391304347826,5
Category_Wikipedia_sockpuppets_of_Frankie0607.csv,1987,313050790.0,525,1462,500,25,0,72.41016607951686,255,82,19.47408152994464,4
Category_Wikipedia_sockpuppets_of_A2004b.csv,314,28042928.0,143,171,37,106,0,37.31528662420382,496,60,24.894904458598727,10
Category_Wikipedia_sockpuppets_of_Navigator1492.csv,64,3286211.0,22,42,7,15,0,52.71875,301,44,25.359375,12
Category_Wikipedia_sockpuppets_of_Bowlsby.csv,16,381.0,10,6,5,5,96,108.25,120,11,11.0,11
Category_Wikipedia_sockpuppets_of_Rakesh_bhumihar.csv,503,20162014.0,228,275,91,137,0,37.24254473161034,494,60,18.576540755467196,5
Category_Wikipedia_sockpuppets_of_Pearllysun.csv,90,366283.0,32,58,32,0,0,35.977777777777774,199,45,26.522222222222222,17
Category_Wikipedia_sockpuppets_of_1999IsCoolNotYou.csv,162,8825587.0,54,108,18,36,0,55.53703703703704,307,37,19.598765432098766,8
Category_Wikipedia_sockpuppets_of_Mauricio80.csv,2045,113958169.0,710,1335,124,586,0,31.80488997555012,265,62,29.330073349633253,9
Category_Wikipedia_sockpuppets_of_Goundermaganprem.csv,47,959478.0,26,21,21,5,0,57.297872340425535,229,24,14.340425531914894,5
Category_Wikipedia_sockpuppets_of_Ranaayyub.csv,21,2807.0,13,8,3,10,0,53.476190476190474,159,14,10.952380952380953,10
Category_Wikipedia_sockpuppets_of_Muvendar.csv,1655,31529174.0,526,1129,500,26,0,46.24773413897281,255,69,17.261631419939576,3
Category_Wikipedia_sockpuppets_of_Microsoftguru.csv,150,17619812.0,60,90,40,20,0,48.346666666666664,326,51,21.62,10
Category_Wikipedia_sockpuppets_of_Orbiston.csv,97,9160075.0,48,49,43,5,0,49.597938144329895,218,22,16.88659793814433,13
Category_Wikipedia_sockpuppets_of_Rmartino873.csv,100,233958.0,42,58,21,21,0,49.18,200,49,19.13,9
Category_Wikipedia_sockpuppets_of_AllStarSun1.csv,349,2612439.0,103,246,74,29,0,43.48137535816619,250,45,22.13753581661891,5
Category_Wikipedia_sockpuppets_of_Juniper_Publishers_LLC.csv,44,1638854.0,13,31,4,9,0,72.0,231,34,20.772727272727273,7
Category_Wikipedia_sockpuppets_of_Johnsmith83.csv,474,3551223.0,152,322,31,121,0,55.107594936708864,489,57,21.109704641350213,6
Category_Wikipedia_sockpuppets_of_Johns17ba.csv,72,224454367.0,18,54,10,8,0,71.61111111111111,404,44,17.40277777777778,10
Category_Wikipedia_sockpuppets_of_BlackflagsofRashidun.csv,105,765070.0,35,70,17,18,0,63.99047619047619,363,41,25.314285714285713,8
Category_Wikipedia_sockpuppets_of_Recorder_XH.csv,105,1823419.0,44,61,31,13,0,47.523809523809526,218,52,20.98095238095238,13
Category_Wikipedia_sockpuppets_of_Berklondo.csv,32,30296310.0,24,8,18,6,0,39.5625,196,45,22.03125,10
Category_Wikipedia_sockpuppets_of_Untoldbastar.csv,710,32657036.0,220,490,171,49,0,47.74084507042254,255,49,16.971830985915492,5
Category_Wikipedia_sockpuppets_of_Curious_boy_km.csv,5078,53065642.0,2012,3066,500,1512,0,46.22646711303663,496,74,26.34895628200079,5
Category_Wikipedia_sockpuppets_of_InYoEyeSucka.csv,15,4051197.0,9,6,6,3,0,66.26666666666667,299,36,22.4,11
Category_Wikipedia_sockpuppets_of_JonCl.csv,75,1755386.0,35,40,21,14,0,36.32,225,17,11.026666666666667,9
Category_Wikipedia_sockpuppets_of_Gabucho181.csv,2455,200284616.0,660,1795,141,519,0,45.59226069246436,313,54,21.728716904276986,5
Category_Wikipedia_sockpuppets_of_627544editor.csv,360,9178275.0,108,252,87,21,0,56.28888888888889,255,41,17.85,4
Category_Wikipedia_sockpuppets_of_Broadcastingandcable1.csv,8,1129832.0,8,0,8,0,0,0.0,0,7,7.0,7
Category_Wikipedia_sockpuppets_of_Aztap.csv,597,475589754.0,229,368,225,4,0,41.97487437185929,253,77,20.504187604690117,10
Category_Wikipedia_sockpuppets_of_Ioan_David.csv,139,4435920.0,79,60,51,28,0,20.107913669064747,206,31,18.928057553956833,4
Category_Wikipedia_sockpuppets_of_Kapspire.csv,1,0.0,1,0,1,0,17,17.0,17,18,18.0,18
Category_Wikipedia_sockpuppets_of_Robert_S.McClain.csv,11,2617.0,4,7,1,3,0,42.90909090909091,152,24,15.181818181818182,5
Category_Wikipedia_sockpuppets_of_Jhonwictor.csv,23,140541.0,11,12,10,1,0,53.0,215,30,18.17391304347826,11
Category_Wikipedia_sockpuppets_of_SinghIsKing123.csv,94,501820.0,60,34,46,14,0,22.585106382978722,237,21,9.617021276595745,7
Category_Wikipedia_sockpuppets_of_Harish_MDU.csv,373,271089808.0,120,253,49,71,0,44.520107238605895,494,54,23.986595174262735,7
Category_Wikipedia_sockpuppets_of_Dciccolella.csv,4,582.0,3,1,3,0,0,7.0,28,31,29.5,25
Category_Wikipedia_sockpuppets_of_EugeneDiamond.csv,22,5631.0,16,6,11,5,0,42.54545454545455,196,45,36.90909090909091,12
Category_Wikipedia_sockpuppets_of_Ceraurus.csv,606,23354673.0,218,388,126,92,0,30.673267326732674,204,63,18.04785478547855,4
Category_Wikipedia_sockpuppets_of_Borates_Today.csv,76,1941072.0,32,44,16,16,0,54.38157894736842,227,32,12.763157894736842,5
Category_Wikipedia_sockpuppets_of_Nas_daily_Daily_Uff.csv,72,2908655.0,27,45,14,13,0,49.013888888888886,255,47,27.305555555555557,11
Category_Wikipedia_sockpuppets_of_PlanespotterA320.csv,4816,57810447.0,1767,3049,500,1267,0,55.9343853820598,511,73,23.56769102990033,3
Category_Wikipedia_sockpuppets_of_Wikilatti_Tuturial.csv,258,269010.0,93,165,86,7,0,52.77906976744186,341,35,17.089147286821706,4
Category_Wikipedia_sockpuppets_of_Dismant39.csv,1587,51598569.0,604,983,488,116,0,35.01134215500945,307,36,15.181474480151229,4
Category_Wikipedia_sockpuppets_of_Phnom_Penh_Skyline.csv,930,157287387.0,404,526,60,344,0,52.36989247311828,503,53,21.913978494623656,4
Category_Wikipedia_sockpuppets_of_Kawsar_Ahmed_Amarwap.csv,8,199856164.0,4,4,2,2,0,74.75,196,30,26.5,6
Category_Wikipedia_sockpuppets_of_George_Russell_1.csv,29,268228.0,14,15,9,5,0,49.58620689655172,152,21,16.448275862068964,12
Category_Wikipedia_sockpuppets_of_Ryancoke1978.csv,468,18102389.0,201,267,194,7,0,39.335470085470085,232,53,26.303418803418804,11
Category_Wikipedia_sockpuppets_of_CentristFiasco.csv,1355,33942302.0,464,891,69,395,0,61.964575645756454,250,62,21.498154981549817,7
Category_Wikipedia_sockpuppets_of_CastleFineArt.csv,44,365179.0,36,8,29,7,0,19.613636363636363,125,23,13.886363636363637,12
Category_Wikipedia_sockpuppets_of_Abbakahr.csv,87,9715447.0,29,58,10,19,0,48.252873563218394,196,29,16.942528735632184,13
Category_Wikipedia_sockpuppets_of_JohnTombs48.csv,721,5446330.0,351,370,264,87,0,34.511789181692095,248,88,28.31761442441054,4
Category_Wikipedia_sockpuppets_of_Ferraralentejo.csv,384,21706208.0,95,289,35,60,0,55.8359375,433,37,12.734375,4
Category_Wikipedia_sockpuppets_of_Nadezda-Tatiania.csv,37,1959.0,13,24,13,0,0,31.7027027027027,156,23,17.62162162162162,5
Category_Wikipedia_sockpuppets_of_Chiikochan.csv,37,85920.0,29,8,21,8,0,18.43243243243243,139,46,16.054054054054053,11
Category_Wikipedia_sockpuppets_of_Thelordofsword.csv,997,16822625.0,367,630,253,114,0,64.69207622868606,497,62,23.749247743229688,8
Category_Wikipedia_sockpuppets_of_Sarah_1940.csv,728,69569522.0,172,556,18,154,0,47.76373626373626,233,64,18.092032967032967,2
Category_Wikipedia_sockpuppets_of_Mjbmr.csv,1491,323046489.0,563,928,500,63,0,48.74983232729711,395,82,28.00335345405768,4
Category_Wikipedia_sockpuppets_of_Jawico666.csv,130,23438196.0,48,82,25,23,0,58.146153846153844,467,31,19.515384615384615,8
Category_Wikipedia_sockpuppets_of_Casaitalianadellusso.csv,70,222975.0,44,26,7,37,0,52.77142857142857,196,48,32.22857142857143,11
Category_Wikipedia_sockpuppets_of_JayMithila.csv,1934,11859293.0,780,1154,500,280,0,47.63236814891417,496,74,28.713547052740434,5
Category_Wikipedia_sockpuppets_of_Apifara.csv,415,24741961.0,177,238,75,102,0,41.43855421686747,322,65,15.443373493975903,5
Category_Wikipedia_sockpuppets_of_SAMAR_FIRDOS_ASHRAF_(ASHRAF_ALAM).csv,1554,69852715.0,555,999,460,95,0,36.49034749034749,394,52,34.52831402831403,9
Category_Wikipedia_sockpuppets_of_DTMGO.csv,2839,82726189.0,1000,1839,500,500,0,54.13067981683692,495,81,25.093694963015146,4
Category_Wikipedia_sockpuppets_of_KyubiVash.csv,40,4406152.0,17,23,17,0,0,29.075,200,14,9.125,9
Category_Wikipedia_sockpuppets_of_ABeeez.csv,14,54795.0,9,5,5,4,0,27.142857142857142,133,43,23.285714285714285,13
Category_Wikipedia_sockpuppets_of_Goluce.csv,34,32139204.0,9,25,9,0,0,84.23529411764706,484,42,23.941176470588236,10
Category_Wikipedia_sockpuppets_of_Kerrykfinley3.csv,28,4234531.0,19,9,12,7,0,45.92857142857143,200,26,24.285714285714285,14
Category_Wikipedia_sockpuppets_of_Deco_Da_Man.csv,566,93400939.0,228,338,222,6,0,36.22968197879859,220,45,19.40459363957597,6
Category_Wikipedia_sockpuppets_of_Enverbius.csv,792,22437599.0,360,432,84,276,0,47.128787878787875,250,38,20.06186868686869,14
Category_Wikipedia_sockpuppets_of_JoeJonas_1233.csv,10,1101643.0,7,3,5,2,0,37.0,138,24,10.5,9
Category_Wikipedia_sockpuppets_of_ZeusIMDB.csv,17,248122.0,9,8,3,6,0,22.176470588235293,76,44,36.64705882352941,19
Category_Wikipedia_sockpuppets_of_Virgil_Vaduva.csv,1881,176397610.0,559,1322,500,59,0,44.367889420521,250,56,18.832535885167463,4
Category_Wikipedia_sockpuppets_of_Danielprashaanth.csv,13,1811921.0,5,8,5,0,0,61.23076923076923,157,30,20.76923076923077,15
Category_Wikipedia_sockpuppets_of_Biggytre.csv,10,7855.0,6,4,6,0,0,12.6,36,50,41.8,9
Category_Wikipedia_sockpuppets_of_Mr._Cookie_715.csv,183,2695623.0,80,103,61,19,0,36.90710382513661,196,45,27.683060109289617,14
Category_Wikipedia_sockpuppets_of_EdelweissofNE.csv,5323,34021410.0,2135,3188,500,1635,0,39.554950216043586,255,50,20.597783204959608,5
Category_Wikipedia_sockpuppets_of_BenAriAtMicrosoft.csv,324,355556809.0,68,256,39,29,0,58.53395061728395,276,42,18.34259259259259,3
Category_Wikipedia_sockpuppets_of_Paschal1999.csv,56,3602858.0,20,36,20,0,0,44.892857142857146,240,56,22.553571428571427,11
Category_Wikipedia_sockpuppets_of_Trekphiler.csv,2204,62762708.0,612,1592,500,112,0,61.23820326678766,390,70,20.327132486388386,3
Category_Wikipedia_sockpuppets_of_Rex65mya.csv,936,34159474.0,341,595,247,94,0,54.10683760683761,500,45,15.165598290598291,5
Category_Wikipedia_sockpuppets_of_Drkevins.csv,54,302059.0,47,7,42,5,0,25.64814814814815,166,29,29.0,29
Category_Wikipedia_sockpuppets_of_AliHyderJunejo.csv,970,67842835.0,299,671,84,215,0,49.08659793814433,500,45,15.631958762886597,3
Category_Wikipedia_sockpuppets_of_S_joesph.csv,34,191911.0,18,16,15,3,0,66.91176470588235,287,54,30.264705882352942,18
Category_Wikipedia_sockpuppets_of_Jean_Girard.csv,109,86705202.0,32,77,17,15,0,44.22935779816514,199,43,23.513761467889907,10
Category_Wikipedia_sockpuppets_of_Cpzphantom.csv,1904,18878819.0,706,1198,419,287,0,26.29621848739496,250,51,16.38813025210084,4
Category_Wikipedia_sockpuppets_of_Bling2bling.csv,139,4658116.0,120,19,43,77,0,30.9568345323741,186,24,12.899280575539569,11
Category_Wikipedia_sockpuppets_of_StrongDraught.csv,84,1502.0,51,33,36,15,0,101.77380952380952,157,46,19.13095238095238,14
Category_Wikipedia_sockpuppets_of_Mainstreammark.csv,1030,6625170.0,453,577,446,7,0,44.244660194174756,255,46,22.672815533980582,6
Category_Wikipedia_sockpuppets_of_Knight_Archie.csv,3,43677765.0,2,1,1,1,68,108.66666666666667,190,40,28.666666666666668,23
Category_Wikipedia_sockpuppets_of_Howlandroamco.csv,45,533338.0,19,26,11,8,0,42.31111111111111,176,53,26.8,10
Category_Wikipedia_sockpuppets_of_KnightWarrior25.csv,782,5598046.0,320,462,85,235,0,60.4539641943734,256,51,23.00383631713555,7
Category_Wikipedia_sockpuppets_of_Zdefector.csv,189,58576966.0,75,114,40,35,0,44.925925925925924,199,80,21.32804232804233,11
Category_Wikipedia_sockpuppets_of_BacknFresh.csv,231,13915687.0,54,177,14,40,0,58.03896103896104,374,55,16.72294372294372,5
Category_Wikipedia_sockpuppets_of_Banovicmiki14.csv,1412,37764782.0,390,1022,275,115,0,62.66784702549575,500,67,19.509915014164307,3
Category_Wikipedia_sockpuppets_of_Gregory_Clegg.csv,1414,122527035.0,486,928,179,307,0,47.01626591230551,236,68,21.227015558698728,4
Category_Wikipedia_sockpuppets_of_Foundinkualalumpur.csv,212,12655803.0,72,140,39,33,0,54.40094339622642,216,38,15.339622641509434,7
Category_Wikipedia_sockpuppets_of_Francinelumbala.csv,55,424371.0,15,40,10,5,0,58.872727272727275,239,28,20.509090909090908,16
Category_Wikipedia_sockpuppets_of_KatiaQQQ.csv,65,261670.0,34,31,22,12,0,24.0,190,21,17.046153846153846,13
Category_Wikipedia_sockpuppets_of_Senthan21.csv,92,315361787.0,38,54,30,8,0,47.06521739130435,496,19,14.380434782608695,12
Category_Wikipedia_sockpuppets_of_Dr42.csv,1569,32427852.0,547,1022,500,47,0,70.18355640535373,463,62,28.946462715105163,9
Category_Wikipedia_sockpuppets_of_The_Mad_Bomber.csv,1388,13658030.0,440,948,419,21,0,29.079250720461093,200,55,17.90922190201729,3
Category_Wikipedia_sockpuppets_of_Mostafaelgammal.csv,179,520231.0,86,93,81,5,0,43.927374301675975,233,47,17.731843575418996,12
Category_Wikipedia_sockpuppets_of_Medhanshch.csv,945,137486707.0,383,562,279,104,0,39.4973544973545,496,53,16.95026455026455,8
Category_Wikipedia_sockpuppets_of_Ponil.csv,12,66039115.0,4,8,4,0,0,61.333333333333336,144,38,21.5,16
Category_Wikipedia_sockpuppets_of_WarFooting_Sub_Antarctic_H20.csv,59,1936727.0,21,38,12,9,0,57.74576271186441,266,38,17.779661016949152,12
Category_Wikipedia_sockpuppets_of_Malabar_Facts.csv,78,74663287.0,37,41,36,1,0,42.61538461538461,228,23,19.307692307692307,15
Category_Wikipedia_sockpuppets_of_Joseprzprz86.csv,990,57649578.0,417,573,198,219,0,38.96767676767677,254,37,14.164646464646465,5
Category_Wikipedia_sockpuppets_of_Ramarao1234.csv,218,3290245.0,92,126,46,46,0,58.49082568807339,348,40,22.243119266055047,5
Category_Wikipedia_sockpuppets_of_Dyedcuro9.csv,30,4421967.0,11,19,2,9,0,124.26666666666667,500,27,16.9,3
Category_Wikipedia_sockpuppets_of_Patelhime.csv,1537,70941668.0,573,964,500,73,0,35.13793103448276,259,57,18.79245283018868,6
Category_Wikipedia_sockpuppets_of_Vujkovica_brdo.csv,2833,255560776.0,1058,1775,372,686,0,50.560889516413695,347,61,21.699611719025768,9
Category_Wikipedia_sockpuppets_of_SonofFeanor.csv,435,11204889.0,175,260,143,32,0,48.33563218390805,221,47,20.360919540229887,6
Category_Wikipedia_sockpuppets_of_Tbf69.csv,3315,6506534.0,1175,2140,500,675,0,58.67179487179487,499,118,28.250980392156862,3
Category_Wikipedia_sockpuppets_of_Tarook97.csv,8173,49836137.0,2330,5843,500,1830,0,50.018108405726174,500,51,14.875076471307965,3
Category_Wikipedia_sockpuppets_of_Emperato0or.csv,11,2553.0,7,4,6,1,0,47.0,152,16,13.545454545454545,13
Category_Wikipedia_sockpuppets_of_A4516416.csv,867,7521075.0,358,509,226,132,0,64.56862745098039,500,73,34.62053056516724,12
Category_Wikipedia_sockpuppets_of_HONTERMX.csv,253,10197225.0,70,183,24,46,0,53.976284584980235,348,38,14.138339920948617,4
Category_Wikipedia_sockpuppets_of_Koolabhieb.csv,83,18675777.0,35,48,35,0,0,27.265060240963855,177,24,15.566265060240964,11
Category_Wikipedia_sockpuppets_of_Igoryu1993.csv,206,55595386.0,93,113,25,68,0,65.24757281553399,263,45,24.33009708737864,13
Category_Wikipedia_sockpuppets_of_B.B._See_(The_Noose).csv,59,268857.0,52,7,28,24,0,13.813559322033898,45,45,20.06779661016949,10
Category_Wikipedia_sockpuppets_of_Gon4z.csv,3219,32949975.0,1018,2201,500,518,0,34.35570052811432,214,54,15.842808325566946,3
Category_Wikipedia_sockpuppets_of_Selmaflora294.csv,42,86578.0,18,24,17,1,0,25.30952380952381,140,45,27.357142857142858,19
Category_Wikipedia_sockpuppets_of_Doufenheimen.csv,12,3267.0,10,2,7,3,0,14.0,168,25,25.0,25
Category_Wikipedia_sockpuppets_of_Wrk678.csv,745,21697559.0,175,570,139,36,0,42.6993288590604,241,56,30.955704697986576,6
Category_Wikipedia_sockpuppets_of_Ramki01061966.csv,22,38186.0,17,5,9,8,0,54.13636363636363,163,18,18.0,18
Category_Wikipedia_sockpuppets_of_Zoxcell.csv,59,358630.0,19,40,13,6,0,39.779661016949156,213,37,20.0,8
Category_Wikipedia_sockpuppets_of_PrincessJoey2024.csv,4,144372.0,3,1,3,0,0,25.75,78,26,26.0,26
Category_Wikipedia_sockpuppets_of_Kenny_usa123.csv,31,4698293.0,10,21,6,4,0,59.32258064516129,207,60,19.35483870967742,11
Category_Wikipedia_sockpuppets_of_Acer735.csv,19,3886.0,16,3,13,3,0,51.473684210526315,116,17,13.842105263157896,12
Category_Wikipedia_sockpuppets_of_Vijaysuthar008877.csv,247,37894684.0,81,166,21,60,0,44.4331983805668,250,51,19.55060728744939,8
Category_Wikipedia_sockpuppets_of_Wadani143.csv,138,3367216.0,50,88,26,24,0,47.55797101449275,376,53,24.333333333333332,7
Category_Wikipedia_sockpuppets_of_Qwertyuiop1212.csv,15,40607.0,10,5,7,3,0,48.733333333333334,226,27,12.466666666666667,8
Category_Wikipedia_sockpuppets_of_Mark_viking.csv,1934,251543830.0,558,1376,500,58,0,63.586349534643226,411,92,27.241468459152017,1
Category_Wikipedia_sockpuppets_of_Curb_Chain.csv,2053,70048746.0,623,1430,500,123,0,50.594252313687285,255,72,21.12323429128105,1
Category_Wikipedia_sockpuppets_of_Lucyintheskywithdada.csv,3421,88340022.0,1266,2155,500,766,0,41.88629055831628,255,111,20.95556854720842,3
Category_Wikipedia_sockpuppets_of_Mwazoo.csv,7,440.0,4,3,3,1,0,71.71428571428571,219,20,20.0,20
Category_Wikipedia_sockpuppets_of_InterHigh12.csv,476,21225420.0,128,348,87,41,0,44.859243697478995,285,44,13.266806722689076,4
Category_Wikipedia_sockpuppets_of_NetruVarai.csv,350,6455670.0,136,214,78,58,0,48.151428571428575,262,44,18.728571428571428,5
Category_Wikipedia_sockpuppets_of_BringSmile.csv,227,6563562.0,89,138,46,43,0,45.37444933920705,253,33,19.83259911894273,4
Category_Wikipedia_sockpuppets_of_Rajaniphysio.csv,1573,107738954.0,454,1119,234,220,0,46.64462809917355,255,67,16.858232676414495,5
Category_Wikipedia_sockpuppets_of_Jotin07.csv,448,44094074.0,134,314,103,31,0,29.691964285714285,210,49,16.359375,9
Category_Wikipedia_sockpuppets_of_NCC17.csv,545,21268250.0,179,366,176,3,0,39.7908256880734,199,29,7.996330275229358,5
Category_Wikipedia_sockpuppets_of_Lucasnac.csv,176,121040885.0,72,104,72,0,0,44.125,249,19,11.994318181818182,8
Category_Wikipedia_sockpuppets_of_Qasimcheema42.csv,134,48732476.0,56,78,56,0,0,48.343283582089555,226,37,23.08955223880597,12
Category_Wikipedia_sockpuppets_of_Unknownkhiladi.csv,12,1957.0,5,7,5,0,0,66.58333333333333,202,21,12.5,6
Category_Wikipedia_sockpuppets_of_Reenakoak.csv,11,1338089.0,4,7,4,0,0,38.90909090909091,90,20,17.454545454545453,13
Category_Wikipedia_sockpuppets_of_Arado_Ar_196.csv,2913,37476123.0,585,2328,500,85,0,73.04977686234123,500,72,15.912118091314795,3
Category_Wikipedia_sockpuppets_of_Vwvu.csv,337,42313025.0,245,92,240,5,0,22.798219584569733,253,47,33.53412462908012,9
Category_Wikipedia_sockpuppets_of_Piandme.csv,2262,123969632.0,740,1522,318,422,0,40.02475685234306,252,78,21.380636604774537,5
Category_Wikipedia_sockpuppets_of_Acacia245.csv,18,40880.0,13,5,10,3,0,57.77777777777778,123,25,25.0,25
Category_Wikipedia_sockpuppets_of_Bullaiytro.csv,1075,59248562.0,424,651,169,255,0,47.08,254,66,21.572093023255814,5
Category_Wikipedia_sockpuppets_of_Deathrocker.csv,120,56059.0,68,52,68,0,0,33.975,142,47,40.108333333333334,23
Category_Wikipedia_sockpuppets_of_Boyhoodjams.csv,10801,67115528.0,3896,6905,500,3396,0,36.02481251735951,343,71,17.863068234422737,3
Category_Wikipedia_sockpuppets_of_Checkin34z.csv,1031,194446746.0,437,594,234,203,0,48.267701260911736,255,26,12.740058195926284,6
Category_Wikipedia_sockpuppets_of_Kura_mahapatro.csv,22,75315188.0,15,7,5,10,0,53.95454545454545,196,53,26.318181818181817,16
Category_Wikipedia_sockpuppets_of_Izendadigitalmarketing.csv,17,96263380.0,4,13,3,1,0,62.11764705882353,177,23,22.352941176470587,16
Category_Wikipedia_sockpuppets_of_FactWriterwoo677.csv,69,344749.0,29,40,16,13,0,61.768115942028984,219,54,28.652173913043477,9
Category_Wikipedia_sockpuppets_of_B9_hummingbird_hovering.csv,1712,423517595.0,567,1145,500,67,0,59.263434579439256,372,64,18.582943925233646,4
Category_Wikipedia_sockpuppets_of_Davidangeleno.csv,59,895116.0,18,41,12,6,0,66.47457627118644,398,48,24.1864406779661,13
Category_Wikipedia_sockpuppets_of_Brett_Cox.csv,3768,57992738.0,1156,2612,500,656,0,48.44161358811041,502,57,12.654723991507431,2
Category_Wikipedia_sockpuppets_of_SoccerElite45.csv,1,0.0,1,0,1,0,28,28.0,28,48,48.0,48
Category_Wikipedia_sockpuppets_of_Yinick.csv,683,90811297.0,291,392,158,133,0,36.68374816983894,207,34,15.669106881405563,5
Category_Wikipedia_sockpuppets_of_Xevres.csv,870,52827449.0,273,597,167,106,0,50.04942528735632,500,54,19.358620689655172,4
Category_Wikipedia_sockpuppets_of_NFL_Star_QB.csv,72,6342955.0,30,42,10,20,0,68.26388888888889,278,75,41.166666666666664,8
Category_Wikipedia_sockpuppets_of_Phabian.csv,65,11929276.0,13,52,13,0,0,54.23076923076923,205,27,12.96923076923077,5
Category_Wikipedia_sockpuppets_of_Ppps2692.csv,133,128476938.0,51,82,46,5,0,40.96992481203007,255,50,17.56390977443609,9
Category_Wikipedia_sockpuppets_of_Changomo.csv,1478,524446890.0,547,931,486,61,0,43.70703653585927,498,47,18.7638700947226,4
Category_Wikipedia_sockpuppets_of_Onlineuser577215.csv,289,54689497.0,100,189,94,6,0,57.844290657439444,496,42,19.31833910034602,10
Category_Wikipedia_sockpuppets_of_Todd_Daring.csv,608,93296703.0,200,408,196,4,0,32.24013157894737,208,39,23.62828947368421,4
Category_Wikipedia_sockpuppets_of_Aureliojohn.csv,387,100846577.0,127,260,116,11,0,54.48062015503876,273,53,21.669250645994833,5
Category_Wikipedia_sockpuppets_of_Kiambu1.csv,73,963238.0,37,36,35,2,0,39.04109589041096,211,44,17.410958904109588,8
Category_Wikipedia_sockpuppets_of_Anthony_Head.csv,198,1438728.0,54,144,36,18,0,25.242424242424242,199,29,14.176767676767676,8
Category_Wikipedia_sockpuppets_of_Thuringowacityrep.csv,1658,126224726.0,509,1149,500,9,0,53.36670687575392,254,58,20.180337756332932,4
Category_Wikipedia_sockpuppets_of_MinderPT.csv,9,953.0,3,6,3,0,0,41.0,226,23,19.77777777777778,12
Category_Wikipedia_sockpuppets_of_LibrarianPerson.csv,206,318253326.0,79,127,56,23,0,44.70388349514563,302,25,15.077669902912621,13
Category_Wikipedia_sockpuppets_of_Ishikaroyy.csv,609,5304669.0,139,470,58,81,0,47.82266009852217,443,50,20.52216748768473,6
Category_Wikipedia_sockpuppets_of_BoxxyBoy.csv,2472,22657546.0,781,1691,500,281,0,46.35113268608414,500,61,20.119741100323626,4
Category_Wikipedia_sockpuppets_of_Syed_amjad08.csv,5350,148870993.0,2045,3305,500,1545,0,48.129719626168225,490,82,22.177383177570093,4
Category_Wikipedia_sockpuppets_of_Keonthetrack1.csv,44,15281368.0,35,9,21,14,9,64.93181818181819,252,17,17.0,17
Category_Wikipedia_sockpuppets_of_Suriwashi.csv,2328,171169539.0,602,1726,302,300,0,49.31314432989691,415,51,17.941580756013746,3
Category_Wikipedia_sockpuppets_of_Widewindow.csv,265,949288.0,108,157,38,70,0,67.71320754716982,251,62,27.18867924528302,6
Category_Wikipedia_sockpuppets_of_Asadul_rasel.csv,146,4120775.0,56,90,49,7,0,54.82876712328767,284,61,16.938356164383563,5
Category_Wikipedia_sockpuppets_of_Khabat4545.csv,1724,97436717.0,795,929,324,471,0,44.39733178654292,496,57,20.18909512761021,5
Category_Wikipedia_sockpuppets_of_R1322.csv,540,4010102.0,178,362,136,42,0,44.23518518518519,333,75,23.024074074074075,4
Category_Wikipedia_sockpuppets_of_Flyingfinn19.csv,446,59896606.0,143,303,68,75,0,45.32286995515695,225,40,20.77578475336323,7
Category_Wikipedia_sockpuppets_of_Juditho123.csv,176,9423935.0,65,111,26,39,0,51.03977272727273,250,47,17.767045454545453,6
Category_Wikipedia_sockpuppets_of_HesAChamp.csv,455,47507650.0,122,333,79,43,0,33.77582417582418,222,35,17.015384615384615,5
Category_Wikipedia_sockpuppets_of_Askebh.csv,613,13714271.0,172,441,77,95,0,37.807504078303424,224,56,22.510603588907014,4
Category_Wikipedia_sockpuppets_of_Finnerz100.csv,90,106482.0,29,61,23,6,0,38.86666666666667,273,37,18.72222222222222,8
Category_Wikipedia_sockpuppets_of_SangeetaMyMagazine.csv,58,4027372.0,25,33,5,20,0,67.27586206896552,196,40,21.79310344827586,8
Category_Wikipedia_sockpuppets_of_Shannon1488.csv,1821,43438471.0,632,1189,346,286,0,42.37232289950577,250,51,19.549697968149367,4
Category_Wikipedia_sockpuppets_of_Darknessitselfflames.csv,183,2609038.0,86,97,55,31,0,152.44808743169398,500,55,36.74863387978142,11
Category_Wikipedia_sockpuppets_of_Ineedanewaccount.csv,151,6051685.0,58,93,22,36,0,49.688741721854306,212,30,18.344370860927153,4
Category_Wikipedia_sockpuppets_of_Bill922.csv,3353,10594040.0,951,2402,118,833,0,48.00984193259767,255,66,16.763793617655832,4
Category_Wikipedia_sockpuppets_of_Irudayaraj_Alias_Suriya.csv,661,2989472.0,190,471,25,165,0,60.081694402420574,495,42,15.004538577912253,3
Category_Wikipedia_sockpuppets_of_Hasp_Sneon.csv,2298,23227486.0,637,1661,255,382,0,42.43080939947781,440,72,17.912097476066144,4
Category_Wikipedia_sockpuppets_of_Therabbit123.csv,313,8542112.0,117,196,48,69,0,42.77955271565495,243,42,21.747603833865814,4
Category_Wikipedia_sockpuppets_of_MF878.csv,62,2947035.0,21,41,12,9,0,53.37096774193548,226,21,15.0,10
Category_Wikipedia_sockpuppets_of_Grayterrygray.csv,31,5110211.0,12,19,6,6,0,30.258064516129032,199,47,39.32258064516129,18
Category_Wikipedia_sockpuppets_of_Urkelkid1978.csv,477,44824514.0,104,373,96,8,0,45.57861635220126,249,38,16.761006289308177,3
Category_Wikipedia_sockpuppets_of_GoldCoaster.csv,1283,180234738.0,317,966,179,138,0,47.79345284489478,265,77,24.37957911145752,5
Category_Wikipedia_sockpuppets_of_Bradmacca007.csv,64,47461440.0,14,50,14,0,0,37.484375,207,23,15.21875,10
Category_Wikipedia_sockpuppets_of_Shakim67.csv,3571,110302768.0,1136,2435,500,636,0,26.727807336880424,221,64,18.42397087650518,3
Category_Wikipedia_sockpuppets_of_Busea.csv,121,15061277.0,50,71,14,36,0,68.57851239669421,493,32,18.47107438016529,13
Category_Wikipedia_sockpuppets_of_Reman_Empire.csv,1519,18674885.0,447,1072,403,44,0,48.58262014483213,495,47,19.781435154707044,4
Category_Wikipedia_sockpuppets_of_International_mercenary.csv,14,196082.0,7,7,5,2,0,44.92857142857143,151,10,8.428571428571429,8
Category_Wikipedia_sockpuppets_of_‡§™‡§æ‡§ü‡§≤‡§ø‡§™‡•Å‡§§‡•ç‡§∞.csv,3973,238559221.0,1667,2306,500,1167,0,44.69242386106217,418,49,15.90359929524289,3
Category_Wikipedia_sockpuppets_of_Boys_beware.csv,8,54477.0,5,3,3,2,0,42.5,136,21,14.25,12
Category_Wikipedia_sockpuppets_of_Lancastria.csv,2849,48739395.0,782,2067,295,487,0,40.72481572481573,255,97,21.65952965952966,3
Category_Wikipedia_sockpuppets_of_Regener.csv,837,80461938.0,337,500,104,233,0,55.42891278375149,250,47,17.44324970131422,5
Category_Wikipedia_sockpuppets_of_Dwltd.csv,101,43950079.0,32,69,14,18,0,42.40594059405941,212,42,20.801980198019802,10
Category_Wikipedia_sockpuppets_of_MY_C0CK.csv,17,1211918.0,10,7,6,4,0,74.52941176470588,208,17,13.117647058823529,6
Category_Wikipedia_sockpuppets_of_Tictok_the_mom.csv,493,23734047.0,320,173,219,101,0,33.281947261663284,493,50,22.892494929006084,8
Category_Wikipedia_sockpuppets_of_Gmann131.csv,41,3500591.0,16,25,12,4,0,47.48780487804878,496,53,24.414634146341463,9
Category_Wikipedia_sockpuppets_of_Webtechc.csv,131,91538656.0,34,97,16,18,0,55.45038167938932,387,44,13.526717557251908,5
Category_Wikipedia_sockpuppets_of_Wiarthurhu.csv,3699,145926299.0,1000,2699,500,500,0,39.47391186807245,250,73,20.979453906461206,3
Category_Wikipedia_sockpuppets_of_Greenfrog23.csv,375,4910591.0,121,254,98,23,0,48.49066666666667,334,48,16.565333333333335,4
Category_Wikipedia_sockpuppets_of_Mormoncrunk.csv,3,67111.0,2,1,1,1,0,24.0,43,10,9.666666666666666,9
Category_Wikipedia_sockpuppets_of_ThreeQuills.csv,33,11542614.0,16,17,16,0,0,56.39393939393939,199,31,15.484848484848484,9
Category_Wikipedia_sockpuppets_of_Yaarann.csv,2150,83138618.0,543,1607,500,43,0,70.25674418604652,500,65,17.253023255813954,3
Category_Wikipedia_sockpuppets_of_DavidStarIsrael7.csv,1006,161803057.0,320,686,289,31,0,45.89662027833002,357,86,20.340954274353876,6
Category_Wikipedia_sockpuppets_of_Sheldybett.csv,1529,44101800.0,505,1024,500,5,0,80.02354480052321,460,80,21.478744277305427,1
Category_Wikipedia_sockpuppets_of_GarethHolteDavies.csv,694,21428130.0,220,474,194,26,0,34.43659942363112,217,75,24.244956772334294,7
Category_Wikipedia_sockpuppets_of_151.118.128.232.csv,129,2543942.0,62,67,27,35,0,32.86821705426357,167,47,23.48062015503876,8
Category_Wikipedia_sockpuppets_of_Truthrealone.csv,69,45496.0,35,34,18,17,0,44.79710144927536,262,27,21.72463768115942,15
Category_Wikipedia_sockpuppets_of_Juko534.csv,103,387799.0,33,70,14,19,0,63.33980582524272,253,28,16.067961165048544,7
Category_Wikipedia_sockpuppets_of_Displaced_Brit.csv,340,1741474.0,116,224,116,0,0,28.058823529411764,195,88,32.48529411764706,5
Category_Wikipedia_sockpuppets_of_Michoball.csv,482,4998334.0,203,279,131,72,0,42.53734439834025,235,50,18.75311203319502,4
Category_Wikipedia_sockpuppets_of_David_Goldensmith_S.csv,30,411490.0,16,14,14,2,0,59.666666666666664,213,17,12.666666666666666,7
Category_Wikipedia_sockpuppets_of_Chubeat8.csv,487,5559104.0,214,273,110,104,0,42.217659137577,212,42,18.37782340862423,5
Category_Wikipedia_sockpuppets_of_Ryan_mohammad.csv,88,12071788.0,30,58,18,12,0,39.22727272727273,177,53,33.73863636363637,12
Category_Wikipedia_sockpuppets_of_Lindodawki.csv,814,152099920.0,365,449,340,25,0,42.345208845208845,255,74,16.12039312039312,2
Category_Wikipedia_sockpuppets_of_Aicykiss.csv,180,12246103.0,81,99,60,21,0,36.8,237,81,19.488888888888887,5
Category_Wikipedia_sockpuppets_of_Wikitiful.csv,18,580525.0,7,11,7,0,0,32.44444444444444,199,43,33.666666666666664,19
Category_Wikipedia_sockpuppets_of_Everetthighschool.csv,74,6476686.0,25,49,18,7,0,48.45945945945946,205,32,18.95945945945946,5
Category_Wikipedia_sockpuppets_of_Digitalican.csv,1654,165752968.0,523,1131,500,23,0,57.06166868198307,244,58,25.106408706166867,9
Category_Wikipedia_sockpuppets_of_WoodsFan.csv,1476,11920307.0,580,896,500,80,0,21.8739837398374,252,47,18.15108401084011,8
Category_Wikipedia_sockpuppets_of_Kirigiri.csv,1301,161643750.0,622,679,500,122,0,50.89777094542659,259,62,16.71022290545734,5
Category_Wikipedia_sockpuppets_of_Cutest_Penguin.csv,85,46696596.0,31,54,31,0,0,57.84705882352941,255,77,34.023529411764706,13
Category_Wikipedia_sockpuppets_of_Cumlord69xxx.csv,9,604.0,4,5,4,0,0,88.0,185,43,18.77777777777778,7
Category_Wikipedia_sockpuppets_of_Texancool.csv,729,23449529.0,264,465,253,11,0,38.18792866941015,255,47,19.545953360768177,5
Category_Wikipedia_sockpuppets_of_Karlvondeutschland.csv,146,5232463.0,57,89,30,27,0,41.34931506849315,188,54,27.82191780821918,13
Category_Wikipedia_sockpuppets_of_Maiyanbu.csv,5,35861.0,4,1,3,1,0,10.6,44,22,20.8,19
Category_Wikipedia_sockpuppets_of_CDveChilliers.csv,1987,10188703.0,969,1018,500,469,0,26.599899345747357,255,38,18.095621540010065,10
Category_Wikipedia_sockpuppets_of_Pulak_Jyoti_Bhuyan.csv,4,339994.0,2,2,1,1,22,30.0,38,19,18.25,18
Category_Wikipedia_sockpuppets_of_Ffunkytownn.csv,13,19764554.0,12,1,5,7,0,90.46153846153847,367,10,10.0,10
Category_Wikipedia_sockpuppets_of_Zulkifl_Agha.csv,80,35238404.0,22,58,12,10,0,49.2125,194,35,17.15,5
Category_Wikipedia_sockpuppets_of_TC89TC.csv,40,528807.0,16,24,5,11,0,40.525,175,21,13.275,10
Category_Wikipedia_sockpuppets_of_Borseter.csv,8,2839.0,4,4,2,2,0,25.0,120,15,12.25,10
Category_Wikipedia_sockpuppets_of_SixMillionStrong.csv,104,534205.0,37,67,31,6,0,82.6923076923077,255,52,19.53846153846154,12
Category_Wikipedia_sockpuppets_of_Teltonika1.csv,7,2001758.0,5,2,3,2,0,10.857142857142858,26,26,23.428571428571427,20
Category_Wikipedia_sockpuppets_of_Navasuv.csv,226,242528675.0,89,137,89,0,0,29.72566371681416,232,30,13.11504424778761,7
Category_Wikipedia_sockpuppets_of_Are_U_Super_Cereal.csv,1094,10716074.0,346,748,116,230,0,46.3382084095064,393,30,13.113345521023765,3
Category_Wikipedia_sockpuppets_of_Rubinkumar.csv,1294,71690854.0,503,791,500,3,0,49.32534775888717,247,83,24.83307573415765,3
Category_Wikipedia_sockpuppets_of_Iammelg.csv,2763,68640043.0,1000,1763,500,500,0,28.825190010857764,253,74,19.610206297502714,5
Category_Wikipedia_sockpuppets_of_ItchyJP.csv,1411,55217126.0,357,1054,94,263,0,46.34372785258682,424,54,19.487597448618,4
Category_Wikipedia_sockpuppets_of_Timur_Komandirskyy.csv,2,1726.0,2,0,1,1,11,26.0,41,23,20.0,17
Category_Wikipedia_sockpuppets_of_Soothsayer79.csv,549,521498048.0,166,383,160,6,0,56.6648451730419,390,126,19.238615664845174,8
Category_Wikipedia_sockpuppets_of_Anatha_Gulati.csv,4616,70377168.0,1729,2887,500,1229,0,52.426993067590985,255,64,20.92894280762565,3
Category_Wikipedia_sockpuppets_of_Drowningseagull.csv,1933,24248425.0,635,1298,500,135,0,52.266942576306256,498,68,36.29953440248319,4
Category_Wikipedia_sockpuppets_of_Wwsurfers.csv,375,204210903.0,129,246,91,38,0,58.224,380,50,15.714666666666666,5
Category_Wikipedia_sockpuppets_of_OrangeJet.csv,1272,5447189.0,339,933,299,40,0,55.3003144654088,481,54,20.62421383647799,7
Category_Wikipedia_sockpuppets_of_AngryBirdy9001.csv,31,10901091.0,14,17,11,3,0,48.32258064516129,210,24,19.516129032258064,17
Category_Wikipedia_sockpuppets_of_Odoveer.csv,387,306952760.0,125,262,92,33,0,40.47803617571059,235,49,20.24547803617571,12
Category_Wikipedia_sockpuppets_of_RobbiemusicGroup.csv,4,402.0,2,2,1,1,0,0.0,0,17,17.0,17
Category_Wikipedia_sockpuppets_of_Nikolas.Sudarpo.csv,6702,70274900.0,1661,5041,481,1180,0,39.94270367054611,255,59,18.19471799462847,3
Category_Wikipedia_sockpuppets_of_DrEdna.csv,386,25625761.0,157,229,90,67,0,66.60103626943005,233,50,20.976683937823836,5
Category_Wikipedia_sockpuppets_of_Aniketdey2116.csv,60,27882383.0,16,44,12,4,0,66.21666666666667,267,45,28.2,6
Category_Wikipedia_sockpuppets_of_Samuel_mathew.csv,194,185427185.0,41,153,21,20,0,55.93298969072165,254,53,18.922680412371133,5
Category_Wikipedia_sockpuppets_of_Bigfatamerican.csv,1,0.0,1,0,1,0,18,18.0,18,25,25.0,25
Category_Wikipedia_sockpuppets_of_Waldemar15.csv,8568,236488701.0,2287,6281,500,1787,0,37.08531746031746,255,69,17.432889822595705,3
Category_Wikipedia_sockpuppets_of_Muhammad_Jalal_al-Din.csv,582,7779829.0,221,361,150,71,0,41.32646048109966,339,39,16.128865979381445,6
Category_Wikipedia_sockpuppets_of_Williewinkie33.csv,96,6950820.0,62,34,61,1,0,29.635416666666668,158,47,14.239583333333334,7
Category_Wikipedia_sockpuppets_of_Vvnrao188.csv,24,7909.0,21,3,16,5,0,40.333333333333336,199,24,19.916666666666668,19
Category_Wikipedia_sockpuppets_of_Generic515.csv,450,7618260.0,149,301,115,34,0,57.95333333333333,451,100,20.555555555555557,4
Category_Wikipedia_sockpuppets_of_Aquamastereditor.csv,9,1077426.0,5,4,3,2,10,31.88888888888889,50,24,22.666666666666668,22
Category_Wikipedia_sockpuppets_of_Apundkofficial.csv,115,396662.0,92,23,82,10,0,31.026086956521738,196,40,24.51304347826087,11
Category_Wikipedia_sockpuppets_of_Ëø∑ËçØÊÄé‰πà‰π∞.csv,13,1357.0,10,3,8,2,0,59.61538461538461,132,24,16.615384615384617,12
Category_Wikipedia_sockpuppets_of_Cristianofigo.csv,277,38183605.0,151,126,33,118,0,52.82671480144404,255,25,13.823104693140793,12
Category_Wikipedia_sockpuppets_of_I_Nyoman_Gede_Anila.csv,2997,28609307.0,1144,1853,500,644,0,45.61561561561562,496,54,23.197864531197865,7
Category_Wikipedia_sockpuppets_of_Yicaichina.csv,1,0.0,1,0,1,0,195,195.0,195,13,13.0,13
Category_Wikipedia_sockpuppets_of_UnitedNationsUnion.csv,116,411529.0,34,82,13,21,0,54.810344827586206,258,34,17.198275862068964,4
Category_Wikipedia_sockpuppets_of_Communiondresses.csv,296,3457874.0,90,206,17,73,0,50.9695945945946,252,45,18.010135135135137,6
Category_Wikipedia_sockpuppets_of_Infozeb.csv,137,59267858.0,33,104,12,21,0,44.77372262773723,187,61,25.802919708029197,4
Category_Wikipedia_sockpuppets_of_Noahjohn.csv,222,237132304.0,69,153,39,30,0,41.52252252252252,227,51,14.175675675675675,7
Category_Wikipedia_sockpuppets_of_PeanutButterMarshmallowTime.csv,1777,323311010.0,513,1264,500,13,0,40.02926280247608,283,85,18.93528418683174,4
Category_Wikipedia_sockpuppets_of_Mohnty143.csv,526,99475734.0,197,329,170,27,0,31.545627376425855,255,64,14.395437262357415,8
Category_Wikipedia_sockpuppets_of_Misconceptions2.csv,2648,411849616.0,891,1757,500,391,0,50.85913897280967,353,67,25.16842900302115,4
Category_Wikipedia_sockpuppets_of_Solidpoop2.csv,119,1752488.0,34,85,30,4,0,54.285714285714285,254,21,14.966386554621849,7
Category_Wikipedia_sockpuppets_of_Damotclese.csv,2136,150670022.0,736,1400,500,236,0,55.27247191011236,264,73,22.09550561797753,5
Category_Wikipedia_sockpuppets_of_Mr_intartok.csv,995,26593449.0,355,640,271,84,0,56.333668341708545,493,58,18.952763819095477,5
Category_Wikipedia_sockpuppets_of_Winner233.csv,220,21428078.0,77,143,18,59,0,39.627272727272725,287,50,19.23181818181818,7
Category_Wikipedia_sockpuppets_of_Chilop.csv,7,261.0,3,4,2,1,0,14.714285714285714,54,19,13.285714285714286,11
Category_Wikipedia_sockpuppets_of_Masckarpone.csv,1296,75958026.0,406,890,110,296,0,52.70987654320987,496,60,19.448302469135804,5
Category_Wikipedia_sockpuppets_of_Dbromage.csv,3506,472787580.0,1002,2504,500,502,0,44.84740444951512,474,74,25.870792926411866,4
Category_Wikipedia_sockpuppets_of_Wojak6.csv,3115,36182524.0,938,2177,500,438,0,47.79069020866773,500,43,17.738362760834672,5
Category_Wikipedia_sockpuppets_of_Eron_Lushaj.csv,330,28089441.0,128,202,51,77,0,52.32727272727273,468,55,19.64848484848485,4
Category_Wikipedia_sockpuppets_of_Ismael866.csv,249,2665538.0,108,141,98,10,0,42.261044176706825,200,38,13.413654618473895,6
Category_Wikipedia_sockpuppets_of_Newyorkrules.csv,160,4609770.0,62,98,43,19,0,40.06875,384,37,24.49375,10
Category_Wikipedia_sockpuppets_of_Vehbikerem2010.csv,1416,7149597.0,540,876,500,40,0,44.24293785310734,494,32,13.75,4
Category_Wikipedia_sockpuppets_of_JayPe.csv,2632,10266052.0,1015,1617,500,515,0,34.55547112462006,259,61,19.036094224924014,4
Category_Wikipedia_sockpuppets_of_TarzanBoy24.csv,1775,9612468.0,619,1156,500,119,0,50.972394366197186,500,59,18.261971830985914,4
Category_Wikipedia_sockpuppets_of_123lel.csv,1115,3112385.0,282,833,206,76,0,56.248430493273545,496,46,13.312107623318386,3
Category_Wikipedia_sockpuppets_of_YuriyMikhaylovskiy.csv,141,102689291.0,35,106,34,1,0,42.36879432624114,230,28,20.163120567375888,6
Category_Wikipedia_sockpuppets_of_Anonymous427.csv,2165,32603873.0,645,1520,500,145,0,43.79214780600462,499,62,25.337644341801386,5
Category_Wikipedia_sockpuppets_of_Tsarisco.csv,1734,209261175.0,470,1264,449,21,0,56.95328719723183,553,60,22.182237600922722,4
Category_Wikipedia_sockpuppets_of_Hashim-afc.csv,1509,226638384.0,523,986,500,23,0,36.57521537442015,436,72,23.754141815772034,5
Category_Wikipedia_sockpuppets_of_Seth_Mason_1.csv,245,8220293.0,86,159,62,24,0,43.20816326530612,367,59,25.66530612244898,5
Category_Wikipedia_sockpuppets_of_Ss34567.csv,24,3896981.0,10,14,4,6,0,45.541666666666664,222,17,9.666666666666666,6
Category_Wikipedia_sockpuppets_of_Bashevis6920.csv,2741,40792107.0,820,1921,439,381,0,49.57716161984677,255,54,15.813571689164538,5
Category_Wikipedia_sockpuppets_of_Solavirum.csv,5426,217344889.0,2002,3424,500,1502,0,44.8560633984519,499,78,21.067453004054553,4
Category_Wikipedia_sockpuppets_of_Mat√≠as2028.csv,1506,99094489.0,384,1122,205,179,0,50.71845949535192,334,62,21.93027888446215,3
Category_Wikipedia_sockpuppets_of_Patriotsdynasty12189.csv,234,68300285.0,86,148,33,53,0,41.53846153846154,201,48,15.320512820512821,6
Category_Wikipedia_sockpuppets_of_POWERFUL_245.csv,5541,81341595.0,2115,3426,500,1615,0,46.32954340371774,500,57,20.520483667208087,5
Category_Wikipedia_sockpuppets_of_checked.csv,1,0.0,1,0,1,0,0,0.0,0,14,14.0,14
Category_Wikipedia_sockpuppets_of_Vibing_&_Chilling.csv,406,28242517.0,132,274,80,52,0,41.08866995073892,335,54,16.071428571428573,8
Category_Wikipedia_sockpuppets_of_Livonia_ainovil.csv,45,5980393.0,13,32,11,2,0,67.31111111111112,240,51,21.022222222222222,8
Category_Wikipedia_sockpuppets_of_Borodainvest.csv,45,80167.0,14,31,13,1,0,43.68888888888889,172,27,22.91111111111111,15
Category_Wikipedia_sockpuppets_of_Wumbotarian.csv,327,2069683.0,98,229,94,4,0,58.62996941896024,255,52,19.015290519877677,4
Category_Wikipedia_sockpuppets_of_Harikaa_Aishwarya.csv,40,5013996.0,21,19,18,3,0,47.575,303,26,21.1,19
Category_Wikipedia_sockpuppets_of_William.bobson.csv,19,11696.0,9,10,5,4,0,46.94736842105263,207,26,17.0,13
Category_Wikipedia_sockpuppets_of_Renamed_user_20200203-001.csv,273,11988085.0,155,118,153,2,0,37.26373626373626,240,56,28.5970695970696,17
Category_Wikipedia_sockpuppets_of_Alireaz.csv,23,10367729.0,9,14,4,5,0,48.78260869565217,160,41,22.043478260869566,17
Category_Wikipedia_sockpuppets_of_TheProudEditor.csv,1422,337526324.0,503,919,500,3,0,47.082981715893105,500,90,21.162447257383967,6
Category_Wikipedia_sockpuppets_of_JoeHynes69.csv,9,117188350.0,7,2,6,1,0,37.22222222222222,197,8,8.0,8
Category_Wikipedia_sockpuppets_of_S536870912.csv,1099,67948711.0,352,747,348,4,0,60.40582347588717,255,63,19.239308462238398,3
Category_Wikipedia_sockpuppets_of_Sud_Solo.csv,269,36027199.0,107,162,82,25,0,44.08550185873606,315,63,14.847583643122677,4
Category_Wikipedia_sockpuppets_of_TamizhRajkumar.csv,357,12121182.0,139,218,131,8,0,39.68627450980392,496,36,20.330532212885153,6
Category_Wikipedia_sockpuppets_of_JunMatsumoto.csv,12,1384858.0,6,6,1,5,16,47.083333333333336,131,13,13.0,13
Category_Wikipedia_sockpuppets_of_G.-M._Cupertino.csv,11915,494889670.0,3737,8178,500,3237,0,39.22215694502728,494,80,23.597817876626102,4
Category_Wikipedia_sockpuppets_of_Janitor102.csv,2970,21696937.0,901,2069,500,401,0,51.15690235690236,496,82,21.075084175084175,2
Category_Wikipedia_sockpuppets_of_Historylover4.csv,3820,183141375.0,1336,2484,500,836,0,51.273298429319375,270,74,19.49633507853403,3
Category_Wikipedia_sockpuppets_of_Moniworld.csv,61,1686792.0,25,36,15,10,0,56.08196721311475,423,44,19.639344262295083,9
Category_Wikipedia_sockpuppets_of_Velogika.csv,41,384439489.0,17,24,10,7,0,42.90243902439025,283,18,17.829268292682926,17
Category_Wikipedia_sockpuppets_of_King_Kurry_II.csv,39,7418106.0,28,11,23,5,0,46.07692307692308,198,33,29.794871794871796,18
Category_Wikipedia_sockpuppets_of_Fixtherecord.csv,31,15469128.0,17,14,10,7,0,46.935483870967744,255,25,19.870967741935484,16
Category_Wikipedia_sockpuppets_of_Mambagoat24.csv,282,39370564.0,78,204,56,22,0,44.812056737588655,386,31,15.695035460992909,8
Category_Wikipedia_sockpuppets_of_Rldmanagement.csv,65,28425.0,21,44,18,3,0,21.2,126,35,24.676923076923078,15
Category_Wikipedia_sockpuppets_of_Iamred1.csv,491,21534392.0,123,368,115,8,0,35.9959266802444,199,60,18.910386965376784,3
Category_Wikipedia_sockpuppets_of_Jones.ava109.csv,30,768543.0,12,18,7,5,0,53.53333333333333,151,13,8.933333333333334,4
Category_Wikipedia_sockpuppets_of_Falconclaw5000.csv,1404,56846264.0,506,898,500,6,0,49.95940170940171,250,65,21.302706552706553,4
Category_Wikipedia_sockpuppets_of_Claritas.csv,7437,103243420.0,2643,4794,500,2143,0,46.41737259647707,255,145,27.150329433911523,2
Category_Wikipedia_sockpuppets_of_Mineraltimer.csv,522,194178837.0,171,351,63,108,0,44.2088122605364,280,50,16.5727969348659,4
Category_Wikipedia_sockpuppets_of_Babamichel.csv,300,17195120.0,100,200,62,38,0,55.053333333333335,226,53,26.936666666666667,10
Category_Wikipedia_sockpuppets_of_Kamal_Afghan01.csv,1472,16760871.0,517,955,163,354,0,52.50679347826087,499,63,20.30638586956522,6
Category_Wikipedia_sockpuppets_of_Alis.Payan.csv,1496,8864679.0,517,979,174,343,0,28.84024064171123,212,37,15.922459893048128,7
Category_Wikipedia_sockpuppets_of_Sanjoy64.csv,1978,23239834.0,792,1186,187,605,0,43.6577350859454,255,70,24.169362992922142,5
Category_Wikipedia_sockpuppets_of_Salamanderindisguise.csv,595,64958480.0,179,416,37,142,0,54.547899159663864,346,63,18.40504201680672,4
Category_Wikipedia_sockpuppets_of_Digi_Kural.csv,153,5808165.0,76,77,30,46,0,48.11764705882353,308,53,28.9281045751634,4
Category_Wikipedia_sockpuppets_of_Dawood.XV.csv,6701,57069797.0,2107,4594,479,1628,0,47.74944038203253,500,92,20.20086554245635,2
Category_Wikipedia_sockpuppets_of_Pesqara.csv,1055,5877080.0,501,554,500,1,0,43.712796208530804,344,64,23.26350710900474,8
Category_Wikipedia_sockpuppets_of_Kunstmolch.csv,308,17917389.0,131,177,83,48,0,46.785714285714285,252,65,18.142857142857142,4
Category_Wikipedia_sockpuppets_of_Velebit.csv,5281,292288498.0,1889,3392,500,1389,0,44.25487597046014,255,56,20.082938837341413,5
Category_Wikipedia_sockpuppets_of_Dusty8686.csv,569,258886504.0,165,404,41,124,0,39.87170474516696,301,45,19.93145869947276,4
Category_Wikipedia_sockpuppets_of_Alvrix3108.csv,1343,26699128.0,421,922,301,120,0,47.68503350707372,437,73,27.32241250930752,6
Category_Wikipedia_sockpuppets_of_SeikoEn.csv,2178,86028975.0,641,1537,471,170,0,39.51010101010101,260,55,16.382460973370065,4
Category_Wikipedia_sockpuppets_of_Leighdean.csv,4,1123.0,3,1,2,1,6,12.0,14,40,40.0,40
Category_Wikipedia_sockpuppets_of_Marcel_Saucet_LCA.csv,14,3160947.0,12,2,6,6,21,85.57142857142857,195,31,13.571428571428571,6
Category_Wikipedia_sockpuppets_of_Snehaprakash07.csv,42,144870.0,29,13,17,12,0,27.857142857142858,121,24,17.833333333333332,14
Category_Wikipedia_sockpuppets_of_KingSheharyarMirza.csv,62,130572858.0,22,40,15,7,0,49.91935483870968,226,41,26.29032258064516,19
Category_Wikipedia_sockpuppets_of_Oyindml.csv,15,804711.0,10,5,6,4,15,36.53333333333333,188,26,20.4,17
Category_Wikipedia_sockpuppets_of_Bnnnperdue.csv,1585,32247273.0,522,1063,500,22,0,39.8403785488959,255,46,18.520504731861198,6
Category_Wikipedia_sockpuppets_of_Marco_santada.csv,43,4587416.0,16,27,12,4,0,50.23255813953488,369,33,30.0,16
Category_Wikipedia_sockpuppets_of_IGuessThisIsAUsernameMaybe.csv,10,58078.0,9,1,9,0,0,12.6,36,20,17.9,13
Category_Wikipedia_sockpuppets_of_Dwainwr123.csv,3079,31083216.0,1218,1861,500,718,0,41.690483923351735,250,86,29.860993829165313,6
Category_Wikipedia_sockpuppets_of_Bri_Kristine.csv,3,1226.0,2,1,1,1,36,103.33333333333333,194,20,19.666666666666668,19
Category_Wikipedia_sockpuppets_of_Atulbahl1986.csv,12,546917.0,9,3,9,0,0,25.416666666666668,131,22,22.0,22
Category_Wikipedia_sockpuppets_of_Mksmothers.csv,403,12359023.0,185,218,165,20,0,39.8014888337469,201,53,19.285359801488834,7
Category_Wikipedia_sockpuppets_of_Richardj5171.csv,39,9163425.0,12,27,7,5,0,46.51282051282051,213,35,16.871794871794872,10
Category_Wikipedia_sockpuppets_of_NatsumiTW.csv,86,2963697.0,41,45,22,19,0,36.69767441860465,329,40,20.53488372093023,4
Category_Wikipedia_sockpuppets_of_Vosizneias.csv,395,7040869.0,202,193,88,114,0,45.89873417721519,255,32,15.281012658227848,7
Category_Wikipedia_sockpuppets_of_Vercetticarl.csv,1858,55335052.0,674,1184,500,174,0,34.818083961248654,250,53,18.532831001076428,4
Category_Wikipedia_sockpuppets_of_Mormonrocks.csv,100,98800089.0,24,76,23,1,0,62.5,268,47,24.68,8
Category_Wikipedia_sockpuppets_of_Kai9045.csv,309,8392964.0,137,172,124,13,0,57.579288025889966,249,43,32.8252427184466,17
Category_Wikipedia_sockpuppets_of_Khangrah.csv,839,136706763.0,260,579,54,206,0,52.785458879618595,242,49,17.107270560190702,3
Category_Wikipedia_sockpuppets_of_Bell_V_Bell.csv,2948,88675020.0,725,2223,284,441,0,36.189280868385346,250,47,16.92842605156038,1
Category_Wikipedia_sockpuppets_of_Lilbadboy312.csv,703,10281686.0,262,441,243,19,0,34.054054054054056,261,42,19.182076813655762,5
Category_Wikipedia_sockpuppets_of_Zed_J_Alexander.csv,1836,64104375.0,509,1327,204,305,0,55.48366013071895,495,88,17.983115468409586,3
Category_Wikipedia_sockpuppets_of_Mellisa97.csv,47,520303.0,34,13,22,12,0,21.46808510638298,199,25,17.340425531914892,10
Category_Wikipedia_sockpuppets_of_Musiclover565.csv,1221,24040239.0,378,843,206,172,0,43.36036036036036,215,50,21.37837837837838,9
Category_Wikipedia_sockpuppets_of_Antoine76000.csv,355,11964739.0,159,196,109,50,0,41.23380281690141,275,21,14.185915492957747,9
Category_Wikipedia_sockpuppets_of_Baby_P's_mum.csv,67,2610.0,31,36,8,23,0,91.35820895522389,232,30,22.597014925373134,14
Category_Wikipedia_sockpuppets_of_Gdffffffffffffffffffff.csv,13,87055.0,11,2,6,5,0,22.53846153846154,246,48,33.76923076923077,11
Category_Wikipedia_sockpuppets_of_Marcelrayduriez.csv,131,71115637.0,31,100,12,19,0,48.50381679389313,363,59,29.572519083969464,9
Category_Wikipedia_sockpuppets_of_Jabbalzar.csv,1464,12093312.0,506,958,259,247,0,26.127732240437158,230,44,15.066939890710383,4
Category_Wikipedia_sockpuppets_of_Connell66.csv,7306,26416258.0,2439,4867,500,1939,0,37.324801532986584,255,81,23.354229400492745,3
Category_Wikipedia_sockpuppets_of_Mikebarias.csv,60,1411823.0,17,43,8,9,0,49.416666666666664,225,28,13.75,4
Category_Wikipedia_sockpuppets_of_Ramesh_kumar_07.csv,89,5493885.0,76,13,47,29,0,11.0,129,20,18.96629213483146,14
Category_Wikipedia_sockpuppets_of_Dixtrix1.csv,1886,120915522.0,623,1263,339,284,0,37.78897136797455,255,72,13.040296924708377,6
Category_Wikipedia_sockpuppets_of_97daviee.csv,99,3898236.0,56,43,46,10,0,18.666666666666668,170,65,52.343434343434346,13
Category_Wikipedia_sockpuppets_of_Ae6yrgbrgygq3456rtf.csv,1,0.0,1,0,1,0,32,32.0,32,20,20.0,20
Category_Wikipedia_sockpuppets_of_Mr._Mega_Mind.csv,8,3264.0,6,2,3,3,0,30.5,142,21,19.75,14
Category_Wikipedia_sockpuppets_of_Gatitoamr12.csv,727,30327005.0,164,563,115,49,0,45.13204951856947,398,51,21.49656121045392,6
Category_Wikipedia_sockpuppets_of_Josprien.csv,176,1998381.0,59,117,41,18,0,54.28977272727273,295,37,18.09659090909091,1
Category_Wikipedia_sockpuppets_of_Loiterton.csv,21,134126.0,6,15,6,0,0,44.857142857142854,181,24,12.904761904761905,6
Category_Wikipedia_sockpuppets_of_MebiusM78.csv,804,30150667.0,412,392,203,209,0,19.114427860696516,261,76,19.672885572139304,7
Category_Wikipedia_sockpuppets_of_TruxtVerified.csv,1618,5054872.0,574,1044,500,74,0,43.17799752781212,500,55,22.876390605686034,6
Category_Wikipedia_sockpuppets_of_Mhhamza123.csv,1,0.0,1,0,1,0,0,0.0,0,20,20.0,20
Category_Wikipedia_sockpuppets_of_Briscoecenter.csv,74,1356988.0,32,42,23,9,0,41.486486486486484,231,22,14.635135135135135,11
Category_Wikipedia_sockpuppets_of_LemonJuice78.csv,2465,97838919.0,801,1664,500,301,0,48.28600405679513,500,53,19.15131845841785,6
Category_Wikipedia_sockpuppets_of_Thiyojs.csv,2571,9568447.0,598,1973,304,294,0,45.71956437183975,376,50,13.20342279268767,3
Category_Wikipedia_sockpuppets_of_SuperSucker.csv,877,142566546.0,380,497,360,20,0,60.370581527936146,338,43,26.389965792474346,7
Category_Wikipedia_sockpuppets_of_Ashish1608.csv,46,6027766.0,13,33,5,8,0,58.54347826086956,214,53,37.73913043478261,15
Category_Wikipedia_sockpuppets_of_Big_Menu_Board_5.csv,72,16968.0,29,43,15,14,0,51.875,224,52,24.84722222222222,5
Category_Wikipedia_sockpuppets_of_Vadodaraaa.csv,87,818840.0,50,37,48,2,0,43.0,209,25,21.24137931034483,8
Category_Wikipedia_sockpuppets_of_Sivakrishna_r_nair.csv,225,119081937.0,113,112,70,43,0,25.56888888888889,255,29,16.44,9
Category_Wikipedia_sockpuppets_of_Dudeperson176123.csv,646,19277066.0,508,138,500,8,0,43.704334365325074,227,43,24.24458204334365,5
Category_Wikipedia_sockpuppets_of_Dubai_Grass_Carpet.csv,3,247749.0,2,1,1,1,0,62.0,176,15,15.0,15
Category_Wikipedia_sockpuppets_of_Cremepuff222.csv,1688,94448688.0,564,1124,500,64,0,47.32642180094787,226,57,21.11196682464455,2
Category_Wikipedia_sockpuppets_of_Deon22brown.csv,21,3743.0,9,12,5,4,10,55.95238095238095,196,33,24.857142857142858,15
Category_Wikipedia_sockpuppets_of_Sufi_Parveen_Bhaaijaan_Chaudhary.csv,48,160768830.0,24,24,9,15,0,36.104166666666664,196,68,25.395833333333332,13
Category_Wikipedia_sockpuppets_of_Shdajkhdkahdkahjk.csv,12,430.0,6,6,6,0,23,119.75,179,24,13.166666666666666,11
Category_Wikipedia_sockpuppets_of_RealHeroRahul.csv,1452,23750579.0,500,952,169,331,0,20.568181818181817,485,41,22.573691460055098,5
Category_Wikipedia_sockpuppets_of_President.USA00.csv,2,63.0,2,0,2,0,0,9.5,19,13,13.0,13
Category_Wikipedia_sockpuppets_of_Musicjournalist71.csv,2,42.0,2,0,2,0,23,23.0,23,10,10.0,10
Category_Wikipedia_sockpuppets_of_Example99.csv,709,45848660.0,291,418,135,156,0,54.63328631875881,496,52,21.440056417489423,3
Category_Wikipedia_sockpuppets_of_Cjk91.csv,232,29368787.0,76,156,75,1,0,36.633620689655174,248,42,13.254310344827585,4
Category_Wikipedia_sockpuppets_of_Danch.csv,43,5641304.0,21,22,12,9,0,59.23255813953488,184,16,16.0,16
Category_Wikipedia_sockpuppets_of_PunkinOutBucks.csv,17,1209.0,6,11,4,2,0,80.17647058823529,193,39,20.941176470588236,3
Category_Wikipedia_sockpuppets_of_Firan_Darok.csv,166,3451550.0,45,121,19,26,0,29.596385542168676,222,35,21.55421686746988,7
Category_Wikipedia_sockpuppets_of_ChocolatePickles.csv,730,28287797.0,161,569,43,118,0,34.01780821917808,232,45,19.73835616438356,6
Category_Wikipedia_sockpuppets_of_Depay11.csv,251,6130296.0,63,188,48,15,0,53.254980079681275,269,33,13.00796812749004,4
Category_Wikipedia_sockpuppets_of_Seafarer_1940.csv,864,67486781.0,277,587,203,74,0,53.561342592592595,348,64,25.047453703703702,8
Category_Wikipedia_sockpuppets_of_Destroyeraa.csv,1511,30930448.0,579,932,500,79,0,53.21906022501655,435,74,29.493712772998016,5
Category_Wikipedia_sockpuppets_of_Comedian_Warmatep.csv,122,29103122.0,41,81,9,32,0,49.18032786885246,285,40,28.598360655737704,17
Category_Wikipedia_sockpuppets_of_Arturootoya27.csv,248,1408110.0,75,173,60,15,0,45.689516129032256,278,51,15.435483870967742,7
Category_Wikipedia_sockpuppets_of_Noyesda.csv,116,24802011.0,71,45,57,14,0,45.53448275862069,181,27,19.224137931034484,18
Category_Wikipedia_sockpuppets_of_Ilikeyouyouyou.csv,74,6033704.0,30,44,15,15,0,59.108108108108105,224,59,20.945945945945947,6
Category_Wikipedia_sockpuppets_of_Pithwilds.csv,175,6944981.0,75,100,72,3,0,44.25142857142857,232,25,10.674285714285714,7
Category_Wikipedia_sockpuppets_of_Pabopa.csv,2211,5321657.0,587,1624,185,402,0,43.65038444142922,226,82,22.937584803256446,5
Category_Wikipedia_sockpuppets_of_Thener3.csv,4,92254.0,3,1,2,1,0,50.75,124,20,16.75,12
Category_Wikipedia_sockpuppets_of_Farticus2000.csv,5,467.0,3,2,3,0,0,0.0,0,33,33.0,33
Category_Wikipedia_sockpuppets_of_LittleSunDragonYang.csv,14,1599.0,6,8,3,3,10,59.214285714285715,151,29,14.285714285714286,10
Category_Wikipedia_sockpuppets_of_ThreeE.csv,1432,58658767.0,530,902,500,30,0,42.32122905027933,218,86,23.75418994413408,2
Category_Wikipedia_sockpuppets_of_Pqktn.csv,588,4384815.0,232,356,163,69,0,41.80102040816327,377,43,19.329931972789115,7
Category_Wikipedia_sockpuppets_of_Moradeldin.csv,67,49372184.0,30,37,20,10,0,70.80597014925372,286,16,6.701492537313433,5
Category_Wikipedia_sockpuppets_of_Shifat.24.csv,38,365664.0,17,21,10,7,0,56.578947368421055,195,39,27.31578947368421,14
Category_Wikipedia_sockpuppets_of_Osatmusic.csv,1302,305156725.0,577,725,500,77,0,40.284946236559136,395,72,19.680491551459294,5
Category_Wikipedia_sockpuppets_of_Anonymousme.csv,50,13442630.0,17,33,17,0,0,53.06,199,47,11.48,7
Category_Wikipedia_sockpuppets_of_SoufianeElBahri2.csv,51,4557791.0,17,34,15,2,0,48.411764705882355,154,53,32.76470588235294,13
Category_Wikipedia_sockpuppets_of_Andyjoe7and8.csv,387,100037912.0,136,251,136,0,0,40.89147286821706,200,54,20.072351421188632,4
Category_Wikipedia_sockpuppets_of_M.Dennis.csv,32,537570.0,23,9,23,0,0,40.1875,196,27,15.5625,13
Category_Wikipedia_sockpuppets_of_1-555-confide.csv,1744,94907556.0,532,1212,500,32,0,49.430045871559635,255,69,18.09919724770642,2
Category_Wikipedia_sockpuppets_of_Safwwefe.csv,4170,234095927.0,1194,2976,500,694,0,43.4189448441247,251,73,18.067865707434052,2
Category_Wikipedia_sockpuppets_of_KoreanWon.csv,111,10535122.0,39,72,28,11,0,42.57657657657658,235,68,27.576576576576578,13
Category_Wikipedia_sockpuppets_of_Phlox.csv,154,17230833.0,44,110,44,0,0,30.584415584415584,162,38,13.558441558441558,8
Category_Wikipedia_sockpuppets_of_Amr_El-Samra.csv,87,306525238.0,34,53,19,15,0,49.41379310344828,260,49,20.586206896551722,16
Category_Wikipedia_sockpuppets_of_Semofolkie.csv,4,197510.0,4,0,2,2,6,11.25,13,47,23.0,15
Category_Wikipedia_sockpuppets_of_ChristwalkWalker.csv,24,2690375.0,8,16,6,2,0,92.79166666666667,237,20,13.166666666666666,9
Category_Wikipedia_sockpuppets_of_GeneralizedMaths.csv,54,10117372.0,17,37,11,6,0,80.57407407407408,397,24,19.462962962962962,15
Category_Wikipedia_sockpuppets_of_Lonewulf44.csv,185,163859332.0,37,148,32,5,0,59.85405405405405,255,21,12.416216216216217,6
Category_Wikipedia_sockpuppets_of_Hgh1985.csv,1746,66723230.0,394,1352,348,46,0,52.769186712485684,495,56,18.605383734249713,3
Category_Wikipedia_sockpuppets_of_ElphionAbraham.csv,259,13791352.0,88,171,70,18,0,68.28185328185329,500,24,9.756756756756756,4
Category_Wikipedia_sockpuppets_of_An08112000.csv,3,66.0,2,1,2,0,0,37.666666666666664,83,37,21.0,13
Category_Wikipedia_sockpuppets_of_Cuty_Pie_Sweetu.csv,5423,106933941.0,1763,3660,500,1263,0,31.949290060851926,559,59,18.575142909828507,3
Category_Wikipedia_sockpuppets_of_Bruce99999.csv,1595,68080862.0,585,1010,181,404,0,40.86144200626959,221,61,21.49717868338558,3
Category_Wikipedia_sockpuppets_of_Taxexpert01.csv,73,44319.0,22,51,21,1,0,60.02739726027397,255,47,17.54794520547945,5
Category_Wikipedia_sockpuppets_of_Woolliment.csv,25,157969.0,9,16,7,2,0,43.48,195,21,20.08,18
Category_Wikipedia_sockpuppets_of_Chinnuabhiram600.csv,1448,74303747.0,551,897,482,69,0,34.005524861878456,304,49,23.793508287292816,6
Category_Wikipedia_sockpuppets_of_TransGobbledygook.csv,1244,16588668.0,521,723,500,21,0,51.263665594855304,500,71,19.279742765273312,4
Category_Wikipedia_sockpuppets_of_Mushupechkar.csv,160,42013783.0,76,84,59,17,0,31.73125,198,53,26.08125,7
Category_Wikipedia_sockpuppets_of_Boolyme.csv,1759,370926885.0,576,1183,500,76,0,53.954519613416714,300,55,18.746446844798182,3
Category_Wikipedia_sockpuppets_of_Nbanic.csv,1911,438104658.0,473,1438,463,10,0,52.80743066457352,446,58,17.65934065934066,4
Category_Wikipedia_sockpuppets_of_Edyancdogg.csv,26,3644623.0,14,12,8,6,0,48.46153846153846,196,45,24.307692307692307,9
Category_Wikipedia_sockpuppets_of_Faltu_Katha.csv,151,1308431.0,52,99,27,25,0,48.688741721854306,237,60,22.986754966887418,8
Category_Wikipedia_sockpuppets_of_Thanika.craftor.csv,4,352247.0,2,2,2,0,0,58.0,196,25,19.5,14
Category_Wikipedia_sockpuppets_of_Gmaxwell.csv,1472,465230873.0,509,963,500,9,0,63.98233695652174,491,70,23.94429347826087,3
Category_Wikipedia_sockpuppets_of_Apelbaum.csv,1484,65434716.0,592,892,219,373,0,35.684636118598384,223,73,21.28032345013477,4
Category_Wikipedia_sockpuppets_of_Walkerdude47.csv,419,20823376.0,110,309,53,57,0,43.859188544152744,338,39,16.632458233890215,5
Category_Wikipedia_sockpuppets_of_Thegodwin6000.csv,236,3893278.0,74,162,48,26,0,43.91101694915254,255,30,13.610169491525424,4
Category_Wikipedia_sockpuppets_of_Shankysupercool.csv,206,6840932.0,47,159,26,21,0,31.58252427184466,255,32,16.616504854368934,6
Category_Wikipedia_sockpuppets_of_Sathishgobi.csv,352,37995499.0,194,158,103,91,0,30.30965909090909,199,47,19.707386363636363,7
Category_Wikipedia_sockpuppets_of_Ijosephgarcia.csv,2,0.0,1,1,1,0,36,36.0,36,23,23.0,23
Category_Wikipedia_sockpuppets_of_Rstmt467.csv,23,68305805.0,7,16,5,2,0,63.0,219,18,9.391304347826088,9
Category_Wikipedia_sockpuppets_of_LOTRrules.csv,2257,11999230.0,733,1524,500,233,0,46.622950819672134,259,113,26.255206025697827,3
Category_Wikipedia_sockpuppets_of_LoudHouseMovie_Fanatic2020305.csv,700,163038308.0,140,560,76,64,0,47.88,357,42,23.15142857142857,6
Category_Wikipedia_sockpuppets_of_Gardez_Bien.csv,511,9231498.0,162,349,103,59,0,34.84931506849315,200,50,19.39334637964775,4
Category_Wikipedia_sockpuppets_of_Kevin_dunne.csv,51,10786.0,37,14,29,8,0,30.745098039215687,151,22,16.901960784313726,12
Category_Wikipedia_sockpuppets_of_Stellas4lunch.csv,1135,6048747.0,394,741,204,190,0,50.57709251101321,250,59,23.442290748898678,5
Category_Wikipedia_sockpuppets_of_Sean135.csv,272,5016715.0,106,166,101,5,0,36.125,288,42,22.856617647058822,5
Category_Wikipedia_sockpuppets_of_LocNguyen.csv,1075,7563127.0,607,468,500,107,0,24.927441860465116,255,53,27.409302325581397,7
Category_Wikipedia_sockpuppets_of_Bob1232098.csv,11,7372.0,10,1,6,4,14,33.45454545454545,150,24,23.09090909090909,23
Category_Wikipedia_sockpuppets_of_Dinosauce2001.csv,1616,40249550.0,494,1122,447,47,0,60.57425742574257,500,81,16.485148514851485,4
Category_Wikipedia_sockpuppets_of_Khameran.csv,232,24789644.0,56,176,15,41,0,68.29741379310344,272,39,15.383620689655173,6
Category_Wikipedia_sockpuppets_of_Membersonlybetheclique.csv,475,6982666.0,123,352,93,30,0,47.24842105263158,376,46,17.490526315789474,2
Category_Wikipedia_sockpuppets_of_AtaurRehman2002.csv,228,8989970.0,82,146,48,34,0,39.96491228070175,233,25,15.5,5
Category_Wikipedia_sockpuppets_of_Theabadi2141.csv,9,80825.0,5,4,3,2,0,43.111111111111114,159,11,11.0,11
Category_Wikipedia_sockpuppets_of_Payexel.csv,1,0.0,1,0,1,0,24,24.0,24,19,19.0,19
Category_Wikipedia_sockpuppets_of_Nokuthula27.csv,9,17659033.0,5,4,4,1,0,49.888888888888886,196,24,22.11111111111111,21
Category_Wikipedia_sockpuppets_of_Baaghjkqahh.csv,6,81829.0,3,3,2,1,0,29.166666666666668,60,21,18.5,18
Category_Wikipedia_sockpuppets_of_Gunnertony01.csv,245,1081104.0,65,180,54,11,0,41.15102040816326,232,73,17.759183673469387,8
Category_Wikipedia_sockpuppets_of_Radidoman.csv,799,111749256.0,278,521,197,81,0,47.62327909887359,500,62,21.06758448060075,7
Category_Wikipedia_sockpuppets_of_JQ_OFFICIAL.csv,29,330354.0,15,14,4,11,0,69.62068965517241,336,47,23.413793103448278,10
Category_Wikipedia_sockpuppets_of_DilHaiChhotaSaChhotiSiAasha.csv,912,10631015.0,307,605,225,82,0,35.69188596491228,496,59,26.702850877192983,6
Category_Wikipedia_sockpuppets_of_Strangesad.csv,1901,32684558.0,564,1337,500,64,0,49.98316675433982,255,57,30.46501841136244,3
Category_Wikipedia_sockpuppets_of_Jmao1.csv,193,43054312.0,66,127,50,16,0,43.590673575129536,199,37,20.077720207253886,10
Category_Wikipedia_sockpuppets_of_Finley22_Waterman.csv,1816,21201025.0,656,1160,166,490,0,43.548458149779734,255,66,22.06057268722467,4
Category_Wikipedia_sockpuppets_of_Manheru.csv,54,692132.0,17,37,15,2,0,53.648148148148145,194,44,12.351851851851851,4
Category_Wikipedia_sockpuppets_of_Leo_Francis_92.csv,1471,35624388.0,615,856,500,115,0,36.337185588035354,516,53,18.647178789938817,6
Category_Wikipedia_sockpuppets_of_BobiSwiftie.csv,1450,17624930.0,516,934,500,16,0,34.05379310344828,255,59,29.215172413793102,9
Category_Wikipedia_sockpuppets_of_ŸÖÿ≠ÿ≥ŸÜ_ÿßÿ≠ŸÖÿØ€å_2022.csv,707,15637791.0,535,172,344,191,0,24.52192362093352,492,64,22.85007072135785,6
Category_Wikipedia_sockpuppets_of_Pranav251216.csv,394,5973113.0,197,197,128,69,0,41.611675126903556,230,41,16.46954314720812,3
Category_Wikipedia_sockpuppets_of_Dan-Shrabi.csv,190,64401597.0,53,137,51,2,0,61.81578947368421,233,35,14.721052631578948,6
Category_Wikipedia_sockpuppets_of_Gibby1242.csv,1011,57367175.0,324,687,252,72,0,38.0702274975272,294,61,23.29080118694362,8
Category_Wikipedia_sockpuppets_of_Elmo2012.csv,26,414480.0,22,4,13,9,0,52.38461538461539,197,17,17.0,17
Category_Wikipedia_sockpuppets_of_Webbjones.csv,1300,15239871.0,679,621,390,289,0,33.43615384615384,254,60,23.453076923076924,11
Category_Wikipedia_sockpuppets_of_SummerRat.csv,632,2726252.0,316,316,314,2,0,45.04430379746835,254,50,20.56645569620253,10
Category_Wikipedia_sockpuppets_of_Akhil.anand.hisar.csv,88,1637602.0,28,60,20,8,0,69.01136363636364,229,26,7.318181818181818,4
Category_Wikipedia_sockpuppets_of_Levinxiong.csv,53,94249.0,14,39,5,9,0,63.16981132075472,200,40,16.943396226415093,11
Category_Wikipedia_sockpuppets_of_Odiumzits.csv,328,3456118.0,138,190,48,90,0,42.75609756097561,271,54,27.539634146341463,13
Category_Wikipedia_sockpuppets_of_Showbiz826.csv,3871,51909032.0,1363,2508,306,1057,0,59.19969000258331,495,76,18.30689744252131,4
Category_Wikipedia_sockpuppets_of_Heyitsmeparitosh.csv,64,3125461.0,20,44,6,14,0,80.859375,358,26,14.015625,7
Category_Wikipedia_sockpuppets_of_Skm2008.csv,18,34713.0,10,8,10,0,20,115.94444444444444,250,18,9.11111111111111,7
Category_Wikipedia_sockpuppets_of_Elighthart.csv,1382,45055451.0,520,862,500,20,0,43.05354558610709,253,85,23.79015918958032,8
Category_Wikipedia_sockpuppets_of_KenKim22228.csv,163,7182461.0,41,122,17,24,0,46.08588957055215,199,31,12.699386503067485,3
Category_Wikipedia_sockpuppets_of_Klocek.csv,2252,241334083.0,686,1566,500,186,0,53.15142095914742,250,60,18.066607460035524,5
Category_Wikipedia_sockpuppets_of_Internationalneta.csv,18,922597.0,14,4,7,7,0,32.666666666666664,186,27,15.444444444444445,14
Category_Wikipedia_sockpuppets_of_Kabirawork.csv,5,82836.0,4,1,4,0,0,124.6,491,20,20.0,20
Category_Wikipedia_sockpuppets_of_SS_Edits.csv,4461,42354142.0,1364,3097,500,864,0,30.88298587760592,496,59,24.64985429275947,5
Category_Wikipedia_sockpuppets_of_Colle.csv,32,246188.0,13,19,7,6,0,36.0625,166,18,7.53125,4
Category_Wikipedia_sockpuppets_of_Zwap2019.csv,1647,11469551.0,651,996,500,151,0,39.71584699453552,517,75,21.485124468731026,5
Category_Wikipedia_sockpuppets_of_Arindami34.csv,231,9076220.0,70,161,49,21,0,57.71861471861472,255,35,17.233766233766232,5
Category_Wikipedia_sockpuppets_of_Efaublas.csv,13,23516661.0,3,10,3,0,0,37.92307692307692,196,33,31.153846153846153,21
Category_Wikipedia_sockpuppets_of_DoubleHammy.csv,1818,28911541.0,551,1267,500,51,0,48.535203520352034,385,63,20.72772277227723,3
Category_Wikipedia_sockpuppets_of_Maxwhr.csv,548,173221545.0,188,360,179,9,0,43.09306569343066,250,54,14.978102189781023,5
Category_Wikipedia_sockpuppets_of_CharliTa.csv,1770,8273462.0,524,1246,500,24,0,24.75367231638418,209,45,15.903389830508475,1
Category_Wikipedia_sockpuppets_of_They_call_me_lily.csv,322,47669022.0,111,211,78,33,0,60.26086956521739,496,53,21.444099378881987,4
Category_Wikipedia_sockpuppets_of_IncompetenceKK.csv,7,6123526.0,5,2,3,2,0,58.57142857142857,161,23,15.142857142857142,12
Category_Wikipedia_sockpuppets_of_Kanak_chandra_sarkar.csv,37,333695.0,9,28,7,2,0,55.432432432432435,215,29,14.297297297297296,10
Category_Wikipedia_sockpuppets_of_Purdya.csv,1218,200595044.0,350,868,310,40,0,38.801313628899834,250,67,24.278325123152708,7
Category_Wikipedia_sockpuppets_of_Lacie_Porilla.csv,3,747093.0,2,1,2,0,0,11.666666666666666,19,12,12.0,12
Category_Wikipedia_sockpuppets_of_Arvatov.csv,323,30587450.0,72,251,40,32,0,20.897832817337463,178,29,11.51702786377709,3
Category_Wikipedia_sockpuppets_of_Beurocraticobama.csv,68,12703400.0,30,38,26,4,0,72.26470588235294,231,27,19.25,8
Category_Wikipedia_sockpuppets_of_Luca_Marco.csv,48,3710351.0,21,27,8,13,0,48.729166666666664,211,26,18.645833333333332,3
Category_Wikipedia_sockpuppets_of_Anthony77600.csv,4118,73874054.0,1116,3002,500,616,0,43.99805730937348,255,52,20.594949004371053,3
Category_Wikipedia_sockpuppets_of_Massimo_Travagli.csv,19,9331461.0,4,15,3,1,0,47.36842105263158,151,19,17.68421052631579,16
Category_Wikipedia_sockpuppets_of_Erik_Linon.csv,2,0.0,1,1,1,0,196,196.0,196,23,23.0,23
Category_Wikipedia_sockpuppets_of_Windows_Official.csv,80,14948794.0,34,46,21,13,0,37.2625,368,29,11.1125,5
Category_Wikipedia_sockpuppets_of_Keith_Bridgeman.csv,1997,174275243.0,482,1515,66,416,0,48.40961442163245,250,54,16.87330996494742,1
Category_Wikipedia_sockpuppets_of_Wikopeduser2.csv,10,489.0,4,6,4,0,0,43.9,184,9,8.8,8
Category_Wikipedia_sockpuppets_of_Finsj.csv,179,318511136.0,37,142,32,5,0,38.597765363128495,227,54,20.329608938547487,10
Category_Wikipedia_sockpuppets_of_Eedino2000.csv,13,5413287.0,9,4,4,5,0,18.384615384615383,76,14,14.0,14
Category_Wikipedia_sockpuppets_of_Bomo28.csv,562,59878018.0,225,337,100,125,0,43.32384341637011,270,47,16.393238434163703,6
Category_Wikipedia_sockpuppets_of_FFGR79.csv,69,1526096.0,32,37,26,6,0,46.666666666666664,235,21,9.608695652173912,7
Category_Wikipedia_sockpuppets_of_Tonystargazer.csv,129,56114917.0,46,83,46,0,0,40.310077519379846,156,39,20.751937984496124,13
Category_Wikipedia_sockpuppets_of_Gobinho.csv,18,35799182.0,7,11,3,4,0,53.44444444444444,106,66,25.11111111111111,17
Category_Wikipedia_sockpuppets_of_Qualitee123.csv,2554,85354365.0,967,1587,500,467,0,40.51409553641347,453,66,19.711041503523884,5
Category_Wikipedia_sockpuppets_of_Whsazdfhnbfxgnh.csv,33,293123.0,23,10,20,3,0,17.939393939393938,158,25,22.545454545454547,18
Category_Wikipedia_sockpuppets_of_Perf1203.csv,43,9514728.0,20,23,12,8,0,30.13953488372093,218,27,12.86046511627907,5
Category_Wikipedia_sockpuppets_of_OPamuk1967b.csv,403,142852446.0,122,281,56,66,0,48.13151364764268,255,34,13.11166253101737,4
Category_Wikipedia_sockpuppets_of_SpencerJameson.csv,30,252209.0,12,18,5,7,0,59.93333333333333,239,53,29.0,5
Category_Wikipedia_sockpuppets_of_Newwikieditorlng.csv,19,181570.0,12,7,9,3,0,59.526315789473685,188,23,16.526315789473685,6
Category_Wikipedia_sockpuppets_of_JohnEC_Jr.csv,398,29934190.0,122,276,118,4,0,54.67085427135678,392,56,14.135678391959798,5
Category_Wikipedia_sockpuppets_of_Ultra_JG_(es).csv,2640,5935293.0,805,1835,500,305,0,22.705303030303032,261,61,25.152651515151515,4
Category_Wikipedia_sockpuppets_of_Cobbsaladin.csv,198,6569690.0,62,136,45,17,0,51.843434343434346,217,66,31.07070707070707,15
Category_Wikipedia_sockpuppets_of_Cebr1979.csv,2083,243166709.0,591,1492,500,91,0,57.060969755160826,414,53,25.11569851176188,4
Category_Wikipedia_sockpuppets_of_DancingPhilosopher.csv,1932,589498762.0,556,1376,500,56,0,49.78778467908903,462,62,18.133022774327124,4
Category_Wikipedia_sockpuppets_of_Evanc1210.csv,66,449117.0,27,39,16,11,0,41.77272727272727,204,22,17.075757575757574,8
Category_Wikipedia_sockpuppets_of_Legaltimes.csv,214,5541097.0,74,140,66,8,0,40.074766355140184,307,53,15.345794392523365,9
Category_Wikipedia_sockpuppets_of_Mister_Collins.csv,1159,16245846.0,384,775,371,13,0,43.07506471095772,248,64,21.766177739430542,5
Category_Wikipedia_sockpuppets_of_LWRH.csv,78,9897.0,30,48,27,3,0,51.55128205128205,231,50,25.384615384615383,10
Category_Wikipedia_sockpuppets_of_Fennomaani.csv,1286,76927415.0,295,991,78,217,0,52.009331259720064,255,57,20.157076205287712,5
Category_Wikipedia_sockpuppets_of_Dede2008.csv,1682,391368597.0,539,1143,500,39,0,55.40011890606421,375,86,19.01605231866825,3
Category_Wikipedia_sockpuppets_of_Free_Belarus.csv,52,8812294.0,11,41,9,2,0,67.75,204,50,29.48076923076923,13
Category_Wikipedia_sockpuppets_of_RomanceLove88.csv,1529,16625406.0,521,1008,500,21,0,44.586657946370174,314,74,19.586003924133422,2
Category_Wikipedia_sockpuppets_of_Obby2000.csv,6,2741.0,3,3,2,1,0,40.0,116,22,14.666666666666666,11
Category_Wikipedia_sockpuppets_of_Purple_flowers_by_default.csv,80,18320318.0,34,46,24,10,0,45.6375,252,30,16.55,10
Category_Wikipedia_sockpuppets_of_ManeuversGold.csv,26,1804398.0,9,17,7,2,11,57.34615384615385,145,21,18.5,16
Category_Wikipedia_sockpuppets_of_RodentofDeath.csv,1202,75677263.0,477,725,474,3,0,52.02828618968386,225,71,28.815307820299502,8
Category_Wikipedia_sockpuppets_of_Ramykhodeir.csv,91,32419226.0,32,59,11,21,0,44.34065934065934,228,34,18.494505494505493,9
Category_Wikipedia_sockpuppets_of_Udom_N._Tantiprasongchai.csv,62,8352866.0,25,37,25,0,0,29.951612903225808,175,30,22.258064516129032,18
Category_Wikipedia_sockpuppets_of_F√¶.csv,1665,113515571.0,520,1145,500,20,0,57.87567567567567,363,89,38.8024024024024,7
Category_Wikipedia_sockpuppets_of_DavidBEKT.csv,34,3536245.0,13,21,10,3,0,39.029411764705884,151,33,18.11764705882353,5
Category_Wikipedia_sockpuppets_of_Rakkid777.csv,103,18892291.0,43,60,25,18,0,51.76699029126213,281,28,16.50485436893204,8
Category_Wikipedia_sockpuppets_of_RomanEmpireXX.csv,57,3812395.0,32,25,19,13,0,38.07017543859649,255,29,21.94736842105263,16
Category_Wikipedia_sockpuppets_of_Rider511.csv,4,2762167.0,2,2,2,0,22,38.0,78,18,18.0,18
Category_Wikipedia_sockpuppets_of_Saihimesh.csv,4436,246765543.0,1581,2855,500,1081,0,35.80590622182146,259,64,20.245040577096482,3
Category_Wikipedia_sockpuppets_of_M.Levy-Happyabout.csv,65,7229977.0,27,38,19,8,0,26.29230769230769,199,35,24.29230769230769,17
Category_Wikipedia_sockpuppets_of_Prof._MagneStormix.csv,1815,6633843.0,478,1337,348,130,0,24.251239669421487,203,48,18.92396694214876,2
Category_Wikipedia_sockpuppets_of_George_Dance.csv,1191,30266910.0,507,684,500,7,0,46.2367758186398,240,57,19.24349286314022,6
Category_Wikipedia_sockpuppets_of_Giubbotto_non_ortodosso.csv,15597,289793504.0,5294,10303,500,4794,0,44.20176957107136,508,61,19.556709623645574,2
Category_Wikipedia_sockpuppets_of_Youngman24.csv,99,42000306.0,28,71,23,5,0,56.76767676767677,216,24,10.282828282828282,6
Category_Wikipedia_sockpuppets_of_Dubaiguy1.csv,101,3144974.0,57,44,31,26,0,42.0990099009901,199,33,19.425742574257427,14
Category_Wikipedia_sockpuppets_of_BrianBeahr.csv,2772,42719996.0,1098,1674,500,598,0,38.74062049062049,260,61,21.08152958152958,8
Category_Wikipedia_sockpuppets_of_Laterzii.csv,127,10783183.0,34,93,7,27,0,46.653543307086615,225,62,21.10236220472441,9
Category_Wikipedia_sockpuppets_of_NancySanchezWinifred.csv,19,7892835.0,9,10,8,1,0,57.10526315789474,236,71,20.63157894736842,4
Category_Wikipedia_sockpuppets_of_Vishal_upaddhyay.csv,20,523223.0,12,8,4,8,2,61.25,496,29,23.25,6
Category_Wikipedia_sockpuppets_of_CheeseDreams.csv,3017,40112486.0,1223,1794,500,723,0,28.61650646337421,229,89,27.045409347033477,2
Category_Wikipedia_sockpuppets_of_MRZM1234.csv,7,911042.0,5,2,2,3,0,56.285714285714285,153,16,16.0,16
Category_Wikipedia_sockpuppets_of_Geopingo.csv,97,6373037.0,33,64,20,13,0,38.845360824742265,223,28,19.38144329896907,7
Category_Wikipedia_sockpuppets_of_PushpaShivaram.csv,105,71368452.0,54,51,26,28,0,53.86666666666667,348,27,13.523809523809524,10
Category_Wikipedia_sockpuppets_of_Shayomo.csv,20,1439740.0,16,4,13,3,22,42.6,136,24,18.2,17
Category_Wikipedia_sockpuppets_of_Kochewada_cricket_team.csv,2,0.0,1,1,1,0,13,13.0,13,17,17.0,17
Category_Wikipedia_sockpuppets_of_Logologist.csv,3703,57294826.0,1121,2582,500,621,0,32.06211180124224,216,67,18.344045368620037,4
Category_Wikipedia_sockpuppets_of_EllaSue111.csv,10,660407.0,6,4,3,3,0,35.9,115,61,57.6,27
Category_Wikipedia_sockpuppets_of_KZTP47.csv,15,23052.0,7,8,5,2,2,65.86666666666666,294,32,16.333333333333332,10
Category_Wikipedia_sockpuppets_of_ComputerWizKid.csv,6,82954.0,4,2,3,1,4,65.83333333333333,158,22,15.0,8
Category_Wikipedia_sockpuppets_of_Eyb0sspizzapls.csv,1947,46633412.0,549,1398,279,270,0,45.14124293785311,395,90,14.68361581920904,3
Category_Wikipedia_sockpuppets_of_Nicotheus.csv,122,8032635.0,41,81,26,15,0,44.385245901639344,184,27,14.721311475409836,7
Category_Wikipedia_sockpuppets_of_Natoresi.mp1976.csv,60,492217.0,35,25,24,11,0,51.15,194,30,23.366666666666667,13
Category_Wikipedia_sockpuppets_of_CCheadle.csv,8,1788.0,6,2,4,2,14,33.25,81,27,20.25,18
Category_Wikipedia_sockpuppets_of_Lauriacts.csv,268,7844946.0,85,183,20,65,0,53.809701492537314,228,55,16.21268656716418,7
Category_Wikipedia_sockpuppets_of_Yfudspuofg.csv,4,347.0,3,1,2,1,0,36.0,144,5,5.0,5
Category_Wikipedia_sockpuppets_of_Abrown1019.csv,463,3347725.0,133,330,121,12,0,55.6133909287257,491,63,16.555075593952484,1
Category_Wikipedia_sockpuppets_of_Kurdo7aladen.csv,85,8042033.0,44,41,21,23,0,40.48235294117647,496,26,18.623529411764707,15
Category_Wikipedia_sockpuppets_of_NoFakeEditsHere.csv,121,1218455.0,41,80,25,16,0,43.768595041322314,270,16,9.818181818181818,6
Category_Wikipedia_sockpuppets_of_PinPointMedia.csv,2,0.0,1,1,1,0,16,16.0,16,35,35.0,35
Category_Wikipedia_sockpuppets_of_„Éï„Ç©„Ç∏„Éº.csv,32,606955.0,24,8,18,6,0,49.125,135,17,14.5625,10
Category_Wikipedia_sockpuppets_of_Manvith_Marupudi.csv,1863,15536219.0,603,1260,227,376,0,33.16800858829844,461,64,21.73913043478261,3
Category_Wikipedia_sockpuppets_of_Sarower_Sigh_Bhati.csv,257,11815629.0,117,140,49,68,0,64.53696498054475,255,56,34.06225680933852,24
Category_Wikipedia_sockpuppets_of_Nicosec.csv,225,17579365.0,47,178,25,22,0,52.84888888888889,211,54,14.426666666666666,7
Category_Wikipedia_sockpuppets_of_Tahdrummond.csv,43,1468180.0,11,32,9,2,0,47.372093023255815,237,31,14.69767441860465,5
Category_Wikipedia_sockpuppets_of_K.duan2009.csv,24,9853963.0,8,16,6,2,1,52.541666666666664,199,66,33.25,9
Category_Wikipedia_sockpuppets_of_ComingSoonDotCz.csv,72,6866978.0,27,45,14,13,0,54.916666666666664,200,37,17.52777777777778,9
Category_Wikipedia_sockpuppets_of_Ssakcaj.csv,205,3019416.0,111,94,111,0,0,81.20487804878049,190,36,23.546341463414635,13
Category_Wikipedia_sockpuppets_of_Sherwinchua.csv,54,174779.0,45,9,24,21,0,20.796296296296298,163,32,21.88888888888889,16
Category_Wikipedia_sockpuppets_of_Greengate1.csv,12,63164.0,8,4,4,4,0,42.583333333333336,196,12,10.916666666666666,10
Category_Wikipedia_sockpuppets_of_BaltimoreCraft.csv,40,1209334.0,14,26,7,7,0,66.35,263,62,20.75,9
Category_Wikipedia_sockpuppets_of_Kevmc.csv,27,854.0,10,17,7,3,0,56.592592592592595,176,22,10.148148148148149,6
Category_Wikipedia_sockpuppets_of_Indo12122.csv,727,3179175.0,285,442,121,164,0,57.902338376891336,500,51,25.694635488308116,8
Category_Wikipedia_sockpuppets_of_Blaine2020.csv,5541,76894014.0,1583,3958,382,1201,0,66.94477531131565,496,86,20.101606208265657,1
Category_Wikipedia_sockpuppets_of_SamuelM555.csv,2745,208038912.0,671,2074,500,171,0,45.24808743169399,265,43,15.12568306010929,5
Category_Wikipedia_sockpuppets_of_Cordeyn.csv,111,396650.0,45,66,39,6,0,30.82882882882883,192,32,20.10810810810811,12
Category_Wikipedia_sockpuppets_of_DanEmptyWords.csv,52,22460640.0,22,30,18,4,0,82.9423076923077,254,18,12.134615384615385,11
Category_Wikipedia_sockpuppets_of_Navedali_shah.csv,2,51.0,2,0,2,0,0,0.0,0,53,53.0,53
Category_Wikipedia_sockpuppets_of_Sydney_Harbor.csv,340,52742775.0,68,272,41,27,0,54.667647058823526,224,33,13.841176470588236,4
Category_Wikipedia_sockpuppets_of_Crowfurt.csv,148,1210692.0,50,98,32,18,0,66.48648648648648,255,53,26.425675675675677,7
Category_Wikipedia_sockpuppets_of_Ahmed88z.csv,1,0.0,1,0,1,0,0,0.0,0,47,47.0,47
Category_Wikipedia_sockpuppets_of_Michael27ca.csv,75,11649541.0,28,47,28,0,0,41.946666666666665,160,48,22.946666666666665,20
Category_Wikipedia_sockpuppets_of_JimmySales.csv,32,3091.0,10,22,9,1,0,72.03125,169,54,28.65625,12
Category_Wikipedia_sockpuppets_of_Kyle_Sheik_Dark.csv,250,1472109.0,65,185,56,9,0,34.28,199,51,32.66,16
Category_Wikipedia_sockpuppets_of_Prince_Godfather.csv,1382,1958093.0,504,878,500,4,0,27.608538350217078,203,50,14.927641099855283,4
Category_Wikipedia_sockpuppets_of_International_Editor_Shah.csv,2569,214950388.0,926,1643,500,426,0,42.58544180615025,376,62,20.542234332425068,5
Category_Wikipedia_sockpuppets_of_Pie1235.csv,45,517577.0,12,33,9,3,0,70.04444444444445,217,38,17.0,5
Category_Wikipedia_sockpuppets_of_Yooknajibah.csv,213,286400340.0,79,134,61,18,0,53.36150234741784,253,54,19.314553990610328,7
Category_Wikipedia_sockpuppets_of_SyedNaqvi90.csv,2526,213034037.0,580,1946,500,80,0,43.462787015043546,253,49,17.725653206650833,4
Category_Wikipedia_sockpuppets_of_Mehzabin_P_S_Alvi.csv,161,19800281.0,56,105,55,1,0,45.546583850931675,359,58,26.93167701863354,7
Category_Wikipedia_sockpuppets_of_Richinstead.csv,1312,431987781.0,424,888,376,48,0,56.50838414634146,508,76,29.570121951219512,6
Category_Wikipedia_sockpuppets_of_CronusXT.csv,1162,7425154.0,348,814,150,198,0,30.382960413080895,250,52,17.611015490533564,3
Category_Wikipedia_sockpuppets_of_Wikidesks.csv,22,1686605.0,14,8,10,4,0,28.636363636363637,216,21,21.0,21
Category_Wikipedia_sockpuppets_of_AyazSheikhPakistaniPlaybackSinger.csv,2,0.0,1,1,1,0,20,20.0,20,43,43.0,43
Category_Wikipedia_sockpuppets_of_MaxPerry.csv,1714,7703193.0,526,1188,404,122,0,22.037339556592766,223,45,22.83022170361727,4
Category_Wikipedia_sockpuppets_of_Anarul_Islam(Rony).csv,688,6427853.0,289,399,221,68,0,33.67296511627907,255,49,18.8125,4
Category_Wikipedia_sockpuppets_of_Philodemous.csv,196,639162.0,89,107,48,41,0,46.0969387755102,257,52,30.18877551020408,17
Category_Wikipedia_sockpuppets_of_Negitota.csv,374,4857533.0,128,246,62,66,0,84.73529411764706,501,44,18.90106951871658,5
Category_Wikipedia_sockpuppets_of_FeelUs.csv,279,215175577.0,69,210,31,38,0,66.52329749103943,304,38,17.053763440860216,7
Category_Wikipedia_sockpuppets_of_Cokolimbi.csv,45,487130.0,15,30,11,4,0,61.48888888888889,239,38,20.555555555555557,6
Category_Wikipedia_sockpuppets_of_Sandro-gi.csv,41,1606644.0,20,21,15,5,0,36.170731707317074,231,61,26.121951219512194,18
Category_Wikipedia_sockpuppets_of_Gaurarjun.csv,1832,8195639.0,568,1264,187,381,0,55.569868995633186,343,57,16.683951965065503,2
Category_Wikipedia_sockpuppets_of_Zingostar.csv,5221,87006788.0,1853,3368,500,1353,0,33.58437081018962,255,93,21.150737406627083,3
Category_Wikipedia_sockpuppets_of_Stone_put_to_sky.csv,1424,7064749.0,583,841,500,83,0,43.20786516853933,250,66,33.54002808988764,5
Category_Wikipedia_sockpuppets_of_Historyofiran2016.csv,131,26365907.0,93,38,57,36,0,20.450381679389313,196,36,17.732824427480917,6
Category_Wikipedia_sockpuppets_of_Tamerradwan99.csv,145,21239372.0,53,92,34,19,0,48.19310344827586,240,65,26.868965517241378,3
Category_Wikipedia_sockpuppets_of_Saishna96.csv,5028,115002048.0,1885,3143,500,1385,0,43.968178202068415,496,59,17.85063643595863,4
Category_Wikipedia_sockpuppets_of_Abdiaziizho.csv,224,58028448.0,80,144,45,35,0,60.129464285714285,476,65,25.379464285714285,10
Category_Wikipedia_sockpuppets_of_Ligma_balls_65.csv,33,516030.0,13,20,6,7,0,61.18181818181818,319,54,29.87878787878788,22
Category_Wikipedia_sockpuppets_of_IfYouLikeMolotovCocktails.csv,1,0.0,1,0,1,0,62,62.0,62,30,30.0,30
Category_Wikipedia_sockpuppets_of_H2H3fanbase2TP.csv,181,5777112.0,58,123,24,34,0,54.011049723756905,264,47,17.25414364640884,6
Category_Wikipedia_sockpuppets_of_Maxwell_Derwinee.csv,797,6050440.0,264,533,196,68,0,35.707653701380174,230,56,21.57465495608532,4
Category_Wikipedia_sockpuppets_of_GLCFan1.csv,2635,11690863.0,1010,1625,500,510,0,40.81555977229601,255,54,25.733965844402277,7
Category_Wikipedia_sockpuppets_of_Ganaaan.csv,147,2314709.0,36,111,27,9,0,46.136054421768705,203,54,19.006802721088434,4
Category_Wikipedia_sockpuppets_of_Eleemosynary.csv,2640,116014718.0,986,1654,500,486,0,47.43409090909091,250,66,26.179545454545455,6
Category_Wikipedia_sockpuppets_of_Mosslandingpowerplant.csv,80,8710333.0,48,32,37,11,0,40.85,173,13,13.0,13
Category_Wikipedia_sockpuppets_of_Hugo_Refachinho.csv,2088,101464848.0,440,1648,283,157,0,58.91954022988506,492,45,13.852490421455938,3
Category_Wikipedia_sockpuppets_of_The7thdr.csv,3000,46679172.0,1132,1868,500,632,0,49.445,265,84,24.390666666666668,3
Category_Wikipedia_sockpuppets_of_Godstimemusic.csv,5,662.0,4,1,4,0,16,80.6,164,23,23.0,23
Category_Wikipedia_sockpuppets_of_Marios2134454.csv,2089,54118738.0,821,1268,410,411,0,26.527525131641934,253,49,16.951651507898514,8
Category_Wikipedia_sockpuppets_of_XtraEdit.csv,10,2158238.0,7,3,5,2,11,75.4,126,18,18.0,18
Category_Wikipedia_sockpuppets_of_Awudineh.csv,5,1022.0,4,1,4,0,20,71.8,124,34,19.4,8
Category_Wikipedia_sockpuppets_of_DavidEvans8C.csv,1,0.0,1,0,1,0,35,35.0,35,15,15.0,15
Category_Wikipedia_sockpuppets_of_SOLFO.csv,50,1655171.0,46,4,34,12,0,17.88,92,9,9.0,9
Category_Wikipedia_sockpuppets_of_Mazum24.csv,1048,43135923.0,432,616,303,129,0,50.850190839694655,333,57,25.53530534351145,10
Category_Wikipedia_sockpuppets_of_Havesmite.csv,69,5089091.0,27,42,16,11,0,42.08695652173913,197,40,30.594202898550726,25
Category_Wikipedia_sockpuppets_of_AlexLWitt.csv,74,74701929.0,26,48,22,4,0,54.63513513513514,205,47,26.972972972972972,15
Category_Wikipedia_sockpuppets_of_Acp_1987.csv,446,81290006.0,111,335,51,60,0,38.74215246636771,203,68,16.394618834080717,6
Category_Wikipedia_sockpuppets_of_Mrashid364.csv,778,33721168.0,303,475,88,215,0,39.29562982005142,253,68,23.80077120822622,8
Category_Wikipedia_sockpuppets_of_TDRSen.csv,341,1844202.0,197,144,133,64,0,33.78885630498534,296,49,24.777126099706745,7
Category_Wikipedia_sockpuppets_of_Rajpurohit-Veer.csv,72,5095535.0,33,39,29,4,0,84.29166666666667,235,25,13.916666666666666,10
Category_Wikipedia_sockpuppets_of_Tools4Men.csv,221,1562762.0,103,118,18,85,0,51.22171945701358,368,30,20.65158371040724,10
Category_Wikipedia_sockpuppets_of_Matthiasberoli.csv,1435,9166952.0,727,708,500,227,0,35.325435540069684,250,58,22.70383275261324,5
Category_Wikipedia_sockpuppets_of_Ujjalkuri.csv,81,6129203.0,30,51,10,20,0,46.95061728395062,191,49,22.51851851851852,5
Category_Wikipedia_sockpuppets_of_Johnqdillion.csv,228,45507718.0,101,127,41,60,0,38.17982456140351,199,49,19.36842105263158,12
Category_Wikipedia_sockpuppets_of_Postdeleter.csv,10,45286.0,7,3,4,3,15,61.7,178,22,10.8,5
Category_Wikipedia_sockpuppets_of_Hunter2hunter.csv,72,2926328.0,33,39,29,4,0,56.44444444444444,221,27,11.541666666666666,5
Category_Wikipedia_sockpuppets_of_Tere_Mast.csv,501,13574278.0,165,336,79,86,0,46.70259481037924,255,60,23.7624750499002,7
Category_Wikipedia_sockpuppets_of_Gold_heart.csv,2781,63836892.0,776,2005,500,276,0,35.295936713412445,252,56,20.830636461704422,4
Category_Wikipedia_sockpuppets_of_Electroide.csv,1413,13140723.0,520,893,500,20,0,29.452229299363058,265,53,19.981599433828734,4
Category_Wikipedia_sockpuppets_of_Dave_Ramsey.csv,327,26157057.0,85,242,13,72,0,59.95107033639144,255,44,21.388379204892967,12
Category_Wikipedia_sockpuppets_of_Aliyu_Ndagi.csv,417,3495847.0,114,303,107,7,0,60.82254196642686,273,60,15.623501199040767,4
Category_Wikipedia_sockpuppets_of_Idontknow111.csv,46,3191285.0,31,15,17,14,0,47.130434782608695,199,34,21.934782608695652,7
Category_Wikipedia_sockpuppets_of_Praveen_Singh_Rajpoot.csv,14,159105588.0,4,10,4,0,0,45.92857142857143,157,13,12.642857142857142,12
Category_Wikipedia_sockpuppets_of_Christiangarcia726.csv,264,1104774.0,74,190,56,18,0,58.64393939393939,395,47,19.75378787878788,5
Category_Wikipedia_sockpuppets_of_Heavymetalmaniacforever.csv,63,1745333.0,22,41,11,11,0,48.333333333333336,491,36,21.238095238095237,13
Category_Wikipedia_sockpuppets_of_Chelston-temp-1.csv,1354,101134753.0,399,955,386,13,0,70.8685376661743,352,99,30.89290989660266,6
Category_Wikipedia_sockpuppets_of_Greco_dani.csv,935,4512183.0,498,437,345,153,0,29.10053475935829,206,47,13.381818181818181,4
Category_Wikipedia_sockpuppets_of_Runtshit.csv,17541,299626828.0,5294,12247,33,5261,0,45.04469528533151,255,69,15.453622940539308,4
Category_Wikipedia_sockpuppets_of_HRS395.csv,794,49651477.0,500,294,500,0,0,44.68387909319899,248,34,25.122166246851386,11
Category_Wikipedia_sockpuppets_of_Popologyy.csv,24,251198.0,12,12,11,1,0,52.375,226,19,15.875,11
Category_Wikipedia_sockpuppets_of_Myzmyrell.csv,4,2658.0,4,0,4,0,0,12.0,48,14,14.0,14
Category_Wikipedia_sockpuppets_of_ShƒÅnti√°n_T√†il√°ng.csv,1975,14962191.0,606,1369,500,106,0,46.809113924050635,500,71,20.98481012658228,3
Category_Wikipedia_sockpuppets_of_Ameer_Fauri.csv,186,9965354.0,84,102,54,30,0,46.575268817204304,178,47,18.731182795698924,10
Category_Wikipedia_sockpuppets_of_Jsmithn22.csv,84,62909027.0,18,66,13,5,0,34.154761904761905,208,29,18.083333333333332,4
Category_Wikipedia_sockpuppets_of_FilthyKing.csv,20,2221818.0,7,13,5,2,0,33.2,199,22,13.1,10
Category_Wikipedia_sockpuppets_of_Maritzaperez10.csv,93,35726870.0,27,66,2,25,0,55.494623655913976,229,35,22.774193548387096,14
Category_Wikipedia_sockpuppets_of_Ashfaq_nezamani.csv,633,178238774.0,166,467,40,126,0,48.75987361769352,547,41,15.004739336492891,3
Category_Wikipedia_sockpuppets_of_AllThingsTelevision.csv,70,204333.0,48,22,32,16,0,57.4,201,41,27.17142857142857,10
Category_Wikipedia_sockpuppets_of_Matroesjka.csv,2890,139905207.0,885,2005,500,385,0,47.002768166089965,422,68,22.132871972318338,3
Category_Wikipedia_sockpuppets_of_Zyhfiery.csv,4,117659.0,3,1,2,1,0,22.5,35,21,18.5,14
Category_Wikipedia_sockpuppets_of_Nohaata.csv,296,80203240.0,123,173,31,92,0,41.388513513513516,213,23,13.04054054054054,6
Category_Wikipedia_sockpuppets_of_COD_T_3.csv,2372,24784640.0,941,1431,500,441,0,47.10328836424958,255,66,24.596964586846543,11
Category_Wikipedia_sockpuppets_of_MitchHorn.csv,149,266248.0,50,99,23,27,0,53.919463087248324,212,34,19.308724832214764,6
Category_Wikipedia_sockpuppets_of_Left_Nut.csv,12,1150.0,6,6,5,1,0,72.41666666666667,206,7,6.5,5
Category_Wikipedia_sockpuppets_of_Elladog.csv,404,1914588.0,119,285,60,59,0,37.65841584158416,215,33,15.297029702970297,3
Category_Wikipedia_sockpuppets_of_Pbfreespace3.csv,2026,19304162.0,808,1218,500,308,0,94.10365251727542,255,62,34.93139190523198,5
Category_Wikipedia_sockpuppets_of_Marvingroves.csv,1365,16153978.0,444,921,120,324,0,31.63956043956044,237,35,13.134065934065934,2
Category_Wikipedia_sockpuppets_of_JarlaxleArtemis.csv,3133,237733441.0,903,2230,500,403,0,42.72965209064794,253,62,16.792211937440154,1
Category_Wikipedia_sockpuppets_of_Alex_Upadhyay.csv,2,0.0,1,1,1,0,0,0.0,0,15,15.0,15
Category_Wikipedia_sockpuppets_of_Rukshar1293.csv,10,1151.0,10,0,6,4,0,19.6,30,15,15.0,15
Category_Wikipedia_sockpuppets_of_Fouldsy91.csv,348,6876916.0,109,239,51,58,0,45.43390804597701,217,52,16.70689655172414,1
Category_Wikipedia_sockpuppets_of_VishGopi.csv,1345,107454040.0,508,837,500,8,0,36.79182156133829,285,62,14.15910780669145,5
Category_Wikipedia_sockpuppets_of_Lulzmaster.csv,1,0.0,1,0,1,0,0,0.0,0,15,15.0,15
Category_Wikipedia_sockpuppets_of_RAJAGOPALAN_SRINIVASAN.csv,6,106156.0,2,4,1,1,0,43.0,127,53,53.0,53
Category_Wikipedia_sockpuppets_of_Dimror.csv,1697,55310334.0,591,1106,452,139,0,28.278137890394813,199,75,13.106658809664113,6
Category_Wikipedia_sockpuppets_of_Bababa67.csv,912,2325499.0,503,409,500,3,0,26.286184210526315,252,47,17.68201754385965,11
Category_Wikipedia_sockpuppets_of_Helwr.csv,2208,394329110.0,549,1659,500,49,0,51.18115942028985,371,50,17.39673913043478,5
Category_Wikipedia_sockpuppets_of_Spiritualbanda.csv,266,19959137.0,91,175,40,51,0,43.07518796992481,255,60,23.590225563909776,5
Category_Wikipedia_sockpuppets_of_TheEditor2000001.csv,23,7262562.0,8,15,7,1,0,51.21739130434783,231,53,23.695652173913043,16
Category_Wikipedia_sockpuppets_of_Phantasus_Magician.csv,2484,78943887.0,729,1755,229,500,0,33.407407407407405,255,51,17.988727858293075,3
Category_Wikipedia_sockpuppets_of_Bobbywithtechies.csv,9,64882.0,6,3,5,1,0,11.0,66,50,50.0,50
Category_Wikipedia_sockpuppets_of_DXMLJanssen.csv,65,184450470.0,13,52,3,10,0,73.0923076923077,202,42,18.692307692307693,7
Category_Wikipedia_sockpuppets_of_Nakauka.csv,54,1193008.0,17,37,11,6,0,41.166666666666664,276,37,22.574074074074073,9
Category_Wikipedia_sockpuppets_of_Cleanupcrew2.csv,32,39510668.0,13,19,10,3,0,83.28125,253,22,15.9375,14
Category_Wikipedia_sockpuppets_of_HJafri.csv,108,11153487.0,36,72,25,11,0,55.2037037037037,256,57,24.72222222222222,6
Category_Wikipedia_sockpuppets_of_Fargeaux.csv,33,2348892.0,29,4,20,9,0,25.09090909090909,196,47,22.757575757575758,14
Category_Wikipedia_sockpuppets_of_Christianthomaskohl.csv,30,491650.0,10,20,10,0,13,47.46666666666667,145,27,21.6,17
Category_Wikipedia_sockpuppets_of_Tpromotional.csv,3,612.0,2,1,1,1,0,64.66666666666667,194,13,13.0,13
Category_Wikipedia_sockpuppets_of_PowerHenry.csv,714,29173265.0,261,453,245,16,0,53.054621848739494,294,38,22.208683473389357,7
Category_Wikipedia_sockpuppets_of_Garr1984.csv,2402,361040932.0,589,1813,471,118,0,42.99458784346378,252,58,19.209825145711907,3
Category_Wikipedia_sockpuppets_of_BhaujanStar.csv,1062,18043671.0,355,707,127,228,0,47.5225988700565,429,61,16.95668549905838,5
Category_Wikipedia_sockpuppets_of_Wolfkeeper.csv,2207,35887785.0,617,1590,500,117,0,48.8060715903942,249,63,19.10693248753965,3
Category_Wikipedia_sockpuppets_of_Fox931711.csv,68,5203138.0,25,43,14,11,0,66.55882352941177,292,23,12.882352941176471,6
Category_Wikipedia_sockpuppets_of_Mpmccart.csv,215,87810918.0,64,151,25,39,0,42.16279069767442,200,46,16.195348837209302,8
Category_Wikipedia_sockpuppets_of_Shubhammaantech123.csv,8,160098.0,8,0,6,2,37,48.25,56,28,27.25,25
Category_Wikipedia_sockpuppets_of_Notforlackofeffort.csv,700,12843956.0,248,452,131,117,0,45.55714285714286,255,78,36.28,11
Category_Wikipedia_sockpuppets_of_EXPLICITKID.csv,573,50113475.0,189,384,50,139,0,43.10122164048865,494,47,15.089005235602095,4
Category_Wikipedia_sockpuppets_of_Trueanthem.csv,45,61235941.0,19,26,8,11,0,28.77777777777778,199,17,14.244444444444444,12
Category_Wikipedia_sockpuppets_of_Kehlstein.csv,29,1699166.0,21,8,18,3,0,54.0,238,39,26.586206896551722,15
Category_Wikipedia_sockpuppets_of_Kofthewiki.csv,7,6509.0,3,4,2,1,19,81.42857142857143,151,21,20.142857142857142,18
Category_Wikipedia_sockpuppets_of_Kamalika_Basu.csv,328,76970125.0,96,232,50,46,0,49.55487804878049,281,64,18.774390243902438,5
Category_Wikipedia_sockpuppets_of_Chalkieperfect.csv,576,259827937.0,124,452,117,7,0,43.845486111111114,255,47,18.90277777777778,5
Category_Wikipedia_sockpuppets_of_Opoooooooo.csv,4,1209085.0,3,1,2,1,11,47.75,120,16,16.0,16
Category_Wikipedia_sockpuppets_of_FrancisLightHouse2.csv,41,30582332.0,19,22,18,1,0,37.853658536585364,199,28,20.170731707317074,8
Category_Wikipedia_sockpuppets_of_Bob_the_angry_flower.csv,20,5747.0,9,11,6,3,4,65.3,148,30,10.9,6
Category_Wikipedia_sockpuppets_of_JACKonWIKIS.csv,1631,33238592.0,536,1095,128,408,0,66.53280196198651,288,83,23.314530962599633,4
Category_Wikipedia_sockpuppets_of_DifensorFidelis.csv,726,26229710.0,271,455,163,108,0,60.388429752066116,253,47,17.144628099173552,5
Category_Wikipedia_sockpuppets_of_EpsomGentleman.csv,215,53228086.0,70,145,34,36,0,54.16744186046512,298,65,15.525581395348837,5
Category_Wikipedia_sockpuppets_of_Rebin'_Harris.csv,14,303.0,6,8,3,3,0,89.64285714285714,135,23,23.0,23
Category_Wikipedia_sockpuppets_of_Dcgene.csv,3247,230987134.0,1197,2050,488,709,0,51.955959347089625,495,70,22.48444718201417,4
Category_Wikipedia_sockpuppets_of_Jsmorse47.csv,1141,58986678.0,396,745,245,151,0,29.58983347940403,215,66,15.536371603856267,4
Category_Wikipedia_sockpuppets_of_Prince_of_Judah.csv,26,44507.0,14,12,8,6,0,63.30769230769231,204,30,12.5,10
Category_Wikipedia_sockpuppets_of_Irvi_Hyka.csv,552,116177347.0,148,404,97,51,0,44.55072463768116,255,90,26.018115942028984,5
Category_Wikipedia_sockpuppets_of_Sipho_Tottenham.csv,24,76925856.0,9,15,4,5,0,38.958333333333336,169,19,19.0,19
Category_Wikipedia_sockpuppets_of_Scout256.csv,16,698700.0,11,5,3,8,0,41.5625,181,20,17.1875,15
Category_Wikipedia_sockpuppets_of_Classicstruggle4.csv,24,1931.0,9,15,4,5,12,68.125,148,15,8.833333333333334,6
Category_Wikipedia_sockpuppets_of_Ranjit_pasi.csv,2440,27469594.0,855,1585,500,355,0,40.071311475409836,500,85,18.733606557377048,4
Category_Wikipedia_sockpuppets_of_Tryt_(musician).csv,64,17531843.0,18,46,10,8,0,45.1875,177,28,19.75,6
Category_Wikipedia_sockpuppets_of_Swe41.csv,246,5935056.0,80,166,65,15,0,44.8739837398374,228,47,22.658536585365855,11
Category_Wikipedia_sockpuppets_of_AprilMaple2016.csv,29,1992616.0,23,6,19,4,0,40.44827586206897,488,23,11.413793103448276,11
Category_Wikipedia_sockpuppets_of_TheRoyalTrust.csv,744,7020772.0,353,391,351,2,0,41.766129032258064,472,50,25.138440860215052,9
Category_Wikipedia_sockpuppets_of_Wiki.damsel.csv,221,120912701.0,56,165,44,12,0,51.62443438914027,246,47,21.574660633484164,10
Category_Wikipedia_sockpuppets_of_BOYAR_DEBBARMA.csv,34,47676417.0,24,10,11,13,0,28.558823529411764,145,31,22.176470588235293,12
Category_Wikipedia_sockpuppets_of_KirkleyHigh.csv,6985,98847629.0,2301,4684,500,1801,0,32.163350035790984,272,74,22.319398711524695,3
Category_Wikipedia_sockpuppets_of_Aryan_Kandoria.csv,26,271867.0,19,7,9,10,0,68.11538461538461,116,11,11.0,11
Category_Wikipedia_sockpuppets_of_Elandroid.csv,429,20030170.0,167,262,150,17,0,44.94172494172494,229,47,20.643356643356643,7
Category_Wikipedia_sockpuppets_of_Hunter_Arjunsinh.csv,417,7781081.0,192,225,133,59,0,40.0599520383693,254,55,17.882494004796165,5
Category_Wikipedia_sockpuppets_of_Das_Dipanjan.csv,342,34750656.0,218,124,192,26,0,24.444444444444443,240,27,12.728070175438596,7
Category_Wikipedia_sockpuppets_of_Fostera12.csv,2589,47401884.0,916,1673,500,416,0,48.25994592506759,423,65,21.355349555813056,6
Category_Wikipedia_sockpuppets_of_HaughtonBrit.csv,3881,100476013.0,1132,2749,500,632,0,57.82118010821953,500,65,20.991497036846173,4
Category_Wikipedia_sockpuppets_of_Spfr.csv,99,161206543.0,37,62,19,18,0,53.92929292929293,209,17,12.676767676767676,9
Category_Wikipedia_sockpuppets_of_ChrisWarner2.csv,336,4323057.0,120,216,69,51,0,36.76190476190476,410,42,23.696428571428573,8
Category_Wikipedia_sockpuppets_of_OscarSammeli.csv,6,402303.0,5,1,3,2,28,138.16666666666666,280,22,15.333333333333334,14
Category_Wikipedia_sockpuppets_of_Accurateinfo973.csv,243,134433711.0,101,142,80,21,0,56.31275720164609,250,30,12.613168724279836,5
Category_Wikipedia_sockpuppets_of_CanadianBBQ.csv,88,11151269.0,32,56,32,0,0,46.07954545454545,230,53,15.965909090909092,5
Category_Wikipedia_sockpuppets_of_Rust_Eze_X.csv,95,2139.0,31,64,15,16,0,78.43157894736842,286,28,14.852631578947369,5
Category_Wikipedia_sockpuppets_of_Charles_lindberg.csv,8513,45481020.0,2410,6103,500,1910,0,50.22882650064607,440,85,21.572066251615176,5
Category_Wikipedia_sockpuppets_of_Nitinule.csv,932,275411295.0,227,705,111,116,0,39.72103004291846,365,41,10.524678111587983,3
Category_Wikipedia_sockpuppets_of_Creativejon.csv,47,6899667.0,17,30,6,11,0,47.51063829787234,195,53,27.02127659574468,6
Category_Wikipedia_sockpuppets_of_Worldhistoryguru67.csv,147,2073004.0,59,88,31,28,0,88.98639455782313,485,41,19.108843537414966,8
Category_Wikipedia_sockpuppets_of_Dibya_Ranjan_Giri.csv,11,3556763.0,4,7,3,1,0,86.54545454545455,196,24,21.727272727272727,19
Category_Wikipedia_sockpuppets_of_Bravewell.csv,83,2049312.0,48,35,28,20,0,38.204819277108435,222,25,20.180722891566266,15
Category_Wikipedia_sockpuppets_of_HerbEA.csv,185,56671.0,70,115,38,32,0,62.83783783783784,199,42,18.518918918918917,5
Category_Wikipedia_sockpuppets_of_Devraj5000.csv,2785,29266960.0,557,2228,468,89,0,37.994254937163376,224,63,19.41077199281867,7
Category_Wikipedia_sockpuppets_of_Backflip123.csv,639,2183708.0,216,423,115,101,0,33.979655712050075,226,48,26.779342723004696,9
Category_Wikipedia_sockpuppets_of_Aman9877.csv,169,53222.0,73,96,37,36,0,33.03550295857988,210,22,10.201183431952662,6
Category_Wikipedia_sockpuppets_of_Tim_PimPim.csv,1662,3198377.0,510,1152,309,201,0,32.265342960288805,376,63,17.318892900120336,3
Category_Wikipedia_sockpuppets_of_Wiki_Greek_Basketball.csv,2619,3323217.0,1000,1619,500,500,0,27.11111111111111,259,65,24.690721649484537,7
Category_Wikipedia_sockpuppets_of_Whywhy99.csv,649,196006601.0,188,461,184,4,0,36.335901386748844,255,45,19.779661016949152,4
Category_Wikipedia_sockpuppets_of_Ivan_Cetnic.csv,197,2277964.0,52,145,25,27,0,43.91370558375635,212,42,17.35532994923858,7
Category_Wikipedia_sockpuppets_of_Tony_Feld.csv,956,9166206.0,243,713,243,0,0,30.189330543933053,212,61,19.028242677824267,4
Category_Wikipedia_sockpuppets_of_Boblas215.csv,363,19585722.0,95,268,16,79,0,42.05234159779614,255,24,13.59504132231405,7
Category_Wikipedia_sockpuppets_of_Maria_Dulight.csv,55,1905891.0,31,24,16,15,0,57.38181818181818,233,45,17.236363636363638,8
Category_Wikipedia_sockpuppets_of_Ceddy06.csv,1788,134045346.0,500,1288,500,0,0,32.830536912751676,250,55,24.274608501118568,6
Category_Wikipedia_sockpuppets_of_Mahdiul.csv,48,518243.0,48,0,32,16,0,36.416666666666664,196,25,15.5,12
Category_Wikipedia_sockpuppets_of_Eldred_carp.csv,21,1063.0,9,12,4,5,0,35.476190476190474,161,18,16.952380952380953,15
Category_Wikipedia_sockpuppets_of_AdnanAliAfzal.csv,2312,90338250.0,1090,1222,500,590,0,43.64359861591696,255,59,22.05190311418685,5
Category_Wikipedia_sockpuppets_of_Sheds_thus_guys_argh_g_ugh_b.csv,330,17138334.0,112,218,13,99,0,54.803030303030305,255,71,24.354545454545455,10
Category_Wikipedia_sockpuppets_of_ECHLN.csv,38,4771672.0,26,12,19,7,0,33.973684210526315,161,42,18.63157894736842,7
Category_Wikipedia_sockpuppets_of_Mamadoutadioukone.csv,3338,99121654.0,1319,2019,500,819,0,49.9673457159976,270,73,21.51318154583583,3
Category_Wikipedia_sockpuppets_of_Metroindia.csv,137,40770496.0,48,89,21,27,0,45.0,255,43,18.32846715328467,6
Category_Wikipedia_sockpuppets_of_Yashthakurkamail.csv,2074,23686036.0,655,1419,191,464,0,45.11620057859209,474,52,18.619575699132113,4
Category_Wikipedia_sockpuppets_of_Zhuying_Shi.csv,23,104608848.0,9,14,9,0,0,64.56521739130434,195,53,37.43478260869565,16
Category_Wikipedia_sockpuppets_of_JoshuaZ.csv,2183,553719353.0,580,1603,500,80,0,51.98030233623454,350,96,23.32295006871278,4
Category_Wikipedia_sockpuppets_of_Thursby16.csv,1719,253334734.0,506,1213,500,6,0,48.959278650378124,434,67,18.3891797556719,3
Category_Wikipedia_sockpuppets_of_Timmybiscool.csv,771,366838974.0,215,556,140,75,0,42.46562905317769,257,137,22.491569390402073,7
Category_Wikipedia_sockpuppets_of_OwenSoo513.csv,23,2690207.0,12,11,7,5,7,57.78260869565217,122,20,15.565217391304348,6
Category_Wikipedia_sockpuppets_of_Allthingsgo.csv,824,366110967.0,332,492,322,10,0,43.65533980582524,255,44,17.430825242718445,5
Category_Wikipedia_sockpuppets_of_RKG_Ah_Tow.csv,56,945463.0,34,22,27,7,0,50.125,159,39,18.196428571428573,12
Category_Wikipedia_sockpuppets_of_Tarheelz123.csv,1679,3413976.0,517,1162,500,17,0,39.68314472900536,250,68,20.572364502680166,5
Category_Wikipedia_sockpuppets_of_Rymax23.csv,6892,229659629.0,2021,4871,500,1521,0,32.48316889146837,439,64,20.556732443412653,4
Category_Wikipedia_sockpuppets_of_DEA4120.csv,40,255768.0,30,10,23,7,0,34.925,196,19,14.75,12
Category_Wikipedia_sockpuppets_of_Potato3719.csv,2,544.0,2,0,2,0,22,22.0,22,13,13.0,13
Category_Wikipedia_sockpuppets_of_Erwinrajemmanuel.csv,6,785865.0,2,4,2,0,0,64.33333333333333,196,28,27.666666666666668,26
Category_Wikipedia_sockpuppets_of_Rk.productionofficial.csv,86,1180524.0,38,48,25,13,0,24.209302325581394,156,41,23.406976744186046,7
Category_Wikipedia_sockpuppets_of_Scissorfidelity.csv,27,1239654.0,12,15,6,6,0,59.851851851851855,206,27,18.296296296296298,9
Category_Wikipedia_sockpuppets_of_HJawad.csv,873,1123424.0,223,650,182,41,0,39.797250859106526,244,49,14.72508591065292,4
Category_Wikipedia_sockpuppets_of_Jjirit.csv,308,41451553.0,117,191,74,43,0,35.23051948051948,500,23,16.003246753246753,6
Category_Wikipedia_sockpuppets_of_Uchiha_Baba.csv,1875,68255003.0,695,1180,235,460,0,45.16106666666666,496,65,19.154666666666667,4
Category_Wikipedia_sockpuppets_of_Fishguyen.csv,2466,8727865.0,801,1665,102,699,0,35.784671532846716,500,91,41.7757502027575,5
Category_Wikipedia_sockpuppets_of_Rrajesh.shandilya.csv,297,49008513.0,99,198,60,39,0,36.784511784511785,220,36,17.68013468013468,6
Category_Wikipedia_sockpuppets_of_Tandynfan.csv,48,283166.0,26,22,14,12,0,43.125,242,38,18.458333333333332,13
Category_Wikipedia_sockpuppets_of_Fire2456.csv,66,2034587.0,33,33,30,3,0,73.3030303030303,509,38,28.939393939393938,21
Category_Wikipedia_sockpuppets_of_Jesse_Daniel_Brown.csv,72,7551965.0,39,33,27,12,0,39.34722222222222,136,39,22.38888888888889,13
Category_Wikipedia_sockpuppets_of_JacTankies.csv,189,2470830.0,63,126,35,28,0,54.93121693121693,234,47,20.29100529100529,6
Category_Wikipedia_sockpuppets_of_Littleduty.csv,173,14162541.0,57,116,22,35,0,45.225433526011564,197,41,22.346820809248555,8
Category_Wikipedia_sockpuppets_of_Mr._Master_of_Editor.csv,1592,7338557.0,579,1013,350,229,0,36.5320351758794,310,48,15.955402010050252,6
Category_Wikipedia_sockpuppets_of_Imtitanium.csv,2797,85223537.0,1147,1650,500,647,0,35.20378977475867,255,54,26.24991061851984,5
Category_Wikipedia_sockpuppets_of_CherryCoke027.csv,133,16411833.0,29,104,17,12,0,61.35338345864662,233,23,12.233082706766917,3
Category_Wikipedia_sockpuppets_of_Chandan_kar.csv,157,108255650.0,72,85,57,15,0,39.140127388535035,292,47,16.261146496815286,11
Category_Wikipedia_sockpuppets_of_Tribute_to_the_damned.csv,322,5283461.0,119,203,81,38,0,53.422360248447205,337,45,25.885093167701864,4
Category_Wikipedia_sockpuppets_of_Pohick2.csv,3405,76240947.0,1205,2200,500,705,0,43.16299559471366,245,77,19.308957415565345,7
Category_Wikipedia_sockpuppets_of_Mishae.csv,2179,148614134.0,1000,1179,500,500,0,47.73244607618174,253,57,17.974300137677833,4
Category_Wikipedia_sockpuppets_of_Jayasurya9750660976.csv,1,0.0,1,0,1,0,0,0.0,0,28,28.0,28
Category_Wikipedia_sockpuppets_of_Imsess.csv,494,223622939.0,137,357,7,130,0,48.493927125506076,231,38,17.831983805668017,5
Category_Wikipedia_sockpuppets_of_LatiefDionk.csv,14,4566.0,10,4,9,1,0,41.857142857142854,196,24,24.0,24
Category_Wikipedia_sockpuppets_of_Bigchungus01.csv,19,2403324.0,9,10,5,4,0,63.21052631578947,196,23,17.42105263157895,13
Category_Wikipedia_sockpuppets_of_Thealdershotwriter.csv,61,90148529.0,17,44,9,8,0,52.83606557377049,230,36,23.049180327868854,14
Category_Wikipedia_sockpuppets_of_Jone.Hu.csv,97,2789859.0,54,43,46,8,0,32.350515463917525,230,40,28.422680412371133,12
Category_Wikipedia_sockpuppets_of_Sammetsfan.csv,1720,364206598.0,525,1195,500,25,0,47.050581395348836,451,74,23.084302325581394,4
Category_Wikipedia_sockpuppets_of_Infinitehate.csv,1,0.0,1,0,1,0,29,29.0,29,41,41.0,41
Category_Wikipedia_sockpuppets_of_Gattysandhu.csv,77,9515293.0,31,46,22,9,0,57.0,219,25,14.12987012987013,5
Category_Wikipedia_sockpuppets_of_Festal82.csv,1966,221305661.0,658,1308,327,331,0,49.35045778229908,255,62,20.290946083418106,5
Category_Wikipedia_sockpuppets_of_Niranjandeshmukh.csv,720,327138676.0,257,463,233,24,0,44.204166666666666,255,70,16.425,5
Category_Wikipedia_sockpuppets_of_5flipper.csv,47,2474.0,12,35,9,3,0,59.61702127659574,175,25,10.74468085106383,3
Category_Wikipedia_sockpuppets_of_Ddonald99.csv,152,16732736.0,46,106,45,1,0,45.35526315789474,248,48,19.20394736842105,3
Category_Wikipedia_sockpuppets_of_Dghsimr.csv,9,1655011.0,6,3,3,3,0,59.0,179,79,46.0,19
Category_Wikipedia_sockpuppets_of_Mahalaxmanan.csv,31,645679.0,13,18,5,8,0,44.45161290322581,159,17,12.096774193548388,7
Category_Wikipedia_sockpuppets_of_P4K1574N.csv,73,25331695.0,20,53,9,11,0,44.84931506849315,218,37,16.493150684931507,7
Category_Wikipedia_sockpuppets_of_Melsaran.csv,1708,3321231.0,539,1169,500,39,0,43.41686182669789,234,92,28.475409836065573,3
Category_Wikipedia_sockpuppets_of_Dominique_Kuhne.csv,92,17279914.0,57,35,51,6,0,27.630434782608695,199,44,20.91304347826087,19
Category_Wikipedia_sockpuppets_of_Sansonic.csv,2086,356963859.0,543,1543,500,43,0,45.125599232981784,279,56,19.340364333652925,3
Category_Wikipedia_sockpuppets_of_Dazzling_Pod.csv,18,1907.0,9,9,6,3,0,23.444444444444443,130,21,17.11111111111111,7
Category_Wikipedia_sockpuppets_of_Rawlico4real.csv,11,79261.0,10,1,4,6,0,51.09090909090909,196,23,17.90909090909091,13
Category_Wikipedia_sockpuppets_of_Xuxiang900.csv,86,1182226.0,30,56,23,7,0,49.2906976744186,190,39,14.906976744186046,2
Category_Wikipedia_sockpuppets_of_Dr._Syed_Shahzad_Ali_Najmi.csv,158,51326446.0,55,103,18,37,0,41.87341772151899,254,53,26.670886075949365,6
Category_Wikipedia_sockpuppets_of_Whsc1.csv,156,9676108.0,37,119,13,24,0,58.02564102564103,214,40,12.576923076923077,3
Category_Wikipedia_sockpuppets_of_Panda89123.csv,10,5229803.0,5,5,1,4,0,94.1,445,15,9.4,6
Category_Wikipedia_sockpuppets_of_Sn√∏hettaAS.csv,27,583780.0,23,4,20,3,0,20.925925925925927,204,20,18.22222222222222,18
Category_Wikipedia_sockpuppets_of_Rawna_Praveen_singh_solanki.csv,850,33885511.0,444,406,258,186,0,43.91058823529412,500,37,18.93294117647059,6
Category_Wikipedia_sockpuppets_of_Stang504.csv,73,935851.0,27,46,8,19,0,70.43835616438356,234,16,7.917808219178082,4
Category_Wikipedia_sockpuppets_of_Lilitynatuli.csv,21,5019.0,8,13,2,6,0,53.80952380952381,179,18,15.047619047619047,12
Category_Wikipedia_sockpuppets_of_Zxcv9.csv,1117,15067038.0,530,587,128,402,0,50.05192479856759,255,53,18.98478066248881,3
Category_Wikipedia_sockpuppets_of_Dreambigger121.csv,23,750906.0,9,14,8,1,0,40.82608695652174,131,28,8.08695652173913,6
Category_Wikipedia_sockpuppets_of_Oliboy500.csv,14,1965.0,7,7,4,3,0,81.14285714285714,201,27,21.785714285714285,20
Category_Wikipedia_sockpuppets_of_Borisyy.csv,29,1245549.0,12,17,9,3,0,51.44827586206897,186,20,14.275862068965518,11
Category_Wikipedia_sockpuppets_of_WikiWriter4Peanuts.csv,4,12151.0,2,2,1,1,0,62.75,121,53,43.75,16
Category_Wikipedia_sockpuppets_of_TommFreemann.csv,7,222456.0,6,1,6,0,18,25.142857142857142,60,22,22.0,22
Category_Wikipedia_sockpuppets_of_Cantus.csv,1491,64213587.0,524,967,500,24,0,20.912810194500334,198,71,19.022132796780685,3
Category_Wikipedia_sockpuppets_of_20_upper.csv,1576,10111379.0,504,1072,500,4,0,62.38769035532995,500,57,17.406725888324875,4
Category_Wikipedia_sockpuppets_of_Denflynn.csv,193,238196436.0,60,133,40,20,0,59.129533678756474,248,46,15.709844559585493,9
Category_Wikipedia_sockpuppets_of_Armanjarrettp.csv,3814,107820025.0,1213,2601,500,713,0,39.13896171997902,362,77,25.319874147876245,7
Category_Wikipedia_sockpuppets_of_Sizylar.csv,886,8798382.0,322,564,213,109,0,46.17607223476298,496,45,16.793453724604966,7
Category_Wikipedia_sockpuppets_of_Liamatk2020.csv,123,15467284.0,33,90,29,4,0,42.47154471544715,384,38,20.910569105691057,7
Category_Wikipedia_sockpuppets_of_KimYaJong.csv,131,3829216.0,52,79,39,13,0,70.32824427480917,494,48,19.35114503816794,5
Category_Wikipedia_sockpuppets_of_Cianzera.csv,79,27843202.0,22,57,22,0,0,55.64556962025316,275,33,19.89873417721519,6
Category_Wikipedia_sockpuppets_of_Himanshusingh031.csv,28,8117920.0,13,15,4,9,0,60.607142857142854,218,28,16.785714285714285,14
Category_Wikipedia_sockpuppets_of_H0llande.csv,839,115963845.0,246,593,125,121,0,57.76877234803337,387,58,20.61740166865316,7
Category_Wikipedia_sockpuppets_of_Bobby_Boulders.csv,485,25588174.0,122,363,20,102,0,34.49278350515464,248,59,18.690721649484537,4
Category_Wikipedia_sockpuppets_of_Aquelli.csv,1743,80667167.0,703,1040,500,203,0,33.46528973034997,360,51,31.34021801491681,7
Category_Wikipedia_sockpuppets_of_Rudi_Dierick.csv,2672,162393752.0,676,1996,500,176,0,40.11938622754491,252,66,19.981287425149702,5
Category_Wikipedia_sockpuppets_of_IKPlusOne.csv,1481,72518314.0,535,946,500,35,0,48.2457798784605,439,56,21.556380823767725,3
Category_Wikipedia_sockpuppets_of_Ericmalibu.csv,831,168607670.0,321,510,314,7,0,48.49578820697954,334,73,25.677496991576415,12
Category_Wikipedia_sockpuppets_of_ThundermanLover1.csv,127,2558788.0,76,51,68,8,0,32.30708661417323,207,30,15.582677165354331,11
Category_Wikipedia_sockpuppets_of_Lemon4954.csv,8,963.0,5,3,4,1,0,52.75,217,24,19.5,6
Category_Wikipedia_sockpuppets_of_Gstigler.csv,1623,84320817.0,527,1096,164,363,0,39.52926678989525,254,54,17.38693776956254,3
Category_Wikipedia_sockpuppets_of_Vivendi45.csv,226,10837289.0,56,170,27,29,0,48.5,282,46,17.154867256637168,4
Category_Wikipedia_sockpuppets_of_Ginsuloft.csv,6329,11279520.0,1962,4367,500,1462,0,63.84089113604045,255,79,19.753041554747984,2
Category_Wikipedia_sockpuppets_of_Ubixmage.csv,44,66007.0,20,24,13,7,0,15.659090909090908,137,35,17.022727272727273,14
Category_Wikipedia_sockpuppets_of_Victoriawilson.csv,3,375.0,2,1,2,0,0,56.666666666666664,154,16,14.0,10
Category_Wikipedia_sockpuppets_of_Dr.Mukesh111.csv,7534,207112629.0,2260,5274,500,1760,0,39.744093443058134,250,77,13.336341916644544,4
Category_Wikipedia_sockpuppets_of_Andyvyrha.csv,188,73281612.0,63,125,24,39,0,65.30851063829788,495,50,15.904255319148936,6
Category_Wikipedia_sockpuppets_of_Osli73.csv,3175,94607641.0,1019,2156,500,519,0,43.61889763779528,245,85,18.787401574803148,5
Category_Wikipedia_sockpuppets_of_Blue-Continent.csv,4352,192176979.0,1398,2954,368,1030,0,47.83295036764706,547,87,20.762408088235293,3
Category_Wikipedia_sockpuppets_of_Reargun.csv,2050,52067955.0,509,1541,478,31,0,57.16780487804878,241,72,18.368780487804877,4
Category_Wikipedia_sockpuppets_of_Steveg79.csv,205,79441.0,78,127,70,8,0,60.33170731707317,250,50,24.75121951219512,11
Category_Wikipedia_sockpuppets_of_Menj.csv,1959,415737046.0,566,1393,500,66,0,41.74629913221031,281,69,18.0,3
Category_Wikipedia_sockpuppets_of_Fiauser.csv,38,1575498.0,27,11,25,2,0,31.18421052631579,186,45,25.42105263157895,15
Category_Wikipedia_sockpuppets_of_Jofab08.csv,6,1861.0,6,0,6,0,0,0.0,0,10,10.0,10
Category_Wikipedia_sockpuppets_of_Rmarcano.csv,26,240167.0,14,12,14,0,0,41.65384615384615,127,30,23.923076923076923,14
Category_Wikipedia_sockpuppets_of_BlackBeasts.csv,129,67371478.0,42,87,25,17,0,48.651162790697676,177,40,17.27906976744186,12
Category_Wikipedia_sockpuppets_of_James_Zeeder.csv,95,283426.0,41,54,40,1,0,53.27368421052632,247,22,15.957894736842105,12
Category_Wikipedia_sockpuppets_of_Hamaze01.csv,2782,231158463.0,875,1907,500,375,0,44.453989935298345,497,68,19.77821710999281,2
Category_Wikipedia_sockpuppets_of_Brown_Crowford.csv,89,548397.0,35,54,22,13,0,43.943820224719104,312,53,25.719101123595507,6
Category_Wikipedia_sockpuppets_of_Cruizir.csv,334,99738773.0,99,235,97,2,0,58.58383233532934,249,58,25.092814371257486,3
Category_Wikipedia_sockpuppets_of_Vioricamarin.csv,156,7006110.0,59,97,36,23,0,55.493589743589745,234,41,19.096153846153847,11
Category_Wikipedia_sockpuppets_of_Julio_Puentes.csv,2082,292069810.0,561,1521,493,68,0,44.08981748318924,395,80,17.854466858789625,4
Category_Wikipedia_sockpuppets_of_Meerkatxoxo.csv,180,28237467.0,69,111,63,6,0,41.80555555555556,217,44,21.255555555555556,5
Category_Wikipedia_sockpuppets_of_Max_Arosev.csv,15820,118188864.0,4863,10957,500,4363,0,46.990960809102404,500,92,32.213211125158026,4
Category_Wikipedia_sockpuppets_of_Gtkrwn1488.csv,123,327708.0,65,58,63,2,0,28.75609756097561,204,33,30.21951219512195,9
Category_Wikipedia_sockpuppets_of_22holberg.csv,13,1264.0,11,2,11,0,0,12.538461538461538,116,9,9.0,9
Category_Wikipedia_sockpuppets_of_Trojanishere.csv,1641,46392707.0,521,1120,500,21,0,73.55210237659963,499,83,24.038391224862888,4
Category_Wikipedia_sockpuppets_of_Raxythecat.csv,2152,89592354.0,570,1582,300,270,0,61.1881970260223,499,87,21.526951672862452,4
Category_Wikipedia_sockpuppets_of_Jonathan_ryan.csv,801,20142252.0,294,507,248,46,0,28.98876404494382,242,34,19.283395755305868,3
Category_Wikipedia_sockpuppets_of_Kadoon2013.csv,54,8145885.0,13,41,12,1,31,65.11111111111111,117,53,45.68518518518518,14
Category_Wikipedia_sockpuppets_of_Over9000edits.csv,4917,35192357.0,1476,3441,500,976,0,39.17653040471832,484,67,27.62192393736018,4
Category_Wikipedia_sockpuppets_of_Dillonmcallaway.csv,221,1134319.0,77,144,75,2,0,47.71493212669683,194,51,15.190045248868778,8
Category_Wikipedia_sockpuppets_of_DavidJamesMusic.csv,29,87770794.0,12,17,12,0,0,17.20689655172414,152,32,21.137931034482758,11
Category_Wikipedia_sockpuppets_of_Ras_mekonnen4334.csv,361,22017142.0,156,205,124,32,0,47.10526315789474,494,36,17.750692520775623,4
Category_Wikipedia_sockpuppets_of_Zalgo.csv,8011,513643170.0,2491,5520,500,1991,0,57.589564349020094,547,85,17.091873673698665,3
Category_Wikipedia_sockpuppets_of_Geo357.csv,71,1276660.0,28,43,17,11,0,67.07042253521126,230,22,13.28169014084507,4
Category_Wikipedia_sockpuppets_of_Kqui13772.csv,102,1601660.0,32,70,27,5,0,40.009803921568626,218,30,14.049019607843137,5
Category_Wikipedia_sockpuppets_of_AungKaung932.csv,2310,81468380.0,1101,1209,500,601,0,30.00735930735931,496,69,23.25930735930736,7
Category_Wikipedia_sockpuppets_of_Nic.cartagena12.csv,1111,12377991.0,449,662,59,390,0,47.494149414941496,496,71,19.385238523852387,6
Category_Wikipedia_sockpuppets_of_Poopduck.csv,21,385.0,6,15,5,1,0,66.47619047619048,208,30,8.666666666666666,6
Category_Wikipedia_sockpuppets_of_Gabriela_Costa.csv,113,8901715.0,41,72,15,26,0,41.65486725663717,247,32,13.513274336283185,5
Category_Wikipedia_sockpuppets_of_Jealousagain38.csv,1195,42058849.0,343,852,76,267,0,28.797489539748955,202,48,17.143096234309624,3
Category_Wikipedia_sockpuppets_of_DC_Themmie.csv,152,22337018.0,66,86,17,49,0,47.703947368421055,347,33,17.848684210526315,4
Category_Wikipedia_sockpuppets_of_FiGhT_12.csv,2117,6308007.0,613,1504,500,113,0,32.9041095890411,241,54,19.201228153046763,4
Category_Wikipedia_sockpuppets_of_Styron111.csv,50,204026044.0,15,35,6,9,0,39.48,141,62,30.3,14
Category_Wikipedia_sockpuppets_of_Winningman7634.csv,21,59686.0,9,12,5,4,0,35.95238095238095,149,26,18.38095238095238,15
Category_Wikipedia_sockpuppets_of_JHerbertMunster.csv,1121,34588305.0,410,711,124,286,0,47.81177520071365,255,55,21.060660124888493,5
Category_Wikipedia_sockpuppets_of_CyberAnth.csv,4071,37776955.0,1419,2652,500,919,0,42.07541144681896,263,98,21.296978629329402,3
Category_Wikipedia_sockpuppets_of_Egwiki.csv,88,50594387.0,34,54,25,9,0,31.34090909090909,199,47,23.34090909090909,13
Category_Wikipedia_sockpuppets_of_Quinn2go.csv,190,23528821.0,114,76,31,83,0,48.57368421052632,245,47,23.278947368421054,16
Category_Wikipedia_sockpuppets_of_Pololhv123.csv,3,61.0,2,1,2,0,0,6.666666666666667,20,45,22.333333333333332,11
Category_Wikipedia_sockpuppets_of_Lilb1293.csv,915,10468552.0,303,612,303,0,0,20.540983606557376,204,55,17.277595628415302,3
Category_Wikipedia_sockpuppets_of_Cardiff123098.csv,975,25325586.0,286,689,266,20,0,40.026666666666664,244,55,12.875897435897436,2
Category_Wikipedia_sockpuppets_of_Sam_Lodding.csv,10,737.0,5,5,3,2,2,46.4,184,34,25.2,12
Category_Wikipedia_sockpuppets_of_JoshBower.csv,11,566.0,4,7,3,1,0,91.72727272727273,199,26,18.545454545454547,15
Category_Wikipedia_sockpuppets_of_Kicks_of_seven.csv,130,6315976.0,38,92,33,5,0,46.4,202,53,17.776923076923076,9
Category_Wikipedia_sockpuppets_of_Mohawashh.csv,42,296702.0,18,24,15,3,5,55.76190476190476,204,26,17.476190476190474,14
Category_Wikipedia_sockpuppets_of_Littleredm&m.csv,193,908378.0,101,92,101,0,0,54.196891191709845,212,51,19.989637305699482,13
Category_Wikipedia_sockpuppets_of_Gurmeet_Singh001.csv,27,129541.0,10,17,9,1,0,49.51851851851852,243,38,22.14814814814815,16
Category_Wikipedia_sockpuppets_of_Ab007sr6.csv,44,6548151.0,27,17,12,15,0,39.61363636363637,247,40,20.113636363636363,8
Category_Wikipedia_sockpuppets_of_GoodCyberCitizen.csv,61,854522.0,31,30,14,17,0,55.278688524590166,247,41,28.770491803278688,6
Category_Wikipedia_sockpuppets_of_Therealmjcainglet.csv,59,4326389.0,20,39,10,10,0,35.644067796610166,196,53,26.728813559322035,10
Category_Wikipedia_sockpuppets_of_MeLucifer.csv,1009,62616005.0,315,694,315,0,0,58.697720515361745,424,96,27.934588701684838,3
Category_Wikipedia_sockpuppets_of_Takesspout.csv,30,114629.0,22,8,20,2,0,63.63333333333333,111,46,36.6,7
Category_Wikipedia_sockpuppets_of_Charlesaustria971.csv,740,63757080.0,237,503,170,67,0,37.182432432432435,263,52,16.501351351351353,4
Category_Wikipedia_sockpuppets_of_Hamiltson.csv,2,18.0,2,0,2,0,11,11.0,11,19,16.5,14
Category_Wikipedia_sockpuppets_of_Orchon.csv,13,50343.0,8,5,4,4,92,111.07692307692308,136,32,16.0,9
Category_Wikipedia_sockpuppets_of_Menulog_Red_Agency.csv,50,7854875.0,22,28,13,9,0,33.14,171,33,18.96,7
Category_Wikipedia_sockpuppets_of_LisaPea.csv,24,44746715.0,10,14,10,0,0,57.666666666666664,184,46,26.166666666666668,17
Category_Wikipedia_sockpuppets_of_MuffinKing12344.csv,327,19343992.0,165,162,108,57,0,58.703363914373085,321,48,22.813455657492355,12
Category_Wikipedia_sockpuppets_of_Eastbridaleastbridal.csv,1,0.0,1,0,1,0,80,80.0,80,22,22.0,22
Category_Wikipedia_sockpuppets_of_Max_Aquino.csv,172,7914060.0,52,120,44,8,0,51.43604651162791,253,53,24.6046511627907,3
Category_Wikipedia_sockpuppets_of_PoopMoney923.csv,834,31945235.0,284,550,139,145,0,52.408872901678656,421,48,17.88968824940048,3
Category_Wikipedia_sockpuppets_of_Er._Shivam_Gupta.csv,2,0.0,1,1,1,0,102,102.0,102,25,25.0,25
Category_Wikipedia_sockpuppets_of_Bormalagurski.csv,3739,45002343.0,1278,2461,500,778,0,27.245787643755015,200,81,17.906124632254613,3
Category_Wikipedia_sockpuppets_of_Tiniphilip.csv,151,24386718.0,92,59,69,23,0,49.96026490066225,307,25,17.960264900662253,10
Category_Wikipedia_sockpuppets_of_Waffles_on_Box.csv,255,7007806.0,59,196,11,48,0,50.09803921568628,213,44,19.83137254901961,8
Category_Wikipedia_sockpuppets_of_Potofflowers.csv,15,345628.0,8,7,4,4,0,22.333333333333332,41,43,30.2,19
Category_Wikipedia_sockpuppets_of_Alphonse2.csv,299,191224777.0,99,200,52,47,0,38.11036789297659,212,26,11.02675585284281,3
Category_Wikipedia_sockpuppets_of_Secretaria.csv,878,10893183.0,500,378,500,0,0,27.355353075170843,353,61,27.484054669703873,12
Category_Wikipedia_sockpuppets_of_Tedted17.csv,16,1021.0,7,9,5,2,0,46.125,158,17,10.8125,7
Category_Wikipedia_sockpuppets_of_Eblackadder3.csv,5105,98015892.0,1308,3797,500,808,0,44.62135161606268,502,72,17.354554358472086,3
Category_Wikipedia_sockpuppets_of_Realzac3016.csv,284,107233061.0,67,217,54,13,0,50.29929577464789,254,39,17.566901408450704,7
Category_Wikipedia_sockpuppets_of_Nautilyus.csv,2047,18887076.0,697,1350,118,579,0,37.18661455788959,250,44,14.259892525647288,4
Category_Wikipedia_sockpuppets_of_Gabriel_Moginot.csv,326,334747.0,97,229,91,6,0,46.53680981595092,217,38,14.269938650306749,3
Category_Wikipedia_sockpuppets_of_Prince1917.csv,408,11903321.0,115,293,97,18,0,56.92892156862745,430,56,16.247549019607842,5
Category_Wikipedia_sockpuppets_of_Donald_Melvin.csv,1262,42091749.0,364,898,246,118,0,37.48098256735341,414,71,38.08795562599049,8
Category_Wikipedia_sockpuppets_of_Adityashashtri.csv,415,1030552.0,138,277,50,88,0,59.24096385542169,255,50,21.180722891566266,5
Category_Wikipedia_sockpuppets_of_Guccilover2019.csv,4,1023457.0,4,0,3,1,44,54.25,85,27,25.0,19
Category_Wikipedia_sockpuppets_of_Ivor_Browning.csv,203,858527.0,97,106,92,5,0,35.39408866995074,253,75,30.029556650246306,10
Category_Wikipedia_sockpuppets_of_Rzombie1988.csv,918,316906468.0,282,636,215,67,0,39.11764705882353,227,44,19.9281045751634,6
Category_Wikipedia_sockpuppets_of_Medianetwork4.csv,7,14085053.0,7,0,4,3,0,61.142857142857146,196,26,23.857142857142858,11
Category_Wikipedia_sockpuppets_of_Amazoncalluk.csv,7,257447.0,3,4,3,0,53,83.0,110,35,32.142857142857146,30
Category_Wikipedia_sockpuppets_of_Big_Bird_From_Sesame_Street.csv,11,79395.0,3,8,2,1,0,31.0,138,25,20.636363636363637,13
Category_Wikipedia_sockpuppets_of_Nnimrodd.csv,640,223552241.0,212,428,85,127,0,30.9859375,232,47,14.1109375,4
Category_Wikipedia_sockpuppets_of_Pikminlover.csv,3085,129154781.0,1018,2067,500,518,0,34.58897893030794,230,80,20.34230145867099,2
Category_Wikipedia_sockpuppets_of_Carlitohm11.csv,427,4526019.0,115,312,101,14,0,35.2903981264637,227,42,30.686182669789225,9
Category_Wikipedia_sockpuppets_of_Yamacyan.csv,1509,16386762.0,656,853,500,156,0,49.807157057654074,499,88,15.886679920477137,4
Category_Wikipedia_sockpuppets_of_Ifaz_Ali_Khan.csv,767,16176066.0,258,509,176,82,0,42.41981747066493,254,43,16.190352020860495,4
Category_Wikipedia_sockpuppets_of_Vehoo.csv,231,2984779.0,77,154,73,4,0,50.16450216450217,251,31,16.073593073593074,9
Category_Wikipedia_sockpuppets_of_TVDATARU.csv,169,30510045.0,54,115,50,4,0,39.650887573964496,184,34,15.49112426035503,6
Category_Wikipedia_sockpuppets_of_Talpis.csv,13,172356.0,8,5,7,1,0,58.46153846153846,126,8,8.0,8
Category_Wikipedia_sockpuppets_of_Drms106.csv,19,180486.0,10,9,4,6,0,69.0,200,13,10.789473684210526,8
Category_Wikipedia_sockpuppets_of_Santap.csv,908,72793241.0,301,607,71,230,0,25.395374449339208,193,42,14.41409691629956,4
Category_Wikipedia_sockpuppets_of_Elyu143.csv,67,2069867.0,57,10,36,21,0,29.686567164179106,196,27,9.776119402985074,8
Category_Wikipedia_sockpuppets_of_Vamlos.csv,3836,214783174.0,1122,2714,500,622,0,55.262513034410844,497,62,19.76303441084463,3
Category_Wikipedia_sockpuppets_of_Jadesdandy156.csv,46,2144602.0,22,24,16,6,0,50.08695652173913,264,29,26.195652173913043,18
Category_Wikipedia_sockpuppets_of_IBobi.csv,112,139099652.0,33,79,32,1,0,49.535714285714285,255,59,31.973214285714285,6
Category_Wikipedia_sockpuppets_of_GeezGod.csv,396,1005282.0,140,256,60,80,0,50.23232323232323,381,53,27.843434343434343,5
Category_Wikipedia_sockpuppets_of_Doom127.csv,3057,78705936.0,733,2324,500,233,0,46.70428524697416,225,66,18.619888779849525,3
Category_Wikipedia_sockpuppets_of_Silicone_Mane.csv,112,1436.0,30,82,15,15,0,49.160714285714285,216,40,19.580357142857142,5
Category_Wikipedia_sockpuppets_of_JoMontNW.csv,1477,96341816.0,530,947,89,441,0,50.70480704129993,253,59,21.28232904536222,5
Category_Wikipedia_sockpuppets_of_BWikiBW02.csv,733,3453132.0,226,507,148,78,0,54.29331514324693,287,50,19.661664392905866,5
Category_Wikipedia_sockpuppets_of_Paulika1995.csv,2637,51509510.0,1524,1113,500,1024,0,30.37315130830489,253,44,24.2707622298066,8
Category_Wikipedia_sockpuppets_of_Chessmaster8x.csv,311,12615636.0,94,217,61,33,0,25.771704180064308,172,50,23.434083601286172,4
Category_Wikipedia_sockpuppets_of_Zebrasil.csv,371,201920739.0,131,240,72,59,0,45.315363881401616,226,47,19.97843665768194,7
Category_Wikipedia_sockpuppets_of_Sportscorestore.csv,942,128553159.0,307,635,193,114,0,40.32271762208068,243,36,14.930997876857749,7
Category_Wikipedia_sockpuppets_of_Muthu_jeyachandran.csv,3,5441359.0,3,0,2,1,0,55.666666666666664,85,20,15.333333333333334,13
Category_Wikipedia_sockpuppets_of_Matheweditking.csv,1860,83285957.0,588,1272,497,91,0,51.5989247311828,255,61,20.648387096774194,4
Category_Wikipedia_sockpuppets_of_AAA_Marketing.csv,6,412570.0,2,4,2,0,0,66.5,163,53,47.166666666666664,18
Category_Wikipedia_sockpuppets_of_EvilEggy.csv,12,3542288.0,4,8,2,2,0,63.583333333333336,183,23,15.083333333333334,10
Category_Wikipedia_sockpuppets_of_JWilson0923.csv,244,35056728.0,92,152,71,21,0,65.65983606557377,255,47,22.44672131147541,12
Category_Wikipedia_sockpuppets_of_Vivo78.csv,1662,287990077.0,541,1121,500,41,0,46.73225030084236,500,56,16.282791817087848,4
Category_Wikipedia_sockpuppets_of_Xanderliptak.csv,2110,47482631.0,718,1392,500,218,0,42.70710900473934,258,82,27.924644549763034,5
Category_Wikipedia_sockpuppets_of_Quantum1988.csv,24,7409.0,9,15,5,4,0,37.708333333333336,133,44,26.916666666666668,13
Category_Wikipedia_sockpuppets_of_Gareth32cliffer.csv,92,863941.0,37,55,31,6,0,44.09782608695652,187,34,19.869565217391305,13
Category_Wikipedia_sockpuppets_of_Lilianarice.csv,934,114359158.0,284,650,60,224,0,41.91006423982869,255,86,19.82762312633833,5
Category_Wikipedia_sockpuppets_of_ParthianShot.csv,1429,5953769.0,500,929,500,0,0,38.60181945416375,255,77,23.26032190342897,4
Category_Wikipedia_sockpuppets_of_Gabe226.csv,2,0.0,1,1,1,0,0,0.0,0,17,17.0,17
Category_Wikipedia_sockpuppets_of_Maplefan.csv,508,20975901.0,146,362,58,88,0,39.79330708661417,199,53,14.456692913385826,5
Category_Wikipedia_sockpuppets_of_Tannerslaught.csv,104,20855333.0,49,55,38,11,0,44.64423076923077,244,53,31.557692307692307,11
Category_Wikipedia_sockpuppets_of_ArabianJews.csv,151,3194066.0,68,83,20,48,0,49.83443708609271,219,50,27.04635761589404,9
Category_Wikipedia_sockpuppets_of_Vanca92.csv,1278,102522125.0,491,787,439,52,0,38.51173708920188,870,78,17.010172143974962,4
Category_Wikipedia_sockpuppets_of_Mmmaniroy.csv,3,51939.0,2,1,2,0,48,61.0,84,25,23.0,19
Category_Wikipedia_sockpuppets_of_JavaSoldier.csv,2075,31952013.0,588,1487,500,88,0,42.989879518072286,500,49,15.628915662650602,5
Category_Wikipedia_sockpuppets_of_Ultra8K.csv,234,7883703.0,117,117,72,45,0,51.18376068376068,256,51,22.854700854700855,12
Category_Wikipedia_sockpuppets_of_HappyCreateJohn.csv,531,1343887.0,177,354,164,13,0,34.013182674199626,265,25,4.440677966101695,4
Category_Wikipedia_sockpuppets_of_45Prank54.csv,6,1392779.0,5,1,3,2,0,19.333333333333332,102,14,7.333333333333333,6
Category_Wikipedia_sockpuppets_of_Benebimo.csv,722,55222067.0,290,432,147,143,0,33.45429362880886,255,49,20.601108033240997,10
Category_Wikipedia_sockpuppets_of_Zakariayps.csv,2804,33319026.0,1061,1743,363,698,0,44.99322396576319,255,40,12.420470756062768,4
Category_Wikipedia_sockpuppets_of_Cartoons2022.csv,1437,34803381.0,417,1020,374,43,0,50.063326374391096,496,104,24.22964509394572,4
Category_Wikipedia_sockpuppets_of_Vivty12xc.csv,23,5762905.0,9,14,7,2,0,39.69565217391305,207,24,16.043478260869566,14
Category_Wikipedia_sockpuppets_of_Geraldo_Perez_4.csv,9,675.0,5,4,3,2,0,40.44444444444444,162,34,28.0,25
Category_Wikipedia_sockpuppets_of_Ishultz11.csv,145,52944463.0,47,98,20,27,0,51.172413793103445,255,36,22.317241379310346,11
Category_Wikipedia_sockpuppets_of_DomoplayzX.csv,1,0.0,1,0,1,0,63,63.0,63,15,15.0,15
Category_Wikipedia_sockpuppets_of_AnItalianEditor.csv,177,20363828.0,53,124,39,14,0,61.32203389830509,319,51,15.107344632768362,7
Category_Wikipedia_sockpuppets_of_Mascot_Guy.csv,160,718297.0,45,115,45,0,0,20.5,133,60,29.61875,6
Category_Wikipedia_sockpuppets_of_Golf-ben10.csv,4410,68333989.0,1906,2504,500,1406,0,44.04512471655329,487,64,24.12312925170068,2
Category_Wikipedia_sockpuppets_of_Justmangalore.csv,218,4413481.0,69,149,31,38,0,42.65596330275229,254,58,20.31651376146789,6
Category_Wikipedia_sockpuppets_of_Notable_Sweety.csv,2015,51933286.0,515,1500,252,263,0,48.7136476426799,255,85,21.290818858560794,7
Category_Wikipedia_sockpuppets_of_Maya515.csv,7529,19920960.0,2373,5156,500,1873,0,53.153274007172264,255,87,21.717890822154338,1
Category_Wikipedia_sockpuppets_of_EvanFinney08.csv,3365,70780560.0,968,2397,500,468,0,30.20891530460624,249,67,25.36374442793462,3
Category_Wikipedia_sockpuppets_of_Anabil83.csv,77,13046130.0,59,18,43,16,0,20.09090909090909,231,46,42.90909090909091,12
Category_Wikipedia_sockpuppets_of_RugbyNut2040.csv,3,462.0,3,0,3,0,30,36.0,48,22,22.0,22
Category_Wikipedia_sockpuppets_of_Jake_Duncan.csv,362,21517890.0,91,271,64,27,0,40.61602209944751,231,36,20.80939226519337,4
Category_Wikipedia_sockpuppets_of_Gigogag.csv,2037,376577693.0,648,1389,500,148,0,43.41580756013746,325,64,16.199803632793323,4
Category_Wikipedia_sockpuppets_of_Luther_Aragones.csv,197,169075457.0,73,124,73,0,0,45.48730964467005,215,53,17.263959390862944,7
Category_Wikipedia_sockpuppets_of_W._Frank.csv,3887,493691941.0,1044,2843,500,544,0,61.59737586827888,423,73,21.4792899408284,5
Category_Wikipedia_sockpuppets_of_Fritella.csv,1,0.0,1,0,1,0,0,0.0,0,19,19.0,19
Category_Wikipedia_sockpuppets_of_Killacat.csv,23,624.0,10,13,7,3,0,43.43478260869565,137,43,29.08695652173913,22
Category_Wikipedia_sockpuppets_of_Yryriza.csv,613,24352048.0,137,476,135,2,0,50.435562805872756,250,62,18.212071778140295,8
Category_Wikipedia_sockpuppets_of_Daciproteasa09.csv,9,14566033.0,3,6,2,1,4,91.66666666666667,280,27,20.0,14
Category_Wikipedia_sockpuppets_of_Middled.csv,98,19764223.0,23,75,20,3,0,67.28571428571429,200,38,16.70408163265306,9
Category_Wikipedia_sockpuppets_of_Tomheslop.csv,17,10109649.0,5,12,3,2,0,17.352941176470587,47,29,26.88235294117647,20
Category_Wikipedia_sockpuppets_of_Aditya1868.csv,32,64896.0,14,18,8,6,0,54.3125,196,27,17.25,10
Category_Wikipedia_sockpuppets_of_Notnoteworthy.csv,308,308765.0,134,174,117,17,0,43.04220779220779,231,52,20.49025974025974,5
Category_Wikipedia_sockpuppets_of_Lapalalupalacarsipazara.csv,182,264181.0,82,100,48,34,0,53.51648351648352,278,37,15.95054945054945,4
Category_Wikipedia_sockpuppets_of_Pnelnik.csv,1534,84306837.0,453,1081,287,166,0,43.134289439374186,255,58,18.391786179921773,4
Category_Wikipedia_sockpuppets_of_Dr_Chatterjee.csv,1490,3103895.0,563,927,430,133,0,28.91476510067114,200,88,28.34026845637584,3
Category_Wikipedia_sockpuppets_of_Ladyoftrees.csv,2809,174408874.0,954,1855,500,454,0,40.59700961196155,397,76,22.39195443218227,8
Category_Wikipedia_sockpuppets_of_Tdi7457.csv,2366,90488516.0,616,1750,355,261,0,39.175824175824175,246,73,21.312341504649197,4
Category_Wikipedia_sockpuppets_of_Ismail2212.csv,105,11122449.0,23,82,22,1,0,49.99047619047619,201,26,21.485714285714284,15
Category_Wikipedia_sockpuppets_of_Oscar22.csv,456,333806043.0,127,329,125,2,0,50.396929824561404,227,63,24.535087719298247,6
Category_Wikipedia_sockpuppets_of_Weedftw.csv,46,16491216.0,15,31,15,0,0,55.95652173913044,241,38,20.869565217391305,12
Category_Wikipedia_sockpuppets_of_No1coolfool.csv,13,2092.0,6,7,6,0,0,46.15384615384615,219,27,21.76923076923077,17
Category_Wikipedia_sockpuppets_of_SS54143.csv,806,5278715.0,346,460,296,50,0,43.727047146401986,493,53,18.787841191067,6
Category_Wikipedia_sockpuppets_of_JakeNyg25.csv,643,371097127.0,199,444,134,65,0,45.40590979782271,299,45,20.52877138413686,10
Category_Wikipedia_sockpuppets_of_LebanonPage.csv,27,33325.0,17,10,15,2,0,48.18518518518518,318,16,16.0,16
Category_Wikipedia_sockpuppets_of_Rappydappy.csv,7,1258.0,4,3,2,2,0,62.42857142857143,141,16,16.0,16
Category_Wikipedia_sockpuppets_of_MARK100.csv,6,85400.0,4,2,2,2,0,75.66666666666667,199,22,20.333333333333332,17
Category_Wikipedia_sockpuppets_of_FDJK001.csv,1175,38602109.0,370,805,211,159,0,44.96765957446809,254,47,20.00340425531915,2
Category_Wikipedia_sockpuppets_of_Lyle123.csv,429,138058608.0,97,332,34,63,0,34.53379953379953,232,56,24.34731934731935,6
Category_Wikipedia_sockpuppets_of_Johnny_Squeaky.csv,2737,22488339.0,860,1877,500,360,0,49.68542199488491,255,62,17.797223237120935,5
Category_Wikipedia_sockpuppets_of_AbacusSmasher.csv,117,6660775.0,37,80,21,16,0,58.93162393162393,213,28,14.085470085470085,6
Category_Wikipedia_sockpuppets_of_Elshadiman.csv,1944,124071810.0,739,1205,395,344,0,43.657407407407405,500,125,27.419753086419753,5
Category_Wikipedia_sockpuppets_of_JackW436.csv,2335,7536786.0,785,1550,500,285,0,39.96059957173448,255,53,16.06509635974304,4
Category_Wikipedia_sockpuppets_of_Technethalesian.csv,203,18657128.0,104,99,55,49,0,67.19211822660098,254,43,13.586206896551724,8
Category_Wikipedia_sockpuppets_of_M.manirabiee.csv,5,3942016.0,2,3,2,0,19,60.4,174,57,33.0,17
Category_Wikipedia_sockpuppets_of_&watiMi&hra.csv,36,6388616.0,12,24,8,4,0,36.80555555555556,129,53,18.333333333333332,12
Category_Wikipedia_sockpuppets_of_Brian_Boru_is_awesome.csv,1838,325647508.0,500,1338,500,0,0,45.58596300326442,345,60,18.666485310119697,4
Category_Wikipedia_sockpuppets_of_Speakeasysky.csv,32,13842.0,19,13,16,3,0,74.625,240,24,12.34375,7
Category_Wikipedia_sockpuppets_of_Collin_is_cool.csv,71,2813831.0,30,41,23,7,0,59.352112676056336,254,28,19.422535211267604,13
Category_Wikipedia_sockpuppets_of_Justallofthem.csv,1352,15847718.0,504,848,500,4,0,49.79585798816568,246,69,28.548076923076923,4
Category_Wikipedia_sockpuppets_of_TROLLER1111.csv,13,9650.0,8,5,4,4,0,47.46153846153846,226,26,19.846153846153847,10
Category_Wikipedia_sockpuppets_of_Vanmodhe.csv,460,138365029.0,152,308,131,21,0,36.78478260869565,244,64,20.219565217391306,6
Category_Wikipedia_sockpuppets_of_Seancarlin84.csv,711,46537723.0,238,473,171,67,0,35.45428973277075,250,59,20.008438818565402,5
Category_Wikipedia_sockpuppets_of_JuanRomero2008.csv,255,28988127.0,79,176,53,26,0,40.02745098039216,394,47,17.972549019607843,9
Category_Wikipedia_sockpuppets_of_YesMovementEtTU.csv,654,88792709.0,237,417,236,1,0,48.37308868501529,252,66,16.48776758409786,5
Category_Wikipedia_sockpuppets_of_Ztaobb.csv,423,11236180.0,212,211,183,29,0,56.63356973995272,255,22,11.20094562647754,3
Category_Wikipedia_sockpuppets_of_Hongsta.csv,406,457200067.0,126,280,109,17,0,45.785714285714285,278,45,16.251231527093594,5
Category_Wikipedia_sockpuppets_of_I_AM_LEAFISH.csv,2,0.0,1,1,1,0,35,35.0,35,5,5.0,5
Category_Wikipedia_sockpuppets_of_Rabindranath_01.csv,27,1141968.0,10,17,4,6,0,47.407407407407405,150,38,23.77777777777778,6
Category_Wikipedia_sockpuppets_of_DeportivoLara.csv,362,21772581.0,128,234,111,17,0,38.6767955801105,338,77,23.5,9
Category_Wikipedia_sockpuppets_of_Dschor.csv,2802,25576600.0,567,2235,500,67,0,39.27551748750892,242,88,28.334760885082083,3
Category_Wikipedia_sockpuppets_of_I_Love_Bridges.csv,6999,117933069.0,2536,4463,500,2036,0,61.56293756250893,492,87,24.982283183311903,1
Category_Wikipedia_sockpuppets_of_Sahib0921.csv,87,23276280.0,27,60,13,14,0,31.597701149425287,213,40,24.977011494252874,10
Category_Wikipedia_sockpuppets_of_Ben_swarbrick.csv,11,107241321.0,8,3,3,5,0,42.90909090909091,97,23,15.818181818181818,12
Category_Wikipedia_sockpuppets_of_Richardstapleton.csv,14,57095.0,9,5,7,2,0,16.571428571428573,122,26,20.357142857142858,13
Category_Wikipedia_sockpuppets_of_FinkleEinhorn.csv,20,104903.0,13,7,7,6,0,33.45,184,49,32.5,23
Category_Wikipedia_sockpuppets_of_Harrisonnash.csv,31,321655.0,21,10,12,9,0,25.483870967741936,169,45,33.41935483870968,8
Category_Wikipedia_sockpuppets_of_A_plague_of_rainbows.csv,5316,19019453.0,1418,3898,500,918,0,36.364559819413095,255,82,16.05116629044394,3
Category_Wikipedia_sockpuppets_of_Mognj.csv,72,524079.0,42,30,28,14,0,45.583333333333336,217,63,25.34722222222222,10
Category_Wikipedia_sockpuppets_of_Spartawasdope.csv,168,14278426.0,49,119,21,28,0,60.404761904761905,360,43,19.36904761904762,5
Category_Wikipedia_sockpuppets_of_Hadir007.csv,45,45660.0,12,33,12,0,0,56.044444444444444,224,36,18.044444444444444,4
Category_Wikipedia_sockpuppets_of_YusufRenasIssa.csv,78,2580506.0,22,56,17,5,0,60.782051282051285,359,29,13.512820512820513,7
Category_Wikipedia_sockpuppets_of_Sima-azad.csv,417,50912921.0,222,195,106,116,0,41.21103117505995,222,39,23.016786570743406,11
Category_Wikipedia_sockpuppets_of_Capitolcap.csv,36,5213805.0,17,19,12,5,0,36.72222222222222,195,31,20.27777777777778,15
Category_Wikipedia_sockpuppets_of_HarvardBruin.csv,406,7805506.0,158,248,76,82,0,73.64285714285714,416,54,31.677339901477833,11
Category_Wikipedia_sockpuppets_of_FI.214.csv,1417,6028546.0,506,911,500,6,0,62.988002822865205,496,83,31.997177134791812,5
Category_Wikipedia_sockpuppets_of_Nastyasova.csv,144,364696.0,50,94,13,37,0,47.03472222222222,244,60,16.291666666666668,6
Category_Wikipedia_sockpuppets_of_Gaura79.csv,1811,358979163.0,522,1289,500,22,0,52.68691330756488,394,75,25.040861402540035,5
Category_Wikipedia_sockpuppets_of_Ericsaindon2.csv,2793,53903545.0,915,1878,500,415,0,33.193698532044394,249,74,24.838524883637664,6
Category_Wikipedia_sockpuppets_of_Burger_Alison.csv,195,50045197.0,39,156,25,14,0,59.14358974358974,254,30,15.707692307692307,5
Category_Wikipedia_sockpuppets_of_Durdana987.csv,72,14164598.0,27,45,17,10,0,52.43055555555556,220,54,31.875,13
Category_Wikipedia_sockpuppets_of_Vsco_mike.csv,4623,6539788.0,2002,2621,500,1502,0,32.734155310404496,395,74,22.435864157473503,7
Category_Wikipedia_sockpuppets_of_Aliasghar_ghorbandokht.csv,417,78348955.0,175,242,122,53,0,38.853717026378895,346,53,22.585131894484412,9
Category_Wikipedia_sockpuppets_of_Craftymanders.csv,14,1288835.0,9,5,5,4,6,72.14285714285714,192,17,11.0,10
Category_Wikipedia_sockpuppets_of_Harryhighams.csv,15,177859.0,4,11,3,1,0,57.53333333333333,230,15,11.466666666666667,6
Category_Wikipedia_sockpuppets_of_Immaculatefancy.csv,78,3237780.0,25,53,9,16,0,41.85897435897436,255,50,16.794871794871796,7
Category_Wikipedia_sockpuppets_of_Justjihad.csv,136,14858560.0,33,103,33,0,0,43.86029411764706,209,42,16.0,4
Category_Wikipedia_sockpuppets_of_Useitorloseit.csv,1512,314215893.0,476,1036,469,7,0,56.52777777777778,367,61,29.086640211640212,5
Category_Wikipedia_sockpuppets_of_Nathanrdotcom.csv,1835,22704318.0,654,1181,500,154,0,38.18801089918256,233,75,21.631062670299727,3
Category_Wikipedia_sockpuppets_of_Munchiesalldaylong.csv,7,95299.0,3,4,2,1,0,123.14285714285714,218,22,21.142857142857142,21
Category_Wikipedia_sockpuppets_of_Alestorm95.csv,90,7171697.0,27,63,12,15,0,48.733333333333334,211,45,17.855555555555554,4
Category_Wikipedia_sockpuppets_of_ScienceApologist.csv,1101,46319713.0,274,827,197,77,0,54.25703905540418,248,71,31.1244323342416,6
Category_Wikipedia_sockpuppets_of_Kristianatienza.csv,19361,108202706.0,7076,12285,500,6576,0,34.039305820980324,496,57,19.136614844274572,4
Category_Wikipedia_sockpuppets_of_Sankarns.csv,471,4050082.0,196,275,119,77,0,45.36518046709129,259,36,17.906581740976645,7
Category_Wikipedia_sockpuppets_of_Jubman.csv,138,3416107.0,86,52,53,33,0,27.13768115942029,214,59,25.355072463768117,11
Category_Wikipedia_sockpuppets_of_◊û◊ï◊ß◊î◊û◊ï◊ß◊î.csv,449,13253310.0,124,325,117,7,0,49.26726057906459,492,27,8.325167037861915,4
Category_Wikipedia_sockpuppets_of_Raman.01.csv,7,2593.0,7,0,3,4,0,107.0,196,16,13.571428571428571,12
Category_Wikipedia_sockpuppets_of_Waterlust.csv,16,77685.0,9,7,8,1,0,32.8125,196,59,43.875,41
Category_Wikipedia_sockpuppets_of_Hhh6811.csv,4,75556.0,3,1,2,1,0,37.0,148,37,37.0,37
Category_Wikipedia_sockpuppets_of_Gallura.csv,3203,210206190.0,1398,1805,500,898,0,42.58788635654074,452,55,16.126443958788634,3
Category_Wikipedia_sockpuppets_of_Gramegna_Nickitin.csv,27,6819361.0,11,16,4,7,0,63.925925925925924,249,32,21.40740740740741,14
Category_Wikipedia_sockpuppets_of_RFmedic.csv,145,2718193.0,42,103,24,18,0,56.53793103448276,184,91,33.46896551724138,8
Category_Wikipedia_sockpuppets_of_Krisgrayer10.csv,177,205875638.0,54,123,40,14,0,51.067796610169495,218,35,13.790960451977401,4
Category_Wikipedia_sockpuppets_of_Xcreeper.csv,36,1295908.0,26,10,20,6,0,47.388888888888886,230,31,19.02777777777778,1
Category_Wikipedia_sockpuppets_of_Wikiscribe.csv,2450,396080118.0,527,1923,500,27,0,51.38,500,63,16.947755102040816,4
Category_Wikipedia_sockpuppets_of_Flasty_Jam.csv,747,177228605.0,262,485,180,82,0,56.904953145917,496,58,28.365461847389557,11
Category_Wikipedia_sockpuppets_of_Masood_Anil.csv,168,80098744.0,67,101,37,30,0,32.94047619047619,263,41,16.68452380952381,6
Category_Wikipedia_sockpuppets_of_Ohmy45.csv,3249,45171838.0,1127,2122,500,627,0,53.1320406278855,306,206,17.29763004001231,4
Category_Wikipedia_sockpuppets_of_Swetasingh.de.csv,15,5961097.0,8,7,7,1,0,62.2,228,23,14.266666666666667,8
Category_Wikipedia_sockpuppets_of_Php.gody.csv,46,342863.0,19,27,8,11,0,49.08695652173913,196,39,25.956521739130434,13
Category_Wikipedia_sockpuppets_of_Menon1000.csv,71,517229.0,40,31,18,22,0,35.40845070422535,138,13,6.76056338028169,6
Category_Wikipedia_sockpuppets_of_Prathambhu.csv,1180,143459195.0,359,821,316,43,0,52.884745762711866,250,55,17.035593220338985,5
Category_Wikipedia_sockpuppets_of_Rameses.csv,2155,290992762.0,679,1476,500,179,0,56.33178654292343,250,64,20.74199535962877,4
Category_Wikipedia_sockpuppets_of_Schneehasi.csv,68,436193.0,30,38,30,0,0,66.95588235294117,131,42,24.294117647058822,18
Category_Wikipedia_sockpuppets_of_(W)rid(t)ing_High.csv,1956,13926110.0,660,1296,500,160,0,44.40337423312884,496,112,17.298568507157466,3
Category_Wikipedia_sockpuppets_of_Thenightchicagodied.csv,213,3260265.0,83,130,53,30,0,50.183098591549296,243,54,24.342723004694836,11
Category_Wikipedia_sockpuppets_of_Flashg321.csv,14,14908.0,8,6,6,2,18,69.71428571428571,207,50,17.5,15
Category_Wikipedia_sockpuppets_of_0lesson.csv,2916,36285493.0,988,1928,500,488,0,54.512002743484224,395,85,19.327846364883403,3
Category_Wikipedia_sockpuppets_of_Vintagemi.csv,1035,11007409.0,491,544,443,48,0,35.76328502415459,496,70,28.943961352657006,2
Category_Wikipedia_sockpuppets_of_Ldiff23.csv,113,107905245.0,39,74,33,6,0,58.07964601769911,206,53,17.601769911504423,10
Category_Wikipedia_sockpuppets_of_TimesUpBeirut.csv,111,6560296.0,68,43,50,18,0,66.90090090090091,284,26,15.27927927927928,13
Category_Wikipedia_sockpuppets_of_Billy_Hathorn.csv,12091,387847299.0,3225,8866,500,2725,0,42.82209908196179,418,75,21.950045488379786,4
Category_Wikipedia_sockpuppets_of_Monkeyman34391.csv,3,83.0,2,1,2,0,16,62.0,154,34,34.0,34
Category_Wikipedia_sockpuppets_of_IamtrollingLOL.csv,5,1332.0,4,1,2,2,0,52.0,152,21,12.8,9
Category_Wikipedia_sockpuppets_of_Antonio_Vinzaretti.csv,787,7626961.0,330,457,308,22,0,40.4294790343075,495,69,25.607369758576873,3
Category_Wikipedia_sockpuppets_of_Toothie3.csv,1244,6094408.0,448,796,164,284,0,44.404340836012864,243,55,18.672829581993568,5
Category_Wikipedia_sockpuppets_of_Petermiketaylor.csv,24,5057971.0,12,12,5,7,0,89.33333333333333,255,40,26.333333333333332,18
Category_Wikipedia_sockpuppets_of_Mattthebohl.csv,255,2927150.0,75,180,38,37,0,36.74901960784314,255,38,15.27450980392157,9
Category_Wikipedia_sockpuppets_of_Davidahamd123.csv,843,15203014.0,306,537,262,44,0,53.88137603795967,494,43,18.983392645314353,5
Category_Wikipedia_sockpuppets_of_Vijji.hope.csv,29,59174033.0,29,0,29,0,0,21.689655172413794,194,28,19.75862068965517,15
Category_Wikipedia_sockpuppets_of_Mizzoufan24.csv,13,316363.0,7,6,5,2,0,38.46153846153846,147,47,44.53846153846154,36
Category_Wikipedia_sockpuppets_of_Gjergj_Zogaj128.csv,130,7242981.0,39,91,24,15,0,59.146153846153844,500,37,16.176923076923078,5
Category_Wikipedia_sockpuppets_of_The_Untouchables.csv,105,349270264.0,21,84,20,1,0,57.95238095238095,212,28,16.21904761904762,5
Category_Wikipedia_sockpuppets_of_TheRealCGC.csv,14,31515.0,8,6,7,1,0,87.57142857142857,226,24,13.642857142857142,5
Category_Wikipedia_sockpuppets_of_Tonny_Graphix_Tz.csv,2,0.0,1,1,1,0,55,55.0,55,53,53.0,53
Category_Wikipedia_sockpuppets_of_Amritpal_Singh_Kotli.csv,189,8902452.0,110,79,78,32,0,29.83068783068783,198,20,14.507936507936508,7
Category_Wikipedia_sockpuppets_of_Ptmccain.csv,1703,17718055.0,717,986,500,217,0,42.69230769230769,200,56,22.081033470346448,6
Category_Wikipedia_sockpuppets_of_Mingxiwu.csv,90,25746523.0,40,50,31,9,0,47.28888888888889,180,23,16.81111111111111,13
Category_Wikipedia_sockpuppets_of_Hmulligan.csv,18,2345896.0,6,12,4,2,5,56.94444444444444,187,42,25.333333333333332,4
Category_Wikipedia_sockpuppets_of_Albanian_Historian.csv,3456,142453152.0,1307,2149,500,807,0,49.712094907407405,495,81,18.870949074074073,5
Category_Wikipedia_sockpuppets_of_The_abolobo.csv,6,131783.0,4,2,2,2,45,101.0,165,37,37.0,37
Category_Wikipedia_sockpuppets_of_Rafaschool.csv,8,229915.0,6,2,4,2,0,94.5,191,11,11.0,11
Category_Wikipedia_sockpuppets_of_MooshiePorkFace.csv,8304,72807734.0,3016,5288,500,2516,0,45.101999036608866,257,93,18.721941233140655,3
Category_Wikipedia_sockpuppets_of_Ameera_Patel.csv,149,21837009.0,46,103,33,13,0,58.90604026845637,266,64,26.677852348993287,6
Category_Wikipedia_sockpuppets_of_Torga.csv,428,192316329.0,155,273,143,12,0,46.978971962616825,235,62,23.815420560747665,8
Category_Wikipedia_sockpuppets_of_Niederrheiner81.csv,505,101922391.0,159,346,108,51,0,57.06138613861386,496,60,15.279207920792079,3
Category_Wikipedia_sockpuppets_of_Alam567.csv,245,74020360.0,105,140,97,8,0,42.35918367346939,231,70,20.522448979591836,3
Category_Wikipedia_sockpuppets_of_Faizkhahmed133.csv,8,1626536.0,6,2,6,0,0,90.625,495,32,21.625,15
Category_Wikipedia_sockpuppets_of_Vishalinfidigit.csv,1042,42496723.0,287,755,95,192,0,44.382917466410746,255,36,14.808061420345489,4
Category_Wikipedia_sockpuppets_of_Rejs12345.csv,2626,320993498.0,633,1993,291,342,0,44.634044173648135,502,53,15.746001523229246,2
Category_Wikipedia_sockpuppets_of_King_of_Mercia.csv,267,2392832.0,81,186,81,0,0,43.36329588014981,223,34,19.089887640449437,10
Category_Wikipedia_sockpuppets_of_BarehamOliver.csv,5330,84953151.0,1952,3378,500,1452,0,50.56885553470919,496,140,23.705440900562852,5
Category_Wikipedia_sockpuppets_of_Marrrrr.csv,51,315529.0,17,34,17,0,0,30.098039215686274,173,17,12.333333333333334,9
Category_Wikipedia_sockpuppets_of_Johnviz.csv,48,2882029.0,40,8,22,18,0,22.541666666666668,109,19,17.791666666666668,12
Category_Wikipedia_sockpuppets_of_Rflans.csv,62,301819137.0,22,40,14,8,0,46.95161290322581,241,30,17.43548387096774,11
Category_Wikipedia_sockpuppets_of_Vigneshcinema.csv,8,3772.0,8,0,8,0,0,134.5,495,23,19.25,18
Category_Wikipedia_sockpuppets_of_Shir-e-Iran.csv,210,839708.0,88,122,56,32,0,41.22857142857143,197,82,20.20952380952381,5
Category_Wikipedia_sockpuppets_of_TheOneCandleMan.csv,88,19560540.0,31,57,31,0,0,36.06818181818182,188,31,17.897727272727273,6
Category_Wikipedia_sockpuppets_of_Messupthesite.csv,2,203.0,2,0,2,0,0,6.5,13,20,20.0,20
Category_Wikipedia_sockpuppets_of_KiddKash32.csv,15,92636.0,12,3,10,2,0,20.533333333333335,144,8,6.666666666666667,4
Category_Wikipedia_sockpuppets_of_H5andh5.csv,65,2682217.0,26,39,26,0,0,40.6,192,38,19.43076923076923,13
Category_Wikipedia_sockpuppets_of_SwedishSven.csv,596,156869992.0,155,441,86,69,0,56.18791946308725,250,65,23.203020134228186,8
Category_Wikipedia_sockpuppets_of_CIH0426.csv,237,2638.0,100,137,100,0,0,29.042194092827003,255,31,21.47257383966245,12
Category_Wikipedia_sockpuppets_of_PapaMcBengoglio.csv,5,519590.0,2,3,1,1,12,57.8,134,29,15.2,6
Category_Wikipedia_sockpuppets_of_Subhrakant_sahoo.csv,27,9512091.0,12,15,5,7,0,45.629629629629626,185,26,5.148148148148148,2
Category_Wikipedia_sockpuppets_of_NflFanInEditing.csv,710,18640441.0,230,480,122,108,0,43.297183098591546,496,56,15.922535211267606,8
Category_Wikipedia_sockpuppets_of_Dougal83.csv,173,230166999.0,67,106,54,13,0,63.410404624277454,255,50,21.040462427745666,16
Category_Wikipedia_sockpuppets_of_Asdisis.csv,1984,64657783.0,715,1269,500,215,0,50.676411290322584,255,50,27.706149193548388,7
Category_Wikipedia_sockpuppets_of_Nazrulbdjessore.csv,58,27413589.0,14,44,14,0,0,49.08620689655172,236,36,24.586206896551722,14
Category_Wikipedia_sockpuppets_of_Liam-dino.csv,3101,64100831.0,656,2445,500,156,0,45.598194130925506,255,67,18.405353111899387,2
Category_Wikipedia_sockpuppets_of_Blogs19.csv,17986,57441565.0,6274,11712,500,5774,0,45.530912932280664,496,74,17.801512287334592,3
Category_Wikipedia_sockpuppets_of_Irate.csv,4615,42069780.0,1768,2847,500,1268,0,27.401083423618633,228,98,21.887973997833154,3
Category_Wikipedia_sockpuppets_of_KahnJohn27.csv,2879,13296033.0,1037,1842,500,537,0,52.687391455366445,255,52,21.36853073984022,4
Category_Wikipedia_sockpuppets_of_Alexisdaoud.csv,18,34191052.0,11,7,6,5,0,62.94444444444444,247,10,10.0,10
Category_Wikipedia_sockpuppets_of_ReeceTheHawk.csv,311,7413530.0,110,201,71,39,0,58.842443729903536,253,47,24.009646302250804,8
Category_Wikipedia_sockpuppets_of_Alysia121.csv,9,1182.0,8,1,5,3,13,28.0,123,15,13.0,12
Category_Wikipedia_sockpuppets_of_Stravin.csv,4537,88127560.0,1722,2815,500,1222,0,40.477407978840645,263,81,21.073176107560062,6
Category_Wikipedia_sockpuppets_of_Radiokills.csv,9,9257598.0,2,7,2,0,31,52.333333333333336,111,34,30.88888888888889,20
Category_Wikipedia_sockpuppets_of_Hansi_jat.csv,2206,60202028.0,648,1558,413,235,0,29.37851314596555,254,56,15.12692656391659,5
Category_Wikipedia_sockpuppets_of_Cleander.csv,577,9144294.0,187,390,169,18,0,31.27209705372617,248,28,15.892547660311958,5
Category_Wikipedia_sockpuppets_of_Abhijeet_Sinha_Sinha.csv,253,49792509.0,81,172,57,24,0,43.794466403162055,236,51,25.75889328063241,5
Category_Wikipedia_sockpuppets_of_Nvarunk.csv,211,84135620.0,55,156,25,30,0,44.65876777251185,255,49,17.46919431279621,3
Category_Wikipedia_sockpuppets_of_BlackAnt1997.csv,224,18908818.0,63,161,46,17,0,59.098214285714285,254,68,21.727678571428573,6
Category_Wikipedia_sockpuppets_of_Spotfixer.csv,4907,88130616.0,1492,3415,500,992,0,49.16140207866314,250,64,21.736702669655593,3
Category_Wikipedia_sockpuppets_of_Ashutoshsinghkaulvalmiki.csv,651,7364163.0,303,348,203,100,0,37.663594470046085,247,45,16.98310291858679,11
Category_Wikipedia_sockpuppets_of_Sanjay911.csv,566,62962250.0,170,396,169,1,0,44.42402826855124,248,50,23.681978798586574,5
Category_Wikipedia_sockpuppets_of_Smmtt.csv,276,186551467.0,100,176,78,22,0,41.71376811594203,248,41,18.391304347826086,10
Category_Wikipedia_sockpuppets_of_Eurodanceguy.csv,1612,29250096.0,1023,589,500,523,0,29.320719602977668,312,63,19.193548387096776,4
Category_Wikipedia_sockpuppets_of_Knectek.csv,91,4768766.0,29,62,12,17,0,42.97802197802198,232,42,21.12087912087912,10
Category_Wikipedia_sockpuppets_of_DaSa37126.csv,5,2264.0,4,1,3,1,45,63.2,118,15,15.0,15
Category_Wikipedia_sockpuppets_of_IWILFIXTHEWIKIFORYOUMYFRIENDS.csv,20,982832.0,10,10,8,2,0,55.9,220,29,13.05,5
Category_Wikipedia_sockpuppets_of_Paul_iwarri_kingsley.csv,120,104173713.0,37,83,22,15,0,46.516666666666666,352,25,13.491666666666667,6
Category_Wikipedia_sockpuppets_of_ModelsNews.csv,44,60026.0,27,17,22,5,0,28.931818181818183,165,22,16.045454545454547,5
Category_Wikipedia_sockpuppets_of_WzhanG829175.csv,170,295590149.0,34,136,31,3,0,62.84705882352941,271,18,12.117647058823529,8
Category_Wikipedia_sockpuppets_of_Md_Molla.csv,59,25940754.0,15,44,11,4,0,50.220338983050844,224,58,22.559322033898304,8
Category_Wikipedia_sockpuppets_of_Magichar.csv,18,71702.0,7,11,7,0,0,37.666666666666664,100,41,38.27777777777778,18
Category_Wikipedia_sockpuppets_of_NotWorkin.csv,50,177177.0,13,37,10,3,0,60.04,187,23,13.98,7
Category_Wikipedia_sockpuppets_of_AshleyJackson2013.csv,161,171279571.0,101,60,60,41,0,52.67080745341615,233,25,12.490683229813664,10
Category_Wikipedia_sockpuppets_of_LLArrow.csv,1327,74658859.0,520,807,500,20,0,49.508666164280335,255,44,23.418990203466464,10
Category_Wikipedia_sockpuppets_of_FLYEZ.csv,18,9746.0,11,7,11,0,0,42.0,189,15,14.666666666666666,13
Category_Wikipedia_sockpuppets_of_Ibrahim.rashid55.csv,1466,10975020.0,646,820,500,146,0,35.22578444747612,500,73,21.29263301500682,6
Category_Wikipedia_sockpuppets_of_Petey_Parrot.csv,4563,203474909.0,1162,3401,500,662,0,50.14223098838483,255,97,18.96756519833443,1
Category_Wikipedia_sockpuppets_of_DrPoglum.csv,409,78351576.0,174,235,154,20,0,48.11002444987775,443,65,30.731051344743275,10
Category_Wikipedia_sockpuppets_of_Bronx24.csv,173,25764817.0,58,115,29,29,0,52.16184971098266,236,55,13.77456647398844,6
Category_Wikipedia_sockpuppets_of_Dont_do_anything_horny_on_me.csv,76,426201.0,33,43,14,19,0,67.02631578947368,338,50,24.763157894736842,9
Category_Wikipedia_sockpuppets_of_CKJJ99.csv,40,638717.0,20,20,9,11,0,49.675,255,34,21.775,8
Category_Wikipedia_sockpuppets_of_FergusM1970.csv,1861,7387349.0,606,1255,500,106,0,51.59860290166577,255,49,35.86996238581408,3
Category_Wikipedia_sockpuppets_of_Vivekanands28.csv,80,40983096.0,31,49,14,17,0,60.8375,255,29,16.8875,7
Category_Wikipedia_sockpuppets_of_Fredrick_day.csv,5151,14768508.0,1486,3665,500,986,0,46.84080761017278,272,103,26.94253543001359,4
Category_Wikipedia_sockpuppets_of_ProfMozart.csv,212,5444268.0,78,134,46,32,0,25.49056603773585,199,56,23.66509433962264,6
Category_Wikipedia_sockpuppets_of_Axmannate.csv,132,114764.0,74,58,41,33,0,35.90151515151515,152,43,21.954545454545453,16
Category_Wikipedia_sockpuppets_of_MUHAMMAD_IQBAL_ZAHARY_NIKPURWIL.csv,333,30955779.0,76,257,26,50,0,25.49249249249249,247,46,26.465465465465467,7
Category_Wikipedia_sockpuppets_of_Johnantony679.csv,3,1033.0,2,1,2,0,90,95.0,102,31,31.0,31
Category_Wikipedia_sockpuppets_of_TinGamerTV.csv,577,178915476.0,148,429,144,4,0,62.70363951473137,496,61,19.552859618717505,3
Category_Wikipedia_sockpuppets_of_Jasoncallen.csv,1,0.0,1,0,1,0,34,34.0,34,34,34.0,34
Category_Wikipedia_sockpuppets_of_Mrjbmrjb.csv,229,28963556.0,79,150,50,29,0,44.81659388646288,253,35,16.16157205240175,6
Category_Wikipedia_sockpuppets_of_Lman1987.csv,1851,10329544.0,524,1327,155,369,0,30.043760129659642,202,54,14.582928146947596,6
Category_Wikipedia_sockpuppets_of_Combatuser1.csv,1665,16769479.0,474,1191,164,310,0,51.807207207207206,446,78,20.807207207207206,4
Category_Wikipedia_sockpuppets_of_User38563.csv,2237,13776934.0,707,1530,419,288,0,39.08091193562807,250,46,15.953509164059007,9
Category_Wikipedia_sockpuppets_of_Wikionline101.csv,4,44764.0,2,2,1,1,0,18.25,42,15,15.0,15
Category_Wikipedia_sockpuppets_of_Chapter1947.csv,73,164053755.0,25,48,20,5,0,56.6986301369863,255,40,23.589041095890412,15
Category_Wikipedia_sockpuppets_of_Pnguyen4087.csv,43,2350449.0,19,24,13,6,0,28.72093023255814,96,74,25.3953488372093,16
Category_Wikipedia_sockpuppets_of_LiquidNix.csv,187,13971491.0,67,120,35,32,0,44.45989304812834,430,21,13.315508021390375,5
Category_Wikipedia_sockpuppets_of_Suicidal_tendancies.csv,856,30185147.0,241,615,147,94,0,31.992990654205606,194,111,22.352803738317757,7
Category_Wikipedia_sockpuppets_of_Ferura123.csv,66,8985464.0,26,40,14,12,0,74.03030303030303,250,20,14.166666666666666,12
Category_Wikipedia_sockpuppets_of_Germanicus44.csv,275,2007808.0,106,169,64,42,0,45.763636363636365,500,43,20.578181818181818,13
Category_Wikipedia_sockpuppets_of_KaiHunter12.csv,1534,2688827.0,480,1054,460,20,0,49.932203389830505,492,40,15.20599739243807,5
Category_Wikipedia_sockpuppets_of_TORR.csv,2500,270371832.0,500,2000,500,0,0,40.146,255,53,16.398,3
Category_Wikipedia_sockpuppets_of_Dwayneflanders.csv,8,2297.0,3,5,3,0,0,90.125,200,14,14.0,14
Category_Wikipedia_sockpuppets_of_The_almighty_stevens.csv,19,4707.0,8,11,4,4,0,73.78947368421052,235,30,13.578947368421053,8
Category_Wikipedia_sockpuppets_of_Silver_exe.csv,1776,17181481.0,707,1069,406,301,0,37.822072072072075,367,43,20.363175675675677,4
Category_Wikipedia_sockpuppets_of_Halfacanyon.csv,252,2637394.0,79,173,79,0,0,51.05952380952381,200,90,24.984126984126984,10
Category_Wikipedia_sockpuppets_of_Andriyiw.csv,116,6573817.0,46,70,36,10,0,35.577586206896555,486,30,20.68103448275862,15
Category_Wikipedia_sockpuppets_of_Religiouswog.csv,22,23949.0,10,12,10,0,0,48.0,233,24,14.0,4
Category_Wikipedia_sockpuppets_of_Ananislam.csv,2180,43858731.0,661,1519,248,413,0,64.46559633027523,496,77,21.09862385321101,3
Category_Wikipedia_sockpuppets_of_Wiki_Editor1974.csv,241,16729955.0,79,162,29,50,0,32.87966804979253,232,29,20.30290456431535,14
Category_Wikipedia_sockpuppets_of_Philipbrochard.csv,1838,75252274.0,530,1308,500,30,0,54.71926006528836,500,59,17.714907508161044,3
Category_Wikipedia_sockpuppets_of_MasaoOhba1949.csv,145,7022994.0,69,76,25,44,0,42.793103448275865,200,36,19.420689655172414,5
Category_Wikipedia_sockpuppets_of_Free_Hans.csv,44,315000.0,18,26,17,1,0,58.75,184,49,17.863636363636363,5
Category_Wikipedia_sockpuppets_of_Dontlietomenow.csv,26,1150581.0,11,15,6,5,0,54.96153846153846,225,28,18.115384615384617,17
Category_Wikipedia_sockpuppets_of_Sex_love.csv,168,170711016.0,35,133,29,6,0,71.17261904761905,236,39,11.339285714285714,3
Category_Wikipedia_sockpuppets_of_Burek021.csv,118,105828316.0,33,85,33,0,0,58.40677966101695,222,47,29.449152542372882,13
Category_Wikipedia_sockpuppets_of_74.138.237.75.csv,358,62041322.0,91,267,90,1,0,35.497206703910614,210,37,23.019553072625698,9
Category_Wikipedia_sockpuppets_of_Chantessy.csv,7980,193337879.0,2493,5487,500,1993,0,34.782080200501255,255,76,20.129949874686716,3
Category_Wikipedia_sockpuppets_of_Zombiedude101z.csv,486,196735005.0,140,346,88,52,0,59.77366255144033,285,44,19.39917695473251,4
Category_Wikipedia_sockpuppets_of_ElricFullMetal.csv,445,7874071.0,182,263,154,28,0,47.81797752808989,257,61,24.069662921348314,10
Category_Wikipedia_sockpuppets_of_Java7837.csv,5135,13626420.0,1144,3991,500,644,0,41.54683544303798,255,68,17.76689386562804,4
Category_Wikipedia_sockpuppets_of_Solutions4ga.csv,13,3094892.0,5,8,4,1,0,34.23076923076923,71,36,27.846153846153847,21
Category_Wikipedia_sockpuppets_of_Splifftastic.csv,24,2772.0,9,15,8,1,0,59.875,139,17,9.375,6
Category_Wikipedia_sockpuppets_of_DQMrMoney.csv,1787,71650360.0,516,1271,500,16,0,46.34247341913822,523,98,20.69054280917739,4
Category_Wikipedia_sockpuppets_of_Wikigiraffes.csv,182,2478778.0,54,128,28,26,0,46.010989010989015,195,53,24.296703296703296,10
Category_Wikipedia_sockpuppets_of_Mark_Marino.csv,226,2072822.0,70,156,57,13,0,34.03982300884956,209,47,25.36725663716814,8
Category_Wikipedia_sockpuppets_of_BenjaminSky.csv,502,10327562.0,169,333,148,21,0,35.37051792828685,250,51,16.87051792828685,7
Category_Wikipedia_sockpuppets_of_Atifsilal.csv,10,15188584.0,6,4,6,0,0,54.1,206,19,16.5,14
Category_Wikipedia_sockpuppets_of_Dalejenkins.csv,3132,113903600.0,1202,1930,500,702,0,40.56896551724138,261,99,28.84227330779055,5
Category_Wikipedia_sockpuppets_of_Wikimagic098.csv,262,26345188.0,63,199,7,56,0,87.77480916030534,255,67,15.034351145038167,3
Category_Wikipedia_sockpuppets_of_Jwratner1.csv,4014,8307505.0,1353,2661,500,853,0,53.51893373193822,263,59,15.017189835575486,3
Category_Wikipedia_sockpuppets_of_Afjnsd.csv,507,1840282.0,149,358,136,13,0,58.02564102564103,418,80,26.48915187376726,9
Category_Wikipedia_sockpuppets_of_TashHarr.csv,60,3364920.0,28,32,23,5,0,33.28333333333333,228,24,17.533333333333335,11
Category_Wikipedia_sockpuppets_of_Anhinhhhd.csv,6,6848922.0,4,2,2,2,0,28.666666666666668,118,49,48.0,47
Category_Wikipedia_sockpuppets_of_GroundhogTheater.csv,3288,58413590.0,1145,2143,497,648,0,36.590328467153284,254,86,25.71198296836983,4
Category_Wikipedia_sockpuppets_of_Anopjat12.csv,1,0.0,1,0,1,0,5,5.0,5,19,19.0,19
Category_Wikipedia_sockpuppets_of_Johnpayoyce1.csv,9,618.0,8,1,6,2,0,15.222222222222221,115,29,29.0,29
Category_Wikipedia_sockpuppets_of_Arjun7007.csv,252,46731552.0,79,173,32,47,0,45.567460317460316,223,52,25.654761904761905,10
Category_Wikipedia_sockpuppets_of_Erica_Doebbler.csv,91,41924090.0,36,55,16,20,0,60.967032967032964,199,19,12.417582417582418,8
Category_Wikipedia_sockpuppets_of_EXPolaris.csv,13,8585.0,12,1,8,4,0,27.53846153846154,116,29,17.153846153846153,10
Category_Wikipedia_sockpuppets_of_Eraseroftheevilshit.csv,579,13091873.0,256,323,186,70,0,28.95336787564767,261,41,11.259067357512953,6
Category_Wikipedia_sockpuppets_of_Saderocks.csv,101,5609592.0,41,60,18,23,0,22.633663366336634,171,43,23.168316831683168,13
Category_Wikipedia_sockpuppets_of_Sulshanamoodhi.csv,3538,37185106.0,1431,2107,500,931,0,42.750423968343696,359,105,22.976823063877898,4
Category_Wikipedia_sockpuppets_of_Yujeshkc.csv,115,43685036.0,23,92,22,1,0,57.54782608695652,245,25,14.608695652173912,10
Category_Wikipedia_sockpuppets_of_Marissa_Lautner.csv,7,3806.0,4,3,3,1,0,29.857142857142858,89,19,19.0,19
Category_Wikipedia_sockpuppets_of_Itsumitfrank.csv,150,19721030.0,68,82,57,11,0,46.00666666666667,254,42,19.766666666666666,6
Category_Wikipedia_sockpuppets_of_Tulshi_Pandey.csv,1432,32687545.0,583,849,500,83,0,33.354050279329606,255,60,18.203212290502794,4
Category_Wikipedia_sockpuppets_of_Amirv60~fawiki.csv,411,48304494.0,174,237,84,90,0,46.545012165450125,496,55,19.476885644768856,5
Category_Wikipedia_sockpuppets_of_Arder.csv,19,4078616.0,5,14,3,2,0,42.421052631578945,136,29,22.68421052631579,21
Category_Wikipedia_sockpuppets_of_Tehalpreet_Comedian.csv,47,2228659.0,29,18,21,8,0,54.8936170212766,170,29,14.063829787234043,5
Category_Wikipedia_sockpuppets_of_Jambot1872.csv,6,51.0,2,4,2,0,0,74.33333333333333,224,34,27.0,13
Category_Wikipedia_sockpuppets_of_Winston_S_Smith.csv,330,5631804.0,88,242,46,42,0,52.412121212121214,255,47,18.78181818181818,4
Category_Wikipedia_sockpuppets_of_Cos02125.csv,103,57370135.0,39,64,34,5,0,48.49514563106796,217,28,16.33009708737864,13
Category_Wikipedia_sockpuppets_of_Lets.Custodio.csv,183,1113287.0,66,117,66,0,0,79.52459016393442,500,80,25.56830601092896,9
Category_Wikipedia_sockpuppets_of_Bjaco18.csv,1185,18095916.0,516,669,500,16,0,36.28354430379747,213,63,19.768776371308018,6
Category_Wikipedia_sockpuppets_of_Vijay9699.csv,659,33295429.0,229,430,106,123,0,39.49317147192716,460,53,17.305007587253414,7
Category_Wikipedia_sockpuppets_of_Axience_Counsulting.csv,2,0.0,1,1,1,0,0,0.0,0,29,29.0,29
Category_Wikipedia_sockpuppets_of_Major_Dump.csv,1520,103593327.0,510,1010,257,253,0,64.92368421052632,500,50,18.455921052631577,7
Category_Wikipedia_sockpuppets_of_Carvin11.csv,2385,203207155.0,1000,1385,500,500,0,35.86918238993711,255,80,25.792033542976938,4
Category_Wikipedia_sockpuppets_of_TheErectile.csv,179,1562199.0,106,73,77,29,0,39.60335195530726,255,38,16.324022346368714,9
Category_Wikipedia_sockpuppets_of_Fisheriesjoe.csv,1058,153302145.0,259,799,157,102,0,39.13232514177694,252,71,18.48109640831758,5
Category_Wikipedia_sockpuppets_of_Sarbojnan.csv,27,348907.0,12,15,11,1,0,30.48148148148148,142,28,19.11111111111111,10
Category_Wikipedia_sockpuppets_of_TheBrokenTusk.csv,46,842110.0,25,21,25,0,0,108.8913043478261,407,49,12.173913043478262,8
Category_Wikipedia_sockpuppets_of_Pionier.csv,236,28062914.0,65,171,17,48,0,45.932203389830505,210,61,21.13135593220339,6
Category_Wikipedia_sockpuppets_of_Jlance3.csv,171,163814588.0,71,100,36,35,0,50.71345029239766,250,57,34.432748538011694,19
Category_Wikipedia_sockpuppets_of_Jvm21.csv,2421,73010161.0,1000,1421,500,500,0,28.933498554316397,310,59,20.919867823213547,4
Category_Wikipedia_sockpuppets_of_Jesse_wiseman.csv,41,524449.0,23,18,12,11,0,40.97560975609756,181,26,13.75609756097561,10
Category_Wikipedia_sockpuppets_of_Swallowing_gum.csv,947,10448574.0,326,621,27,299,0,45.550158394931366,257,48,15.598732840549102,3
Category_Wikipedia_sockpuppets_of_Taracka.csv,906,22213425.0,251,655,106,145,0,29.455849889624723,199,58,16.306843267108167,3
Category_Wikipedia_sockpuppets_of_CMAXHawkeye123.csv,18,3038.0,8,10,4,4,0,65.11111111111111,197,18,16.333333333333332,6
Category_Wikipedia_sockpuppets_of_Barseghyan1234321.csv,78,20714254.0,29,49,11,18,0,44.67948717948718,362,51,21.846153846153847,8
Category_Wikipedia_sockpuppets_of_Snleicester.csv,389,10433789.0,172,217,41,131,0,47.670951156812336,231,63,19.96401028277635,8
Category_Wikipedia_sockpuppets_of_Crawdad22.csv,108,11065678.0,44,64,42,2,0,65.08333333333333,215,35,21.47222222222222,17
Category_Wikipedia_sockpuppets_of_Izunna_Okafor.csv,294,203858097.0,106,188,87,19,0,51.87755102040816,453,39,16.503401360544217,4
Category_Wikipedia_sockpuppets_of_Once_and_Forever.csv,265,26633267.0,77,188,33,44,0,44.40754716981132,199,71,30.267924528301887,10
Category_Wikipedia_sockpuppets_of_Khan_Of_Naral.csv,1374,6234047.0,562,812,233,329,0,50.58369723435226,496,47,16.79330422125182,4
Category_Wikipedia_sockpuppets_of_False_dawn.csv,18,22326.0,8,10,8,0,0,33.888888888888886,138,25,14.5,8
Category_Wikipedia_sockpuppets_of_Candystaff.csv,17,2934819.0,7,10,5,2,0,43.8235294117647,271,18,15.764705882352942,12
Category_Wikipedia_sockpuppets_of_GGirl2012.csv,3,3464062.0,2,1,1,1,0,56.333333333333336,156,19,19.0,19
Category_Wikipedia_sockpuppets_of_Avesnape.csv,55,6469286.0,27,28,5,22,0,42.18181818181818,236,45,23.01818181818182,12
Category_Wikipedia_sockpuppets_of_Gudis50.csv,2,128.0,2,0,2,0,28,40.5,53,17,17.0,17
Category_Wikipedia_sockpuppets_of_Angela_from_the_Blue.csv,2718,26166641.0,810,1908,500,310,0,40.54562178072112,255,65,20.724061810154524,4
Category_Wikipedia_sockpuppets_of_Smartmyna.csv,499,17791053.0,163,336,71,92,0,49.30861723446894,304,55,21.160320641282564,5
Category_Wikipedia_sockpuppets_of_Selfdelusivecontradictoryliar.csv,101,4754042.0,41,60,25,16,0,44.31683168316832,253,39,18.594059405940595,5
Category_Wikipedia_sockpuppets_of_Ebadur.csv,194,78134417.0,98,96,83,15,0,39.123711340206185,216,44,17.38659793814433,6
Category_Wikipedia_sockpuppets_of_Beatthecyberhate.csv,221,348978.0,93,128,69,24,0,36.86425339366516,249,40,19.787330316742082,13
Category_Wikipedia_sockpuppets_of_Minun.csv,3582,90298808.0,1320,2262,500,820,0,32.80960357342267,228,68,21.65605806811837,4
Category_Wikipedia_sockpuppets_of_Stanislawlemlemlem.csv,268,179455042.0,65,203,38,27,0,56.23134328358209,229,50,23.39179104477612,17
Category_Wikipedia_sockpuppets_of_Alibarzanjilo.csv,693,178669187.0,224,469,55,169,0,46.552669552669556,276,50,17.004329004329005,5
Category_Wikipedia_sockpuppets_of_Aviation_geek.csv,219,25274819.0,83,136,21,62,0,55.0958904109589,249,71,19.073059360730593,3
Category_Wikipedia_sockpuppets_of_Bayramovi√ß.csv,230,66263845.0,61,169,36,25,0,58.46086956521739,501,47,25.81304347826087,11
Category_Wikipedia_sockpuppets_of_Dequan.csv,18,748041.0,6,12,3,3,0,71.88888888888889,220,45,21.0,12
Category_Wikipedia_sockpuppets_of_UkraineToday.csv,2209,85813119.0,827,1382,500,327,0,44.54368492530557,238,101,25.323223177908556,4
Category_Wikipedia_sockpuppets_of_Gallowayesq.csv,18,158320.0,11,7,8,3,0,27.77777777777778,124,23,21.333333333333332,19
Category_Wikipedia_sockpuppets_of_VeeraVijayapandi.csv,947,67971761.0,358,589,176,182,0,43.8194297782471,394,49,26.560718057022175,6
Category_Wikipedia_sockpuppets_of_ALEXANDERS_GHOST.csv,44,1220057.0,16,28,5,11,0,44.38636363636363,245,18,8.977272727272727,5
Category_Wikipedia_sockpuppets_of_Free_Roux.csv,35,47446798.0,17,18,6,11,0,49.17142857142857,221,39,24.085714285714285,14
Category_Wikipedia_sockpuppets_of_Oluwa2Chainz.csv,2376,132231783.0,1027,1349,500,527,0,57.1523569023569,421,75,19.552188552188554,4
Category_Wikipedia_sockpuppets_of_Chitt66.csv,4072,47218624.0,1500,2572,500,1000,0,47.58104125736739,550,123,17.023575638506877,4
Category_Wikipedia_sockpuppets_of_Finrell_ausi.csv,791,18125400.0,317,474,58,259,0,46.11125158027813,439,93,16.869785082174463,5
Category_Wikipedia_sockpuppets_of_Shivanshis4.csv,94,58203064.0,22,72,15,7,0,54.255319148936174,232,31,13.372340425531915,4
Category_Wikipedia_sockpuppets_of_Ljkwl99.csv,54,32621602.0,14,40,5,9,0,47.648148148148145,231,28,19.90740740740741,10
Category_Wikipedia_sockpuppets_of_Sofarsogood2012.csv,472,7932357.0,249,223,157,92,0,42.29449152542373,252,57,22.639830508474578,10
Category_Wikipedia_sockpuppets_of_Jaspreetsingh6.csv,2022,16739475.0,943,1079,500,443,0,30.398120672601383,496,53,18.4648862512364,3
Category_Wikipedia_sockpuppets_of_KerAvelt.csv,266,3385353.0,173,93,158,15,0,46.80075187969925,218,59,20.169172932330827,7
Category_Wikipedia_sockpuppets_of_123cordelia_villani123.csv,2,0.0,1,1,1,0,8,8.0,8,80,80.0,80
Category_Wikipedia_sockpuppets_of_Cartoonistarif.csv,497,282588994.0,144,353,38,106,0,50.68008048289738,255,35,16.438631790744466,6
Category_Wikipedia_sockpuppets_of_Aarif_shah_92.csv,18,594011.0,8,10,5,3,0,62.111111111111114,227,23,14.444444444444445,6
Category_Wikipedia_sockpuppets_of_Mandingo1212.csv,17,144506.0,8,9,7,1,0,62.23529411764706,219,30,29.823529411764707,29
Category_Wikipedia_sockpuppets_of_AaronShirley.csv,95,28027119.0,56,39,54,2,0,54.85263157894737,255,35,23.50526315789474,17
Category_Wikipedia_sockpuppets_of_Cygnus_Flare.csv,36,71500.0,19,17,16,3,0,36.361111111111114,196,41,32.02777777777778,22
Category_Wikipedia_sockpuppets_of_SpongebobLawyerPants.csv,533,13214559.0,245,288,229,16,0,36.069418386491556,253,59,32.572232645403375,11
Category_Wikipedia_sockpuppets_of_MHNIR.csv,16,1585090.0,13,3,9,4,0,32.375,133,26,13.1875,6
Category_Wikipedia_sockpuppets_of_Electriccatfish2.csv,1657,10954505.0,508,1149,500,8,0,60.54918527459264,255,89,23.626433313216655,1
Category_Wikipedia_sockpuppets_of_Luxembompamu.csv,371,6373468.0,118,253,23,95,0,50.38544474393531,242,42,20.234501347708896,7
Category_Wikipedia_sockpuppets_of_GoWarriors151718.csv,1008,12477021.0,500,508,500,0,0,27.25595238095238,494,98,38.095238095238095,12
Category_Wikipedia_sockpuppets_of_Zenkai251.csv,1208,6279818.0,507,701,500,7,0,50.12582781456954,245,50,19.90976821192053,8
Category_Wikipedia_sockpuppets_of_Vishnuvkt.csv,1,0.0,1,0,1,0,0,0.0,0,46,46.0,46
Category_Wikipedia_sockpuppets_of_Aditya_Khanna_Wiki_Editor.csv,1382,7804753.0,408,974,260,148,0,30.607091172214183,347,53,16.30752532561505,3
Category_Wikipedia_sockpuppets_of_Springsteen1555.csv,2060,16390005.0,539,1521,214,325,0,47.74902912621359,496,52,17.673300970873786,6
Category_Wikipedia_sockpuppets_of_Quixotic92.csv,105,21095444.0,47,58,31,16,0,49.114285714285714,205,52,25.99047619047619,10
Category_Wikipedia_sockpuppets_of_HaruoShin20.csv,1350,13927514.0,501,849,176,325,0,31.32,251,58,19.928148148148146,4
Category_Wikipedia_sockpuppets_of_BenjaminShoe8.csv,66,78396360.0,28,38,15,13,0,68.0,216,37,21.12121212121212,17
Category_Wikipedia_sockpuppets_of_Jiteshdugar.csv,257,71940015.0,67,190,62,5,0,48.011673151750976,253,57,14.424124513618677,4
Category_Wikipedia_sockpuppets_of_Nreuhs.csv,546,72131668.0,179,367,127,52,0,38.404761904761905,214,54,26.882783882783883,11
Category_Wikipedia_sockpuppets_of_Mdp0007.csv,220,1916733.0,104,116,102,2,0,42.20909090909091,255,44,22.7,12
Category_Wikipedia_sockpuppets_of_Pagwghd33.csv,1453,62585364.0,545,908,303,242,0,40.3337921541638,496,47,14.448726772195458,3
Category_Wikipedia_sockpuppets_of_Greenock125.csv,18864,536624172.0,6249,12615,500,5749,0,38.77979219677693,522,84,20.04092451229856,3
Category_Wikipedia_sockpuppets_of_AdaSun1128.csv,26,587136.0,17,9,10,7,0,30.346153846153847,192,24,15.115384615384615,11
Category_Wikipedia_sockpuppets_of_Onara_kun.csv,14,173792.0,9,5,8,1,0,41.92857142857143,226,40,20.142857142857142,10
Category_Wikipedia_sockpuppets_of_HumanRightsVoilations.csv,169,174340.0,58,111,32,26,0,61.928994082840234,398,40,12.337278106508876,5
Category_Wikipedia_sockpuppets_of_Millat_Ahmad.csv,45,4389567.0,20,25,16,4,0,53.422222222222224,178,53,22.8,13
Category_Wikipedia_sockpuppets_of_Thisscol.csv,11,70430.0,6,5,5,1,0,28.818181818181817,148,29,24.636363636363637,17
Category_Wikipedia_sockpuppets_of_Ketias.csv,18,4304730.0,7,11,5,2,0,43.05555555555556,124,34,18.666666666666668,5
Category_Wikipedia_sockpuppets_of_Happinessfabric.csv,17,36263.0,11,6,10,1,0,64.47058823529412,161,36,33.411764705882355,25
Category_Wikipedia_sockpuppets_of_Gahd7894.csv,40,2913.0,11,29,2,9,0,59.95,162,19,12.175,5
Category_Wikipedia_sockpuppets_of_Tex_Goldstein.csv,28,27998.0,9,19,3,6,0,52.107142857142854,198,24,17.821428571428573,11
Category_Wikipedia_sockpuppets_of_Trilobite_Tuesday.csv,136,3020107.0,42,94,22,20,0,52.125,214,51,26.669117647058822,5
Category_Wikipedia_sockpuppets_of_Alwayssmileguys.csv,723,11205538.0,278,445,261,17,0,36.44121715076072,255,64,22.734439834024897,4
Category_Wikipedia_sockpuppets_of_Meetinnovators.csv,42,479613.0,10,32,9,1,0,31.214285714285715,167,35,12.80952380952381,6
Category_Wikipedia_sockpuppets_of_Peacebuildera.csv,8,109983.0,3,5,1,2,3,123.75,413,70,70.0,70
Category_Wikipedia_sockpuppets_of_Habeshan_negus.csv,227,53915238.0,54,173,53,1,0,67.8898678414097,499,24,13.044052863436123,7
Category_Wikipedia_sockpuppets_of_Youareagoner.csv,99,87397789.0,31,68,16,15,0,51.07070707070707,224,40,16.595959595959595,7
Category_Wikipedia_sockpuppets_of_Jack.paton.csv,390,14821359.0,201,189,66,135,0,27.382051282051282,255,37,28.076923076923077,11
Category_Wikipedia_sockpuppets_of_Noneof_yourbusiness48.csv,8769,81898447.0,2448,6321,500,1948,0,65.81651271524689,434,64,21.051203101836013,3
Category_Wikipedia_sockpuppets_of_Md.lemon.mridhaaa.csv,1,0.0,1,0,1,0,55,55.0,55,17,17.0,17
Category_Wikipedia_sockpuppets_of_Prankboy743.csv,2263,10474120.0,945,1318,500,445,0,29.409633230225364,272,78,18.913389306230666,4
Category_Wikipedia_sockpuppets_of_Steinpal.csv,4979,174830378.0,1454,3525,500,954,0,40.01807591885921,280,62,19.491464149427596,3
Category_Wikipedia_sockpuppets_of_Isheek.csv,165,6628826.0,64,101,46,18,0,45.82424242424243,496,53,33.72727272727273,15
Category_Wikipedia_sockpuppets_of_Rembrandt82.csv,8,1650.0,5,3,3,2,0,37.375,187,14,13.25,13
Category_Wikipedia_sockpuppets_of_Arthurberkhardt.csv,254,6656658.0,104,150,100,4,0,52.37795275590551,255,60,37.40551181102362,4
Category_Wikipedia_sockpuppets_of_Cassist.csv,151,98666689.0,56,95,53,3,0,50.4635761589404,249,43,14.71523178807947,11
Category_Wikipedia_sockpuppets_of_Commanderofthescript.csv,52,46128887.0,19,33,14,5,0,37.75,229,26,13.961538461538462,10
Category_Wikipedia_sockpuppets_of_Dustfinger203.csv,24,10882908.0,16,8,11,5,0,27.041666666666668,141,52,28.0,8
Category_Wikipedia_sockpuppets_of_RodolfMita.csv,60,26680126.0,12,48,9,3,0,68.88333333333334,217,52,13.533333333333333,3
Category_Wikipedia_sockpuppets_of_Nyonyalita.csv,246,2772495.0,97,149,75,22,0,38.483739837398375,210,42,16.784552845528456,6
Category_Wikipedia_sockpuppets_of_JonathanVelleRoss.csv,127,10034442.0,64,63,59,5,0,20.503937007874015,201,44,21.385826771653544,15
Category_Wikipedia_sockpuppets_of_Zawl.csv,8596,111593332.0,2566,6030,500,2066,0,62.44183341088878,500,72,20.354699860400185,2
Category_Wikipedia_sockpuppets_of_Pimpjnc.csv,2763,7828576.0,840,1923,500,340,0,36.23127035830619,255,54,16.517915309446256,3
Category_Wikipedia_sockpuppets_of_Engleham.csv,1449,131290654.0,504,945,500,4,0,42.87163561076605,255,56,25.21946169772257,6
Category_Wikipedia_sockpuppets_of_Clukowiak.csv,2843,54150082.0,646,2197,259,387,0,47.905381639113614,502,56,14.165318325712276,7
Category_Wikipedia_sockpuppets_of_Kobe707.csv,8,4222.0,5,3,2,3,0,57.125,181,6,6.0,6
Category_Wikipedia_sockpuppets_of_Ashiqur_Rahman_Junior.csv,24,14364.0,12,12,11,1,24,76.875,235,31,24.458333333333332,14
Category_Wikipedia_sockpuppets_of_MissNadine.csv,17,852877.0,15,2,10,5,0,27.529411764705884,179,33,33.0,33
Category_Wikipedia_sockpuppets_of_Fredrickagyeitwum.csv,49,6350570.0,13,36,9,4,0,49.6530612244898,203,42,16.183673469387756,6
Category_Wikipedia_sockpuppets_of_Sonvito.csv,7,21808.0,5,2,3,2,0,31.428571428571427,110,19,16.857142857142858,14
Category_Wikipedia_sockpuppets_of_Alynahobbs.csv,25,18938623.0,24,1,15,9,0,6.28,113,15,15.0,15
Category_Wikipedia_sockpuppets_of_Genepangettalaga.csv,220,12001905.0,61,159,30,31,0,44.22727272727273,254,50,16.45909090909091,7
Category_Wikipedia_sockpuppets_of_GooseGooseBoi.csv,71,95697.0,33,38,19,14,0,42.19718309859155,159,23,14.71830985915493,4
Category_Wikipedia_sockpuppets_of_Jamewt28.csv,7,21492.0,6,1,1,5,94,104.14285714285714,118,13,13.0,13
Category_Wikipedia_sockpuppets_of_Baloch_khosa.csv,17,464607.0,11,6,4,7,15,68.82352941176471,176,37,21.058823529411764,5
Category_Wikipedia_sockpuppets_of_Business_of_Today.csv,9,332420.0,3,6,3,0,20,55.22222222222222,161,42,29.0,18
Category_Wikipedia_sockpuppets_of_Amir_khorasanizadeh.csv,10,106186.0,7,3,5,2,0,19.7,46,29,26.9,24
Category_Wikipedia_sockpuppets_of_RussianLiberal.csv,184,5124266.0,65,119,57,8,0,38.60326086956522,196,47,28.152173913043477,8
Category_Wikipedia_sockpuppets_of_Sambokim.csv,332,98460267.0,142,190,128,14,0,30.882530120481928,229,22,11.957831325301205,5
Category_Wikipedia_sockpuppets_of_Artisol2345.csv,1442,28850359.0,562,880,500,62,0,30.274618585298196,259,89,23.586685159500693,3
Category_Wikipedia_sockpuppets_of_NitrogenTSRH.csv,935,177670249.0,253,682,158,95,0,44.71764705882353,255,45,18.348663101604277,5
Category_Wikipedia_sockpuppets_of_Kpboyak.csv,34,679003.0,31,3,29,2,0,11.676470588235293,195,51,27.735294117647058,12
Category_Wikipedia_sockpuppets_of_42isthedefiniteanswer.csv,1701,430713916.0,638,1063,500,138,0,43.11169900058789,280,74,24.663139329805997,3
Category_Wikipedia_sockpuppets_of_Hipsterocracy.csv,111,2452832.0,33,78,22,11,0,46.77477477477478,254,56,22.92792792792793,11
Category_Wikipedia_sockpuppets_of_Athenacat34.csv,55,44325929.0,11,44,10,1,0,74.78181818181818,251,14,10.49090909090909,9
Category_Wikipedia_sockpuppets_of_Rasikdave.csv,1189,454217651.0,399,790,246,153,0,36.05130361648444,255,35,10.09251471825063,3
Category_Wikipedia_sockpuppets_of_MS_Games_and_Software.csv,2,0.0,1,1,1,0,22,22.0,22,31,31.0,31
Category_Wikipedia_sockpuppets_of_Secret_of_success.csv,2714,151562842.0,705,2009,500,205,0,44.820560058953575,264,104,17.16249078850405,3
Category_Wikipedia_sockpuppets_of_Dlresbin.csv,8,1522.0,6,2,1,5,0,20.25,65,19,19.0,19
Category_Wikipedia_sockpuppets_of_Manasi2k.csv,7,3182095.0,6,1,5,1,10,22.428571428571427,35,18,9.428571428571429,6
Category_Wikipedia_sockpuppets_of_The_boy_from_mensa.csv,22,2158641.0,6,16,6,0,0,76.9090909090909,186,32,13.545454545454545,4
Category_Wikipedia_sockpuppets_of_Cocacolakogas.csv,1781,41715603.0,565,1216,500,65,0,34.245367770915216,473,67,24.79674340258282,4
Category_Wikipedia_sockpuppets_of_RealGhostbuster.csv,114,82117116.0,28,86,26,2,0,46.833333333333336,255,45,17.56140350877193,4
Category_Wikipedia_sockpuppets_of_~S.Brendan.S~.csv,102,6561670.0,37,65,36,1,0,47.833333333333336,230,25,21.42156862745098,18
Category_Wikipedia_sockpuppets_of_OnIPliOn.csv,2640,34884188.0,1000,1640,500,500,0,70.58901515151516,462,67,19.15681818181818,4
Category_Wikipedia_sockpuppets_of_Karake√ßi24.csv,97,2034587.0,49,48,30,19,0,75.29896907216495,512,38,28.288659793814432,19
Category_Wikipedia_sockpuppets_of_Jonathanbishop.csv,1134,337761026.0,298,836,294,4,0,45.22927689594356,255,66,23.47530864197531,4
Category_Wikipedia_sockpuppets_of_Soso3456.csv,336,4512253.0,107,229,93,14,0,49.901785714285715,332,50,20.81547619047619,7
Category_Wikipedia_sockpuppets_of_Fonte_de_regaz.csv,4004,126644233.0,1426,2578,402,1024,0,39.31043956043956,269,62,29.208541458541458,4
Category_Wikipedia_sockpuppets_of_House1090.csv,2785,514367669.0,859,1926,500,359,0,49.60825852782765,496,77,24.436265709156196,2
Category_Wikipedia_sockpuppets_of_Humanweb.csv,2804,62538980.0,644,2160,297,347,0,57.305634807417974,255,64,16.42938659058488,3
Category_Wikipedia_sockpuppets_of_Naadapriya.csv,1504,83598415.0,588,916,500,88,0,47.400930851063826,250,65,22.179521276595743,6
Category_Wikipedia_sockpuppets_of_ByzantineIsNotRoman.csv,3647,96417500.0,1242,2405,500,742,0,50.88977241568412,504,78,23.79160954208939,4
Category_Wikipedia_sockpuppets_of_CME0i0.csv,1527,24942662.0,439,1088,102,337,0,51.043876882776686,497,58,19.713817943680418,5
Category_Wikipedia_sockpuppets_of_Shivanshsinghrajpoot.csv,1003,62698804.0,505,498,500,5,0,32.13160518444666,251,60,23.235294117647058,5
Category_Wikipedia_sockpuppets_of_Adding_india.csv,21,960043.0,14,7,14,0,0,49.23809523809524,255,32,25.80952380952381,15
Category_Wikipedia_sockpuppets_of_Iamaneditorofwiki.csv,1138,2481278.0,398,740,387,11,0,47.90421792618629,500,53,24.402460456942002,3
Category_Wikipedia_sockpuppets_of_BeaverTails18.csv,167,40379536.0,41,126,15,26,0,55.5748502994012,254,61,20.29940119760479,7
Category_Wikipedia_sockpuppets_of_Jimjones005.csv,24,2665249.0,10,14,8,2,0,23.875,143,21,14.541666666666666,8
Category_Wikipedia_sockpuppets_of_Strangeguy91.csv,630,37135808.0,220,410,205,15,0,55.338095238095235,255,39,14.398412698412699,6
Category_Wikipedia_sockpuppets_of_Infolmanac.csv,28,2244291.0,14,14,9,5,15,102.5,283,23,15.892857142857142,7
Category_Wikipedia_sockpuppets_of_Rick_brace.csv,53,677595.0,22,31,7,15,0,52.264150943396224,210,28,14.49056603773585,10
Category_Wikipedia_sockpuppets_of_TreePaper.csv,39,2579719.0,23,16,15,8,0,21.384615384615383,116,17,16.256410256410255,10
Category_Wikipedia_sockpuppets_of_Jessie881111.csv,84,107595.0,25,59,23,2,0,79.17857142857143,234,46,20.904761904761905,9
Category_Wikipedia_sockpuppets_of_Alexlot.csv,29,2225457.0,7,22,3,4,0,48.275862068965516,171,34,22.724137931034484,4
Category_Wikipedia_sockpuppets_of_Fightcorruption.csv,20,534146.0,8,12,8,0,0,43.35,137,38,36.9,36
Category_Wikipedia_sockpuppets_of_Elephantthegreenmile.csv,37,9308813.0,23,14,9,14,0,28.945945945945947,181,30,23.756756756756758,11
Category_Wikipedia_sockpuppets_of_Sayantansadipur.csv,3,884.0,2,1,2,0,8,18.0,23,25,25.0,25
Category_Wikipedia_sockpuppets_of_Edgaragayi.csv,855,88595921.0,358,497,292,66,0,38.43859649122807,255,77,25.548538011695907,5
Category_Wikipedia_sockpuppets_of_Chelsea232024.csv,2144,69733796.0,768,1376,500,268,0,63.5205223880597,255,65,19.257462686567163,3
Category_Wikipedia_sockpuppets_of_Bartlbs.csv,3176,66882127.0,1029,2147,380,649,0,41.35170025188917,265,112,14.472921914357682,3
Category_Wikipedia_sockpuppets_of_Trickster206.csv,342,14859434.0,114,228,114,0,0,37.03216374269006,219,61,22.31286549707602,11
Category_Wikipedia_sockpuppets_of_Yesson20.csv,68,134103828.0,21,47,19,2,0,55.970588235294116,249,48,17.485294117647058,2
Category_Wikipedia_sockpuppets_of_The_Almightey_Drill.csv,1984,51278460.0,596,1388,500,96,0,46.944556451612904,254,96,18.964717741935484,3
Category_Wikipedia_sockpuppets_of_AlfredVanVonDeDavis.csv,139,1741137.0,42,97,28,14,0,51.67625899280576,299,40,19.496402877697843,11
Category_Wikipedia_sockpuppets_of_SidewaysNic.csv,291,415798743.0,85,206,54,31,0,53.243986254295535,376,28,13.329896907216495,8
Category_Wikipedia_sockpuppets_of_Khilieexodia17.csv,164,4710576.0,53,111,32,21,0,56.97560975609756,326,33,16.96951219512195,7
Category_Wikipedia_sockpuppets_of_Politialguru.csv,6093,87125096.0,2144,3949,500,1644,0,47.78778926637125,500,56,19.591334318069915,2
Category_Wikipedia_sockpuppets_of_Snyth.csv,1470,136030333.0,586,884,500,86,0,38.15102040816326,255,70,19.11156462585034,5
Category_Wikipedia_sockpuppets_of_Soniabusan.csv,14,90433.0,7,7,7,0,0,44.0,129,53,41.857142857142854,20
Category_Wikipedia_sockpuppets_of_Najib_Qadam.csv,177,22484623.0,61,116,16,45,0,40.80790960451977,249,37,15.542372881355933,7
Category_Wikipedia_sockpuppets_of_Uvig8b96.csv,18,214279.0,10,8,6,4,0,53.111111111111114,145,11,10.333333333333334,10
Category_Wikipedia_sockpuppets_of_Dane.rosenberg.csv,9,615351.0,6,3,4,2,0,21.11111111111111,31,51,37.666666666666664,17
Category_Wikipedia_sockpuppets_of_Swe123123.csv,481,6904265.0,174,307,132,42,0,42.2037422037422,247,64,19.87733887733888,4
Category_Wikipedia_sockpuppets_of_Excuseme99.csv,8548,137385328.0,2364,6184,500,1864,0,41.81644829199813,262,54,14.325690219934488,4
Category_Wikipedia_sockpuppets_of_Trotline.csv,463,249504891.0,154,309,76,78,0,57.576673866090715,255,58,17.308855291576673,4
Category_Wikipedia_sockpuppets_of_Anonymous_Bond.csv,480,113467507.0,166,314,165,1,0,55.875,490,44,18.941666666666666,7
Category_Wikipedia_sockpuppets_of_AnAimlessRoad.csv,153,8155674.0,54,99,49,5,0,40.73856209150327,232,46,21.07843137254902,7
Category_Wikipedia_sockpuppets_of_AntonChigurhs_gun.csv,50,5319003.0,21,29,11,10,0,77.98,228,40,29.06,22
Category_Wikipedia_sockpuppets_of_Trowbridge_tim.csv,1175,96372426.0,325,850,215,110,0,53.40085106382979,263,82,19.111489361702127,7
Category_Wikipedia_sockpuppets_of_Agiurov.csv,32,1101247.0,21,11,13,8,0,87.0,152,25,25.0,25
Category_Wikipedia_sockpuppets_of_Rabbithole22.csv,251,8974448.0,72,179,14,58,0,40.07569721115538,233,48,23.589641434262948,5
Category_Wikipedia_sockpuppets_of_Ramakrishnasurathu.csv,146,803331.0,44,102,27,17,0,53.43835616438356,255,38,17.602739726027398,4
Category_Wikipedia_sockpuppets_of_RisingTide45.csv,56,5399149.0,31,25,29,2,0,22.0,199,53,41.482142857142854,17
Category_Wikipedia_sockpuppets_of_Nomalias.csv,254,51778175.0,139,115,129,10,0,24.681102362204726,196,22,16.921259842519685,5
Category_Wikipedia_sockpuppets_of_Hum1969.csv,3031,72408104.0,1030,2001,424,606,0,46.06169580996371,255,62,24.05410755526229,3
Category_Wikipedia_sockpuppets_of_Ggfghhffhhgg.csv,310,10433053.0,99,211,63,36,0,63.458064516129035,259,28,12.348387096774193,7
Category_Wikipedia_sockpuppets_of_BiasMonitor.csv,25,6228092.0,18,7,14,4,20,112.28,254,16,15.04,15
Category_Wikipedia_sockpuppets_of_Yaya222010.csv,96,11301664.0,38,58,25,13,0,46.166666666666664,199,31,16.885416666666668,10
Category_Wikipedia_sockpuppets_of_Emmaimmots.csv,51,463708.0,20,31,15,5,0,34.490196078431374,197,20,18.352941176470587,18
Category_Wikipedia_sockpuppets_of_U2ce.csv,44,13645067.0,16,28,15,1,0,53.04545454545455,212,26,17.045454545454547,9
Category_Wikipedia_sockpuppets_of_Feelthehurns.csv,67,7008765.0,42,25,38,4,0,64.25373134328358,255,24,13.686567164179104,12
Category_Wikipedia_sockpuppets_of_R2d212345.csv,153,104128.0,78,75,69,9,0,49.6797385620915,215,45,18.392156862745097,6
Category_Wikipedia_sockpuppets_of_Grace_1384.csv,64,359222.0,30,34,16,14,0,41.046875,196,23,15.734375,9
Category_Wikipedia_sockpuppets_of_Giuliosavo.csv,86,39288935.0,27,59,27,0,0,37.348837209302324,199,43,20.86046511627907,3
Category_Wikipedia_sockpuppets_of_Semberac.csv,857,51454704.0,380,477,195,185,0,33.910151691948656,216,52,10.602100350058343,4
Category_Wikipedia_sockpuppets_of_Aimspug.csv,417,38278714.0,89,328,33,56,0,42.378896882494004,255,27,11.796163069544365,3
Category_Wikipedia_sockpuppets_of_Akshaykumarvaanam.csv,33,74861.0,18,15,10,8,0,64.27272727272727,243,23,14.303030303030303,5
Category_Wikipedia_sockpuppets_of_0Naught0.csv,4,80151.0,3,1,2,1,0,44.5,178,18,18.0,18
Category_Wikipedia_sockpuppets_of_DETECTIVEX1000.csv,133,2447570.0,34,99,13,21,0,49.7593984962406,211,25,15.150375939849624,5
Category_Wikipedia_sockpuppets_of_Gomezprieto.csv,2620,439014097.0,773,1847,500,273,0,47.652671755725194,372,36,16.266030534351145,5
Category_Wikipedia_sockpuppets_of_Akash_Dahariya.csv,1561,8555623.0,366,1195,343,23,0,52.04099935938501,253,78,19.77578475336323,4
Category_Wikipedia_sockpuppets_of_Israeli_Rabbi.csv,115,65560542.0,39,76,19,20,0,77.79130434782608,498,57,25.695652173913043,15
Category_Wikipedia_sockpuppets_of_Haido_buhari.csv,279,5177325.0,82,197,20,62,0,45.16129032258065,208,45,16.29032258064516,5
Category_Wikipedia_sockpuppets_of_Whisperwire.csv,44,181574.0,30,14,12,18,0,25.636363636363637,119,45,33.84090909090909,21
Category_Wikipedia_sockpuppets_of_Nagyman56.csv,80,862053.0,30,50,19,11,0,40.1875,203,33,22.225,12
Category_Wikipedia_sockpuppets_of_Juliette_Han.csv,1558,11412214.0,518,1040,500,18,0,71.5397946084724,505,79,23.914634146341463,4
Category_Wikipedia_sockpuppets_of_Brennan_Hanalei_Torres.csv,115,11421568.0,82,33,65,17,0,24.547826086956523,199,61,32.017391304347825,24
Category_Wikipedia_sockpuppets_of_Moli1234.csv,60,232569.0,17,43,10,7,0,66.61666666666666,292,53,22.183333333333334,9
Category_Wikipedia_sockpuppets_of_Webster121.csv,690,3718394.0,210,480,182,28,0,39.42463768115942,214,53,17.56086956521739,3
Category_Wikipedia_sockpuppets_of_Lidbate.csv,2,25.0,2,0,2,0,21,30.0,39,17,17.0,17
Category_Wikipedia_sockpuppets_of_332dash.csv,209,8718794.0,70,139,58,12,0,57.47846889952153,250,53,16.88995215311005,9
Category_Wikipedia_sockpuppets_of_Starorion5.csv,93,3330890.0,35,58,17,18,0,44.236559139784944,218,21,14.0,13
Category_Wikipedia_sockpuppets_of_Lilbee4.csv,106,5450005.0,37,69,10,27,0,51.89622641509434,197,58,18.71698113207547,6
Category_Wikipedia_sockpuppets_of_OC_Jonathan.csv,14,463504.0,6,8,5,1,0,76.64285714285714,186,30,21.428571428571427,15
Category_Wikipedia_sockpuppets_of_Zohaib_Ahmad.csv,13,341414.0,7,6,4,3,0,46.15384615384615,195,14,13.538461538461538,12
Category_Wikipedia_sockpuppets_of_GypsyRose909.csv,27,1419.0,11,16,10,1,0,37.925925925925924,191,23,11.962962962962964,5
Category_Wikipedia_sockpuppets_of_Ïä§ÌÖå.csv,96,15673357.0,58,38,52,6,0,26.322916666666668,207,21,15.739583333333334,15
Category_Wikipedia_sockpuppets_of_Wrathofyazdan.csv,841,326674491.0,207,634,25,182,0,50.282996432818074,496,51,17.868014268727705,5
Category_Wikipedia_sockpuppets_of_Abdul-Malik01.csv,822,13242244.0,244,578,99,145,0,41.824817518248175,501,41,15.930656934306569,4
Category_Wikipedia_sockpuppets_of_Snowy26.csv,251,57105110.0,57,194,51,6,0,53.46613545816733,231,50,17.131474103585656,3
Category_Wikipedia_sockpuppets_of_Tkgood.csv,7697,101503148.0,1806,5891,500,1306,0,47.26049110042874,496,62,20.92828374691438,3
Category_Wikipedia_sockpuppets_of_Akash.ka01.csv,71,37302418.0,30,41,30,0,0,43.901408450704224,395,29,18.760563380281692,9
Category_Wikipedia_sockpuppets_of_Estrva.csv,484,107754485.0,142,342,139,3,0,42.111570247933884,250,55,22.642561983471076,3
Category_Wikipedia_sockpuppets_of_AZJustice.csv,595,4799439.0,196,399,55,141,0,34.80336134453781,199,54,19.381512605042015,10
Category_Wikipedia_sockpuppets_of_Apped1951.csv,5,584431.0,5,0,1,4,13,17.8,27,27,21.4,16
Category_Wikipedia_sockpuppets_of_Federicogoico2006.csv,767,176610373.0,278,489,85,193,0,42.60495436766623,376,51,20.048239895697524,5
Category_Wikipedia_sockpuppets_of_FactLabs.csv,1647,1003623.0,498,1149,100,398,0,42.1906496660595,394,79,19.185185185185187,4
Category_Wikipedia_sockpuppets_of_Smqumberrizvi.csv,87,164100626.0,21,66,21,0,0,53.85057471264368,249,34,17.49425287356322,5
Category_Wikipedia_sockpuppets_of_Walter_Ezequiel_Matthysse_Jr..csv,86,32096363.0,49,37,40,9,0,72.1046511627907,514,39,18.209302325581394,15
Category_Wikipedia_sockpuppets_of_AZUMMMIE.csv,13,2304915.0,7,6,4,3,0,75.92307692307692,220,14,14.0,14
Category_Wikipedia_sockpuppets_of_Soapamalkanmaime.csv,38001,302993254.0,10758,27243,500,10258,0,45.844214625930896,500,108,21.647561906265626,2
Category_Wikipedia_sockpuppets_of_Zhongguoyingdu.csv,970,244413509.0,194,776,189,5,0,54.883505154639174,496,62,15.115463917525773,4
Category_Wikipedia_sockpuppets_of_Eeuwaahh.csv,41,487.0,11,30,10,1,0,60.0,199,29,15.682926829268293,8
Category_Wikipedia_sockpuppets_of_Intangible.csv,1528,2805331.0,507,1021,500,7,0,34.14856020942408,200,91,23.532722513089006,5
Category_Wikipedia_sockpuppets_of_CreatorVRXAZ.csv,663,5708920.0,208,455,105,103,0,44.09049773755656,490,58,28.65610859728507,4
Category_Wikipedia_sockpuppets_of_ŒëŒ∏ŒªŒ∑œÑŒπŒ∫Œ¨.csv,1640,62367398.0,621,1019,500,121,0,38.50243902439024,500,73,27.829268292682926,5
Category_Wikipedia_sockpuppets_of_GCpredia.csv,1,0.0,1,0,1,0,101,101.0,101,39,39.0,39
Category_Wikipedia_sockpuppets_of_CLxAgency.csv,84,3076096.0,31,53,9,22,0,48.13095238095238,210,54,24.19047619047619,11
Category_Wikipedia_sockpuppets_of_TRUEV140.csv,2015,29021415.0,677,1338,309,368,0,37.07741935483871,255,50,17.61439205955335,5
Category_Wikipedia_sockpuppets_of_Davidfarly.csv,130,2067323.0,30,100,10,20,0,59.792307692307695,251,27,16.276923076923076,5
Category_Wikipedia_sockpuppets_of_LobitoSnr.csv,431,52758379.0,117,314,67,50,0,55.66125290023202,500,61,17.241299303944317,4
Category_Wikipedia_sockpuppets_of_Djavier.csv,8,8050.0,5,3,4,1,0,33.25,176,24,24.0,24
Category_Wikipedia_sockpuppets_of_JOEWM2004.csv,135,275982158.0,87,48,85,2,0,35.87407407407407,199,26,23.22222222222222,21
Category_Wikipedia_sockpuppets_of_Mrhs707.csv,262,13630893.0,151,111,143,8,0,31.87786259541985,221,54,27.270992366412212,9
Category_Wikipedia_sockpuppets_of_Markshazel.csv,481,5878374.0,129,352,54,75,0,75.21205821205821,255,37,13.792099792099792,3
Category_Wikipedia_sockpuppets_of_Guinea_pig_warrior.csv,1589,9265709.0,530,1059,500,30,0,43.175582127123974,238,67,22.84896161107615,4
Category_Wikipedia_sockpuppets_of_LeCri.csv,49,4338827.0,13,36,10,3,0,63.44897959183673,250,19,8.142857142857142,5
Category_Wikipedia_sockpuppets_of_Emokpareabraham.csv,26,24617122.0,10,16,10,0,0,48.42307692307692,218,29,25.73076923076923,14
Category_Wikipedia_sockpuppets_of_Catsanddogs13e3454.csv,8,95671.0,5,3,4,1,0,29.75,202,15,15.0,15
Category_Wikipedia_sockpuppets_of_Rohana_manjulawm.csv,77,12350587.0,65,12,48,17,0,28.025974025974026,107,29,21.194805194805195,17
Category_Wikipedia_sockpuppets_of_Djmex9205.csv,366,3110004.0,116,250,40,76,0,48.35792349726776,253,50,36.33879781420765,15
Category_Wikipedia_sockpuppets_of_Avnish.vikas.csv,63,10045623.0,20,43,9,11,0,66.0,255,43,23.634920634920636,5
Category_Wikipedia_sockpuppets_of_Rahlgd.csv,2384,22614193.0,613,1771,500,113,0,45.71518456375839,250,73,13.286073825503356,4
Category_Wikipedia_sockpuppets_of_Quickpeter.csv,121,88995489.0,27,94,18,9,0,76.19834710743801,255,15,11.305785123966942,10
Category_Wikipedia_sockpuppets_of_Khabargozari_mehr.csv,420,8618200.0,157,263,95,62,0,45.535714285714285,251,51,18.945238095238096,3
Category_Wikipedia_sockpuppets_of_Xabi1233.csv,9,21767089.0,8,1,5,3,0,68.88888888888889,196,18,13.666666666666666,11
Category_Wikipedia_sockpuppets_of_Puhleec.csv,3664,262522202.0,1425,2239,500,925,0,63.40447598253275,255,56,17.754366812227076,4
Category_Wikipedia_sockpuppets_of_Social_Credit_Generator.csv,2444,12864662.0,851,1593,344,507,0,52.326513911620296,495,42,16.84165302782324,3
Category_Wikipedia_sockpuppets_of_Brandywine_Bridge.csv,52,38371.0,29,23,10,19,0,63.69230769230769,209,32,14.115384615384615,7
Category_Wikipedia_sockpuppets_of_MichaelsNewName.csv,257,14925768.0,81,176,41,40,0,37.16342412451362,249,34,16.392996108949415,5
Category_Wikipedia_sockpuppets_of_Smokva26.csv,1250,6493020.0,376,874,159,217,0,59.8432,491,47,20.84,5
Category_Wikipedia_sockpuppets_of_Carola56.csv,1789,11454036.0,696,1093,280,416,0,42.544438233650084,240,70,19.37283398546674,6
Category_Wikipedia_sockpuppets_of_Dessalew_Berihun.csv,71,7138135.0,56,15,37,19,0,40.014084507042256,196,24,16.661971830985916,7
Category_Wikipedia_sockpuppets_of_Punctualgoose.csv,12,310969.0,4,8,1,3,0,50.25,239,26,21.5,20
Category_Wikipedia_sockpuppets_of_BullochAcademy.csv,36,367686.0,13,23,7,6,0,47.80555555555556,196,32,26.38888888888889,15
Category_Wikipedia_sockpuppets_of_Alifriend7.csv,72,1485776.0,35,37,17,18,0,41.583333333333336,243,38,18.458333333333332,6
Category_Wikipedia_sockpuppets_of_Tarakonas.csv,877,43699968.0,321,556,183,138,0,34.70809578107183,199,41,18.006841505131128,5
Category_Wikipedia_sockpuppets_of_Aprdeepak.csv,26,414813.0,7,19,5,2,0,28.26923076923077,171,53,44.23076923076923,15
Category_Wikipedia_sockpuppets_of_Felix_Natalo.csv,82,3654645.0,43,39,22,21,0,71.39024390243902,196,18,12.463414634146341,11
Category_Wikipedia_sockpuppets_of_Xeniafranklin101.csv,43,16222702.0,10,33,8,2,0,45.81395348837209,204,40,27.813953488372093,10
Category_Wikipedia_sockpuppets_of_Wikiscriber1.csv,7,3183301.0,5,2,3,2,0,68.85714285714286,116,13,13.0,13
Category_Wikipedia_sockpuppets_of_Raconteurmw.csv,4,87496.0,3,1,2,1,19,130.25,236,10,10.0,10
Category_Wikipedia_sockpuppets_of_Hhggtg3279.csv,1563,7010215.0,659,904,442,217,0,41.98848368522073,500,50,24.098528470889317,6
Category_Wikipedia_sockpuppets_of_Angel_Arreguin_Hernandez.csv,1989,37896989.0,855,1134,500,355,0,41.50276520864756,496,58,20.694318753142284,4
Category_Wikipedia_sockpuppets_of_FurbyFan2022.csv,328,5536775.0,110,218,27,83,0,40.30487804878049,298,48,15.021341463414634,4
Category_Wikipedia_sockpuppets_of_Thaiha119.csv,196,11806639.0,57,139,20,37,0,53.326530612244895,248,40,18.0,6
Category_Wikipedia_sockpuppets_of_MohammedBinAbdullah.csv,2280,24684402.0,690,1590,316,374,0,50.281140350877195,255,61,20.667543859649122,4
Category_Wikipedia_sockpuppets_of_Xui-Xui.csv,106,2161800.0,38,68,34,4,0,32.91509433962264,199,46,26.39622641509434,16
Category_Wikipedia_sockpuppets_of_Chopra_Yash.csv,76,6071208.0,32,44,12,20,0,49.10526315789474,228,27,18.75,12
Category_Wikipedia_sockpuppets_of_Editorofthepage1.csv,34,21586.0,24,10,14,10,0,37.5,233,31,31.0,31
Category_Wikipedia_sockpuppets_of_LazyDaisy.csv,123,59409701.0,76,47,58,18,0,23.056910569105693,173,74,35.21951219512195,13
Category_Wikipedia_sockpuppets_of_Leucosticte.csv,3029,106744341.0,955,2074,437,518,0,49.95411026741499,255,74,21.92571805876527,3
Category_Wikipedia_sockpuppets_of_WalterMitty.csv,1008,78945594.0,294,714,175,119,0,38.83134920634921,216,51,17.229166666666668,6
Category_Wikipedia_sockpuppets_of_Liefernando1.csv,161,32142132.0,51,110,15,36,0,51.78260869565217,496,29,15.770186335403727,4
Category_Wikipedia_sockpuppets_of_JellyJammer.csv,101,52999057.0,49,52,39,10,0,50.34653465346535,305,27,17.831683168316832,1
Category_Wikipedia_sockpuppets_of_Bloomfield.csv,6838,132328626.0,2399,4439,500,1899,0,29.789412108803745,254,65,20.3006727113191,2
Category_Wikipedia_sockpuppets_of_Hardknocks22.csv,27,12689347.0,9,18,8,1,0,61.51851851851852,214,22,18.962962962962962,12
Category_Wikipedia_sockpuppets_of_Lemme_Attack.csv,190,9742995.0,75,115,37,38,0,42.26315789473684,249,33,18.931578947368422,11
Category_Wikipedia_sockpuppets_of_Julius_Ceasarus_From_Primus.csv,2070,7164693.0,657,1413,98,559,0,41.19903381642512,228,65,20.097101449275364,5
Category_Wikipedia_sockpuppets_of_MEMZAT10.csv,140,18868079.0,41,99,18,23,0,69.65,505,48,18.678571428571427,4
Category_Wikipedia_sockpuppets_of_Milford2012.csv,1275,7179619.0,457,818,195,262,0,42.05490196078431,250,59,21.48156862745098,5
Category_Wikipedia_sockpuppets_of_Partyhatunicorn.csv,89,43379912.0,19,70,11,8,0,32.48314606741573,169,58,26.269662921348313,4
Category_Wikipedia_sockpuppets_of_Geronikolakis.csv,1739,28687354.0,543,1196,91,452,0,54.582518688901665,503,45,15.513513513513514,5
Category_Wikipedia_sockpuppets_of_Sholi22.csv,615,8167780.0,208,407,40,168,0,52.92845528455285,328,52,16.45528455284553,4
Category_Wikipedia_sockpuppets_of_Chamroshduty.csv,2132,11167837.0,656,1476,457,199,0,51.08067542213884,505,40,12.74390243902439,3
Category_Wikipedia_sockpuppets_of_EchizenRema.csv,81,1868775.0,37,44,27,10,0,55.5679012345679,253,21,13.271604938271604,7
Category_Wikipedia_sockpuppets_of_Siciid_Cabdi_Cismaan_(Siciid_Africa).csv,1553,48941519.0,564,989,500,64,0,56.83451384417257,507,50,12.760463618802317,5
Category_Wikipedia_sockpuppets_of_JoeBiden44.csv,12,243859.0,7,5,4,3,0,49.416666666666664,121,36,27.0,20
Category_Wikipedia_sockpuppets_of_Agamino911.csv,1765,4835720.0,540,1225,500,40,0,51.04702549575071,500,93,19.7643059490085,3
Category_Wikipedia_sockpuppets_of_CurtJames93.csv,171,7205579.0,54,117,39,15,0,36.35087719298246,215,47,19.64327485380117,7
Category_Wikipedia_sockpuppets_of_Movaigonel.csv,1151,34547581.0,375,776,164,211,0,51.80191138140747,496,61,20.95742832319722,4
Category_Wikipedia_sockpuppets_of_DN-boards1.csv,1607,2900920.0,502,1105,500,2,0,48.25762289981331,255,67,19.509645301804603,3
Category_Wikipedia_sockpuppets_of_Sevendust_Nine_Inch_Nails.csv,41,88929.0,13,28,6,7,0,49.21951219512195,218,34,19.634146341463413,7
Category_Wikipedia_sockpuppets_of_skiracer25.csv,117,352018319.0,43,74,38,5,0,52.81196581196581,336,24,14.384615384615385,7
Category_Wikipedia_sockpuppets_of_Theriese.csv,12,521.0,4,8,2,2,0,31.333333333333332,121,54,29.25,19
Category_Wikipedia_sockpuppets_of_Bmusique99.csv,2401,105866729.0,1015,1386,500,515,0,41.386505622657225,384,85,21.1057892544773,4
Category_Wikipedia_sockpuppets_of_Eduardo956.csv,4,1705.0,4,0,2,2,0,47.75,101,18,16.5,15
Category_Wikipedia_sockpuppets_of_SpaceFox99.csv,2058,87954769.0,567,1491,500,67,0,50.505344995140916,445,84,19.15840621963071,4
Category_Wikipedia_sockpuppets_of_I_Heart_Davie_Game.csv,2,0.0,1,1,1,0,197,197.0,197,21,21.0,21
Category_Wikipedia_sockpuppets_of_Abhishekkapdi4u.csv,95,21878759.0,37,58,32,5,0,33.95789473684211,205,33,17.063157894736843,6
Category_Wikipedia_sockpuppets_of_Ravenfan4ever.csv,271,41020979.0,80,191,74,6,0,36.542435424354245,219,57,15.966789667896679,12
Category_Wikipedia_sockpuppets_of_Banana19208.csv,5134,34157831.0,1498,3636,500,998,0,47.61277756135567,515,66,23.13907284768212,3
Category_Wikipedia_sockpuppets_of_Dmattio.csv,128,4929528.0,35,93,24,11,0,43.9296875,227,46,21.0859375,5
Category_Wikipedia_sockpuppets_of_Latertinsna.csv,325,5864254.0,130,195,122,8,0,37.387692307692305,230,55,21.864615384615384,4
Category_Wikipedia_sockpuppets_of_Opeyemi08.csv,46,3007389.0,15,31,13,2,0,39.65217391304348,190,34,23.02173913043478,9
Category_Wikipedia_sockpuppets_of_Dmbusena.csv,64,10213959.0,22,42,17,5,0,58.671875,193,35,21.4375,13
Category_Wikipedia_sockpuppets_of_Vandyrandy.csv,66,11763458.0,17,49,5,12,0,55.46969696969697,216,28,16.242424242424242,11
Category_Wikipedia_sockpuppets_of_Major_nvssk_raghuvarma_karthik.csv,124,4991488.0,72,52,45,27,0,37.225806451612904,221,40,19.370967741935484,7
Category_Wikipedia_sockpuppets_of_MrBoire.csv,767,129084250.0,216,551,131,85,0,49.72490221642764,252,83,22.572359843546284,5
Category_Wikipedia_sockpuppets_of_Haja82.csv,26,373063464.0,12,14,11,1,0,45.19230769230769,196,27,21.346153846153847,11
Category_Wikipedia_sockpuppets_of_DarrenRay.csv,1828,83013409.0,685,1143,500,185,0,31.908096280087527,255,97,21.047045951859957,6
Category_Wikipedia_sockpuppets_of_Ashish_narzy.csv,1885,206414067.0,638,1247,500,138,0,43.1262599469496,326,56,17.33315649867374,4
Category_Wikipedia_sockpuppets_of_Masum_Ibn_Musa.csv,1228,204674393.0,548,680,500,48,0,56.63517915309446,500,90,19.958469055374593,4
Category_Wikipedia_sockpuppets_of_Pizzaman2002.csv,3,188.0,2,1,2,0,5,86.0,226,30,30.0,30
Category_Wikipedia_sockpuppets_of_NostalgiaBuff97501.csv,1414,9545478.0,507,907,500,7,0,38.25813295615276,461,47,20.007779349363506,4
Category_Wikipedia_sockpuppets_of_Socomfan555555.csv,1,0.0,1,0,1,0,0,0.0,0,16,16.0,16
Category_Wikipedia_sockpuppets_of_Jimmygrove.csv,2039,19408184.0,772,1267,500,272,0,33.700343305541935,375,65,30.354095144678762,4
Category_Wikipedia_sockpuppets_of_ILikeEditingFalseInformation.csv,2,100.0,2,0,2,0,10,19.0,28,33,21.0,9
Category_Wikipedia_sockpuppets_of_Thoughtcrime64.csv,114,245648572.0,29,85,27,2,0,58.54385964912281,233,38,30.05263157894737,17
Category_Wikipedia_sockpuppets_of_D1ma_sw3ll.csv,42,1076965.0,14,28,13,1,0,49.666666666666664,201,40,35.80952380952381,19
Category_Wikipedia_sockpuppets_of_Kendra_Citizen.csv,77,4583906.0,34,43,18,16,0,42.96103896103896,196,25,15.818181818181818,4
Category_Wikipedia_sockpuppets_of_Paparazzixox.csv,448,16095917.0,131,317,86,45,0,34.825892857142854,262,49,19.430803571428573,8
Category_Wikipedia_sockpuppets_of_NightBag10.csv,1876,18127297.0,570,1306,500,70,0,50.26865671641791,468,65,17.608742004264393,3
Category_Wikipedia_sockpuppets_of_Jeffersonkendric.csv,280,18746724.0,146,134,20,126,0,48.74285714285714,496,52,25.521428571428572,13
Category_Wikipedia_sockpuppets_of_Safiasouthey.csv,74,18311242.0,47,27,25,22,0,33.945945945945944,249,22,16.864864864864863,15
Category_Wikipedia_sockpuppets_of_Jpowpowpow.csv,2,32.0,2,0,2,0,105,105.0,105,19,19.0,19
Category_Wikipedia_sockpuppets_of_Kabylewarrior15.csv,157,5090501.0,50,107,46,4,0,40.8343949044586,241,46,18.866242038216562,5
Category_Wikipedia_sockpuppets_of_DiscoveryTeenHD.csv,1910,153195874.0,483,1427,50,433,0,43.230366492146594,277,68,17.695811518324607,3
Category_Wikipedia_sockpuppets_of_Dragong4.csv,615,34185093.0,123,492,123,0,0,34.94959349593496,239,71,18.746341463414634,4
Category_Wikipedia_sockpuppets_of_Abinaskar.csv,14,166679.0,12,2,12,0,0,29.714285714285715,86,21,17.5,12
Category_Wikipedia_sockpuppets_of_SailorSonic.csv,777,7312059.0,342,435,193,149,0,39.628056628056626,232,94,30.888030888030887,6
Category_Wikipedia_sockpuppets_of_Legalalan.csv,8,2003429.0,6,2,2,4,0,47.0,171,16,16.0,16
Category_Wikipedia_sockpuppets_of_Wasabi_salafi_koonkati.csv,248,2817106.0,74,174,39,35,0,56.65725806451613,200,37,14.85483870967742,4
Category_Wikipedia_sockpuppets_of_Eyolantro.csv,21,287497.0,10,11,4,6,0,69.76190476190476,185,45,25.904761904761905,14
Category_Wikipedia_sockpuppets_of_Tainted-wingsz.csv,2441,66773048.0,1000,1441,500,500,0,47.36665301106104,330,66,25.34535026628431,6
Category_Wikipedia_sockpuppets_of_OutofTheBoxThinker.csv,1084,68000480.0,334,750,213,121,0,46.7970479704797,246,39,17.728782287822877,3
Category_Wikipedia_sockpuppets_of_Aviary1.csv,7,3327.0,5,2,4,1,0,54.285714285714285,102,16,15.142857142857142,15
Category_Wikipedia_sockpuppets_of_Anders.bergheim.csv,49,9328456.0,15,34,7,8,0,30.632653061224488,199,42,19.448979591836736,4
Category_Wikipedia_sockpuppets_of_Alfred_Harary.csv,21,1779.0,8,13,4,4,0,69.19047619047619,239,35,16.476190476190474,5
Category_Wikipedia_sockpuppets_of_Paektu.csv,2834,434241123.0,748,2086,470,278,0,42.16866619618913,255,100,17.825335215243474,4
Category_Wikipedia_sockpuppets_of_CoCoWaWa.csv,7,1130178.0,3,4,3,0,0,82.28571428571429,134,18,18.0,18
Category_Wikipedia_sockpuppets_of_TrEeMaNsHoE.csv,4474,68251508.0,1489,2985,500,989,0,39.535091640590075,263,67,18.925122932498883,3
Category_Wikipedia_sockpuppets_of_Akash199mishra.csv,68,3200975.0,21,47,8,13,0,74.27941176470588,294,54,18.647058823529413,4
Category_Wikipedia_sockpuppets_of_Aruna_Singh.csv,118,1675166.0,36,82,24,12,0,26.093220338983052,210,22,12.754237288135593,6
Category_Wikipedia_sockpuppets_of_TheKiller1488.csv,379,5121293.0,105,274,62,43,0,49.145118733509236,433,37,15.852242744063325,4
Category_Wikipedia_sockpuppets_of_Murtazakhojami.csv,10,11652.0,9,1,9,0,0,5.3,42,21,20.5,20
Category_Wikipedia_sockpuppets_of_7g7em7ini.csv,531,16813274.0,205,326,204,1,0,25.519774011299436,257,40,13.171374764595104,7
Category_Wikipedia_sockpuppets_of_Abdulgoswami.csv,627,51188479.0,142,485,125,17,0,50.856459330143544,255,48,14.537480063795853,4
Category_Wikipedia_sockpuppets_of_Almisa.csv,109,213930726.0,43,66,43,0,0,32.45871559633027,213,54,26.807339449541285,7
Category_Wikipedia_sockpuppets_of_Creativegb.csv,278,257727466.0,64,214,23,41,0,48.989208633093526,251,86,18.640287769784173,2
Category_Wikipedia_sockpuppets_of_Ineversigninsodonotmessageme.csv,1883,16057709.0,599,1284,500,99,0,36.076473712161444,225,86,16.221986192246415,4
Category_Wikipedia_sockpuppets_of_Edgecompat.csv,179,507070051.0,41,138,25,16,0,45.150837988826815,362,37,16.99441340782123,9
Category_Wikipedia_sockpuppets_of_Barejsha02.csv,305,62905635.0,106,199,106,0,0,59.12786885245902,361,53,19.481967213114753,7
Category_Wikipedia_sockpuppets_of_Carry768.csv,96,6300305.0,34,62,29,5,0,71.29166666666667,272,17,13.604166666666666,8
Category_Wikipedia_sockpuppets_of_Susilobambangentodd.csv,41,897774.0,23,18,10,13,0,29.75609756097561,192,24,20.24390243902439,10
Category_Wikipedia_sockpuppets_of_A06jk2.csv,41,18705851.0,14,27,12,2,0,51.73170731707317,232,55,29.29268292682927,18
Category_Wikipedia_sockpuppets_of_Arjuann.csv,7,1251.0,7,0,5,2,0,62.0,196,20,19.714285714285715,19
Category_Wikipedia_sockpuppets_of_Dabbeydabbey.csv,25,2508605.0,14,11,11,3,0,43.84,191,54,21.68,7
Category_Wikipedia_sockpuppets_of_Gulshankumargautam.csv,57,1427313.0,25,32,20,5,0,42.59649122807018,196,41,19.94736842105263,6
Category_Wikipedia_sockpuppets_of_Shahrozahmed789.csv,340,7777638.0,99,241,14,85,0,60.7,497,53,22.341176470588234,3
Category_Wikipedia_sockpuppets_of_SKW1996.csv,172,5495301.0,55,117,36,19,0,47.75581395348837,255,20,12.604651162790697,8
Category_Wikipedia_sockpuppets_of_FrankKoch.csv,392,67849722.0,176,216,144,32,0,35.92857142857143,255,53,19.714285714285715,3
Category_Wikipedia_sockpuppets_of_Caidin-Johnson.csv,2374,211841364.0,608,1766,38,570,0,48.996208930075824,287,73,24.590985678180285,3
Category_Wikipedia_sockpuppets_of_Rockingbeats.csv,237,193637535.0,88,149,86,2,0,57.84388185654009,500,27,16.23206751054852,7
Category_Wikipedia_sockpuppets_of_Freshmen160.csv,383,29007303.0,118,265,50,68,0,48.78067885117493,283,52,17.138381201044385,7
Category_Wikipedia_sockpuppets_of_Rossjerry.csv,221,157277514.0,125,96,116,9,0,30.407239819004523,207,52,18.28054298642534,7
Category_Wikipedia_sockpuppets_of_Rogue_Gremlin.csv,1570,9247615.0,500,1070,500,0,0,39.50828025477707,208,50,17.380254777070064,7
Category_Wikipedia_sockpuppets_of_SportsTruther.csv,96,461952.0,38,58,30,8,0,39.604166666666664,204,32,13.770833333333334,11
Category_Wikipedia_sockpuppets_of_Jrm1993.csv,26,14930747.0,9,17,7,2,0,66.1923076923077,229,18,15.23076923076923,12
Category_Wikipedia_sockpuppets_of_Grandmangojoy.csv,550,5460836.0,186,364,91,95,0,43.36363636363637,391,40,16.87272727272727,2
Category_Wikipedia_sockpuppets_of_RohitSin.csv,162,11399044.0,35,127,16,19,0,43.31481481481482,224,36,18.253086419753085,4
Category_Wikipedia_sockpuppets_of_Mikunu.csv,1993,55874273.0,800,1193,378,422,0,43.160561966884096,410,28,14.166081284495736,4
Category_Wikipedia_sockpuppets_of_Himynameisboby.csv,16,16442.0,8,8,6,2,0,63.5,212,27,12.4375,11
Category_Wikipedia_sockpuppets_of_Lololololololololololo019664222445.csv,10,1882.0,4,6,3,1,0,63.7,254,23,15.1,10
Category_Wikipedia_sockpuppets_of_Rice_n_Noodles.csv,1791,34150104.0,519,1272,500,19,0,44.747627024008935,449,53,16.402568397543273,5
Category_Wikipedia_sockpuppets_of_Amirbannd.csv,11,503487.0,4,7,2,2,0,85.63636363636364,168,28,26.181818181818183,19
Category_Wikipedia_sockpuppets_of_Ituhubert.csv,546,80431788.0,208,338,135,73,0,52.6978021978022,251,53,34.02197802197802,9
Category_Wikipedia_sockpuppets_of_Africanlivesdontmatter.csv,1,0.0,1,0,1,0,27,27.0,27,22,22.0,22
Category_Wikipedia_sockpuppets_of_Rechtsstreitigkeiten.csv,336,4980004.0,151,185,93,58,0,53.75,411,47,33.81547619047619,15
Category_Wikipedia_sockpuppets_of_Metalx97856.csv,193,1110411.0,79,114,42,37,0,32.3160621761658,199,28,12.61139896373057,5
Category_Wikipedia_sockpuppets_of_Britainneedsyou.csv,141,12932691.0,36,105,19,17,0,49.687943262411345,234,26,13.368794326241135,6
Category_Wikipedia_sockpuppets_of_Baphomet_Dynasty.csv,194,1402537.0,86,108,74,12,0,43.9639175257732,255,41,13.27319587628866,5
Category_Wikipedia_sockpuppets_of_Chris_Murphy_(Record_Producer).csv,27,1642737.0,18,9,14,4,0,33.370370370370374,199,40,33.81481481481482,28
Category_Wikipedia_sockpuppets_of_Nyisnotbad.csv,329,126909872.0,105,224,88,17,0,60.36474164133739,200,42,15.80547112462006,5
Category_Wikipedia_sockpuppets_of_Everywitchwayfannn.csv,3,584.0,2,1,2,0,16,43.0,79,28,16.0,10
Category_Wikipedia_sockpuppets_of_Heo123456789.csv,220,4664316.0,84,136,50,34,0,54.42727272727273,439,44,23.79090909090909,6
Category_Wikipedia_sockpuppets_of_Morris_Hills_GSR.csv,10,5961190.0,7,3,7,0,11,42.7,71,26,24.6,19
Category_Wikipedia_sockpuppets_of_Fwagent.csv,186,1646250.0,68,118,36,32,0,48.134408602150536,236,38,20.489247311827956,4
Category_Wikipedia_sockpuppets_of_BeasttoBeast.csv,1086,32584262.0,283,803,122,161,0,45.52025782688766,248,50,19.361878453038674,7
Category_Wikipedia_sockpuppets_of_Japanhero.csv,634,33027844.0,238,396,58,180,0,31.194006309148264,203,57,19.066246056782333,6
Category_Wikipedia_sockpuppets_of_Dartfan20.csv,517,3171931.0,142,375,116,26,0,47.16634429400387,235,61,25.802707930367504,4
Category_Wikipedia_sockpuppets_of_Chiomaamadi.csv,440,202078518.0,198,242,198,0,0,40.481818181818184,233,62,28.495454545454546,12
Category_Wikipedia_sockpuppets_of_JessicaHendy.csv,23,11838.0,6,17,6,0,3,42.34782608695652,111,47,44.82608695652174,22
Category_Wikipedia_sockpuppets_of_TheMultimediaHub.csv,130,47918534.0,43,87,19,24,0,47.353846153846156,218,62,25.984615384615385,9
Category_Wikipedia_sockpuppets_of_Uarrin.csv,1469,16196748.0,414,1055,63,351,0,47.86249149081007,225,47,11.943498978897209,4
Category_Wikipedia_sockpuppets_of_Xunbi45.csv,318,2775111.0,105,213,72,33,0,43.84276729559748,477,40,14.60377358490566,3
Category_Wikipedia_sockpuppets_of_Lock_Your_Door.csv,28,3239825.0,7,21,3,4,0,59.214285714285715,144,45,24.678571428571427,20
Category_Wikipedia_sockpuppets_of_Yohannes_Goitom.csv,2,0.0,1,1,1,0,81,81.0,81,25,25.0,25
Category_Wikipedia_sockpuppets_of_ArthurRebelnatico.csv,2560,98034057.0,1395,1165,500,895,0,29.048046875,255,56,17.18203125,6
Category_Wikipedia_sockpuppets_of_R&BFandoms93.csv,290,8282480.0,84,206,37,47,0,63.36896551724138,382,51,25.00689655172414,7
Category_Wikipedia_sockpuppets_of_IVANJHN.csv,266,42238549.0,104,162,98,6,0,29.73308270676692,219,52,24.469924812030076,11
Category_Wikipedia_sockpuppets_of_Aduchristiana.csv,272,96327828.0,100,172,33,67,0,50.3860294117647,226,52,17.5,7
Category_Wikipedia_sockpuppets_of_GarfieldFTW_PeppaPigFTL.csv,2184,28754652.0,638,1546,494,144,0,38.29441391941392,428,61,33.342948717948715,6
Category_Wikipedia_sockpuppets_of_Wiki-star.csv,1909,23502330.0,671,1238,500,171,0,25.890518596123623,228,59,11.640125720272394,4
Category_Wikipedia_sockpuppets_of_Ben_hover.csv,10,474.0,3,7,3,0,10,48.5,241,35,23.8,15
Category_Wikipedia_sockpuppets_of_Vikas_sen.csv,7,78464.0,3,4,2,1,0,11.142857142857142,26,18,12.857142857142858,9
Category_Wikipedia_sockpuppets_of_CommunistSith.csv,49,1457026.0,28,21,21,7,0,41.02040816326531,188,27,20.306122448979593,12
Category_Wikipedia_sockpuppets_of_Craigmiller123.csv,4373,266081189.0,1213,3160,357,856,0,38.754630688314656,395,67,23.992453693116854,4
Category_Wikipedia_sockpuppets_of_Ngoctienn.csv,46,32874677.0,18,28,11,7,0,40.93478260869565,234,27,19.91304347826087,15
Category_Wikipedia_sockpuppets_of_Amanpreet_S_Sokhi.csv,160,24151477.0,103,57,36,67,0,38.14375,236,39,19.98125,13
Category_Wikipedia_sockpuppets_of_Dantrevisani.csv,106,162638715.0,26,80,14,12,0,58.132075471698116,184,47,22.21698113207547,7
Category_Wikipedia_sockpuppets_of_HistoricalTeeth.csv,15,537828.0,8,7,4,4,0,49.8,132,20,13.2,12
Category_Wikipedia_sockpuppets_of_Fuckoffjew.csv,737,10541584.0,185,552,138,47,0,48.95522388059702,249,56,29.070556309362278,4
Category_Wikipedia_sockpuppets_of_PsychoticInq.csv,533,261051525.0,146,387,140,6,0,52.789868667917446,247,118,23.651031894934334,10
Category_Wikipedia_sockpuppets_of_Mudran_Eller.csv,28,8420352.0,7,21,7,0,0,49.857142857142854,153,33,17.785714285714285,11
Category_Wikipedia_sockpuppets_of_Zidea002.csv,81,2563840.0,28,53,19,9,0,58.22222222222222,250,37,17.358024691358025,9
Category_Wikipedia_sockpuppets_of_Rawhide1683.csv,148,1045171.0,58,90,39,19,0,32.060810810810814,199,37,22.425675675675677,13
Category_Wikipedia_sockpuppets_of_Ragaricus.csv,456,7600192.0,145,311,15,130,0,42.63815789473684,360,28,14.094298245614034,5
Category_Wikipedia_sockpuppets_of_Black_Power!_19th_Century.csv,9,3179658.0,6,3,4,2,0,41.22222222222222,169,35,28.0,17
Category_Wikipedia_sockpuppets_of_Nathann_sc.csv,853,585358.0,339,514,263,76,0,38.126611957796015,214,49,13.856975381008207,3
Category_Wikipedia_sockpuppets_of_Motaros.csv,6346,76007060.0,1742,4604,500,1242,0,34.50063031831075,253,40,15.262212417270721,2
Category_Wikipedia_sockpuppets_of_NicholasHui.csv,1749,178268596.0,1000,749,500,500,0,23.116066323613495,299,48,29.855345911949687,12
Category_Wikipedia_sockpuppets_of_VoteJagoffForMayor.csv,306,2334913.0,85,221,39,46,0,51.928104575163395,221,55,26.575163398692812,6
Category_Wikipedia_sockpuppets_of_Antminnko20071601.csv,142,3166155.0,40,102,29,11,0,44.83802816901409,220,30,16.774647887323944,3
Category_Wikipedia_sockpuppets_of_JohnnyLurg.csv,3790,226756885.0,954,2836,500,454,0,32.911873350923486,255,63,18.090501319261215,3
Category_Wikipedia_sockpuppets_of_Adis_Mesic.csv,434,1057630.0,172,262,142,30,0,34.076036866359445,255,41,17.77188940092166,8
Category_Wikipedia_sockpuppets_of_Kate_Robyn_Fils_Tunechi.csv,23,45866116.0,6,17,3,3,0,53.78260869565217,192,41,32.04347826086956,18
Category_Wikipedia_sockpuppets_of_Kuku821029.csv,23,122993385.0,15,8,14,1,0,47.91304347826087,254,20,14.26086956521739,14
Category_Wikipedia_sockpuppets_of_Einstong.csv,78,19407602.0,35,43,32,3,0,42.56410256410256,238,18,12.846153846153847,5
Category_Wikipedia_sockpuppets_of_Homeanddesign.csv,26,168883.0,8,18,1,7,0,64.11538461538461,192,22,13.884615384615385,6
Category_Wikipedia_sockpuppets_of_NC4-2014.csv,337,87266052.0,117,220,76,41,0,42.38278931750742,255,50,20.87833827893175,10
Category_Wikipedia_sockpuppets_of_Mmbmmmbm.csv,1495,195800663.0,609,886,456,153,0,38.28896321070234,233,92,31.71638795986622,3
Category_Wikipedia_sockpuppets_of_Dorkakiin.csv,58,10457075.0,26,32,22,4,0,39.172413793103445,151,44,19.775862068965516,7
Category_Wikipedia_sockpuppets_of_Chiromanruma.csv,89,79492459.0,47,42,10,37,0,39.853932584269664,241,53,23.39325842696629,12
Category_Wikipedia_sockpuppets_of_Famguy231.csv,234,24719509.0,79,155,68,11,0,41.44444444444444,234,46,19.927350427350426,8
Category_Wikipedia_sockpuppets_of_Wikigod618.csv,38,2996.0,22,16,12,10,0,54.0,179,46,23.394736842105264,6
Category_Wikipedia_sockpuppets_of_Mmhuang.csv,1588,232942097.0,730,858,500,230,0,33.04030226700252,496,54,27.69206549118388,9
Category_Wikipedia_sockpuppets_of_Pogsurf.csv,275,1978230.0,107,168,73,34,0,39.832727272727276,152,47,23.418181818181818,11
Category_Wikipedia_sockpuppets_of_Ali1872.csv,501,60219112.0,190,311,108,82,0,43.65868263473054,255,70,21.864271457085827,4
Category_Wikipedia_sockpuppets_of_StvJbs1.csv,8,486.0,3,5,3,0,11,66.375,184,26,19.0,15
Category_Wikipedia_sockpuppets_of_Sourcerery.csv,4157,28419939.0,1205,2952,500,705,0,57.53427952850613,500,68,17.18980033678133,3
Category_Wikipedia_sockpuppets_of_My_turds_are_huge.csv,17,10475.0,7,10,5,2,0,63.294117647058826,212,47,25.823529411764707,11
Category_Wikipedia_sockpuppets_of_Masternaveenagroup.csv,9,341193.0,2,7,1,1,2,44.888888888888886,121,28,21.0,19
Category_Wikipedia_sockpuppets_of_Rakhi_Das.csv,239,68481212.0,63,176,34,29,0,43.53556485355649,376,53,18.225941422594143,6
Category_Wikipedia_sockpuppets_of_Wordain.csv,6585,162274088.0,2236,4349,500,1736,0,43.31526195899772,418,85,15.181017463933182,4
Category_Wikipedia_sockpuppets_of_JtV.csv,642,104492518.0,148,494,133,15,0,34.21028037383178,223,51,14.299065420560748,5
Category_Wikipedia_sockpuppets_of_Bucktony.csv,322,76706678.0,95,227,13,82,0,57.524844720496894,280,49,16.664596273291924,5
Category_Wikipedia_sockpuppets_of_Butter72.csv,1528,133211056.0,425,1103,423,2,0,74.38612565445027,459,73,23.519633507853403,3
Category_Wikipedia_sockpuppets_of_Robedia.csv,656,10644075.0,262,394,211,51,0,47.957317073170735,255,37,17.272865853658537,7
Category_Wikipedia_sockpuppets_of_Ali_aff.csv,229,273057329.0,54,175,43,11,0,54.56331877729258,215,45,18.641921397379914,4
Category_Wikipedia_sockpuppets_of_HeteroZygus.csv,19,865428.0,9,10,9,0,0,48.94736842105263,131,50,37.63157894736842,17
Category_Wikipedia_sockpuppets_of_Wahab411.csv,119,67714356.0,26,93,12,14,0,79.52100840336135,255,22,12.663865546218487,6
Category_Wikipedia_sockpuppets_of_MangforYayor.csv,36,847823.0,13,23,7,6,0,69.25,336,47,34.638888888888886,19
Category_Wikipedia_sockpuppets_of_AlfredKamon.csv,60,13213323.0,20,40,9,11,0,53.55,228,20,15.216666666666667,10
Category_Wikipedia_sockpuppets_of_Trust_Is_All_You_Need.csv,3684,182700246.0,1369,2315,500,869,0,53.10667752442997,500,115,29.41802388707926,4
Category_Wikipedia_sockpuppets_of_JuanMaMaster.csv,28,1475021.0,20,8,17,3,0,40.285714285714285,162,12,12.0,12
Category_Wikipedia_sockpuppets_of_ElmoTheRockStar.csv,1915,123948290.0,481,1434,225,256,0,49.945169712793735,500,58,19.789556135770233,3
Category_Wikipedia_sockpuppets_of_Ashuroyadarsh.csv,12,811877.0,5,7,5,0,0,27.25,122,24,20.583333333333332,11
Category_Wikipedia_sockpuppets_of_Polyimagine.csv,84,29990617.0,33,51,22,11,0,40.107142857142854,139,41,21.797619047619047,6
Category_Wikipedia_sockpuppets_of_LLK934U.csv,386,35808811.0,116,270,62,54,0,56.854922279792746,284,62,23.189119170984455,3
Category_Wikipedia_sockpuppets_of_Adam.cj1.csv,28,2097019.0,13,15,6,7,0,59.25,163,23,12.892857142857142,6
Category_Wikipedia_sockpuppets_of_Machn.csv,2601,95369565.0,993,1608,500,493,0,45.99000384467512,250,47,15.184928873510188,5
Category_Wikipedia_sockpuppets_of_Alto212.csv,237,7228011.0,140,97,48,92,0,40.71308016877637,241,59,22.79746835443038,8
Category_Wikipedia_sockpuppets_of_Chandravansh.csv,21,866172.0,14,7,13,1,0,37.38095238095238,238,11,6.476190476190476,6
Category_Wikipedia_sockpuppets_of_Nickicastro.csv,124,28812848.0,28,96,6,22,0,48.266129032258064,235,41,16.06451612903226,6
Category_Wikipedia_sockpuppets_of_Cmax205.csv,1182,345771433.0,336,846,195,141,0,40.9331641285956,247,51,17.76818950930626,5
Category_Wikipedia_sockpuppets_of_Nicokroeker.csv,85,1117532.0,36,49,29,7,0,53.8,220,44,18.470588235294116,9
Category_Wikipedia_sockpuppets_of_Andrewlewisg.csv,9,12664159.0,3,6,2,1,17,44.44444444444444,125,14,10.0,4
Category_Wikipedia_sockpuppets_of_TGODJonJanez.csv,227,2237066.0,107,120,99,8,0,40.36123348017621,263,25,17.26872246696035,10
Category_Wikipedia_sockpuppets_of_Masculofascismus.csv,73,2147998.0,26,47,15,11,0,50.178082191780824,229,63,21.47945205479452,7
Category_Wikipedia_sockpuppets_of_Webraizer.csv,89,6616714.0,38,51,30,8,0,54.7752808988764,496,26,15.157303370786517,5
Category_Wikipedia_sockpuppets_of_Gothic_Forest.csv,1672,55935922.0,581,1091,500,81,0,28.008373205741627,250,32,14.395933014354068,5
Category_Wikipedia_sockpuppets_of_D47817.csv,36772,278177563.0,10703,26069,500,10203,0,43.43753399325574,505,94,22.84871641466333,2
Category_Wikipedia_sockpuppets_of_WitsBlomstein.csv,577,31457180.0,159,418,38,121,0,58.639514731369154,255,56,22.11265164644714,3
Category_Wikipedia_sockpuppets_of_Praytvresmi.csv,42,764478.0,32,10,13,19,0,39.142857142857146,196,35,17.404761904761905,7
Category_Wikipedia_sockpuppets_of_Kleo-Sine.csv,3273,7190758.0,1000,2273,500,500,0,39.04766269477543,465,54,18.585090131377942,4
Category_Wikipedia_sockpuppets_of_Nle_informer.csv,42,3781007.0,13,29,6,7,0,94.14285714285714,412,21,16.11904761904762,7
Category_Wikipedia_sockpuppets_of_Wellwater_Conspiracy.csv,3925,7229045.0,1319,2606,500,819,0,25.706242038216562,236,86,18.34547770700637,4
Category_Wikipedia_sockpuppets_of_MuhdFajar240300.csv,266,13563723.0,65,201,15,50,0,45.95864661654135,362,42,15.969924812030076,2
Category_Wikipedia_sockpuppets_of_YP_Bass_Boosted.csv,7,4889453.0,3,4,2,1,0,46.142857142857146,148,34,26.428571428571427,17
Category_Wikipedia_sockpuppets_of_BashurMan.csv,27,32612410.0,8,19,6,2,0,61.7037037037037,220,45,27.296296296296298,16
Category_Wikipedia_sockpuppets_of_Jmoralesjr9.csv,95,297350876.0,23,72,18,5,0,59.6,315,65,26.621052631578948,11
Category_Wikipedia_sockpuppets_of_Qmihai24.csv,402,29553233.0,132,270,129,3,0,27.05223880597015,218,51,18.66417910447761,4
Category_Wikipedia_sockpuppets_of_Khazen48.csv,346,64805898.0,98,248,85,13,0,43.604046242774565,255,63,23.95664739884393,5
Category_Wikipedia_sockpuppets_of_Ati3414.csv,2183,37957349.0,884,1299,500,384,0,39.824553366926246,200,49,19.775080164910673,5
Category_Wikipedia_sockpuppets_of_CarolSpears.csv,2503,33154525.0,896,1607,500,396,0,35.2988413903316,255,70,19.799840191769878,4
Category_Wikipedia_sockpuppets_of_Neel_Preet.csv,299,167648123.0,99,200,79,20,0,43.04347826086956,246,33,20.431438127090303,8
Category_Wikipedia_sockpuppets_of_Jagzthebest.csv,2577,190446156.0,898,1679,290,608,0,38.35040745052387,245,51,18.42918121847109,3
Category_Wikipedia_sockpuppets_of_Hiphopforlife.csv,528,72756415.0,228,300,149,79,0,37.78977272727273,231,55,18.946969696969695,7
Category_Wikipedia_sockpuppets_of_Joeblanc98.csv,921,3153138.0,362,559,349,13,0,33.534201954397396,250,47,27.23127035830619,5
Category_Wikipedia_sockpuppets_of_AshokaChadha.csv,64,4064895.0,30,34,11,19,0,35.1875,226,23,19.671875,15
Category_Wikipedia_sockpuppets_of_Achal_Harsh.csv,4,193395.0,2,2,2,0,0,53.25,109,21,18.0,15
Category_Wikipedia_sockpuppets_of_John_Sahoo.csv,3,202.0,2,1,2,0,28,140.0,196,23,23.0,23
Category_Wikipedia_sockpuppets_of_Drew_R._Smith.csv,1965,215726362.0,633,1332,500,133,0,51.93078880407125,255,75,25.25852417302799,3
Category_Wikipedia_sockpuppets_of_CameronRichter.csv,11,1134.0,7,4,4,3,15,58.72727272727273,238,17,17.0,17
Category_Wikipedia_sockpuppets_of_SRVswag.csv,51,254774.0,16,35,10,6,0,62.35294117647059,216,46,22.901960784313726,9
Category_Wikipedia_sockpuppets_of_Barrovian.csv,1258,57793099.0,418,840,399,19,0,36.52066772655008,266,68,18.0818759936407,5
Category_Wikipedia_sockpuppets_of_Sennick4858.csv,6,101723.0,2,4,1,1,0,71.16666666666667,204,46,42.666666666666664,36
Category_Wikipedia_sockpuppets_of_Roosterrulez.csv,1382,102136281.0,510,872,500,10,0,34.709840810419685,212,71,23.390738060781477,3
Category_Wikipedia_sockpuppets_of_Yeniseian.csv,307,9253826.0,100,207,74,26,0,48.469055374592834,498,43,21.700325732899024,6
Category_Wikipedia_sockpuppets_of_Mikarna_Inc.csv,50,4237562.0,20,30,10,10,0,65.44,485,40,20.08,7
Category_Wikipedia_sockpuppets_of_Bengaliwikipro.csv,1065,21584880.0,418,647,129,289,0,48.85633802816901,327,46,14.505164319248827,4
Category_Wikipedia_sockpuppets_of_BrightScholarJonathan.csv,5,21518.0,4,1,2,2,0,34.8,91,31,28.8,27
Category_Wikipedia_sockpuppets_of_Fileman67.csv,2200,23844763.0,647,1553,500,147,0,42.77272727272727,517,62,21.48409090909091,8
Category_Wikipedia_sockpuppets_of_Sheehan_Cein.csv,143,553126.0,48,95,22,26,0,63.97202797202797,225,27,13.244755244755245,6
Category_Wikipedia_sockpuppets_of_AVINASH_CND.csv,84,17573410.0,26,58,17,9,0,33.30952380952381,252,37,18.428571428571427,6
Category_Wikipedia_sockpuppets_of_Norvikk.csv,2891,51306646.0,1055,1836,500,555,0,40.52646143203044,499,90,33.9277066758907,8
Category_Wikipedia_sockpuppets_of_Fixingthis1000.csv,158,23845346.0,33,125,17,16,0,66.48101265822785,226,30,13.031645569620252,4
Category_Wikipedia_sockpuppets_of_Angel.Valeriev.Tsvetkov.csv,3,6777.0,2,1,2,0,24,40.0,48,33,19.666666666666668,13
Category_Wikipedia_sockpuppets_of_Abbasulu.csv,1282,66117995.0,574,708,500,74,0,51.765990639625585,496,93,27.641965678627145,7
Category_Wikipedia_sockpuppets_of_Footballfan190.csv,2042,16669164.0,515,1527,500,15,0,52.78256611165524,250,54,17.53232125367287,2
Category_Wikipedia_sockpuppets_of_Anikaaktar59.csv,10,857465.0,9,1,6,3,0,113.7,496,22,18.6,14
Category_Wikipedia_sockpuppets_of_Nat_Rathbone.csv,18,76847.0,7,11,7,0,0,50.22222222222222,195,22,12.666666666666666,8
Category_Wikipedia_sockpuppets_of_Vector1378.csv,10,40563.0,6,4,4,2,0,64.0,196,41,33.2,15
Category_Wikipedia_sockpuppets_of_Mahmoud-rezaei_tehrani.csv,69,2104767.0,34,35,24,10,0,43.7536231884058,176,44,19.71014492753623,6
Category_Wikipedia_sockpuppets_of_LuciferEdits.csv,327,30044728.0,120,207,105,15,0,43.333333333333336,260,59,18.960244648318042,3
Category_Wikipedia_sockpuppets_of_Souvlakis.csv,179,450926.0,51,128,27,24,0,48.71508379888268,231,54,16.960893854748605,3
Category_Wikipedia_sockpuppets_of_Lmthrowaway222.csv,428,8651660.0,132,296,112,20,0,42.570093457943926,256,44,24.792056074766354,9
Category_Wikipedia_sockpuppets_of_Miley_Smile_Cyrus.csv,19,22171.0,12,7,12,0,0,69.6842105263158,187,45,33.68421052631579,22
Category_Wikipedia_sockpuppets_of_Anoshirawan.csv,1669,29876086.0,550,1119,500,50,0,33.82804074295986,255,47,15.805272618334332,4
Category_Wikipedia_sockpuppets_of_EuroQele.csv,29,55965893.0,7,22,6,1,0,39.758620689655174,218,43,26.96551724137931,15
Category_Wikipedia_sockpuppets_of_Mbhiii.csv,1813,91060571.0,525,1288,500,25,0,60.485934914506345,255,77,24.10369553226696,5
Category_Wikipedia_sockpuppets_of_Ghanshyamji.csv,96,22621.0,52,44,41,11,0,46.28125,218,30,18.354166666666668,12
Category_Wikipedia_sockpuppets_of_Wanborough.csv,89,103210319.0,38,51,35,3,0,53.30337078651685,210,42,20.04494382022472,15
Category_Wikipedia_sockpuppets_of_Carro_Singapore.csv,4,953.0,3,1,3,0,0,47.5,150,17,12.75,8
Category_Wikipedia_sockpuppets_of_Ssaarraayyuu.csv,394,87780030.0,120,274,49,71,0,43.71573604060914,216,53,21.17766497461929,8
Category_Wikipedia_sockpuppets_of_Jonthebaptizer4u.csv,63,41744.0,33,30,29,4,0,44.25396825396825,246,38,33.95238095238095,29
Category_Wikipedia_sockpuppets_of_DW_Celt.csv,1605,85663675.0,321,1284,151,170,0,42.75763239875389,214,52,12.694080996884734,4
Category_Wikipedia_sockpuppets_of_Josephjharris.csv,203,6226024.0,51,152,22,29,0,55.8423645320197,254,81,19.201970443349754,8
Category_Wikipedia_sockpuppets_of_Rehan_Khan2050.csv,106,20821235.0,52,54,26,26,0,39.301886792452834,196,24,13.90566037735849,7
Category_Wikipedia_sockpuppets_of_Kinsellawarren.csv,92,8212367.0,39,53,34,5,0,51.17391304347826,175,28,16.445652173913043,11
Category_Wikipedia_sockpuppets_of_Real_PSH_ssinz7.csv,635,120956925.0,246,389,29,217,0,54.61417322834646,286,42,16.815748031496064,12
Category_Wikipedia_sockpuppets_of_YTL_Power_International_Berhad.csv,27,96573.0,16,11,8,8,0,44.148148148148145,196,17,12.703703703703704,9
Category_Wikipedia_sockpuppets_of_Uniquark9.csv,1254,24010118.0,489,765,476,13,0,50.98006379585327,253,50,13.89792663476874,5
Category_Wikipedia_sockpuppets_of_The_Explosive_Apple_Pie.csv,176,8541802.0,62,114,47,15,0,46.78977272727273,295,62,45.52272727272727,10
Category_Wikipedia_sockpuppets_of_Wbbair.csv,2,0.0,1,1,1,0,42,42.0,42,29,29.0,29
Category_Wikipedia_sockpuppets_of_ROBERT_TAGGART.csv,807,15818361.0,289,518,159,130,0,40.95539033457249,211,56,16.895910780669144,5
Category_Wikipedia_sockpuppets_of_Alwongs.csv,152,51372772.0,56,96,27,29,0,38.953947368421055,196,59,24.42763157894737,3
Category_Wikipedia_sockpuppets_of_John_Grabowicz.csv,142,24791477.0,44,98,23,21,0,69.62676056338029,453,51,27.971830985915492,12
Category_Wikipedia_sockpuppets_of_Joshipti.csv,26,11604747.0,10,16,10,0,0,41.07692307692308,84,33,24.692307692307693,16
Category_Wikipedia_sockpuppets_of_Endyboy123.csv,14,2102989.0,5,9,3,2,0,38.92857142857143,150,20,17.142857142857142,15
Category_Wikipedia_sockpuppets_of_Azizbekov.csv,979,2754260.0,348,631,179,169,0,33.47395301327886,221,52,21.92032686414709,6
Category_Wikipedia_sockpuppets_of_Crimefighter123.csv,475,30483754.0,172,303,172,0,0,48.513684210526314,429,51,19.296842105263156,7
Category_Wikipedia_sockpuppets_of_55555power.csv,81,2080744.0,56,25,21,35,0,32.97530864197531,250,41,17.950617283950617,7
Category_Wikipedia_sockpuppets_of_Holy_Logician.csv,96,9859588.0,62,34,37,25,0,44.760416666666664,219,23,18.15625,13
Category_Wikipedia_sockpuppets_of_Kunalbaby.csv,274,17299860.0,120,154,65,55,0,43.11678832116788,300,40,18.0,3
Category_Wikipedia_sockpuppets_of_Elizabeth_Steinberg.csv,110,1748679.0,74,36,20,54,0,43.9,183,87,46.86363636363637,15
Category_Wikipedia_sockpuppets_of_Petre_Andreas.csv,192,1496813.0,64,128,41,23,0,26.921875,219,38,15.140625,4
Category_Wikipedia_sockpuppets_of_Lachelle_Wood.csv,91,11299726.0,38,53,36,2,0,42.15384615384615,236,43,19.23076923076923,8
Category_Wikipedia_sockpuppets_of_Danish.mehraj26.csv,245,231715327.0,85,160,79,6,0,52.69795918367347,252,52,23.2,5
Category_Wikipedia_sockpuppets_of_Paramount08.csv,174,347193318.0,84,90,24,60,0,41.7816091954023,208,39,18.07471264367816,13
Category_Wikipedia_sockpuppets_of_Ttt1238.csv,54,1626.0,17,37,12,5,0,31.833333333333332,233,31,18.796296296296298,8
Category_Wikipedia_sockpuppets_of_Imperator1974.csv,266,530983.0,109,157,75,34,0,40.3984962406015,246,23,12.597744360902256,5
Category_Wikipedia_sockpuppets_of_Funnypoop.csv,7,4760.0,4,3,2,2,0,85.57142857142857,230,24,19.714285714285715,9
Category_Wikipedia_sockpuppets_of_Orlandofiges.csv,10,20016.0,7,3,4,3,0,29.8,146,21,13.8,13
Category_Wikipedia_sockpuppets_of_Schwimmen81.csv,45,8565369.0,20,25,16,4,0,69.8,183,21,11.533333333333333,10
Category_Wikipedia_sockpuppets_of_Macedon-40.csv,420,186039117.0,127,293,118,9,0,49.70952380952381,249,56,18.552380952380954,7
Category_Wikipedia_sockpuppets_of_Ujjwalmishra.csv,6,84903.0,4,2,3,1,0,40.0,156,20,20.0,20
Category_Wikipedia_sockpuppets_of_SummerFunMan.csv,882,103348457.0,292,590,150,142,0,54.77210884353742,255,50,22.578231292517007,4
Category_Wikipedia_sockpuppets_of_Branflakes452701.csv,12110,124938948.0,4037,8073,500,3537,0,42.720313790255986,512,75,27.128488852188273,4
Category_Wikipedia_sockpuppets_of_SporcleBot.csv,104,2240228.0,40,64,31,9,0,35.00961538461539,254,44,16.78846153846154,6
Category_Wikipedia_sockpuppets_of_Jakemitch9485.csv,457,857448.0,210,247,163,47,0,42.44201312910285,422,49,18.0,6
Category_Wikipedia_sockpuppets_of_Agus_suharto.csv,2163,42856527.0,1143,1020,500,643,0,21.25381414701803,275,53,24.167360147942674,10
Category_Wikipedia_sockpuppets_of_Majikjeff.csv,48,8221748.0,17,31,15,2,0,45.020833333333336,199,35,12.354166666666666,4
Category_Wikipedia_sockpuppets_of_Necromancer12458999.csv,604,105347279.0,157,447,128,29,0,32.771523178807946,274,36,15.995033112582782,5
Category_Wikipedia_sockpuppets_of_CivicAphideTheHelper.csv,39,4083938.0,16,23,15,1,0,65.61538461538461,215,19,15.692307692307692,13
Category_Wikipedia_sockpuppets_of_Apoorva2312.csv,255,447375140.0,55,200,55,0,0,49.819607843137256,283,59,21.768627450980393,6
Category_Wikipedia_sockpuppets_of_ForrestLucasFilms.csv,63,9160299.0,19,44,16,3,0,39.142857142857146,272,32,14.825396825396826,8
Category_Wikipedia_sockpuppets_of_Aimar120.csv,158,2511019.0,121,37,73,48,0,15.639240506329115,203,41,16.132911392405063,9
Category_Wikipedia_sockpuppets_of_Subah_Subah.csv,105,5354855.0,60,45,38,22,0,49.39047619047619,329,30,17.409523809523808,9
Category_Wikipedia_sockpuppets_of_Afshin_k2.csv,5,4027552.0,5,0,2,3,21,23.2,32,51,47.8,47
Category_Wikipedia_sockpuppets_of_Ajay2206.csv,330,2203943.0,109,221,63,46,0,41.981818181818184,233,23,13.154545454545454,5
Category_Wikipedia_sockpuppets_of_JohnDoyle.2.csv,148,16616750.0,48,100,28,20,0,47.62837837837838,255,38,14.878378378378379,5
Category_Wikipedia_sockpuppets_of_Judahgreg.csv,1080,23835054.0,385,695,340,45,0,31.007407407407406,255,44,18.321296296296296,7
Category_Wikipedia_sockpuppets_of_AsadR.csv,472,226195730.0,136,336,107,29,0,47.74576271186441,234,55,14.127118644067796,5
Category_Wikipedia_sockpuppets_of_Vigerslev176DD.csv,34,4656651.0,29,5,27,2,0,45.88235294117647,182,33,13.588235294117647,8
Category_Wikipedia_sockpuppets_of_Warbayx.csv,2473,38409975.0,761,1712,500,261,0,49.891629599676506,381,47,13.957541447634451,5
"Category_Wikipedia_sockpuppets_of_World_Population_7,800,000,000.csv",1454,26895943.0,512,942,321,191,0,54.3837689133425,500,75,23.490371389270976,2
Category_Wikipedia_sockpuppets_of_Supreme_Cmdr.csv,1142,32602719.0,504,638,500,4,0,43.03677758318739,199,73,23.39492119089317,11
Category_Wikipedia_sockpuppets_of_Guyguyguyguyguyguyguyguy.csv,163,1653268.0,70,93,62,8,0,39.644171779141104,228,37,27.711656441717793,12
Category_Wikipedia_sockpuppets_of_Diligent007.csv,484,9390826.0,139,345,134,5,0,44.849173553719005,246,50,27.318181818181817,10
Category_Wikipedia_sockpuppets_of_VirtualEye.csv,1867,125091770.0,529,1338,500,29,0,49.12104981253348,250,59,18.43813604713444,5
Category_Wikipedia_sockpuppets_of_Soultripboy.csv,13,1334481.0,6,7,4,2,0,57.46153846153846,230,45,26.846153846153847,6
Category_Wikipedia_sockpuppets_of_Americanidolwatcher.csv,329,10895444.0,154,175,63,91,0,34.98784194528876,199,31,16.762917933130698,11
Category_Wikipedia_sockpuppets_of_TheCondor24.csv,209,3028582.0,105,104,103,2,0,67.64593301435407,245,32,14.61244019138756,7
Category_Wikipedia_sockpuppets_of_Manoscrittoeduecarte.csv,6,90529.0,4,2,1,3,0,29.333333333333332,125,24,19.0,14
Category_Wikipedia_sockpuppets_of_The_way_is_was.csv,28,167649.0,20,8,10,10,0,45.82142857142857,122,54,44.285714285714285,38
Category_Wikipedia_sockpuppets_of_Ilsebeckenpower.csv,64,277383.0,55,9,55,0,15,86.671875,331,25,10.015625,7
Category_Wikipedia_sockpuppets_of_Prejumania.csv,5,134375.0,3,2,2,1,16,32.8,78,6,6.0,6
Category_Wikipedia_sockpuppets_of_Zerida.csv,4140,20924068.0,1318,2822,500,818,0,39.78188405797101,221,50,16.471497584541062,4
Category_Wikipedia_sockpuppets_of_A.R.Nayudu.csv,848,10539122.0,232,616,217,15,0,46.319575471698116,254,97,19.04952830188679,4
Category_Wikipedia_sockpuppets_of_Fireslow.csv,170,1710864.0,72,98,19,53,0,59.55882352941177,393,47,23.82941176470588,6
Category_Wikipedia_sockpuppets_of_Sideburns12.csv,9,294.0,3,6,3,0,0,70.11111111111111,129,41,34.77777777777778,13
Category_Wikipedia_sockpuppets_of_Truthalwaysrules.csv,98,4988013.0,32,66,21,11,0,50.55102040816327,251,33,15.948979591836734,8
Category_Wikipedia_sockpuppets_of_Classyklowngrasper.csv,3171,41000071.0,1299,1872,313,986,0,43.88552507095554,255,51,20.55187637969095,5
Category_Wikipedia_sockpuppets_of_Otiasah_Miracle.csv,184,75421114.0,59,125,48,11,0,41.78804347826087,304,26,14.717391304347826,8
Category_Wikipedia_sockpuppets_of_Hockeystic71.csv,18,4453.0,9,9,9,0,12,52.666666666666664,179,43,26.27777777777778,4
Category_Wikipedia_sockpuppets_of_Juliengeorge2011.csv,58,79670139.0,25,33,21,4,0,26.879310344827587,170,27,18.344827586206897,14
Category_Wikipedia_sockpuppets_of_SahibCollege55.csv,577,37186708.0,139,438,30,109,0,40.07625649913345,227,41,18.299826689774697,6
Category_Wikipedia_sockpuppets_of_Iamthemuffinman.csv,951,13837469.0,327,624,265,62,0,56.478443743427974,255,59,27.226077812828603,4
Category_Wikipedia_sockpuppets_of_Wikiexplorer13.csv,923,330663976.0,282,641,165,117,0,54.686890574214516,255,54,22.27085590465872,5
Category_Wikipedia_sockpuppets_of_DDatGuy1.csv,412,28071887.0,113,299,74,39,0,45.76456310679612,233,45,19.41504854368932,5
Category_Wikipedia_sockpuppets_of_Pencil_pounch12.csv,28,99277.0,10,18,8,2,0,64.78571428571429,220,24,12.071428571428571,7
Category_Wikipedia_sockpuppets_of_ToeLuver420.csv,8,75256.0,6,2,4,2,0,12.125,59,17,16.0,15
Category_Wikipedia_sockpuppets_of_Massyparcer.csv,4833,98082829.0,1582,3251,500,1082,0,48.20918684047176,255,78,24.200496585971447,4
Category_Wikipedia_sockpuppets_of_AARONWARDPittsburgh.csv,1085,9588390.0,349,736,287,62,0,41.49400921658986,255,34,15.146543778801844,7
Category_Wikipedia_sockpuppets_of_Breeze2009.csv,14,12873316.0,4,10,4,0,0,57.142857142857146,200,22,17.571428571428573,14
Category_Wikipedia_sockpuppets_of_MrBoldBald.csv,174,15820157.0,50,124,30,20,0,50.39655172413793,496,46,24.580459770114942,6
Category_Wikipedia_sockpuppets_of_Jackiestud.csv,1558,9220390.0,500,1058,500,0,0,43.912708600770216,250,51,16.508985879332478,4
Category_Wikipedia_sockpuppets_of_Lord_NnNn.csv,359,32424854.0,86,273,81,5,0,59.5933147632312,255,61,26.537604456824514,10
Category_Wikipedia_sockpuppets_of_Masterkarthikyadav.csv,63,3028037.0,16,47,15,1,0,37.84126984126984,220,41,18.015873015873016,7
Category_Wikipedia_sockpuppets_of_RandomAccount1235423.csv,2850,25686602.0,1079,1771,285,794,0,60.09859649122807,500,87,30.505964912280703,4
Category_Wikipedia_sockpuppets_of_Francis_E_Williams.csv,1123,7168586.0,502,621,500,2,0,47.08192341941229,248,59,23.886019590382904,3
Category_Wikipedia_sockpuppets_of_Uywwi.csv,43,1855051.0,15,28,8,7,0,38.395348837209305,199,57,31.6046511627907,8
Category_Wikipedia_sockpuppets_of_Merlin_the_2nd.csv,1616,13380206.0,511,1105,500,11,0,49.336633663366335,255,49,17.894183168316832,4
Category_Wikipedia_sockpuppets_of_Comps.csv,1536,135208111.0,589,947,500,89,0,60.686197916666664,249,62,15.869791666666666,3
Category_Wikipedia_sockpuppets_of_Jakosalem.csv,1176,18776999.0,348,828,191,157,0,34.156462585034014,259,45,16.28061224489796,4
Category_Wikipedia_sockpuppets_of_Bluescreenofdef.csv,597,49760199.0,152,445,145,7,0,46.60469011725293,195,51,29.187604690117254,9
Category_Wikipedia_sockpuppets_of_SolarPACES.csv,88,13168615.0,32,56,29,3,0,50.42045454545455,266,38,22.443181818181817,13
Category_Wikipedia_sockpuppets_of_Sambrama_urs.csv,102,34120057.0,47,55,12,35,0,63.0,310,101,18.745098039215687,8
Category_Wikipedia_sockpuppets_of_NEW_USER_31AUG2020.csv,135,1649542.0,39,96,39,0,0,32.55555555555556,269,59,20.525925925925925,10
Category_Wikipedia_sockpuppets_of_Sangemarwa.csv,120,25847576.0,55,65,22,33,0,36.891666666666666,225,56,16.041666666666668,4
Category_Wikipedia_sockpuppets_of_Zeshan_Mahmood.csv,1995,190689442.0,445,1550,307,138,0,48.10576441102757,330,66,19.714285714285715,3
Category_Wikipedia_sockpuppets_of_Gugulii.csv,36,30295638.0,12,24,10,2,0,61.69444444444444,256,25,22.0,11
Category_Wikipedia_sockpuppets_of_Iplaypokemongoevuridey.csv,3,175350.0,2,1,2,0,0,6.0,14,17,15.666666666666666,15
Category_Wikipedia_sockpuppets_of_Sameergoswami.csv,1083,358628119.0,366,717,327,39,0,43.73130193905817,255,50,18.43397968605725,6
Category_Wikipedia_sockpuppets_of_Srimonbanik2007.csv,13520,117337738.0,5709,7811,500,5209,0,40.39230769230769,500,109,30.955473372781064,3
Category_Wikipedia_sockpuppets_of_Danis_fast_game.csv,228,724108.0,133,95,129,4,0,41.68421052631579,235,46,21.605263157894736,8
Category_Wikipedia_sockpuppets_of_Hisksjueeu.csv,437,26783041.0,129,308,70,59,0,52.2700228832952,348,38,18.151029748283754,6
Category_Wikipedia_sockpuppets_of_ELF_TV.csv,1025,15451662.0,257,768,230,27,0,32.29658536585366,249,45,21.853658536585368,6
Category_Wikipedia_sockpuppets_of_Dipendra2007.csv,2696,540556084.0,909,1787,500,409,0,54.80712166172107,499,50,16.75408011869436,4
Category_Wikipedia_sockpuppets_of_Caleb_shake.csv,36,776589.0,17,19,11,6,0,37.19444444444444,144,17,11.833333333333334,9
Category_Wikipedia_sockpuppets_of_Starwars4004.csv,385,19186107.0,108,277,73,35,0,31.883116883116884,199,52,18.374025974025972,5
Category_Wikipedia_sockpuppets_of_Ccmtt12345.csv,1615,26768636.0,616,999,500,116,0,43.1578947368421,311,61,21.19752321981424,5
Category_Wikipedia_sockpuppets_of_Ishbiliyya.csv,1942,8104437.0,514,1428,500,14,0,56.161688980432544,500,68,17.68228630278064,7
Category_Wikipedia_sockpuppets_of_Tyree999.csv,1566,4557390.0,463,1103,206,257,0,50.7477650063857,250,64,16.32183908045977,4
Category_Wikipedia_sockpuppets_of_Pooja_Khaneja.csv,223,5162341.0,46,177,32,14,0,54.766816143497756,255,54,22.713004484304932,5
Category_Wikipedia_sockpuppets_of_Jimwatch.csv,29,2006372.0,12,17,6,6,0,62.206896551724135,255,43,21.517241379310345,13
Category_Wikipedia_sockpuppets_of_Jerome0012.csv,3622,57836197.0,1413,2209,500,913,0,35.42904472667035,265,69,25.934566537824406,7
Category_Wikipedia_sockpuppets_of_Yattum.csv,4328,108768486.0,1326,3002,353,973,0,50.38909426987061,262,69,20.699630314232902,2
Category_Wikipedia_sockpuppets_of_Akshadev.csv,2808,67829537.0,873,1935,500,373,0,44.88176638176638,496,56,18.29237891737892,2
Category_Wikipedia_sockpuppets_of_Jake.edu.csv,898,2404655.0,242,656,129,113,0,45.61247216035635,249,58,20.633630289532295,4
Category_Wikipedia_sockpuppets_of_Noi98.csv,1299,34063214.0,287,1012,161,126,0,35.351039260969976,232,39,17.124711316397228,5
Category_Wikipedia_sockpuppets_of_Glamhersales.csv,9,518247.0,2,7,1,1,0,105.77777777777777,270,35,13.222222222222221,7
Category_Wikipedia_sockpuppets_of_Gopteato.csv,100,4848960.0,32,68,18,14,0,34.68,229,23,12.88,5
Category_Wikipedia_sockpuppets_of_Moe_Larry_Curly_Shemp.csv,89,527599.0,43,46,21,22,0,45.29213483146067,196,70,36.91011235955056,21
Category_Wikipedia_sockpuppets_of_SoundWaveGaming.csv,19,607192.0,16,3,7,9,0,16.05263157894737,149,29,25.894736842105264,13
Category_Wikipedia_sockpuppets_of_BACON_EXPLOSION.csv,128,183514.0,33,95,33,0,0,64.5,193,54,24.734375,5
Category_Wikipedia_sockpuppets_of_RealKJW.csv,812,23927643.0,215,597,81,134,0,45.17118226600985,255,60,25.810344827586206,7
Category_Wikipedia_sockpuppets_of_Sdname9.csv,180,26269906.0,79,101,61,18,0,35.6,346,58,31.944444444444443,9
Category_Wikipedia_sockpuppets_of_Mijanursrkr.csv,59,1734941.0,21,38,21,0,0,40.71186440677966,274,33,24.694915254237287,13
Category_Wikipedia_sockpuppets_of_LastEdit2008.csv,664,11998708.0,216,448,34,182,0,48.73644578313253,239,41,16.503012048192772,5
Category_Wikipedia_sockpuppets_of_Newspaper_guy_999.csv,77,504311.0,45,32,29,16,0,45.66233766233766,197,54,35.62337662337662,23
Category_Wikipedia_sockpuppets_of_Fajar_Mardiansyah.csv,306,116386475.0,78,228,42,36,0,52.73856209150327,496,35,13.38562091503268,4
Category_Wikipedia_sockpuppets_of_Extrapolaris.csv,2349,98434374.0,951,1398,500,451,0,54.76245210727969,401,83,22.257130693912302,4
Category_Wikipedia_sockpuppets_of_ICarriere.csv,1429,536788923.0,522,907,459,63,0,51.018194541637506,295,58,16.840447865640307,8
Category_Wikipedia_sockpuppets_of_Philip_Adrian.csv,141,19254891.0,41,100,24,17,0,45.45390070921986,424,22,13.53191489361702,9
Category_Wikipedia_sockpuppets_of_Moonrivers.csv,3443,131608917.0,917,2526,500,417,0,47.489398780133605,499,69,21.658437409236132,3
Category_Wikipedia_sockpuppets_of_Nomoredonkeys.csv,63,6518314.0,13,50,7,6,0,52.714285714285715,207,42,19.603174603174605,7
Category_Wikipedia_sockpuppets_of_Chirag-Behre.csv,108,7360633.0,34,74,13,21,0,45.7962962962963,272,53,37.166666666666664,9
Category_Wikipedia_sockpuppets_of_7yPDx4.csv,417,141706459.0,158,259,105,53,0,42.62350119904077,236,47,22.057553956834532,6
Category_Wikipedia_sockpuppets_of_Danish777.csv,110,6213580.0,86,24,64,22,0,33.154545454545456,217,24,19.59090909090909,15
Category_Wikipedia_sockpuppets_of_Srysly1.csv,36,2187295.0,12,24,7,5,0,56.416666666666664,209,30,13.083333333333334,4
Category_Wikipedia_sockpuppets_of_SuperPoweredChickenNuggets.csv,1014,30862768.0,267,747,243,24,0,49.07692307692308,500,49,18.90138067061144,5
Category_Wikipedia_sockpuppets_of_INTUC_Y_Solapur.csv,89,2668850.0,32,57,12,20,0,52.98876404494382,209,49,21.325842696629213,6
Category_Wikipedia_sockpuppets_of_Nick_Fitzpatrick.csv,414,9376094.0,138,276,130,8,0,45.6207729468599,228,57,19.130434782608695,4
Category_Wikipedia_sockpuppets_of_Koushik_Pain.csv,1114,13219706.0,403,711,320,83,0,35.85906642728905,293,37,18.423698384201078,5
Category_Wikipedia_sockpuppets_of_Seb√ØF√Øg.csv,2534,8274369.0,793,1741,500,293,0,65.47395422257301,262,59,18.071428571428573,1
Category_Wikipedia_sockpuppets_of_Shubh2545.csv,155,42679365.0,40,115,35,5,0,47.50322580645161,330,64,26.954838709677418,5
Category_Wikipedia_sockpuppets_of_Sparky-x.csv,8,41763.0,6,2,6,0,13,48.375,125,29,18.625,13
Category_Wikipedia_sockpuppets_of_Zinbarg.csv,2171,83025626.0,710,1461,500,210,0,50.49378166743436,250,57,16.289267618608935,3
Category_Wikipedia_sockpuppets_of_Misterterminater95.csv,139,30579035.0,37,102,34,3,0,45.381294964028775,240,44,17.66906474820144,6
Category_Wikipedia_sockpuppets_of_D.C._at_MAD_Foundation_Inc..csv,561,25853799.0,185,376,138,47,0,53.623885918003566,327,73,21.54901960784314,6
Category_Wikipedia_sockpuppets_of_Sardar_Ali_haider_dogar.csv,38,11285175.0,20,18,9,11,0,32.13157894736842,162,35,18.42105263157895,11
Category_Wikipedia_sockpuppets_of_Netanya9.csv,806,85480264.0,281,525,277,4,0,55.94789081885856,373,55,19.832506203473944,5
Category_Wikipedia_sockpuppets_of_Nerd_with_the_thick_glasses.csv,354,216069645.0,102,252,14,88,0,46.66949152542373,246,35,16.228813559322035,4
Category_Wikipedia_sockpuppets_of_Iggyazalea2017.csv,355,7862891.0,191,164,66,125,0,31.892957746478874,255,42,19.070422535211268,9
Category_Wikipedia_sockpuppets_of_Starcade.csv,1634,122874318.0,429,1205,428,1,0,44.76376988984088,250,56,23.901468788249694,5
Category_Wikipedia_sockpuppets_of_Dcahole.csv,181,3959798.0,79,102,70,9,0,41.71823204419889,198,47,28.314917127071823,12
Category_Wikipedia_sockpuppets_of_Detroser.csv,168,39308458.0,82,86,10,72,0,91.38095238095238,254,41,19.56547619047619,5
Category_Wikipedia_sockpuppets_of_Dward2612.csv,294,52898304.0,98,196,61,37,0,52.48299319727891,254,59,26.58843537414966,9
Category_Wikipedia_sockpuppets_of_Seng_mi.csv,203,984407.0,50,153,33,17,0,52.95073891625616,265,26,12.54679802955665,4
Category_Wikipedia_sockpuppets_of_Hjh874.csv,75,7525441.0,29,46,20,9,0,40.82666666666667,233,47,33.54666666666667,10
Category_Wikipedia_sockpuppets_of_Lam_Thuy_Van.csv,849,102345672.0,198,651,180,18,0,38.64428739693757,254,42,22.17196702002356,9
Category_Wikipedia_sockpuppets_of_CadAPL.csv,22556,163964077.0,6334,16222,500,5834,0,39.870544422769996,500,80,19.06384110657918,3
Category_Wikipedia_sockpuppets_of_Joe_sav2.csv,24,629.0,8,16,8,0,0,61.375,205,14,8.833333333333334,4
Category_Wikipedia_sockpuppets_of_GJOLEKA.csv,2051,10939436.0,744,1307,500,244,0,50.87859580692345,500,74,14.74597757191614,3
Category_Wikipedia_sockpuppets_of_Emerynelson01.csv,19,5628.0,6,13,2,4,0,54.36842105263158,207,40,16.31578947368421,10
Category_Wikipedia_sockpuppets_of_TheWeldere.csv,122,11184512.0,64,58,29,35,0,40.59836065573771,302,26,15.87704918032787,8
Category_Wikipedia_sockpuppets_of_DumaTorpedo.csv,1279,71336007.0,496,783,437,59,0,54.23455824863174,414,50,19.74511336982017,7
Category_Wikipedia_sockpuppets_of_Gunnala.csv,1849,362543354.0,507,1342,500,7,0,37.00648999459167,254,72,18.451595457003787,3
Category_Wikipedia_sockpuppets_of_RobotRat.csv,28,66915.0,13,15,12,1,0,59.5,217,37,20.178571428571427,10
"Category_Wikipedia_sockpuppets_of_Asperger,_he'll_know..csv",71,2260929.0,29,42,13,16,0,46.40845070422535,215,32,16.619718309859156,4
Category_Wikipedia_sockpuppets_of_Holdenlaneginsburg.csv,71,1771554.0,52,19,48,4,0,25.56338028169014,206,28,24.183098591549296,15
Category_Wikipedia_sockpuppets_of_A.K.Nole.csv,3262,133584693.0,1022,2240,500,522,0,43.87400367872471,245,86,19.910790925812385,4
Category_Wikipedia_sockpuppets_of_Cocainaenvenenada.csv,151,30038996.0,81,70,72,9,0,34.12582781456954,233,37,22.019867549668874,6
Category_Wikipedia_sockpuppets_of_Roz_Lipschitz.csv,903,138860687.0,306,597,188,118,0,57.07641196013289,237,60,20.090808416389812,5
Category_Wikipedia_sockpuppets_of_Supernightmare101.csv,60,27443531.0,21,39,15,6,0,39.7,213,47,20.183333333333334,9
Category_Wikipedia_sockpuppets_of_VisitEureka.csv,253,3800451.0,77,176,76,1,0,41.1501976284585,200,32,20.636363636363637,6
Category_Wikipedia_sockpuppets_of_Barakabless.csv,79,208221.0,48,31,41,7,0,42.08860759493671,138,33,15.772151898734178,8
Category_Wikipedia_sockpuppets_of_Jesus_Riding_a_Dinosaur.csv,8,88160.0,7,1,4,3,0,27.0,113,20,20.0,20
Category_Wikipedia_sockpuppets_of_Matchbook_Romance_Winter_Solstice.csv,191,6936274.0,59,132,12,47,0,43.1151832460733,376,44,21.900523560209425,9
Category_Wikipedia_sockpuppets_of_Cfcilldara.csv,161,21587536.0,70,91,62,8,0,66.41614906832298,221,37,19.422360248447205,8
Category_Wikipedia_sockpuppets_of_Toshikenan.csv,667,40377808.0,244,423,36,208,0,47.72713643178411,493,56,17.995502248875564,5
Category_Wikipedia_sockpuppets_of_PokestarFan.csv,1308,212680885.0,550,758,391,159,0,41.919724770642205,270,76,21.204128440366972,2
Category_Wikipedia_sockpuppets_of_Marktreut.csv,2005,97589262.0,524,1481,500,24,0,37.66483790523691,261,69,20.931670822942642,5
Category_Wikipedia_sockpuppets_of_CafecitodeStarbucks.csv,124,22360334.0,46,78,24,22,0,66.98387096774194,480,64,18.798387096774192,7
Category_Wikipedia_sockpuppets_of_Tomas_Gilbfarb.csv,365,3212590.0,134,231,67,67,0,39.56986301369863,254,92,26.602739726027398,4
Category_Wikipedia_sockpuppets_of_Hoelzer.csv,41,1334314.0,16,25,8,8,0,67.78048780487805,255,40,26.024390243902438,17
Category_Wikipedia_sockpuppets_of_Banned25.csv,7,1486.0,4,3,3,1,12,53.142857142857146,143,24,24.0,24
Category_Wikipedia_sockpuppets_of_Taimoorahmed11.csv,353,23048387.0,146,207,146,0,0,43.226628895184135,312,50,27.77903682719547,4
Category_Wikipedia_sockpuppets_of_Plsletmehaveadrink.csv,2108,8761678.0,685,1423,275,410,0,43.532732447817835,499,61,18.377134724857687,1
Category_Wikipedia_sockpuppets_of_Mindcraftnation.csv,5,1615.0,5,0,5,0,21,21.0,21,25,25.0,25
Category_Wikipedia_sockpuppets_of_Bwoodcock.csv,3489,31024894.0,1197,2292,500,697,0,56.39896818572657,500,103,20.54284895385497,3
Category_Wikipedia_sockpuppets_of_Gravitom.csv,563,85765280.0,266,297,77,189,0,38.89698046181172,200,57,20.91829484902309,9
Category_Wikipedia_sockpuppets_of_IworkforNASA.csv,1060,59506433.0,335,725,179,156,0,34.93396226415094,198,90,24.082075471698115,4
Category_Wikipedia_sockpuppets_of_Crunchyking.csv,49,1566.0,15,34,7,8,0,58.97959183673469,220,36,17.918367346938776,3
Category_Wikipedia_sockpuppets_of_Top_Gun_Maverick_1.csv,9,1167.0,3,6,3,0,14,51.55555555555556,153,37,22.333333333333332,11
Category_Wikipedia_sockpuppets_of_Damonthesis.csv,966,275240196.0,304,662,303,1,0,60.96376811594203,368,52,31.83126293995859,3
Category_Wikipedia_sockpuppets_of_Lytotr.csv,97,220651595.0,65,32,60,5,0,28.164948453608247,226,22,10.556701030927835,10
Category_Wikipedia_sockpuppets_of_YourLord.csv,4233,214587089.0,1224,3009,500,724,0,41.578077013938106,251,78,18.368296716276873,3
Category_Wikipedia_sockpuppets_of_Babybirdhouse.csv,153,56335025.0,95,58,60,35,0,37.71895424836601,246,23,16.941176470588236,16
Category_Wikipedia_sockpuppets_of_Tromaintern.csv,532,70156018.0,191,341,157,34,0,44.0093984962406,219,48,19.719924812030076,10
Category_Wikipedia_sockpuppets_of_LotobomyMaster.csv,61,36686.0,38,23,25,13,0,64.44262295081967,373,29,18.131147540983605,1
Category_Wikipedia_sockpuppets_of_CulverPR.csv,29,3641334.0,11,18,8,3,0,58.275862068965516,185,38,25.03448275862069,17
Category_Wikipedia_sockpuppets_of_Dakotaparty.csv,4552,102083888.0,1900,2652,500,1400,0,28.858743409490334,255,59,20.264718804920914,5
Category_Wikipedia_sockpuppets_of_Illyrian5999.csv,126,10751664.0,50,76,43,7,0,58.642857142857146,281,54,27.142857142857142,15
Category_Wikipedia_sockpuppets_of_Wrabbjr902.csv,1235,13771684.0,521,714,500,21,0,27.388663967611336,255,32,19.892307692307693,10
Category_Wikipedia_sockpuppets_of_Lord_Aseem.csv,526,5800351.0,226,300,152,74,0,62.99619771863118,255,50,21.136882129277566,6
Category_Wikipedia_sockpuppets_of_Sallypond.csv,20,2761957.0,8,12,5,3,0,45.2,149,31,31.0,31
Category_Wikipedia_sockpuppets_of_Mapd43.csv,143,48860622.0,58,85,55,3,0,42.86013986013986,228,51,18.104895104895103,9
Category_Wikipedia_sockpuppets_of_Johnbkidd.csv,270,65482290.0,102,168,76,26,0,42.507407407407406,236,32,15.751851851851852,7
Category_Wikipedia_sockpuppets_of_Poledlimps.csv,538,13240989.0,172,366,49,123,0,58.67843866171004,420,48,16.529739776951672,2
Category_Wikipedia_sockpuppets_of_Thegontlit.csv,76,86419.0,28,48,22,6,0,34.9078947368421,158,25,19.36842105263158,16
Category_Wikipedia_sockpuppets_of_HibikiZenkai.csv,430,10993862.0,194,236,151,43,0,37.84186046511628,439,34,19.6046511627907,3
Category_Wikipedia_sockpuppets_of_Royclark06.csv,1,0.0,1,0,1,0,0,0.0,0,17,17.0,17
Category_Wikipedia_sockpuppets_of_Ivymike21.csv,1116,82009941.0,266,850,252,14,0,36.00985663082437,208,49,15.007168458781361,3
Category_Wikipedia_sockpuppets_of_ScienceArtz.csv,220,1731019.0,69,151,25,44,0,30.304545454545455,138,49,23.23181818181818,4
Category_Wikipedia_sockpuppets_of_Kerashtra21.csv,118,1043545.0,54,64,49,5,0,36.67796610169491,496,66,38.63559322033898,16
Category_Wikipedia_sockpuppets_of_Vernonsmusic.csv,43,10352664.0,14,29,5,9,0,40.16279069767442,256,31,19.25581395348837,11
Category_Wikipedia_sockpuppets_of_LiveIsle2022.csv,1091,7005049.0,998,93,500,498,0,20.737855178735106,496,62,45.13290559120073,9
Category_Wikipedia_sockpuppets_of_Donovyegg.csv,2264,55727053.0,582,1682,487,95,0,54.98851590106007,504,57,20.608215547703182,4
Category_Wikipedia_sockpuppets_of_Jorjman.csv,1744,92642226.0,501,1243,227,274,0,45.41743119266055,268,53,16.168577981651374,4
Category_Wikipedia_sockpuppets_of_Comprendo.csv,1024,400222809.0,314,710,312,2,0,49.3515625,255,53,17.4130859375,6
Category_Wikipedia_sockpuppets_of_AMglobal.csv,82,7351955.0,22,60,14,8,0,50.353658536585364,195,43,16.048780487804876,7
Category_Wikipedia_sockpuppets_of_Jnyssen.csv,2681,54791586.0,1000,1681,500,500,0,57.97239835882134,500,85,17.123461395001865,3
Category_Wikipedia_sockpuppets_of_Fazekhan1262.csv,97,4611.0,40,57,37,3,0,30.896907216494846,233,22,12.958762886597938,7
Category_Wikipedia_sockpuppets_of_Soulemediavijay.csv,63,1568783.0,44,19,44,0,0,23.3015873015873,235,26,15.80952380952381,8
Category_Wikipedia_sockpuppets_of_TheChangeLover.csv,1035,1403528.0,273,762,266,7,0,37.853140096618354,290,52,16.878260869565217,3
Category_Wikipedia_sockpuppets_of_Zanyar.csv,310,3971963.0,107,203,97,10,0,32.409677419354836,234,29,11.580645161290322,4
Category_Wikipedia_sockpuppets_of_SpiringCord7.csv,2660,18139737.0,1108,1552,500,608,0,36.856766917293236,255,72,23.180075187969926,5
Category_Wikipedia_sockpuppets_of_Taavocatt123.csv,46,883420.0,35,11,9,26,0,25.47826086956522,192,21,17.52173913043478,17
Category_Wikipedia_sockpuppets_of_Youngmanstop.csv,3,50.0,2,1,2,0,0,6.333333333333333,19,30,25.666666666666668,17
Category_Wikipedia_sockpuppets_of_Gaybryant.csv,87,263270111.0,47,40,23,24,0,58.11494252873563,315,23,12.954022988505747,10
Category_Wikipedia_sockpuppets_of_Mysteryman90.csv,214,147261878.0,75,139,69,6,0,35.822429906542055,230,42,21.96728971962617,3
Category_Wikipedia_sockpuppets_of_9no1.csv,2093,85895917.0,630,1463,500,130,0,34.9842331581462,472,40,17.175346392737698,3
Category_Wikipedia_sockpuppets_of_IbrahimWeed.csv,4350,147430951.0,1464,2886,500,964,0,52.80965517241379,478,85,25.089195402298852,4
Category_Wikipedia_sockpuppets_of_Mark7532222.csv,629,101064866.0,154,475,44,110,0,45.50079491255962,237,40,15.461049284578696,2
Category_Wikipedia_sockpuppets_of_Simonsyo.csv,401,15456189.0,128,273,125,3,0,52.74064837905237,231,55,26.51620947630923,7
Category_Wikipedia_sockpuppets_of_Thewolfspider20.csv,85,6041994.0,41,44,15,26,0,45.423529411764704,243,30,22.823529411764707,4
Category_Wikipedia_sockpuppets_of_HazaraHistorian.csv,902,24421089.0,307,595,282,25,0,47.311529933481154,312,53,21.148558758314856,6
Category_Wikipedia_sockpuppets_of_Sekanaya12.csv,154,6436688.0,65,89,24,41,0,29.850649350649352,220,50,24.967532467532468,5
Category_Wikipedia_sockpuppets_of_Jimiwriter.csv,7,38398.0,2,5,2,0,46,71.57142857142857,125,36,23.142857142857142,18
Category_Wikipedia_sockpuppets_of_Riathamus.csv,132,318448457.0,34,98,26,8,0,64.90151515151516,241,29,15.780303030303031,6
Category_Wikipedia_sockpuppets_of_Clevershop.csv,9,56860.0,5,4,5,0,0,48.888888888888886,196,33,25.77777777777778,20
Category_Wikipedia_sockpuppets_of_Kashem_overflow.csv,424,61484544.0,185,239,79,106,0,53.56603773584906,496,77,28.431603773584907,7
Category_Wikipedia_sockpuppets_of_Doncsecz.csv,81,262933631.0,23,58,16,7,0,51.41975308641975,309,44,18.814814814814813,4
Category_Wikipedia_sockpuppets_of_Simon_westall191.csv,11,2177.0,6,5,4,2,0,102.36363636363636,271,29,26.272727272727273,26
Category_Wikipedia_sockpuppets_of_Koskenkorva.csv,271,1375190.0,104,167,102,2,0,62.07380073800738,221,43,25.0,14
Category_Wikipedia_sockpuppets_of_Terribear69.csv,84,776498.0,41,43,25,16,0,30.476190476190474,179,47,23.238095238095237,6
Category_Wikipedia_sockpuppets_of_Charlieagrinsoni.csv,71,115092400.0,32,39,31,1,0,44.11267605633803,247,29,24.704225352112676,21
Category_Wikipedia_sockpuppets_of_Moonballs.csv,302,2936938.0,108,194,49,59,0,58.824503311258276,491,52,20.198675496688743,8
Category_Wikipedia_sockpuppets_of_Bobby_Nandra.csv,118,168045.0,49,69,48,1,0,46.80508474576271,200,60,25.3135593220339,15
Category_Wikipedia_sockpuppets_of_Noormohammed_satya.csv,5274,270169371.0,1506,3768,500,1006,0,33.24554417899128,395,73,21.311149032992038,5
Category_Wikipedia_sockpuppets_of_Kambojadvocate.csv,11,399247039.0,3,8,2,1,0,33.81818181818182,71,58,45.18181818181818,19
Category_Wikipedia_sockpuppets_of_Proficiency_Group.csv,14,4784428.0,8,6,4,4,0,20.071428571428573,196,23,17.428571428571427,12
Category_Wikipedia_sockpuppets_of_Dega-lasy_Singer.csv,84,21810013.0,46,38,14,32,0,36.79761904761905,196,26,19.273809523809526,12
Category_Wikipedia_sockpuppets_of_Midgette.csv,51,31535425.0,17,34,17,0,0,56.35294117647059,214,17,7.588235294117647,4
Category_Wikipedia_sockpuppets_of_Slxm_Jay.csv,108,45007465.0,37,71,29,8,0,45.78703703703704,374,47,13.898148148148149,6
Category_Wikipedia_sockpuppets_of_Joseph_kargbo.csv,485,253675945.0,144,341,27,117,0,43.5298969072165,312,42,25.690721649484537,10
Category_Wikipedia_sockpuppets_of_Racerkid27.csv,31,4785.0,11,20,6,5,0,46.935483870967744,190,23,14.806451612903226,10
Category_Wikipedia_sockpuppets_of_Aohunnil.csv,72,3274532.0,22,50,1,21,0,57.125,266,31,16.15277777777778,7
Category_Wikipedia_sockpuppets_of_CNGLITCHINFO.csv,1881,2503664.0,641,1240,388,253,0,49.71079213184476,249,78,22.237639553429027,3
Category_Wikipedia_sockpuppets_of_Digitaldistortion2k17.csv,6,11861.0,3,3,2,1,0,85.66666666666667,197,7,7.0,7
Category_Wikipedia_sockpuppets_of_Cinque_stelle.csv,469,305797908.0,144,325,90,54,0,45.29637526652452,248,50,16.71641791044776,5
Category_Wikipedia_sockpuppets_of_Graham_Heavy.csv,2,123.0,2,0,2,0,34,34.0,34,9,9.0,9
Category_Wikipedia_sockpuppets_of_Shqip√´ris√´tonluk.csv,2946,36523959.0,1030,1916,205,825,0,47.142905634758996,255,77,23.31500339443313,3
Category_Wikipedia_sockpuppets_of_Md._Ehsanul_Habib_Onik.csv,20,10831969.0,8,12,6,2,0,43.15,174,32,14.45,5
Category_Wikipedia_sockpuppets_of_IvanthegreatLaw.csv,84,340960912.0,19,65,12,7,0,59.642857142857146,193,41,24.05952380952381,13
Category_Wikipedia_sockpuppets_of_Scibaby.csv,22882,403802464.0,6773,16109,344,6429,0,59.280657285202345,441,131,19.332313608950265,2
Category_Wikipedia_sockpuppets_of_Sueson766.csv,90,17122291.0,35,55,8,27,0,53.98888888888889,235,22,15.38888888888889,7
Category_Wikipedia_sockpuppets_of_Spiderman's_Companion.csv,59,363695.0,18,41,17,1,0,42.932203389830505,254,57,18.16949152542373,5
Category_Wikipedia_sockpuppets_of_S1l3ntx5.csv,62,43715350.0,14,48,11,3,0,40.37096774193548,181,18,15.983870967741936,13
Category_Wikipedia_sockpuppets_of_JohnPeterson.csv,438,6074847.0,131,307,81,50,0,56.88812785388128,255,57,19.34931506849315,4
Category_Wikipedia_sockpuppets_of_Chait2001.csv,206,1417036.0,82,124,43,39,0,46.922330097087375,206,35,16.24271844660194,10
Category_Wikipedia_sockpuppets_of_Phaenix_007.csv,381,113020885.0,93,288,92,1,0,36.52230971128609,500,46,17.438320209973753,5
Category_Wikipedia_sockpuppets_of_Klynn203.csv,1,0.0,1,0,1,0,13,13.0,13,18,18.0,18
Category_Wikipedia_sockpuppets_of_ChrisGriswold.csv,3138,355889804.0,912,2226,500,412,0,45.72912683237731,259,94,23.777884002549396,4
Category_Wikipedia_sockpuppets_of_Vivekrjain.csv,220,19183070.0,79,141,54,25,0,44.84090909090909,254,27,14.018181818181818,11
Category_Wikipedia_sockpuppets_of_OldUncleRemus.csv,1826,14827957.0,536,1290,500,36,0,44.85815991237678,458,60,19.136363636363637,4
Category_Wikipedia_sockpuppets_of_Panchitone.csv,527,93894625.0,189,338,72,117,0,46.95445920303605,244,59,19.045540796963948,5
Category_Wikipedia_sockpuppets_of_Ooshiscribbles.csv,37,437483.0,18,19,16,2,0,39.972972972972975,233,36,22.486486486486488,5
Category_Wikipedia_sockpuppets_of_YerYeller.csv,144,588680.0,44,100,37,7,0,49.21527777777778,214,30,13.29861111111111,4
Category_Wikipedia_sockpuppets_of_DrJSE.csv,44,4389582.0,30,14,21,9,0,18.34090909090909,246,39,19.84090909090909,8
Category_Wikipedia_sockpuppets_of_DSNR.csv,204,8643833.0,85,119,60,25,0,53.09313725490196,245,54,17.55392156862745,6
Category_Wikipedia_sockpuppets_of_Vivekmeena29.csv,93,17987145.0,48,45,41,7,0,29.29032258064516,208,23,18.50537634408602,12
Category_Wikipedia_sockpuppets_of_Airserma.csv,124,3740718.0,42,82,19,23,0,41.63709677419355,255,35,16.68548387096774,4
Category_Wikipedia_sockpuppets_of_Khalidatwiki.csv,183,2194743.0,75,108,38,37,0,39.666666666666664,234,45,20.081967213114755,6
Category_Wikipedia_sockpuppets_of_VolkswagenKing28.csv,1469,78280320.0,439,1030,107,332,0,38.879509870660314,221,40,15.808032675289313,3
Category_Wikipedia_sockpuppets_of_ManishMuradiya.csv,166,24354935.0,56,110,36,20,0,49.993975903614455,255,38,18.174698795180724,9
Category_Wikipedia_sockpuppets_of_Runninmanofficial.csv,711,392792695.0,175,536,170,5,0,47.76933895921238,327,43,16.91279887482419,3
Category_Wikipedia_sockpuppets_of_Dev21seo.csv,11,69700.0,3,8,3,0,0,25.636363636363637,50,21,19.363636363636363,15
Category_Wikipedia_sockpuppets_of_117daveawesome.csv,1282,7328995.0,553,729,500,53,0,57.67706708268331,500,50,18.76833073322933,3
Category_Wikipedia_sockpuppets_of_Anand.Hegde.csv,2341,111866685.0,531,1810,500,31,0,46.02520290474156,255,59,14.877402819307989,4
Category_Wikipedia_sockpuppets_of_Uekhen.csv,145,29922959.0,50,95,36,14,0,45.55862068965517,199,56,23.2,8
Category_Wikipedia_sockpuppets_of_Cristina_neagu.csv,9143,24468348.0,3502,5641,500,3002,0,35.534397900032815,500,66,20.943782128404244,4
Category_Wikipedia_sockpuppets_of_DrL.csv,1451,477182324.0,510,941,500,10,0,53.8973121984838,316,69,23.98759476223294,6
Category_Wikipedia_sockpuppets_of_EnglishEfternamn.csv,5324,391247350.0,1681,3643,500,1181,0,50.88974455296769,271,69,20.716754320060105,3
Category_Wikipedia_sockpuppets_of_Zoyahssn.csv,1514,9581523.0,462,1052,187,275,0,61.41941875825628,492,55,18.60766182298547,4
Category_Wikipedia_sockpuppets_of_Brodielytle.csv,28,10281542.0,8,20,4,4,0,41.285714285714285,175,22,13.928571428571429,5
Category_Wikipedia_sockpuppets_of_Thenumberonegeniusoftheevent.csv,13,53476.0,6,7,3,3,0,76.3076923076923,215,40,24.153846153846153,7
Category_Wikipedia_sockpuppets_of_Saklesh.csv,525,23171673.0,202,323,89,113,0,35.135238095238094,496,56,22.822857142857142,10
Category_Wikipedia_sockpuppets_of_Big.mc.jew.csv,36,175194.0,12,24,3,9,0,50.166666666666664,243,42,16.944444444444443,2
Category_Wikipedia_sockpuppets_of_Tomasss1988.csv,42,287721.0,13,29,12,1,0,55.73809523809524,219,21,15.023809523809524,10
Category_Wikipedia_sockpuppets_of_Hkelkar.csv,13763,120115996.0,4594,9169,500,4094,0,42.829615636125844,255,69,20.364818716849523,3
Category_Wikipedia_sockpuppets_of_Jamiawala.csv,137,1027760.0,49,88,29,20,0,52.54744525547445,225,55,18.83941605839416,5
Category_Wikipedia_sockpuppets_of_Doctor_Michael.David.csv,1,0.0,1,0,1,0,21,21.0,21,12,12.0,12
Category_Wikipedia_sockpuppets_of_Cruiserbmw.csv,303,140196572.0,89,214,84,5,0,44.91089108910891,236,38,17.260726072607262,4
Category_Wikipedia_sockpuppets_of_Justjust12.csv,47,55224653.0,17,30,5,12,0,70.46808510638297,255,58,23.5531914893617,6
Category_Wikipedia_sockpuppets_of_Nivea_Dabre.csv,9,436365.0,9,0,6,3,0,42.44444444444444,194,20,18.666666666666668,18
Category_Wikipedia_sockpuppets_of_EmorejMedia.csv,10,6841.0,5,5,3,2,0,55.4,246,47,24.6,21
Category_Wikipedia_sockpuppets_of_Nat429.csv,14,514320.0,3,11,3,0,0,46.142857142857146,122,34,23.428571428571427,18
Category_Wikipedia_sockpuppets_of_Ihsanss86.csv,752,39154174.0,276,476,124,152,0,39.68617021276596,250,40,13.680851063829786,3
Category_Wikipedia_sockpuppets_of_KevinWilliam2016.csv,9,6800695.0,3,6,2,1,0,38.666666666666664,132,21,15.0,12
Category_Wikipedia_sockpuppets_of_Onward123.csv,26,327613.0,21,5,12,9,0,21.846153846153847,161,19,19.0,19
Category_Wikipedia_sockpuppets_of_Louis_Sarwal.csv,287,20121137.0,96,191,87,9,0,57.177700348432055,319,43,17.29616724738676,4
Category_Wikipedia_sockpuppets_of_Yellowboy7.csv,282,127693816.0,75,207,48,27,0,47.854609929078016,360,43,22.918439716312058,7
Category_Wikipedia_sockpuppets_of_Gtarmanperson.csv,390,176484240.0,132,258,131,1,0,40.85897435897436,236,30,16.3025641025641,6
Category_Wikipedia_sockpuppets_of_Mikemchugh2k.csv,87,6740420.0,29,58,21,8,0,63.770114942528735,255,45,22.49425287356322,10
Category_Wikipedia_sockpuppets_of_Anony123456000.csv,15,89474805.0,5,10,3,2,4,40.06666666666667,87,41,25.266666666666666,17
Category_Wikipedia_sockpuppets_of_Olliestacey.csv,5,1602.0,4,1,3,1,10,35.0,135,14,14.0,14
Category_Wikipedia_sockpuppets_of_Hypocaustic.csv,8444,133491178.0,2350,6094,500,1850,0,45.73010421601137,255,66,20.294291804831833,3
Category_Wikipedia_sockpuppets_of_Indian_ai.csv,78,1162463.0,42,36,21,21,0,41.666666666666664,228,23,11.73076923076923,8
Category_Wikipedia_sockpuppets_of_ÿ±ÿ¶Ÿäÿ≥_⁄Ø⁄èŸè_ÿ≥ŸàŸÑŸÜ⁄ØŸä.csv,102,18179666.0,40,62,39,1,0,49.6078431372549,225,31,18.225490196078432,11
Category_Wikipedia_sockpuppets_of_Fieryflames.csv,1508,34454920.0,396,1112,81,315,0,53.21153846153846,368,61,13.628647214854112,4
Category_Wikipedia_sockpuppets_of_Stmichael1060.csv,265,88509501.0,87,178,87,0,0,49.45283018867924,254,28,19.056603773584907,12
Category_Wikipedia_sockpuppets_of_Truth_cola.csv,19,5050.0,11,8,6,5,0,43.1578947368421,134,27,27.0,27
Category_Wikipedia_sockpuppets_of_Ventom_Group.csv,331,70400023.0,99,232,21,78,0,42.570996978851966,255,53,16.854984894259818,8
Category_Wikipedia_sockpuppets_of_Baoci.csv,102,1157092.0,42,60,16,26,0,24.46078431372549,149,28,17.735294117647058,11
Category_Wikipedia_sockpuppets_of_Lorin_Schonfeld.csv,88,1319643.0,33,55,32,1,0,24.704545454545453,155,36,24.943181818181817,12
Category_Wikipedia_sockpuppets_of_Scout_MLG.csv,1569,11530363.0,547,1022,500,47,0,52.61822817080943,337,77,20.84193753983429,3
Category_Wikipedia_sockpuppets_of_Elster000.csv,924,156066290.0,346,578,158,188,0,49.0974025974026,252,55,22.857142857142858,4
Category_Wikipedia_sockpuppets_of_Spartanad.csv,200,55005293.0,91,109,88,3,0,50.88,220,27,18.425,14
Category_Wikipedia_sockpuppets_of_Sain123.csv,50,2418936.0,24,26,9,15,8,64.8,206,25,14.04,2
Category_Wikipedia_sockpuppets_of_Hookerfucker.csv,19,3853391.0,14,5,8,6,0,42.473684210526315,147,22,8.894736842105264,5
Category_Wikipedia_sockpuppets_of_Computer_Guy_2.csv,1455,37073746.0,560,895,500,60,0,48.28591065292096,255,58,32.09484536082474,4
Category_Wikipedia_sockpuppets_of_Sghjkg.csv,54,615704.0,22,32,12,10,0,49.22222222222222,205,22,16.685185185185187,10
Category_Wikipedia_sockpuppets_of_Âè≥Â≠î‰∏ò.csv,2842,124022988.0,768,2074,140,628,0,49.85221674876847,496,63,14.406755805770585,3
Category_Wikipedia_sockpuppets_of_ISuperRich.csv,20,9353744.0,20,0,6,14,0,16.95,196,29,16.1,12
Category_Wikipedia_sockpuppets_of_Jefferson_Airplane.csv,93,50708552.0,27,66,27,0,0,56.0,231,53,17.666666666666668,9
Category_Wikipedia_sockpuppets_of_Timothy143.csv,220,63497553.0,87,133,22,65,0,48.61818181818182,237,32,18.62727272727273,3
Category_Wikipedia_sockpuppets_of_MyNameIsASDF.csv,2437,27562348.0,744,1693,500,244,0,41.6766516208453,395,58,22.87566680344686,6
Category_Wikipedia_sockpuppets_of_AttackTheMoonNow.csv,514,157338385.0,179,335,29,150,0,51.476653696498055,499,54,27.85408560311284,8
Category_Wikipedia_sockpuppets_of_Sneha_Yogesh.csv,90,55634418.0,23,67,16,7,0,65.9,386,38,14.655555555555555,9
Category_Wikipedia_sockpuppets_of_Arunverma26.csv,102,277973403.0,32,70,15,17,0,53.98039215686274,240,53,18.980392156862745,4
Category_Wikipedia_sockpuppets_of_France2007.csv,98,1046377.0,62,36,40,22,0,32.142857142857146,113,50,43.775510204081634,15
Category_Wikipedia_sockpuppets_of_Bellacolleman.5.csv,145,5002456.0,39,106,16,23,0,39.0551724137931,245,41,28.248275862068965,13
Category_Wikipedia_sockpuppets_of_Foodyfanatic.csv,186,22631684.0,83,103,70,13,0,57.86021505376344,255,37,16.483870967741936,7
Category_Wikipedia_sockpuppets_of_Dan_mathew_ryan.csv,11,94118.0,5,6,4,1,0,57.0,154,31,13.909090909090908,9
Category_Wikipedia_sockpuppets_of_A_Glass_Bubble.csv,382,26645700.0,110,272,29,81,0,41.98429319371728,199,47,24.61780104712042,11
Category_Wikipedia_sockpuppets_of_Alofra.csv,13,47691.0,10,3,7,3,0,39.46153846153846,133,17,17.0,17
Category_Wikipedia_sockpuppets_of_Mustapha_khalid.csv,80,2589585.0,25,55,9,16,0,44.7,199,57,19.575,14
Category_Wikipedia_sockpuppets_of_Gongfeiguagua.csv,179,9859496.0,48,131,41,7,0,52.70391061452514,205,23,17.51396648044693,9
Category_Wikipedia_sockpuppets_of_Saurabh.bagchi.1.csv,30,2909099.0,14,16,11,3,0,74.9,196,26,19.8,13
Category_Wikipedia_sockpuppets_of_Anthony_E._Lahmann.csv,342,36526536.0,94,248,57,37,0,49.19005847953216,319,54,17.52046783625731,1
Category_Wikipedia_sockpuppets_of_Brightify.csv,8020,408659617.0,2102,5918,318,1784,0,39.640399002493766,395,99,19.866209476309226,1
Category_Wikipedia_sockpuppets_of_B√§bb√´r_≈†h√™r.csv,134,31412706.0,32,102,24,8,0,70.53731343283582,392,22,13.156716417910447,5
Category_Wikipedia_sockpuppets_of_DridsOBrien.csv,575,127477704.0,176,399,141,35,0,45.928695652173914,255,69,23.436521739130434,9
Category_Wikipedia_sockpuppets_of_YouTubeFan123.csv,2513,6492582.0,782,1731,500,282,0,37.8141663350577,260,62,15.191802626343016,2
Category_Wikipedia_sockpuppets_of_Ahmed_Mohi_El_din.csv,254,131861923.0,82,172,68,14,0,41.30708661417323,222,48,20.12204724409449,6
Category_Wikipedia_sockpuppets_of_Ken.kwek.csv,55,299412760.0,22,33,18,4,0,52.45454545454545,202,35,11.545454545454545,7
Category_Wikipedia_sockpuppets_of_Ibague_Monkey.csv,45,603663.0,20,25,6,14,0,38.91111111111111,157,25,16.355555555555554,6
Category_Wikipedia_sockpuppets_of_StephaneTolland.csv,244,131820462.0,71,173,17,54,0,55.34836065573771,254,51,18.82377049180328,5
Category_Wikipedia_sockpuppets_of_Georgesajan.csv,9,6802.0,6,3,3,3,0,29.0,123,40,40.0,40
Category_Wikipedia_sockpuppets_of_Goalandgoal.csv,308,26656395.0,115,193,37,78,0,38.49025974025974,387,53,19.944805194805195,4
Category_Wikipedia_sockpuppets_of_Prashantpking.csv,2534,106744180.0,698,1836,344,354,0,41.42028413575375,255,55,18.85082872928177,3
Category_Wikipedia_sockpuppets_of_Klaus_Ebner.csv,563,83172227.0,231,332,125,106,0,36.04262877442274,208,47,17.985790408525755,7
Category_Wikipedia_sockpuppets_of_ShappeAli.csv,900,174909105.0,552,348,500,52,0,35.623333333333335,495,31,15.193333333333333,4
Category_Wikipedia_sockpuppets_of_Aaron.iji2.csv,155,9959239.0,62,93,23,39,0,61.458064516129035,241,30,15.832258064516129,5
Category_Wikipedia_sockpuppets_of_VanishedUser99.csv,513,4991581.0,176,337,173,3,0,52.02923976608187,231,56,22.226120857699804,5
Category_Wikipedia_sockpuppets_of_Tecmobowl.csv,4098,15545538.0,1244,2854,500,744,0,41.125915080527086,219,79,19.309175207418253,7
Category_Wikipedia_sockpuppets_of_Just_H.csv,3027,20375549.0,1023,2004,500,523,0,26.978526593987446,250,97,19.9203832177073,4
Category_Wikipedia_sockpuppets_of_Nehalsharma472.csv,8,5694.0,5,3,5,0,0,30.875,91,48,12.625,5
Category_Wikipedia_sockpuppets_of_I_eat_potholes_for_lettuce_arms..csv,129,3951772.0,39,90,23,16,0,61.248062015503876,248,42,17.852713178294575,5
Category_Wikipedia_sockpuppets_of_Iadmitmybiaswhycantyou_.csv,3,869.0,2,1,2,0,15,110.0,176,34,32.0,28
Category_Wikipedia_sockpuppets_of_Willy_Batz_MD.csv,55,425435.0,26,29,19,7,0,62.50909090909091,276,26,19.8,17
Category_Wikipedia_sockpuppets_of_SteaminThomasTheTrain32.csv,209,34785143.0,82,127,63,19,0,51.97607655502392,286,57,29.9377990430622,11
Category_Wikipedia_sockpuppets_of_Renardfox.csv,56,342663124.0,12,44,7,5,0,38.30357142857143,185,24,16.375,9
Category_Wikipedia_sockpuppets_of_MDM551.csv,102,5537505.0,49,53,18,31,0,60.049019607843135,242,47,27.480392156862745,14
Category_Wikipedia_sockpuppets_of_Mcjakeqcool.csv,2353,46230183.0,803,1550,500,303,0,39.014874628134294,253,88,26.48873778155546,3
Category_Wikipedia_sockpuppets_of_Muhammad_zalid.csv,50,5701860.0,12,38,5,7,0,57.8,179,40,16.72,6
Category_Wikipedia_sockpuppets_of_BJSelavka.csv,1640,321039869.0,444,1196,24,420,0,44.171341463414635,377,59,19.43780487804878,3
Category_Wikipedia_sockpuppets_of_YugoBasket.csv,1207,46987926.0,503,704,500,3,0,31.388566694283348,500,96,28.44490472245236,7
Category_Wikipedia_sockpuppets_of_PictureTrivia.csv,59,198504.0,23,36,16,7,0,51.69491525423729,252,54,27.661016949152543,12
Category_Wikipedia_sockpuppets_of_Jackcrane25.csv,29,68765.0,18,11,14,4,0,37.86206896551724,196,36,24.96551724137931,17
Category_Wikipedia_sockpuppets_of_Benjaminvermersch.csv,236,114305425.0,89,147,57,32,0,37.855932203389834,248,63,24.135593220338983,12
Category_Wikipedia_sockpuppets_of_Subhajit_Parbat.csv,45,12449629.0,19,26,19,0,0,44.0,237,66,26.666666666666668,14
Category_Wikipedia_sockpuppets_of_Karl_xx.csv,87,8196720.0,36,51,19,17,0,64.17241379310344,496,80,22.75862068965517,12
Category_Wikipedia_sockpuppets_of_True_story_off.csv,111,4320086.0,52,59,38,14,0,37.9009009009009,334,24,14.603603603603604,7
Category_Wikipedia_sockpuppets_of_Writer_alamin_321.csv,27,7459213.0,9,18,6,3,0,45.74074074074074,127,26,18.22222222222222,12
Category_Wikipedia_sockpuppets_of_Zo√´2000.csv,1563,20032804.0,558,1005,500,58,0,43.88419705694178,388,69,22.28982725527831,9
Category_Wikipedia_sockpuppets_of_Rembot.csv,10,1686.0,5,5,5,0,0,108.1,184,22,14.8,10
Category_Wikipedia_sockpuppets_of_Janvez.csv,530,165433526.0,193,337,121,72,0,53.83396226415094,446,48,20.4811320754717,8
Category_Wikipedia_sockpuppets_of_Gjeykretm.csv,323,349560.0,108,215,58,50,0,57.09907120743034,494,45,14.56656346749226,3
Category_Wikipedia_sockpuppets_of_Koorja.csv,591,68540469.0,137,454,136,1,0,48.367174280879865,253,39,18.85279187817259,5
Category_Wikipedia_sockpuppets_of_JackNinte.csv,109,59341033.0,41,68,12,29,0,43.96330275229358,315,65,19.073394495412845,9
Category_Wikipedia_sockpuppets_of_Pagasangpilipinas.csv,2,11904.0,2,0,1,1,10,11.5,13,17,17.0,17
Category_Wikipedia_sockpuppets_of_Janj9088.csv,240,122842215.0,91,149,57,34,0,58.31666666666667,387,49,25.7375,11
Category_Wikipedia_sockpuppets_of_Wikiguywho.csv,34,1008338.0,17,17,13,4,0,109.94117647058823,250,16,8.647058823529411,5
Category_Wikipedia_sockpuppets_of_Paulsimonmightbegiants.csv,35,73816.0,15,20,9,6,0,49.8,237,43,23.085714285714285,5
Category_Wikipedia_sockpuppets_of_Chimmy87.csv,106,1484279.0,41,65,35,6,0,52.70754716981132,318,53,33.70754716981132,3
Category_Wikipedia_sockpuppets_of_Player2847582.csv,123,432145.0,47,76,47,0,0,36.048780487804876,155,64,30.4390243902439,18
Category_Wikipedia_sockpuppets_of_Blindedhall.csv,74,89695997.0,26,48,22,4,0,65.4054054054054,236,22,12.95945945945946,8
Category_Wikipedia_sockpuppets_of_Guinsberg.csv,1558,10053439.0,618,940,500,118,0,48.69512195121951,255,57,27.49165596919127,5
Category_Wikipedia_sockpuppets_of_Jgreene1333.csv,852,311986866.0,326,526,323,3,0,41.917840375586856,254,63,20.4037558685446,4
Category_Wikipedia_sockpuppets_of_Dimpsboyno3.csv,6780,69859453.0,1892,4888,500,1392,0,52.91017699115044,500,78,22.705899705014748,3
Category_Wikipedia_sockpuppets_of_Thehelpinghand.csv,1427,9418064.0,500,927,500,0,0,48.78906797477225,224,64,22.057463209530482,4
Category_Wikipedia_sockpuppets_of_Wenovio.csv,4,350256.0,4,0,4,0,88,99.5,116,23,16.5,12
Category_Wikipedia_sockpuppets_of_Holdengreen.csv,49,102128477.0,14,35,13,1,0,64.08163265306122,255,47,15.26530612244898,12
Category_Wikipedia_sockpuppets_of_Newalbin.csv,111,14336463.0,60,51,51,9,0,54.77477477477478,255,24,17.08108108108108,10
Category_Wikipedia_sockpuppets_of_Bradleylendrum.csv,8,88694.0,7,1,7,0,13,46.25,195,24,17.875,17
Category_Wikipedia_sockpuppets_of_Raviranaseo.csv,13,145042.0,4,9,4,0,15,47.15384615384615,78,22,20.076923076923077,19
Category_Wikipedia_sockpuppets_of_Strabeller.csv,49,6483227.0,21,28,14,7,0,42.183673469387756,203,14,12.857142857142858,11
Category_Wikipedia_sockpuppets_of_MysterioRey619.csv,3467,45172394.0,791,2676,500,291,0,42.973464089991346,500,57,17.003749639457745,3
Category_Wikipedia_sockpuppets_of_GarrettRock.csv,1193,55209082.0,385,808,304,81,0,39.59513830678961,209,114,23.60268231349539,3
Category_Wikipedia_sockpuppets_of_HermeticScholar.csv,323,757626.0,109,214,107,2,0,41.43034055727554,200,48,41.62229102167183,17
Category_Wikipedia_sockpuppets_of_Ocarinaofsmash.csv,91,5171396.0,28,63,9,19,0,59.10989010989011,241,55,20.65934065934066,5
Category_Wikipedia_sockpuppets_of_Suthasianhistorian8.csv,4156,14450495.0,1321,2835,500,821,0,55.40519730510106,500,56,17.963185755534166,3
Category_Wikipedia_sockpuppets_of_ShmuelGoldstein.csv,257,221352665.0,70,187,67,3,0,58.688715953307394,255,42,18.35408560311284,5
Category_Wikipedia_sockpuppets_of_Toreilly97.csv,156,4424811.0,53,103,38,15,0,32.77564102564103,228,30,13.294871794871796,5
Category_Wikipedia_sockpuppets_of_Sadaryohan.csv,882,11299918.0,405,477,327,78,0,49.77891156462585,255,54,18.97732426303855,6
Category_Wikipedia_sockpuppets_of_Musiclovereveryday.csv,812,33935752.0,307,505,94,213,0,40.01600985221675,268,72,22.235221674876847,5
Category_Wikipedia_sockpuppets_of_Pleasetalktome.csv,193,195322.0,67,126,67,0,0,31.854922279792746,250,47,22.93782383419689,8
Category_Wikipedia_sockpuppets_of_SandyMcNally.csv,1,0.0,1,0,1,0,21,21.0,21,25,25.0,25
Category_Wikipedia_sockpuppets_of_Msqared80.csv,223,231861911.0,64,159,58,6,0,75.77578475336323,411,51,26.27354260089686,4
Category_Wikipedia_sockpuppets_of_BhaktaDASS.csv,226,26470013.0,71,155,24,47,0,57.88053097345133,250,54,25.1858407079646,6
Category_Wikipedia_sockpuppets_of_N-C16.csv,115,875594.0,42,73,38,4,0,26.921739130434784,147,45,28.22608695652174,16
Category_Wikipedia_sockpuppets_of_Voda9.csv,80,215885.0,53,27,22,31,0,48.4875,233,44,21.825,6
Category_Wikipedia_sockpuppets_of_Lydia9087.csv,62,1221300.0,17,45,14,3,0,50.17741935483871,218,28,14.46774193548387,9
Category_Wikipedia_sockpuppets_of_Stormkrow.csv,25,146820947.0,7,18,6,1,0,43.0,104,26,22.96,19
Category_Wikipedia_sockpuppets_of_Pamba23.csv,19,30293419.0,6,13,5,1,0,54.94736842105263,196,16,10.368421052631579,3
Category_Wikipedia_sockpuppets_of_PHDoctorate.csv,31,185963.0,11,20,4,7,0,30.70967741935484,204,41,28.419354838709676,11
Category_Wikipedia_sockpuppets_of_Januaryfriend.csv,21,2609162.0,19,2,11,8,0,26.095238095238095,129,24,19.476190476190474,15
Category_Wikipedia_sockpuppets_of_Securxx.csv,70,221659819.0,26,44,16,10,0,47.957142857142856,229,20,17.557142857142857,17
Category_Wikipedia_sockpuppets_of_Tr·ªãnh_Ho√†ng_Huy.csv,381,57676445.0,241,140,153,88,0,26.501312335958005,230,33,24.540682414698164,16
Category_Wikipedia_sockpuppets_of_Ccamm.csv,100,90540705.0,20,80,8,12,0,45.8,199,48,20.06,8
Category_Wikipedia_sockpuppets_of_Tel_yari.csv,1502,32135706.0,478,1024,193,285,0,51.323568575233026,255,52,22.479360852197072,5
Category_Wikipedia_sockpuppets_of_Tauqonhcet.csv,105,202186.0,40,65,26,14,0,50.114285714285714,196,47,23.304761904761904,14
Category_Wikipedia_sockpuppets_of_Skylark2.csv,76,7152975.0,54,22,44,10,0,26.894736842105264,197,51,45.21052631578947,26
Category_Wikipedia_sockpuppets_of_Alilon123.csv,4,12734.0,3,1,2,1,0,43.25,121,22,22.0,22
Category_Wikipedia_sockpuppets_of_Factorhk.csv,138,3186896.0,64,74,26,38,0,56.572463768115945,255,58,20.384057971014492,10
Category_Wikipedia_sockpuppets_of_Marsbartastic.csv,12,4184.0,8,4,5,3,0,63.416666666666664,173,23,15.5,13
Category_Wikipedia_sockpuppets_of_Yalladar.csv,2154,16911302.0,965,1189,500,465,0,32.19823584029712,247,48,18.317548746518106,8
Category_Wikipedia_sockpuppets_of_Jyotinaik.csv,145,345436170.0,40,105,33,7,0,45.751724137931035,206,19,10.441379310344828,4
Category_Wikipedia_sockpuppets_of_Zimidar.csv,1615,17259069.0,517,1098,500,17,0,39.328173374613,496,59,17.323219814241487,5
Category_Wikipedia_sockpuppets_of_SkylarLVJY.csv,121,4465213.0,42,79,32,10,0,67.7603305785124,492,49,21.66115702479339,13
Category_Wikipedia_sockpuppets_of_Soapfan91.csv,2311,15823667.0,828,1483,500,328,0,31.240155776720034,215,51,23.036780614452617,5
Category_Wikipedia_sockpuppets_of_Savy_Sarey.csv,62,5329231.0,13,49,12,1,0,39.32258064516129,221,38,18.516129032258064,5
Category_Wikipedia_sockpuppets_of_Orina22.csv,188,13338466.0,54,134,39,15,0,42.744680851063826,213,35,15.98404255319149,4
Category_Wikipedia_sockpuppets_of_Aaron_Christopher_IMDB_ACTOR.csv,2,0.0,1,1,1,0,14,14.0,14,38,38.0,38
Category_Wikipedia_sockpuppets_of_Williamsdoritios.csv,1448,15893552.0,562,886,500,62,0,43.046270718232044,379,45,16.635359116022098,7
Category_Wikipedia_sockpuppets_of_WikipedianEditors.csv,16,261651.0,7,9,7,0,0,90.0,255,18,13.375,12
Category_Wikipedia_sockpuppets_of_ChuckNoll_vs_Vince_Lombardi.csv,1623,272919934.0,620,1003,500,120,0,45.86629698089957,320,72,33.84596426370918,9
Category_Wikipedia_sockpuppets_of_S993.csv,144,385047.0,67,77,57,10,0,43.701388888888886,207,60,18.45138888888889,8
Category_Wikipedia_sockpuppets_of_TNSD.csv,1672,120149833.0,639,1033,500,139,0,35.442583732057415,255,64,25.188995215311003,3
Category_Wikipedia_sockpuppets_of_Jhoven_Sulla.csv,2732,34629268.0,904,1828,500,404,0,32.57064421669107,299,63,17.383967789165446,4
Category_Wikipedia_sockpuppets_of_Farmertedmustgo.csv,62,222507.0,20,42,14,6,0,58.354838709677416,199,32,19.451612903225808,9
Category_Wikipedia_sockpuppets_of_Pvn2266.csv,14,1563779.0,5,9,5,0,0,50.714285714285715,192,25,18.714285714285715,17
Category_Wikipedia_sockpuppets_of_Ajwysocki.csv,135,11043711.0,61,74,60,1,0,33.22222222222222,222,38,19.94074074074074,10
Category_Wikipedia_sockpuppets_of_Hscfbdcyu.csv,23,1491.0,14,9,9,5,0,44.130434782608695,130,22,16.0,9
Category_Wikipedia_sockpuppets_of_DineshRedbull.csv,82,791251.0,68,14,63,5,0,33.78048780487805,492,30,19.402439024390244,14
Category_Wikipedia_sockpuppets_of_Zeshankhan2400.csv,210,23137588.0,68,142,27,41,0,47.838095238095235,499,51,20.86190476190476,7
Category_Wikipedia_sockpuppets_of_MalesAlwaysBest.csv,2066,15316472.0,751,1315,381,370,0,49.46515004840271,255,80,25.196515004840272,5
Category_Wikipedia_sockpuppets_of_Afleet222.csv,15,2017861.0,8,7,5,3,0,51.333333333333336,249,27,23.266666666666666,19
Category_Wikipedia_sockpuppets_of_Joseanthreeni0.csv,851,31292486.0,266,585,142,124,0,58.94477085781433,467,47,15.27027027027027,5
Category_Wikipedia_sockpuppets_of_EWAdams.csv,726,489464449.0,154,572,115,39,0,54.1198347107438,432,47,20.104683195592287,3
Category_Wikipedia_sockpuppets_of_Ajax_Coleman.csv,1545,1651832.0,523,1022,500,23,0,53.48284789644013,430,72,36.83495145631068,9
Category_Wikipedia_sockpuppets_of_Gardezz.csv,5557,464252607.0,1873,3684,321,1552,0,38.173114990102576,465,90,20.407234119129026,3
Category_Wikipedia_sockpuppets_of_Ehsan_iq.csv,1249,190862493.0,429,820,108,321,0,54.715772618094476,500,60,18.653322658126502,4
Category_Wikipedia_sockpuppets_of_Elan26.csv,1439,4822592.0,615,824,500,115,0,36.52744961779013,230,57,22.851285615010426,8
Category_Wikipedia_sockpuppets_of_Lanni91.csv,33,10629484.0,11,22,11,0,0,44.81818181818182,224,29,17.21212121212121,6
Category_Wikipedia_sockpuppets_of_Spartiatisspartiatis.csv,198,41741002.0,55,143,45,10,0,66.31818181818181,255,28,10.378787878787879,4
Category_Wikipedia_sockpuppets_of_Liamb2011.csv,1193,50331636.0,372,821,109,263,0,46.761106454316845,500,54,17.3151718357083,5
Category_Wikipedia_sockpuppets_of_Amanda_Smalls.csv,4829,65700904.0,1768,3061,500,1268,0,48.82977842203355,253,59,23.16628701594533,5
Category_Wikipedia_sockpuppets_of_Troy86.csv,1676,57593144.0,521,1155,181,340,0,35.52505966587112,257,53,17.933770883054894,4
Category_Wikipedia_sockpuppets_of_Carsten11.csv,3074,85304345.0,1181,1893,500,681,0,33.06018217306441,275,54,28.485361093038385,6
Category_Wikipedia_sockpuppets_of_Valkyrie_Red.csv,1988,416173511.0,542,1446,500,42,0,52.475352112676056,498,78,19.8023138832998,2
Category_Wikipedia_sockpuppets_of_ElLuzDelSur.csv,1826,5720277.0,776,1050,500,276,0,46.190580503833516,500,81,20.830777656078862,5
Category_Wikipedia_sockpuppets_of_EddieDrood.csv,3133,126770638.0,1000,2133,500,500,0,48.599744653686564,255,53,14.350462815193106,4
Category_Wikipedia_sockpuppets_of_Aniket_k._Rastogi.csv,26,6388.0,10,16,6,4,0,62.73076923076923,290,19,10.5,5
Category_Wikipedia_sockpuppets_of_Astrometre.csv,63,3021381.0,28,35,10,18,2,37.38095238095238,133,75,34.36507936507937,18
Category_Wikipedia_sockpuppets_of_CubeSat4U.csv,5896,191963890.0,1369,4527,500,869,0,60.829884667571235,255,65,16.527815468113975,1
Category_Wikipedia_sockpuppets_of_LordOzark.csv,16,220382.0,16,0,9,7,0,29.9375,105,23,16.9375,14
Category_Wikipedia_sockpuppets_of_Magicnerd24.csv,16,161439.0,5,11,4,1,0,22.1875,78,31,22.375,11
Category_Wikipedia_sockpuppets_of_PakistaniDramaFan.csv,178,8708308.0,77,101,70,7,0,29.5561797752809,247,28,17.314606741573034,6
Category_Wikipedia_sockpuppets_of_DavidStats.csv,995,81929725.0,259,736,50,209,0,43.992964824120605,255,75,32.93266331658292,9
Category_Wikipedia_sockpuppets_of_WordSeventeen.csv,3991,57530418.0,1448,2543,500,948,0,51.94938611876723,255,82,20.726885492357805,5
Category_Wikipedia_sockpuppets_of_Piermark.csv,3863,98871932.0,1122,2741,44,1078,0,78.04763137457934,526,95,20.578307015273104,1
Category_Wikipedia_sockpuppets_of_George_Pintell.csv,2,0.0,1,1,1,0,0,0.0,0,16,16.0,16
Category_Wikipedia_sockpuppets_of_Araxes_TheThief.csv,3253,70757091.0,1284,1969,500,784,0,43.18874884721795,497,50,13.317860436520135,3
Category_Wikipedia_sockpuppets_of_Twosided55.csv,307,2413301.0,94,213,34,60,0,61.44951140065147,252,52,14.166123778501628,4
Category_Wikipedia_sockpuppets_of_Screenmutt.csv,266,387809181.0,76,190,70,6,0,59.785714285714285,241,55,24.80827067669173,8
Category_Wikipedia_sockpuppets_of_RichaKol.csv,127,26286911.0,76,51,40,36,0,30.69291338582677,232,33,17.661417322834644,7
Category_Wikipedia_sockpuppets_of_Luvyduvy56.csv,86,234467548.0,33,53,32,1,0,38.651162790697676,255,41,24.906976744186046,13
Category_Wikipedia_sockpuppets_of_Ê≤≥ÊµÅÂêëÂ§ßÊµ∑.csv,64,8147173.0,18,46,13,5,0,58.796875,248,68,27.828125,11
Category_Wikipedia_sockpuppets_of_Burbak.csv,2950,81832667.0,1000,1950,500,500,0,48.76677966101695,254,57,16.487796610169493,4
Category_Wikipedia_sockpuppets_of_Kurtiswilliams.csv,419,12194141.0,87,332,80,7,0,49.14558472553699,243,61,25.782816229116946,7
Category_Wikipedia_sockpuppets_of_Julia1287.csv,414,37411785.0,145,269,109,36,0,30.758454106280194,260,40,18.265700483091788,7
Category_Wikipedia_sockpuppets_of_WiliWiji.csv,30,2987959.0,12,18,8,4,0,38.666666666666664,192,19,11.166666666666666,4
Category_Wikipedia_sockpuppets_of_NestleNW911.csv,1544,74886015.0,531,1013,382,149,0,49.33160621761658,255,59,17.821891191709845,4
Category_Wikipedia_sockpuppets_of_Editor2626744.csv,768,17410145.0,310,458,145,165,0,48.651041666666664,250,59,18.688802083333332,4
Category_Wikipedia_sockpuppets_of_NanoKid.csv,43,155609804.0,17,26,17,0,0,54.2093023255814,296,17,15.093023255813954,12
Category_Wikipedia_sockpuppets_of_ÁôΩÈ™®ÈùíÁÅ∞.csv,98,162904.0,57,41,57,0,0,54.795918367346935,267,47,22.6734693877551,9
Category_Wikipedia_sockpuppets_of_Yash_flibtech.csv,2,0.0,1,1,1,0,28,28.0,28,23,23.0,23
Category_Wikipedia_sockpuppets_of_Anaflaggot.csv,12,3016280.0,6,6,3,3,0,37.666666666666664,123,22,19.666666666666668,16
Category_Wikipedia_sockpuppets_of_VinegarTom2017.csv,13,1562.0,8,5,5,3,0,46.92307692307692,161,13,13.0,13
Category_Wikipedia_sockpuppets_of_admirenepal.csv,175,57640062.0,35,140,19,16,0,41.47428571428571,195,57,14.48,4
Category_Wikipedia_sockpuppets_of_PrideOfKorea.csv,69,30856609.0,18,51,8,10,0,49.2463768115942,178,20,17.391304347826086,15
Category_Wikipedia_sockpuppets_of_Fatmanonthehorse.csv,1684,81211740.0,490,1194,297,193,0,45.462589073634206,255,50,19.017814726840854,4
Category_Wikipedia_sockpuppets_of_Gak_jelas.csv,144,87236.0,49,95,24,25,0,40.298611111111114,253,33,16.23611111111111,7
Category_Wikipedia_sockpuppets_of_Eastern_but_not_so_Middle.csv,738,5236948.0,218,520,202,16,0,55.1449864498645,495,41,15.044715447154472,1
Category_Wikipedia_sockpuppets_of_JMB1980.csv,1319,139958724.0,420,899,212,208,0,53.23047763457164,496,71,26.05155420773313,5
Category_Wikipedia_sockpuppets_of_Nicgf.csv,1253,40132526.0,392,861,181,211,0,51.549082202713485,255,57,16.43016759776536,4
Category_Wikipedia_sockpuppets_of_Ritvik12.csv,1145,25501711.0,306,839,125,181,0,42.5292576419214,243,47,20.987772925764194,4
Category_Wikipedia_sockpuppets_of_Dozerindia.csv,44,9838648.0,17,27,15,2,0,56.11363636363637,255,22,13.340909090909092,5
Category_Wikipedia_sockpuppets_of_Celticbhoy_kev.csv,64,69629465.0,15,49,15,0,0,36.796875,182,25,16.84375,3
Category_Wikipedia_sockpuppets_of_Masterofsuspense.csv,289,6830130.0,97,192,23,74,0,45.996539792387544,234,57,17.612456747404845,4
Category_Wikipedia_sockpuppets_of_Southreally54321.csv,29,434552.0,15,14,8,7,0,64.75862068965517,234,15,10.310344827586206,5
Category_Wikipedia_sockpuppets_of_NtokozoJiyana.csv,31,6448025.0,10,21,10,0,0,44.064516129032256,144,33,22.129032258064516,5
Category_Wikipedia_sockpuppets_of_Che829.csv,4250,302277568.0,1500,2750,500,1000,0,55.76635294117647,255,97,27.31270588235294,2
Category_Wikipedia_sockpuppets_of_Westrextravels.csv,34,7498905.0,9,25,7,2,0,28.941176470588236,140,57,20.176470588235293,13
Category_Wikipedia_sockpuppets_of_Alpha200807.csv,1993,5437203.0,657,1336,500,157,0,44.042147516307075,359,55,13.138484696437532,1
Category_Wikipedia_sockpuppets_of_Dominic_Santiago.csv,500,12208421.0,178,322,135,43,0,40.218,199,54,20.638,5
Category_Wikipedia_sockpuppets_of_KK_(Komail_Shayan).csv,39,16451494.0,8,31,7,1,0,29.025641025641026,189,26,13.461538461538462,5
Category_Wikipedia_sockpuppets_of_Katydidit.csv,2426,14377087.0,941,1485,500,441,0,42.10840890354493,255,65,22.943528441879636,1
Category_Wikipedia_sockpuppets_of_Vo147daKat.csv,43,1557055.0,28,15,24,4,0,65.88372093023256,223,20,12.651162790697674,10
Category_Wikipedia_sockpuppets_of_Islooguy.csv,125,76345571.0,55,70,35,20,0,47.416,212,23,18.936,7
Category_Wikipedia_sockpuppets_of_JasonA34.csv,106,20124391.0,36,70,24,12,0,57.971698113207545,384,46,21.49056603773585,4
Category_Wikipedia_sockpuppets_of_Stonic.csv,335,466535.0,99,236,99,0,0,39.25671641791045,145,34,17.608955223880596,7
Category_Wikipedia_sockpuppets_of_Malayalam_movies_1234.csv,905,861240.0,520,385,81,439,0,25.802209944751382,235,38,22.05745856353591,5
Category_Wikipedia_sockpuppets_of_Calmsurble.csv,107,37916861.0,58,49,33,25,0,45.86915887850467,318,54,32.02803738317757,11
Category_Wikipedia_sockpuppets_of_Sbobet.csv,5,1305079.0,4,1,2,2,0,87.8,158,26,19.6,13
Category_Wikipedia_sockpuppets_of_Corporate_Raider.csv,1459,59960446.0,408,1051,61,347,0,45.54146675805346,255,59,17.945167923235093,8
Category_Wikipedia_sockpuppets_of_Risk_Skar.csv,22,1912306.0,9,13,3,6,0,54.22727272727273,188,20,17.227272727272727,14
Category_Wikipedia_sockpuppets_of_Karanbhambra.csv,4,519.0,3,1,3,0,65,109.0,127,22,20.75,17
Category_Wikipedia_sockpuppets_of_Luxoculi.csv,21,68294.0,15,6,9,6,6,22.80952380952381,57,42,38.19047619047619,26
Category_Wikipedia_sockpuppets_of_Xewemo861.csv,12,193527.0,8,4,5,3,0,78.0,195,20,15.833333333333334,15
Category_Wikipedia_sockpuppets_of_Mattsabe.csv,793,100401288.0,186,607,94,92,0,57.91803278688525,255,50,18.564943253467845,4
Category_Wikipedia_sockpuppets_of_Musethica_e.V..csv,10,7334.0,6,4,5,1,0,25.3,140,24,12.0,9
Category_Wikipedia_sockpuppets_of_Supremewisdom.csv,326,8520974.0,100,226,81,19,0,47.236196319018404,255,46,12.202453987730062,4
Category_Wikipedia_sockpuppets_of_TheodorL2000.csv,39,2249039.0,21,18,14,7,0,29.102564102564102,145,53,26.692307692307693,15
Category_Wikipedia_sockpuppets_of_Elmalawx.csv,109,190446285.0,30,79,20,10,0,47.981651376146786,276,18,9.605504587155963,4
Category_Wikipedia_sockpuppets_of_Tbacon143.csv,165,3316038.0,65,100,59,6,0,45.551515151515154,254,50,19.703030303030303,13
Category_Wikipedia_sockpuppets_of_Chipdorrito.csv,8,42650.0,6,2,4,2,0,47.75,155,21,21.0,21
Category_Wikipedia_sockpuppets_of_Mayankvivek.csv,262,7097096.0,93,169,60,33,0,42.599236641221374,470,33,16.057251908396946,6
Category_Wikipedia_sockpuppets_of_Kiranmayi_pal.csv,1707,85706481.0,716,991,500,216,0,42.383128295254835,463,29,15.357937902753369,5
Category_Wikipedia_sockpuppets_of_Milan_sarmah.csv,559,55548141.0,235,324,83,152,0,41.38282647584973,306,53,19.178890876565294,3
Category_Wikipedia_sockpuppets_of_TEAMSAMADI.csv,37,689517.0,24,13,16,8,0,32.13513513513514,165,29,17.864864864864863,10
Category_Wikipedia_sockpuppets_of_Tacoelf7.csv,44,16851453.0,10,34,7,3,0,51.77272727272727,181,38,19.431818181818183,10
Category_Wikipedia_sockpuppets_of_118_alex.csv,4175,5743279.0,1330,2845,500,830,0,33.977005988023954,255,92,22.50107784431138,3
Category_Wikipedia_sockpuppets_of_Jatin_Patnaik.csv,15,514630.0,9,6,7,2,0,36.8,125,24,18.0,15
Category_Wikipedia_sockpuppets_of_Avalanche2020.csv,50,738429.0,17,33,15,2,0,56.3,361,51,28.04,11
Category_Wikipedia_sockpuppets_of_Organometalic1.csv,260,174757450.0,63,197,20,43,0,46.96153846153846,245,58,12.007692307692308,8
Category_Wikipedia_sockpuppets_of_Levijustus.csv,243,379500348.0,70,173,57,13,0,42.77777777777778,255,70,27.28395061728395,6
Category_Wikipedia_sockpuppets_of_Iamsushanth.csv,18,3992323.0,16,2,14,2,0,32.77777777777778,195,25,24.166666666666668,20
Category_Wikipedia_sockpuppets_of_Darth-Wiki-Man.csv,4908,41815905.0,1582,3326,500,1082,0,49.75081499592502,496,100,24.58088834555827,3
Category_Wikipedia_sockpuppets_of_Rochound57.csv,860,10824977.0,305,555,172,133,0,43.604651162790695,255,50,19.17906976744186,4
Category_Wikipedia_sockpuppets_of_Elvey.csv,2629,206491643.0,685,1944,500,185,0,59.28680106504374,255,66,20.13655382274629,3
Category_Wikipedia_sockpuppets_of_Neurosurgeon2be123.csv,84,3996971.0,28,56,18,10,0,75.64285714285714,219,41,17.13095238095238,5
Category_Wikipedia_sockpuppets_of_Auwall.csv,42,710026.0,16,26,11,5,0,36.857142857142854,151,24,15.30952380952381,13
Category_Wikipedia_sockpuppets_of_Aryan121.csv,150,20547541.0,59,91,44,15,0,73.99333333333334,254,62,24.06,10
Category_Wikipedia_sockpuppets_of_Jo2uke.csv,1572,229925588.0,516,1056,447,69,0,46.11704834605598,500,69,26.552162849872772,3
Category_Wikipedia_sockpuppets_of_JerryBusser.csv,503,172030.0,165,338,60,105,0,30.687872763419485,200,55,18.117296222664017,9
Category_Wikipedia_sockpuppets_of_Eeeeeewtw.csv,4369,272085011.0,1033,3336,302,731,0,43.33325703822385,255,56,20.121309224078736,3
Category_Wikipedia_sockpuppets_of_AtlanticDeep.csv,15625,204864720.0,5681,9944,500,5181,0,39.341568,272,84,19.324736,1
Category_Wikipedia_sockpuppets_of_Russel641.csv,1894,12115690.0,651,1243,500,151,0,49.98363252375924,500,62,21.88806758183738,4
Category_Wikipedia_sockpuppets_of_MrDrBaskets.csv,2040,20995639.0,508,1532,478,30,0,39.57990196078431,255,57,21.62843137254902,4
Category_Wikipedia_sockpuppets_of_Smurfmeister.csv,2253,262030615.0,513,1740,500,13,0,55.30670217487794,321,57,23.696404793608522,5
Category_Wikipedia_sockpuppets_of_OBED_THE_BULLSHITTER.csv,16,3112687.0,10,6,4,6,0,82.5,202,16,10.0,4
Category_Wikipedia_sockpuppets_of_Rosenthal88.csv,241,3533189.0,73,168,28,45,0,50.95020746887967,200,41,17.323651452282157,10
Category_Wikipedia_sockpuppets_of_Techpriya.csv,17,1111375.0,5,12,4,1,0,31.529411764705884,75,18,15.058823529411764,13
Category_Wikipedia_sockpuppets_of_Marytrott.csv,45,3483255.0,9,36,9,0,0,49.266666666666666,192,19,14.377777777777778,5
Category_Wikipedia_sockpuppets_of_Candyapple690.csv,636,173510484.0,201,435,108,93,0,50.58490566037736,499,45,19.261006289308177,5
Category_Wikipedia_sockpuppets_of_Socket_Preservation.csv,7,2020.0,4,3,4,0,25,83.71428571428571,199,24,24.0,24
Category_Wikipedia_sockpuppets_of_Calvinung2000.csv,40,13220548.0,13,27,12,1,0,54.85,199,37,19.925,6
Category_Wikipedia_sockpuppets_of_Nguy·ªÖn_Tr·∫ßn_Minh_Long.csv,28,674632.0,12,16,6,6,0,22.285714285714285,134,52,17.25,5
Category_Wikipedia_sockpuppets_of_GopiSandy2025.csv,19,840070.0,16,3,15,1,0,42.578947368421055,162,11,11.0,11
Category_Wikipedia_sockpuppets_of_Kingbrandus123.csv,69,23992416.0,27,42,26,1,0,45.17391304347826,233,49,35.26086956521739,4
Category_Wikipedia_sockpuppets_of_Aszblue.csv,19,231837.0,13,6,10,3,0,48.473684210526315,236,13,13.0,13
Category_Wikipedia_sockpuppets_of_Panda619.csv,2210,167698901.0,881,1329,500,381,0,50.12217194570136,496,67,26.1131221719457,6
Category_Wikipedia_sockpuppets_of_Cvpatel95.csv,60,4313506.0,26,34,16,10,0,35.3,178,35,19.916666666666668,4
Category_Wikipedia_sockpuppets_of_Spjimr.csv,18,23319023.0,9,9,7,2,0,26.5,152,47,47.0,47
Category_Wikipedia_sockpuppets_of_Mwangi2017.csv,189,47138594.0,72,117,40,32,0,40.857142857142854,226,28,15.534391534391535,6
Category_Wikipedia_sockpuppets_of_ThomasMasonDanny.csv,198,3397246.0,64,134,38,26,0,42.156565656565654,255,52,19.853535353535353,9
Category_Wikipedia_sockpuppets_of_Hernonwith7767.csv,7,260716.0,5,2,2,3,0,13.857142857142858,65,42,39.42857142857143,24
Category_Wikipedia_sockpuppets_of_Aboobackeramani.csv,3177,182695420.0,1112,2065,500,612,0,50.65942713251495,255,83,24.937677053824363,3
Category_Wikipedia_sockpuppets_of_Lucy-marie.csv,4042,196411814.0,1424,2618,500,924,0,48.34586838198911,250,67,26.55071746660069,6
Category_Wikipedia_sockpuppets_of_JOE128990303.csv,10,852021.0,5,5,2,3,0,99.3,324,34,18.8,15
Category_Wikipedia_sockpuppets_of_EuroTube.csv,46,513088.0,21,25,11,10,0,29.391304347826086,157,36,19.543478260869566,8
Category_Wikipedia_sockpuppets_of_AbeARules.csv,143,25376710.0,37,106,19,18,0,49.77622377622377,196,28,13.23076923076923,5
Category_Wikipedia_sockpuppets_of_Ppwrong.csv,1299,13353977.0,451,848,436,15,0,28.136258660508084,235,36,14.888375673595073,6
Category_Wikipedia_sockpuppets_of_Artaxerex.csv,1825,414847439.0,724,1101,500,224,0,49.412602739726026,264,145,21.333698630136986,7
Category_Wikipedia_sockpuppets_of_Bazaan.csv,9554,166037321.0,3560,5994,500,3060,0,44.7506803433117,444,78,18.602156164957087,4
Category_Wikipedia_sockpuppets_of_Prince_Of_Roblox.csv,29353,178303666.0,7935,21418,500,7435,0,48.99025653255204,500,74,14.574660171021701,3
Category_Wikipedia_sockpuppets_of_Minhascaa.csv,421,87822484.0,165,256,117,48,0,41.07600950118765,255,51,19.926365795724465,7
Category_Wikipedia_sockpuppets_of_Homme.csv,1980,299090145.0,446,1534,401,45,0,46.56969696969697,449,65,19.6989898989899,4
Category_Wikipedia_sockpuppets_of_Robjwev.csv,1308,98008644.0,388,920,387,1,0,74.4480122324159,500,55,24.17584097859327,5
Category_Wikipedia_sockpuppets_of_Haywon123.csv,178,99597033.0,51,127,46,5,0,57.651685393258425,385,61,20.93258426966292,5
Category_Wikipedia_sockpuppets_of_Conradlasbry.csv,110,16858843.0,22,88,19,3,0,50.58181818181818,230,34,12.927272727272728,3
Category_Wikipedia_sockpuppets_of_El_Machete_Guerrero.csv,2114,15418955.0,860,1254,352,508,0,40.978240302743615,255,50,22.508041627246925,5
Category_Wikipedia_sockpuppets_of_Datu_Hulyo.csv,2841,23917667.0,758,2083,500,258,0,50.30306230200634,494,73,21.09468497008096,4
Category_Wikipedia_sockpuppets_of_Kj650.csv,1317,29578797.0,326,991,122,204,0,41.73955960516325,250,58,29.473044798785118,4
Category_Wikipedia_sockpuppets_of_Sreekumarps0.csv,87,133047838.0,23,64,22,1,0,46.0919540229885,277,22,15.413793103448276,7
Category_Wikipedia_sockpuppets_of_Bauser68.csv,13,8901908.0,6,7,3,3,0,30.076923076923077,135,14,13.923076923076923,13
Category_Wikipedia_sockpuppets_of_Undersucker.csv,787,14321918.0,261,526,134,127,0,34.560355781448536,212,54,14.940279542566708,3
Category_Wikipedia_sockpuppets_of_Aroojakhan.csv,76,6114347.0,27,49,25,2,0,51.53947368421053,217,46,20.86842105263158,10
Category_Wikipedia_sockpuppets_of_Pakistaniengineer123.csv,186,88742284.0,69,117,31,38,0,49.89247311827957,239,47,24.516129032258064,15
Category_Wikipedia_sockpuppets_of_Carlospe67.csv,542,21794956.0,176,366,159,17,0,55.52767527675277,250,79,20.142066420664207,4
Category_Wikipedia_sockpuppets_of_TVSGuy.csv,1638,17945790.0,535,1103,500,35,0,50.505494505494504,496,55,26.116605616605618,2
Category_Wikipedia_sockpuppets_of_Kenatics.csv,20,66014.0,7,13,7,0,0,37.85,152,24,18.65,14
Category_Wikipedia_sockpuppets_of_American_Orthodox_Censor.csv,102,2825535.0,31,71,7,24,0,47.76470588235294,199,33,17.19607843137255,8
Category_Wikipedia_sockpuppets_of_CanadanHockley.csv,203,201928.0,65,138,24,41,0,48.433497536945815,229,54,19.74384236453202,5
Category_Wikipedia_sockpuppets_of_Magichan.csv,11,804.0,5,6,5,0,0,39.72727272727273,95,56,31.09090909090909,12
Category_Wikipedia_sockpuppets_of_Yas121.csv,1786,34409509.0,582,1204,500,82,0,45.577827547592385,224,50,18.637737961926092,3
Category_Wikipedia_sockpuppets_of_Futoshi_Takeyuki.csv,1314,115496010.0,381,933,319,62,0,39.545662100456624,381,65,18.961948249619482,4
Category_Wikipedia_sockpuppets_of_Surronie.csv,178,52561732.0,55,123,44,11,0,73.48314606741573,358,23,12.337078651685394,8
Category_Wikipedia_sockpuppets_of_Bro_Dude51.csv,346,5312045.0,101,245,89,12,0,48.10693641618497,277,41,17.734104046242773,8
Category_Wikipedia_sockpuppets_of_Davina.R.csv,63,11319307.0,25,38,13,12,0,46.26984126984127,174,64,32.285714285714285,16
Category_Wikipedia_sockpuppets_of_MBNO.csv,134,1232056.0,92,42,91,1,0,70.80597014925372,495,41,27.44776119402985,13
Category_Wikipedia_sockpuppets_of_Tintor3.csv,449,2735665.0,141,308,31,110,0,59.84187082405345,250,47,18.305122494432073,3
Category_Wikipedia_sockpuppets_of_Hereherer.csv,295,6037519.0,153,142,138,15,0,63.101694915254235,200,64,26.99322033898305,14
Category_Wikipedia_sockpuppets_of_Giriprasad_Damodar_02.csv,2154,45197405.0,675,1479,259,416,0,27.35933147632312,378,50,19.690807799442897,4
Category_Wikipedia_sockpuppets_of_BothRiver2000.csv,91,6056370.0,26,65,20,6,0,71.7032967032967,255,50,16.076923076923077,6
Category_Wikipedia_sockpuppets_of_FE_Freak.csv,226,22040131.0,60,166,25,35,0,57.676991150442475,244,55,18.756637168141594,3
Category_Wikipedia_sockpuppets_of_Jaleeljaleejaleel.csv,24,2119.0,8,16,7,1,0,68.29166666666667,208,25,13.125,10
Category_Wikipedia_sockpuppets_of_Jemz21.csv,1,0.0,1,0,1,0,10,10.0,10,49,49.0,49
Category_Wikipedia_sockpuppets_of_Musicfandom.csv,261,35553382.0,114,147,74,40,0,29.831417624521073,240,27,18.613026819923373,11
Category_Wikipedia_sockpuppets_of_TVFAN24.csv,2365,86750211.0,718,1647,500,218,0,33.25327695560254,251,70,24.45200845665962,3
Category_Wikipedia_sockpuppets_of_Aaron_j_christopher_101.csv,206,12964321.0,63,143,16,47,0,50.83980582524272,248,41,21.116504854368934,5
Category_Wikipedia_sockpuppets_of_Woohoo5241.csv,2767,550841184.0,599,2168,358,241,0,48.62631008312252,416,60,18.667871340802314,3
Category_Wikipedia_sockpuppets_of_Ritto77777.csv,3,479.0,2,1,2,0,38,160.66666666666666,404,39,37.333333333333336,34
Category_Wikipedia_sockpuppets_of_Indoor_Heater.csv,19,6041631.0,6,13,4,2,0,52.10526315789474,199,28,21.36842105263158,15
Category_Wikipedia_sockpuppets_of_FR30799386.csv,2292,8977683.0,765,1527,500,265,0,51.74520069808028,283,71,20.2521815008726,4
Category_Wikipedia_sockpuppets_of_Brick6900.csv,106,31185682.0,29,77,20,9,0,60.15094339622642,224,38,17.4811320754717,11
Category_Wikipedia_sockpuppets_of_Editingguy12345.csv,13,23015636.0,9,4,8,1,0,33.69230769230769,133,28,16.384615384615383,15
Category_Wikipedia_sockpuppets_of_Davidmarshall682.csv,15,272451.0,6,9,3,3,0,34.2,109,52,24.333333333333332,11
Category_Wikipedia_sockpuppets_of_Contributor10000000.csv,194,802811.0,81,113,67,14,0,40.170103092783506,236,58,35.99484536082474,11
Category_Wikipedia_sockpuppets_of_Harmony944.csv,2919,8375089.0,1000,1919,500,500,0,51.150393970537856,495,75,23.256252141144227,5
Category_Wikipedia_sockpuppets_of_Butterflycrowdwiki.csv,79,453880.0,69,10,64,5,0,18.164556962025316,255,28,14.329113924050633,13
Category_Wikipedia_sockpuppets_of_RuslanTheEditor.csv,262,14267924.0,110,152,98,12,0,46.07251908396947,378,65,20.061068702290076,7
Category_Wikipedia_sockpuppets_of_Jai_Ram_Tripura.csv,68,21964780.0,49,19,47,2,0,38.0735294117647,184,15,10.294117647058824,10
Category_Wikipedia_sockpuppets_of_DiamondTester.csv,11,4085.0,3,8,3,0,0,55.72727272727273,158,14,10.0,6
Category_Wikipedia_sockpuppets_of_HrakeDing.csv,127,1276627.0,44,83,12,32,0,53.21259842519685,239,31,15.377952755905511,10
Category_Wikipedia_sockpuppets_of_Sidowpknbkhihj.csv,2582,102358725.0,863,1719,416,447,0,49.67350890782339,400,50,21.529821843532147,3
Category_Wikipedia_sockpuppets_of_Be_Black_Hole_Sun.csv,3734,15736270.0,1330,2404,500,830,0,33.14033208355651,224,97,22.846813069094804,3
Category_Wikipedia_sockpuppets_of_Chadwickschool.csv,736,101255905.0,261,475,232,29,0,44.16711956521739,241,31,15.508152173913043,3
Category_Wikipedia_sockpuppets_of_Dakshband.csv,86,114562390.0,22,64,19,3,0,51.93023255813954,236,26,15.325581395348838,10
Category_Wikipedia_sockpuppets_of_Jaycen_A'mour.csv,8,259643.0,6,2,4,2,0,34.5,138,12,11.5,11
Category_Wikipedia_sockpuppets_of_Redpionia.csv,344,9245101.0,120,224,43,77,0,42.43023255813954,396,52,23.569767441860463,9
Category_Wikipedia_sockpuppets_of_Jonathanmbaez.csv,36,1971852.0,12,24,7,5,0,33.0,192,23,21.47222222222222,18
Category_Wikipedia_sockpuppets_of_AdamEmbry.csv,17,1384519.0,10,7,7,3,0,66.23529411764706,191,11,11.0,11
Category_Wikipedia_sockpuppets_of_Kylekieran.csv,1356,324780767.0,503,853,500,3,0,51.674778761061944,494,74,27.724188790560472,4
Category_Wikipedia_sockpuppets_of_Joetrohman.csv,3,1153.0,2,1,1,1,20,30.333333333333332,43,11,11.0,11
Category_Wikipedia_sockpuppets_of_Nowhereian.csv,477,363690098.0,178,299,158,20,0,66.0,821,49,17.51781970649895,8
Category_Wikipedia_sockpuppets_of_Bubblesmcfuglyguy.csv,1169,7611554.0,426,743,145,281,0,30.857998289136013,223,43,15.330196749358427,4
Category_Wikipedia_sockpuppets_of_Cool_aire_of_1998.csv,434,76204711.0,97,337,51,46,0,56.05990783410138,236,34,13.26958525345622,4
Category_Wikipedia_sockpuppets_of_JackofTradeA.csv,6,29671.0,4,2,4,0,58,152.0,200,17,12.833333333333334,12
Category_Wikipedia_sockpuppets_of_Singopo.csv,6253,122983666.0,2297,3956,500,1797,0,27.061090676475292,259,76,21.931233008156084,3
Category_Wikipedia_sockpuppets_of_Sue_Gollings.csv,22,92190.0,17,5,9,8,0,17.681818181818183,196,29,23.40909090909091,15
Category_Wikipedia_sockpuppets_of_ÿßŸÜÿ™ÿßŸÑŸäŸà.csv,7,3448.0,4,3,3,1,0,55.42857142857143,196,28,22.571428571428573,17
Category_Wikipedia_sockpuppets_of_Maddyfan.csv,1451,126869073.0,508,943,500,8,0,37.12611991729842,271,51,19.11784975878704,5
Category_Wikipedia_sockpuppets_of_Tony590.csv,500,2855010.0,145,355,145,0,0,46.678,376,56,16.592,3
Category_Wikipedia_sockpuppets_of_Nscotian.csv,157,13586655.0,99,58,79,20,0,32.13375796178344,199,27,18.159235668789808,15
Category_Wikipedia_sockpuppets_of_Blue_username.csv,22,971634.0,13,9,8,5,4,50.54545454545455,162,27,17.727272727272727,9
Category_Wikipedia_sockpuppets_of_Coolstru01.csv,54,8718004.0,27,27,12,15,0,30.24074074074074,243,55,17.37037037037037,10
Category_Wikipedia_sockpuppets_of_Charis_M._Galanakis.csv,317,48442580.0,77,240,35,42,0,58.542586750788644,249,34,15.817034700315457,9
Category_Wikipedia_sockpuppets_of_Andymsci.csv,433,189126466.0,148,285,82,66,0,59.12009237875289,369,44,21.702078521939953,8
Category_Wikipedia_sockpuppets_of_Editor_wikip6.csv,1174,2924199.0,529,645,500,29,0,50.85860306643952,469,54,17.352640545144805,5
Category_Wikipedia_sockpuppets_of_Rannulz2000.csv,152,88236438.0,49,103,43,6,0,38.44736842105263,226,50,16.276315789473685,7
Category_Wikipedia_sockpuppets_of_Animum.csv,1900,286662102.0,555,1345,500,55,0,48.18052631578947,255,131,21.504210526315788,4
Category_Wikipedia_sockpuppets_of_Rahsin88.csv,61,81420303.0,25,36,24,1,0,50.16393442622951,223,24,16.81967213114754,15
Category_Wikipedia_sockpuppets_of_Kazaro.csv,2184,11164670.0,887,1297,500,387,0,53.354395604395606,255,69,22.922619047619047,7
Category_Wikipedia_sockpuppets_of_Dan_Gallagher.csv,310,196477085.0,111,199,73,38,0,58.31290322580645,493,50,33.52903225806452,14
Category_Wikipedia_sockpuppets_of_Oakley77.csv,1531,7081578.0,544,987,500,44,0,49.02090137165251,255,107,23.80731548007838,3
Category_Wikipedia_sockpuppets_of_Ianosistvan.csv,115,426346.0,41,74,35,6,0,18.17391304347826,139,25,12.069565217391304,7
Category_Wikipedia_sockpuppets_of_KennyYudashi.csv,100,739443.0,76,24,41,35,0,34.05,223,31,22.84,19
Category_Wikipedia_sockpuppets_of_Alan8746.csv,22,778228.0,12,10,7,5,14,81.81818181818181,194,35,26.863636363636363,18
Category_Wikipedia_sockpuppets_of_Eragon.raju.csv,222,8431546.0,68,154,40,28,0,44.171171171171174,237,61,20.644144144144143,10
Category_Wikipedia_sockpuppets_of_Johnnyturk888.csv,1217,12476540.0,503,714,500,3,0,39.02547247329499,232,103,18.957271980279376,4
Category_Wikipedia_sockpuppets_of_Theradioeditor.csv,20,5985522.0,6,14,3,3,0,31.3,93,53,46.4,20
Category_Wikipedia_sockpuppets_of_Fossey.csv,3,1140.0,2,1,2,0,0,95.66666666666667,177,11,11.0,11
Category_Wikipedia_sockpuppets_of_Viaankapoor2012.csv,6,1041529.0,6,0,6,0,0,45.666666666666664,120,22,11.166666666666666,9
Category_Wikipedia_sockpuppets_of_Political_Expert_47.csv,411,69116170.0,91,320,88,3,0,49.627737226277375,500,53,25.367396593673966,6
Category_Wikipedia_sockpuppets_of_Watashi_wa_kawaii_desu_ka.csv,9,114277.0,3,6,2,1,0,52.22222222222222,87,30,21.88888888888889,19
Category_Wikipedia_sockpuppets_of_Fourmilesc.csv,521,14200444.0,198,323,169,29,0,94.54126679462571,334,53,17.36468330134357,4
Category_Wikipedia_sockpuppets_of_Champ_Imi.csv,14,73080829.0,7,7,5,2,0,41.857142857142854,110,21,19.714285714285715,18
Category_Wikipedia_sockpuppets_of_Altus_mare.csv,61,262348.0,24,37,16,8,0,37.60655737704918,196,83,39.295081967213115,7
Category_Wikipedia_sockpuppets_of_You_have_sat_through_1_spin.csv,527,165848207.0,113,414,95,18,0,30.83111954459203,201,94,15.912713472485768,4
Category_Wikipedia_sockpuppets_of_Lichinsol.csv,509,41222069.0,181,328,178,3,0,67.86247544204322,500,51,13.88212180746562,3
Category_Wikipedia_sockpuppets_of_The_Wurdalak.csv,2193,26224021.0,858,1335,452,406,0,43.78248974008208,255,70,22.929320565435475,7
Category_Wikipedia_sockpuppets_of_Pokemonblackds.csv,1907,26134753.0,419,1488,380,39,0,51.35920293654956,250,67,16.630833770319875,1
Category_Wikipedia_sockpuppets_of_Tomsefal12.csv,5,6900370.0,3,2,2,1,0,25.4,41,21,20.4,20
Category_Wikipedia_sockpuppets_of_BBMatBlood.csv,1637,16110059.0,519,1118,500,19,0,49.616371411117896,500,52,16.31215638362859,3
Category_Wikipedia_sockpuppets_of_Msgelhorn.csv,252,6936072.0,82,170,81,1,0,45.757936507936506,255,70,19.023809523809526,5
Category_Wikipedia_sockpuppets_of_The_UPN_Vandal.csv,1027,10587522.0,237,790,14,223,0,29.933787731256086,199,47,19.527750730282374,3
Category_Wikipedia_sockpuppets_of_Abbrickman.csv,87,591103.0,37,50,26,11,0,44.60919540229885,180,29,20.60919540229885,12
Category_Wikipedia_sockpuppets_of_Thelastamazinggrace.csv,20,1162.0,10,10,7,3,0,40.55,173,19,16.2,15
Category_Wikipedia_sockpuppets_of_Mystic212.csv,1060,2418316.0,393,667,299,94,0,36.83490566037736,434,40,13.7,3
Category_Wikipedia_sockpuppets_of_BrittonLaRoche.csv,1834,2222542.0,824,1010,426,398,0,31.66793893129771,199,57,20.655943293347875,3
Category_Wikipedia_sockpuppets_of_Ahmedmusalman.csv,24,47524.0,12,12,8,4,0,33.833333333333336,159,34,20.291666666666668,12
Category_Wikipedia_sockpuppets_of_Ronnie432.csv,99,6891396.0,40,59,5,35,0,87.48484848484848,237,46,13.93939393939394,4
Category_Wikipedia_sockpuppets_of_89Lightyear.csv,11,335.0,6,5,4,2,0,103.72727272727273,232,18,15.727272727272727,13
Category_Wikipedia_sockpuppets_of_Destinee_Brown.csv,4,263.0,2,2,2,0,32,122.5,196,24,21.5,19
Category_Wikipedia_sockpuppets_of_Gmkarve.csv,155,72104258.0,88,67,24,64,0,26.90967741935484,198,53,26.316129032258065,16
Category_Wikipedia_sockpuppets_of_Joan97.csv,1321,80611330.0,559,762,438,121,0,36.97880393641181,245,79,27.51778955336866,4
Category_Wikipedia_sockpuppets_of_Sameeryasir123.csv,1,0.0,1,0,1,0,50,50.0,50,44,44.0,44
Category_Wikipedia_sockpuppets_of_HarimauFury.csv,496,66213020.0,239,257,234,5,0,51.54435483870968,492,74,48.274193548387096,12
Category_Wikipedia_sockpuppets_of_Shran.csv,2191,17003665.0,544,1647,476,68,0,31.204929256047468,199,53,15.032405294386125,3
Category_Wikipedia_sockpuppets_of_Page_Ostrow.csv,6,600792.0,5,1,5,0,10,24.833333333333332,47,22,20.333333333333332,17
Category_Wikipedia_sockpuppets_of_Charliebloom2.csv,50,62585378.0,18,32,16,2,0,54.12,234,38,23.42,14
Category_Wikipedia_sockpuppets_of_Louisalande.csv,161,1440944.0,82,79,24,58,0,36.037267080745345,230,33,16.596273291925467,14
Category_Wikipedia_sockpuppets_of_Johnclean184.csv,65,20584487.0,31,34,22,9,0,33.66153846153846,139,70,47.0,15
Category_Wikipedia_sockpuppets_of_Marina1banch.csv,834,18236223.0,184,650,165,19,0,47.799760191846524,493,32,11.207434052757794,3
Category_Wikipedia_sockpuppets_of_Rajendranwiki.csv,215,12424879.0,95,120,39,56,0,37.51627906976744,199,23,13.64186046511628,6
Category_Wikipedia_sockpuppets_of_Rowssusan.csv,2892,8334104.0,934,1958,500,434,0,56.22441217150761,255,76,27.95435684647303,6
Category_Wikipedia_sockpuppets_of_Phanuruch8555.csv,1833,7593643.0,532,1301,500,32,0,30.82378614293508,263,70,19.28914348063284,3
Category_Wikipedia_sockpuppets_of_WheezyF.csv,871,11877466.0,314,557,310,4,0,31.381171067738233,259,57,18.412169919632607,5
Category_Wikipedia_sockpuppets_of_Deprtcsa.csv,259,60574045.0,73,186,73,0,0,57.857142857142854,255,50,22.06949806949807,7
Category_Wikipedia_sockpuppets_of_LocoWiki.csv,951,286968982.0,226,725,222,4,0,45.262881177707676,244,60,15.980021030494216,4
Category_Wikipedia_sockpuppets_of_Brokeradar222.csv,34,1345381.0,19,15,19,0,0,46.205882352941174,144,42,35.11764705882353,16
Category_Wikipedia_sockpuppets_of_Zainalee.csv,1738,75425000.0,617,1121,500,117,0,45.15937859608746,495,55,19.522439585730726,3
Category_Wikipedia_sockpuppets_of_8742hhh.csv,272,24188630.0,98,174,61,37,0,41.50367647058823,321,45,18.66176470588235,5
Category_Wikipedia_sockpuppets_of_Nathphoenix.csv,8,507801.0,2,6,1,1,0,41.875,196,17,13.5,13
Category_Wikipedia_sockpuppets_of_ÿπÿ®ÿØÿßŸÑŸàŸáÿßÿ®_ÿßŸÑŸÑŸäÿ®Ÿä.csv,147,4642684.0,40,107,27,13,0,58.755102040816325,323,26,7.517006802721088,5
Category_Wikipedia_sockpuppets_of_Habesha_Konjo.csv,80,8711610.0,47,33,45,2,0,11.5125,122,42,14.2,12
Category_Wikipedia_sockpuppets_of_MinecraftFan35.csv,307,20193276.0,98,209,29,69,0,62.07817589576547,496,47,20.140065146579804,3
Category_Wikipedia_sockpuppets_of_Skibidirizzohio1.csv,7,756.0,5,2,3,2,0,37.0,139,26,13.0,10
Category_Wikipedia_sockpuppets_of_Digitolfleeron.csv,186,15117621.0,50,136,46,4,0,38.38172043010753,232,44,13.526881720430108,5
Category_Wikipedia_sockpuppets_of_Alison_Buchanan.csv,315,23351782.0,93,222,87,6,0,43.21904761904762,253,55,26.368253968253967,11
Category_Wikipedia_sockpuppets_of_Iching4096.csv,2154,37761497.0,811,1343,500,311,0,48.91225626740947,255,49,14.794800371402042,1
Category_Wikipedia_sockpuppets_of_NichePenguinLifestyle.csv,120,9695159.0,33,87,29,4,0,63.65833333333333,497,36,18.675,7
Category_Wikipedia_sockpuppets_of_Factcolony.csv,428,23725151.0,132,296,98,34,0,51.56542056074766,249,47,17.957943925233646,4
Category_Wikipedia_sockpuppets_of_Gluvmal.csv,46,133088.0,18,28,4,14,0,58.73913043478261,229,24,12.434782608695652,3
Category_Wikipedia_sockpuppets_of_PhysicianEdits.csv,119,1371589.0,40,79,22,18,0,46.378151260504204,236,39,22.932773109243698,9
Category_Wikipedia_sockpuppets_of_Giorgi_Diasamidze.csv,547,358275603.0,236,311,141,95,0,35.55941499085923,255,46,18.084095063985373,7
Category_Wikipedia_sockpuppets_of_Brentbucci.csv,105,16915429.0,23,82,14,9,0,41.72380952380952,217,31,17.733333333333334,3
Category_Wikipedia_sockpuppets_of_Chadbryant.csv,2553,45258271.0,693,1860,500,193,0,35.5515080297689,215,87,19.07246376811594,3
Category_Wikipedia_sockpuppets_of_SpiritMachine.csv,241,142745951.0,81,160,47,34,0,36.933609958506224,231,50,23.775933609958507,8
Category_Wikipedia_sockpuppets_of_Trulexicon.csv,881,175503672.0,262,619,234,28,0,41.5266742338252,255,47,15.324631101021566,5
Category_Wikipedia_sockpuppets_of_ThiefOfBagdad.csv,2738,64960764.0,829,1909,500,329,0,55.86413440467494,344,79,25.22936449963477,3
Category_Wikipedia_sockpuppets_of_Mk5384.csv,3219,7572936.0,1013,2206,500,513,0,48.904007455731595,250,63,16.87573780677229,5
Category_Wikipedia_sockpuppets_of_HRHLPZ.csv,141,1412150.0,75,66,19,56,0,67.27659574468085,334,29,15.836879432624114,3
Category_Wikipedia_sockpuppets_of_Gloria_Maria_Cardona.csv,269,24855517.0,81,188,57,24,0,49.69516728624535,252,47,22.442379182156134,7
Category_Wikipedia_sockpuppets_of_Seeknikkihi.csv,754,260078591.0,233,521,49,184,0,46.12068965517241,250,56,15.908488063660478,4
Category_Wikipedia_sockpuppets_of_Ebbeckham.csv,7,246.0,4,3,4,0,7,24.0,66,45,26.142857142857142,5
Category_Wikipedia_sockpuppets_of_Tinpa.csv,740,47686955.0,331,409,255,76,0,53.747297297297294,232,42,24.35135135135135,12
Category_Wikipedia_sockpuppets_of_Vwegba4real.csv,668,235571092.0,258,410,186,72,0,55.471556886227546,690,38,19.9625748502994,5
Category_Wikipedia_sockpuppets_of_Karsan_Chanda.csv,1381,28528955.0,632,749,500,132,0,37.1643736422882,496,50,19.601737871107893,4
Category_Wikipedia_sockpuppets_of_Ernst_S._Blofeld.csv,234,112761562.0,90,144,84,6,0,43.042735042735046,235,41,18.072649572649574,11
Category_Wikipedia_sockpuppets_of_Snoopfox.csv,1,0.0,1,0,1,0,168,168.0,168,20,20.0,20
Category_Wikipedia_sockpuppets_of_Whimwhiz.csv,2079,54088226.0,755,1324,486,269,0,58.23184223184223,496,67,19.48051948051948,3
Category_Wikipedia_sockpuppets_of_Mumtazabdullahahsan1.csv,37,335554.0,18,19,18,0,0,43.4054054054054,210,25,11.45945945945946,7
Category_Wikipedia_sockpuppets_of_Boyofjawad.csv,724,207771483.0,266,458,244,22,0,53.89779005524862,500,60,18.444751381215468,4
Category_Wikipedia_sockpuppets_of_1975janelle.csv,49,2341.0,20,29,13,7,0,48.38775510204081,234,24,13.448979591836734,13
Category_Wikipedia_sockpuppets_of_Farhan_Rana_Rajpoot.csv,823,168542418.0,223,600,68,155,0,52.31470230862698,483,67,18.970838396111787,4
Category_Wikipedia_sockpuppets_of_Singhnipender.csv,68,21470884.0,19,49,16,3,0,53.38235294117647,199,25,14.735294117647058,7
Category_Wikipedia_sockpuppets_of_Malvinsub3.csv,177,15876962.0,80,97,38,42,0,57.175141242937855,487,47,16.672316384180792,7
Category_Wikipedia_sockpuppets_of_EgBoi_YT.csv,18,77237.0,13,5,11,2,0,44.44444444444444,197,27,17.666666666666668,6
Category_Wikipedia_sockpuppets_of_Captainmoondog.csv,37,73551420.0,12,25,11,1,0,53.67567567567568,185,29,23.10810810810811,14
Category_Wikipedia_sockpuppets_of_Coolpanda1234.csv,106,4504427.0,71,35,31,40,0,45.27358490566038,254,24,17.254716981132077,11
Category_Wikipedia_sockpuppets_of_Classicjupiter2.csv,1729,47020938.0,724,1005,500,224,0,31.77327935222672,200,56,18.508964719491036,5
Category_Wikipedia_sockpuppets_of_Tseung_kang_99.csv,63,40675318.0,35,28,34,1,0,26.349206349206348,252,27,21.984126984126984,15
Category_Wikipedia_sockpuppets_of_Kayteigh.csv,2122,1513339.0,639,1483,500,139,0,89.0296889726673,260,74,18.17200754005655,4
Category_Wikipedia_sockpuppets_of_Prophaniti.csv,2759,123954662.0,713,2046,500,213,0,43.836172526277636,250,54,19.840159478071765,5
Category_Wikipedia_sockpuppets_of_LovelyGirl7.csv,4419,81275182.0,1698,2721,500,1198,0,42.2582032133967,482,77,25.27132835483141,3
Category_Wikipedia_sockpuppets_of_Navidulhuq.csv,101,319996.0,38,63,26,12,0,39.336633663366335,495,23,15.821782178217822,10
Category_Wikipedia_sockpuppets_of_David9991.csv,278,28704825.0,123,155,82,41,0,30.93525179856115,245,41,18.794964028776977,9
Category_Wikipedia_sockpuppets_of_Fareed30.csv,2244,16465126.0,769,1475,500,269,0,51.15017825311943,255,50,19.245098039215687,5
Category_Wikipedia_sockpuppets_of_Wifione.csv,2907,280848823.0,1077,1830,500,577,0,64.20949432404541,498,77,34.499484004127964,5
Category_Wikipedia_sockpuppets_of_BusinessSetupInDubai_zejaj.csv,3,62.0,2,1,2,0,0,107.33333333333333,161,31,31.0,31
Category_Wikipedia_sockpuppets_of_Underblasst.csv,333,34143753.0,151,182,103,48,0,31.6996996996997,199,36,8.732732732732734,4
Category_Wikipedia_sockpuppets_of_Tanvir_Hayder.csv,449,56518048.0,130,319,56,74,0,50.69933184855234,298,54,20.835189309576837,4
Category_Wikipedia_sockpuppets_of_Georgewelles2021.csv,1788,17783068.0,450,1338,259,191,0,46.52684563758389,485,56,14.433445190156599,8
Category_Wikipedia_sockpuppets_of_Osourdounmou.csv,5393,204505902.0,1765,3628,500,1265,0,53.963842017430004,500,80,19.648804005191916,3
Category_Wikipedia_sockpuppets_of_GreyDiomed.csv,1804,160207526.0,736,1068,500,236,0,43.791574279379155,390,53,20.85310421286031,6
Category_Wikipedia_sockpuppets_of_Arunkumarnaik.csv,265,13478950.0,114,151,73,41,0,39.69433962264151,495,30,9.275471698113208,5
Category_Wikipedia_sockpuppets_of_Kxing.csv,88,768148.0,53,35,53,0,0,22.625,126,64,21.681818181818183,4
Category_Wikipedia_sockpuppets_of_Robert_McBrownNose.csv,1,0.0,1,0,1,0,32,32.0,32,25,25.0,25
Category_Wikipedia_sockpuppets_of_Anonymousdontneedtoknowme.csv,77,6886.0,43,34,26,17,0,56.701298701298704,368,35,17.01298701298701,13
Category_Wikipedia_sockpuppets_of_Priyaaravind.csv,116,53992794.0,52,64,29,23,0,60.60344827586207,255,31,12.85344827586207,9
Category_Wikipedia_sockpuppets_of_LtWinters.csv,2040,17687286.0,686,1354,500,186,0,37.437745098039215,255,93,21.847549019607843,3
Category_Wikipedia_sockpuppets_of_Hycent_hyt.csv,168,106004789.0,40,128,23,17,0,45.023809523809526,251,26,12.797619047619047,3
Category_Wikipedia_sockpuppets_of_Connerdn.csv,40,6273458.0,20,20,12,8,0,91.55,247,18,11.475,9
Category_Wikipedia_sockpuppets_of_Patchy34.csv,20,865765.0,8,12,7,1,0,51.5,209,44,16.3,8
Category_Wikipedia_sockpuppets_of_Yunike1337.csv,9,63438.0,6,3,3,3,12,31.333333333333332,67,38,29.444444444444443,13
Category_Wikipedia_sockpuppets_of_Laptopmaker.csv,130,15626559.0,45,85,40,5,0,44.95384615384615,193,44,26.607692307692307,10
Category_Wikipedia_sockpuppets_of_PoIiTheoryNerd22.csv,12,3951600.0,4,8,2,2,0,22.75,50,59,20.0,3
Category_Wikipedia_sockpuppets_of_Xxxx693.csv,240,1689229.0,73,167,59,14,0,40.291666666666664,236,49,20.466666666666665,9
Category_Wikipedia_sockpuppets_of_Thesaviors.csv,24,1493.0,13,11,10,3,0,35.0,177,33,18.0,11
Category_Wikipedia_sockpuppets_of_JasdeeptS29.csv,372,28363929.0,160,212,31,129,0,38.15860215053763,495,40,16.091397849462364,3
Category_Wikipedia_sockpuppets_of_CIosedMouth.csv,104,50992211.0,36,68,35,1,0,39.51923076923077,194,53,43.03846153846154,15
Category_Wikipedia_sockpuppets_of_Christian_villafuerte.csv,147,111871.0,61,86,34,27,0,32.53061224489796,265,43,26.12925170068027,15
Category_Wikipedia_sockpuppets_of_PrivacyFocusedOnline.csv,65,21670.0,35,30,34,1,0,66.21538461538462,277,50,36.353846153846156,10
Category_Wikipedia_sockpuppets_of_Akurti25.csv,33,730076.0,32,1,32,0,0,12.93939393939394,60,18,13.090909090909092,12
Category_Wikipedia_sockpuppets_of_Cubbie4.csv,24,539466.0,15,9,5,10,0,40.041666666666664,165,26,20.583333333333332,18
Category_Wikipedia_sockpuppets_of_Username314159.csv,80,101140825.0,16,64,7,9,0,64.1625,232,43,13.6375,6
Category_Wikipedia_sockpuppets_of_Yamsahh.csv,69,1806949.0,23,46,21,2,0,37.11594202898551,153,51,22.391304347826086,13
Category_Wikipedia_sockpuppets_of_Ledzeppelin93827.csv,3461,25163153.0,1001,2460,500,501,0,47.01415775787345,500,56,17.080034672060098,3
Category_Wikipedia_sockpuppets_of_Jakel087.csv,9,8103.0,7,2,6,1,4,35.888888888888886,176,12,12.0,12
Category_Wikipedia_sockpuppets_of_Beckhamwong2004.csv,96,17619226.0,53,43,19,34,0,36.177083333333336,196,30,17.354166666666668,7
Category_Wikipedia_sockpuppets_of_PeopleEater143.csv,184,13902373.0,59,125,52,7,0,61.13586956521739,237,50,32.02717391304348,7
Category_Wikipedia_sockpuppets_of_Kbtudios0121.csv,14,92826.0,4,10,2,2,0,42.5,206,27,19.428571428571427,15
Category_Wikipedia_sockpuppets_of_JimmyDarmodyRules.csv,1291,24081916.0,617,674,500,117,0,32.89542989930287,261,49,23.202168861347793,9
Category_Wikipedia_sockpuppets_of_Nuclearram.csv,1183,171505875.0,389,794,357,32,0,45.75316990701606,255,50,20.46830092983939,4
Category_Wikipedia_sockpuppets_of_Zephyr3N16M4.csv,4,95135.0,2,2,2,0,0,21.25,81,22,22.0,22
Category_Wikipedia_sockpuppets_of_Aledownload.csv,3918,56578627.0,1064,2854,500,564,0,44.96503318019398,494,56,19.603369065849922,3
Category_Wikipedia_sockpuppets_of_Hinomaru.csv,210,4663874.0,42,168,12,30,0,39.72380952380952,221,37,13.966666666666667,4
Category_Wikipedia_sockpuppets_of_EdwardSuperR.csv,50,40882495.0,10,40,8,2,0,43.22,231,31,15.64,4
Category_Wikipedia_sockpuppets_of_DeanStudent.csv,13,4914696.0,8,5,4,4,6,46.53846153846154,202,12,12.0,12
Category_Wikipedia_sockpuppets_of_Bdub2018.csv,571,4961166.0,278,293,252,26,0,56.02802101576182,500,44,21.875656742556917,5
Category_Wikipedia_sockpuppets_of_Whitmore_8621.csv,2775,19750428.0,961,1814,500,461,0,39.09801801801802,245,73,21.543783783783784,3
Category_Wikipedia_sockpuppets_of_Ma_Swingle.csv,147,6825705.0,38,109,24,14,0,44.156462585034014,211,68,24.27891156462585,6
Category_Wikipedia_sockpuppets_of_Lympo.csv,1,0.0,1,0,1,0,77,77.0,77,20,20.0,20
Category_Wikipedia_sockpuppets_of_Hurungudo.csv,1098,31262429.0,526,572,500,26,0,36.91256830601093,336,60,18.209471766848814,6
Category_Wikipedia_sockpuppets_of_Vegavairbob.csv,214,6845898.0,97,117,97,0,0,35.191588785046726,226,38,18.299065420560748,13
Category_Wikipedia_sockpuppets_of_CharlesTaze34.csv,104,8386295.0,62,42,46,16,0,54.16346153846154,247,35,19.71153846153846,12
Category_Wikipedia_sockpuppets_of_Bhushan_Vitthal_Pawar.csv,10,340826.0,7,3,6,1,0,8.8,31,18,12.9,7
Category_Wikipedia_sockpuppets_of_Mpuskad3.csv,12,4805.0,8,4,6,2,0,44.0,199,59,54.833333333333336,54
Category_Wikipedia_sockpuppets_of_Avalathikaaram.csv,3,514.0,2,1,1,1,19,41.0,84,23,20.333333333333332,19
Category_Wikipedia_sockpuppets_of_Hunnic_Enjoyer.csv,409,17104178.0,186,223,184,2,0,51.511002444987774,496,76,24.117359413202934,6
Category_Wikipedia_sockpuppets_of_Unem2009.csv,15,548053.0,10,5,3,7,0,33.266666666666666,199,37,29.4,18
Category_Wikipedia_sockpuppets_of_Adammccallig03.csv,518,60665390.0,168,350,166,2,0,34.932432432432435,363,50,24.071428571428573,6
Category_Wikipedia_sockpuppets_of_Mattisse.csv,23285,296773050.0,6844,16441,500,6344,0,45.790809534034786,255,83,19.173459308567747,3
Category_Wikipedia_sockpuppets_of_Sugablast.csv,460,412275711.0,151,309,99,52,0,53.38913043478261,300,37,17.27173913043478,5
Category_Wikipedia_sockpuppets_of_Jcnilcne.csv,10,255311.0,5,5,4,1,0,45.2,183,12,10.4,8
Category_Wikipedia_sockpuppets_of_Dinkton.csv,385,5334921.0,99,286,63,36,0,62.675324675324674,245,58,21.514285714285716,5
Category_Wikipedia_sockpuppets_of_Cbrubaker.csv,66,1287218.0,28,38,23,5,0,37.28787878787879,210,44,19.893939393939394,8
Category_Wikipedia_sockpuppets_of_Surge_Of_Reason.csv,1584,4828781.0,504,1080,500,4,0,54.18118686868687,452,47,15.556818181818182,3
Category_Wikipedia_sockpuppets_of_Bollywoodcritic.csv,354,218737668.0,131,223,98,33,0,46.13841807909605,499,47,23.059322033898304,5
Category_Wikipedia_sockpuppets_of_Lurulu.csv,4804,241321473.0,1497,3307,500,997,0,41.779142381348876,395,76,19.147793505412157,2
Category_Wikipedia_sockpuppets_of_Rakibsinha.csv,35,6238110.0,24,11,18,6,0,29.37142857142857,138,23,18.4,13
Category_Wikipedia_sockpuppets_of_Yh00157.csv,2648,203714361.0,648,2000,500,148,0,46.446374622356494,420,55,21.00188821752266,3
Category_Wikipedia_sockpuppets_of_Thatonebossdude.csv,105,5460029.0,56,49,29,27,0,36.94285714285714,240,28,20.304761904761904,14
Category_Wikipedia_sockpuppets_of_Thewow96.csv,45,27897519.0,18,27,10,8,0,48.111111111111114,224,20,15.688888888888888,5
Category_Wikipedia_sockpuppets_of_James1168.csv,164,90278783.0,56,108,23,33,0,39.56707317073171,152,51,22.536585365853657,13
Category_Wikipedia_sockpuppets_of_Azerti83.csv,3039,34349519.0,1104,1935,500,604,0,54.55840737084567,554,72,22.117472852912144,3
Category_Wikipedia_sockpuppets_of_BookingsEdward.csv,93,61361548.0,33,60,29,4,0,43.655913978494624,247,33,12.043010752688172,7
Category_Wikipedia_sockpuppets_of_D7256.csv,1615,2252419.0,472,1143,382,90,0,37.78761609907121,378,70,14.926934984520123,3
Category_Wikipedia_sockpuppets_of_Felipe_Garcia.csv,2555,210757624.0,598,1957,39,559,0,41.297455968688844,249,71,18.632485322896283,4
Category_Wikipedia_sockpuppets_of_SpectresWrath.csv,4719,66104990.0,1635,3084,500,1135,0,36.89764780673872,496,71,24.329307056579783,3
Category_Wikipedia_sockpuppets_of_Snthilakammarist.csv,13422,61846571.0,3692,9730,266,3426,0,44.639845030546866,500,86,24.817687378930113,3
Category_Wikipedia_sockpuppets_of_Amithvpurushothaman.csv,30,47412691.0,6,24,6,0,0,36.43333333333333,144,23,20.4,17
Category_Wikipedia_sockpuppets_of_Redneck_Wikipedian.csv,27,1053632.0,12,15,7,5,0,95.44444444444444,224,28,17.74074074074074,9
Category_Wikipedia_sockpuppets_of_AshelenaRoger999.csv,63,33352530.0,26,37,13,13,0,40.73015873015873,189,35,21.555555555555557,8
Category_Wikipedia_sockpuppets_of_Rashid_Ghafoor.csv,3483,25057560.0,1386,2097,500,886,0,41.22681596325007,600,67,22.14843525696239,4
Category_Wikipedia_sockpuppets_of_Hopeful2014.csv,4966,48890753.0,2018,2948,500,1518,0,35.93979057591623,424,62,17.84393878372936,4
Category_Wikipedia_sockpuppets_of_Bestof2022.csv,1750,14169875.0,565,1185,395,170,0,47.96,496,58,19.42685714285714,3
Category_Wikipedia_sockpuppets_of_Weasteam.csv,126,224123903.0,33,93,33,0,0,48.79365079365079,235,56,45.26984126984127,23
Category_Wikipedia_sockpuppets_of_Missileinfo.csv,267,12957632.0,79,188,37,42,0,71.82397003745318,387,42,15.142322097378278,5
Category_Wikipedia_sockpuppets_of_Azad_chai.csv,231,6828237.0,66,165,56,10,0,44.25108225108225,203,49,19.441558441558442,6
Category_Wikipedia_sockpuppets_of_Appleby.csv,3751,4633680.0,1285,2466,500,785,0,25.362836576912823,213,66,16.593974940015997,3
Category_Wikipedia_sockpuppets_of_Laura_Bakhuis.csv,154,96320269.0,54,100,13,41,0,50.564935064935064,263,30,14.045454545454545,3
Category_Wikipedia_sockpuppets_of_Thetoledoartist.csv,128,32367578.0,63,65,19,44,0,40.046875,225,42,20.609375,8
Category_Wikipedia_sockpuppets_of_Iserden.csv,871,39577957.0,211,660,73,138,0,51.13318025258324,250,42,11.388059701492537,4
Category_Wikipedia_sockpuppets_of_Lil'_kim187.csv,70,534729.0,21,49,11,10,0,24.857142857142858,199,53,26.2,18
Category_Wikipedia_sockpuppets_of_NOOBSKINSPAMMER.csv,583,135375433.0,177,406,167,10,0,48.51114922813036,265,60,24.7958833619211,4
Category_Wikipedia_sockpuppets_of_Satyacyclopedia.csv,171,720642.0,77,94,42,35,0,36.36842105263158,254,36,20.84795321637427,8
Category_Wikipedia_sockpuppets_of_Jean70000.csv,903,199269619.0,240,663,238,2,0,40.04761904761905,318,56,21.46511627906977,4
Category_Wikipedia_sockpuppets_of_JavaPythonLutz.csv,647,3480448.0,206,441,130,76,0,53.629057187017004,288,50,18.143740340030913,5
Category_Wikipedia_sockpuppets_of_Wojciech_G.csv,122,1813134.0,35,87,21,14,0,61.82786885245902,245,41,17.352459016393443,3
Category_Wikipedia_sockpuppets_of_Arikogbon.csv,29,55055321.0,7,22,7,0,0,69.37931034482759,264,35,19.896551724137932,12
Category_Wikipedia_sockpuppets_of_IDSS-AI.csv,1,0.0,1,0,1,0,0,0.0,0,18,18.0,18
Category_Wikipedia_sockpuppets_of_AnnalesSchool.csv,1491,148698467.0,499,992,495,4,0,58.10999329309188,255,59,30.61234071093226,15
Category_Wikipedia_sockpuppets_of_Lko84.csv,11,2616.0,3,8,2,1,0,49.45454545454545,131,45,37.36363636363637,16
Category_Wikipedia_sockpuppets_of_Tuaron.csv,11,595057.0,9,2,9,0,0,17.0,60,18,18.0,18
Category_Wikipedia_sockpuppets_of_PEMNCX.csv,127,5091589.0,76,51,33,43,0,37.43307086614173,371,28,17.228346456692915,6
Category_Wikipedia_sockpuppets_of_VRANSW.csv,25,382919.0,19,6,11,8,0,25.6,123,16,14.24,14
Category_Wikipedia_sockpuppets_of_Abbruscato.csv,237,7709772.0,80,157,32,48,0,52.177215189873415,218,55,24.47257383966245,11
Category_Wikipedia_sockpuppets_of_S2sufc.csv,1339,89191221.0,505,834,500,5,0,41.206123973114266,496,77,21.753547423450335,4
Category_Wikipedia_sockpuppets_of_Mahbubur.bcd.csv,36,1323261.0,32,4,25,7,0,23.5,255,22,13.777777777777779,12
Category_Wikipedia_sockpuppets_of_Eli_posey.csv,18,79703.0,14,4,10,4,0,23.555555555555557,224,11,11.0,11
Category_Wikipedia_sockpuppets_of_ZnatNepo23892.csv,414,24012699.0,157,257,67,90,0,43.95410628019324,461,43,17.22222222222222,7
Category_Wikipedia_sockpuppets_of_Carriouyou.csv,297,157198414.0,105,192,65,40,0,48.91582491582491,226,20,10.158249158249157,8
Category_Wikipedia_sockpuppets_of_Black_Jewish_Woman.csv,6,1383957.0,4,2,1,3,21,117.66666666666667,189,9,9.0,9
Category_Wikipedia_sockpuppets_of_Halwapista.csv,58,1877784.0,17,41,10,7,0,42.55172413793103,254,34,14.0,7
Category_Wikipedia_sockpuppets_of_Proudpurian.csv,1265,53589882.0,374,891,202,172,0,36.06719367588933,255,49,14.058498023715416,7
Category_Wikipedia_sockpuppets_of_Magicmiracle.csv,127,1280066.0,59,68,28,31,0,40.38582677165354,199,48,24.937007874015748,8
Category_Wikipedia_sockpuppets_of_Jaishankar_Chigurula.csv,844,88130097.0,333,511,102,231,0,37.73696682464455,253,63,21.774881516587676,2
Category_Wikipedia_sockpuppets_of_Askrajniastro.csv,2,0.0,1,1,1,0,36,36.0,36,33,33.0,33
Category_Wikipedia_sockpuppets_of_Sandakelum.csv,1025,276274593.0,355,670,298,57,0,50.55512195121951,254,78,23.913170731707318,1
Category_Wikipedia_sockpuppets_of_Mikeis1996.csv,1928,92459961.0,505,1423,500,5,0,48.56898340248963,255,50,18.41286307053942,5
Category_Wikipedia_sockpuppets_of_Nigam.kirtimaan.csv,73,58139189.0,25,48,21,4,0,52.71232876712329,255,52,21.54794520547945,13
Category_Wikipedia_sockpuppets_of_–ú–∫–¥–≤–∏–∫–∏.csv,182,2578466.0,64,118,39,25,0,40.76373626373626,251,47,23.5989010989011,16
Category_Wikipedia_sockpuppets_of_Alex_Devens.csv,2125,62116953.0,504,1621,257,247,0,55.12894117647059,499,111,21.42494117647059,1
Category_Wikipedia_sockpuppets_of_SemenOfDong.csv,16,1734362.0,13,3,9,4,0,23.6875,128,25,25.0,25
Category_Wikipedia_sockpuppets_of_Darthchess.csv,150,52158495.0,39,111,34,5,0,52.666666666666664,199,36,17.0,8
Category_Wikipedia_sockpuppets_of_Truthinnutrition.csv,92,45768912.0,29,63,15,14,0,55.73913043478261,185,45,22.75,10
Category_Wikipedia_sockpuppets_of_Sandrotnli.csv,84,8682854.0,28,56,10,18,0,42.035714285714285,241,45,18.571428571428573,10
Category_Wikipedia_sockpuppets_of_Gabi_Hernandez.csv,3716,26939856.0,1402,2314,500,902,0,31.029601722282024,262,91,19.008611410118405,6
Category_Wikipedia_sockpuppets_of_Pierlot.csv,1457,30684469.0,388,1069,186,202,0,50.13246396705559,246,53,13.886067261496224,3
Category_Wikipedia_sockpuppets_of_Kaylaelyse219.csv,30,423273.0,13,17,6,7,0,39.53333333333333,163,59,34.53333333333333,12
Category_Wikipedia_sockpuppets_of_TejinderPSingh.csv,131,81902080.0,40,91,15,25,0,64.3206106870229,496,38,22.27480916030534,8
Category_Wikipedia_sockpuppets_of_NOLA28.csv,1,0.0,1,0,1,0,0,0.0,0,18,18.0,18
Category_Wikipedia_sockpuppets_of_Manveermalhi.csv,1350,89926430.0,555,795,500,55,0,48.42296296296296,255,49,18.394074074074073,4
Category_Wikipedia_sockpuppets_of_Authorevole.csv,127,3310473.0,36,91,23,13,0,59.28346456692913,277,25,13.960629921259843,4
Category_Wikipedia_sockpuppets_of_TopGun1066.csv,261,44307789.0,92,169,79,13,0,55.26053639846743,320,62,25.950191570881227,8
Category_Wikipedia_sockpuppets_of_Y26Z3.csv,1645,54262524.0,568,1077,286,282,0,51.224316109422496,255,76,18.590273556231004,5
Category_Wikipedia_sockpuppets_of_Bclrocks10.csv,1446,18512027.0,521,925,500,21,0,31.99930843706777,221,34,19.00899031811895,11
Category_Wikipedia_sockpuppets_of_Chiwit0217.csv,280,9842299.0,129,151,118,11,0,43.332142857142856,500,31,16.764285714285716,4
Category_Wikipedia_sockpuppets_of_Solhjoo.csv,1031,105635199.0,273,758,236,37,0,47.39670223084384,255,41,13.153249272550921,4
Category_Wikipedia_sockpuppets_of_Benjamin_Larson.csv,23,21334.0,6,17,5,1,0,85.30434782608695,219,8,4.130434782608695,3
Category_Wikipedia_sockpuppets_of_JamieAdams.csv,2222,243585867.0,661,1561,500,161,0,37.55580558055806,255,57,21.423942394239425,4
Category_Wikipedia_sockpuppets_of_TnucbackwardsisHinnBenny.csv,6,427.0,4,2,3,1,0,80.33333333333333,202,10,10.0,10
Category_Wikipedia_sockpuppets_of_Firemanpb.csv,32,22248.0,14,18,6,8,0,48.65625,151,31,14.59375,6
Category_Wikipedia_sockpuppets_of_GabrielLopez7.csv,2331,43624114.0,640,1691,500,140,0,42.95624195624195,493,48,19.234234234234233,3
Category_Wikipedia_sockpuppets_of_Mike2moto.csv,49,34297350.0,17,32,17,0,0,32.40816326530612,199,24,16.448979591836736,10
Category_Wikipedia_sockpuppets_of_Sunearthly.csv,78,31551765.0,32,46,30,2,0,61.51282051282051,329,43,19.653846153846153,10
Category_Wikipedia_sockpuppets_of_PinkOrangeCat.csv,125,5284752.0,40,85,24,16,0,59.744,297,27,13.096,4
Category_Wikipedia_sockpuppets_of_089baby.csv,2416,267326553.0,1093,1323,412,681,0,27.071192052980134,255,51,20.533940397350992,7
Category_Wikipedia_sockpuppets_of_Jedi_order_master.csv,17,46411.0,9,8,6,3,0,8.823529411764707,41,27,15.352941176470589,10
Category_Wikipedia_sockpuppets_of_Shivam.Tyagii.csv,24,47985.0,22,2,18,4,0,24.125,176,23,21.541666666666668,16
Category_Wikipedia_sockpuppets_of_Hous21.csv,1575,392985980.0,506,1069,500,6,0,54.275555555555556,450,62,23.954920634920637,5
Category_Wikipedia_sockpuppets_of_Music_biograpiez.csv,6,4259618.0,2,4,2,0,0,23.166666666666668,63,53,53.0,53
Category_Wikipedia_sockpuppets_of_SyedAhmad01.csv,117,814307.0,43,74,32,11,0,74.82905982905983,400,27,13.76923076923077,6
Category_Wikipedia_sockpuppets_of_Sniper_65k.csv,947,7863139.0,523,424,500,23,0,47.43611404435058,344,24,17.011615628299893,5
Category_Wikipedia_sockpuppets_of_Bosnipedian.csv,3816,442442298.0,1366,2450,376,990,0,52.357442348008384,404,89,23.574685534591193,4
Category_Wikipedia_sockpuppets_of_Ericgleonard.csv,6,26461.0,4,2,4,0,0,44.333333333333336,196,53,29.0,17
Category_Wikipedia_sockpuppets_of_Drkatzjr27.csv,215,46537310.0,109,106,80,29,0,39.53023255813954,339,42,31.869767441860464,11
Category_Wikipedia_sockpuppets_of_Davnel03.csv,1574,20145385.0,411,1163,296,115,0,42.15565438373571,250,83,23.126429479034307,3
Category_Wikipedia_sockpuppets_of_Kelseymadas.csv,56,220076950.0,25,31,23,2,0,49.660714285714285,212,23,23.0,23
Category_Wikipedia_sockpuppets_of_Qmanwiki.csv,57,4391045.0,31,26,25,6,0,45.26315789473684,251,10,9.12280701754386,9
Category_Wikipedia_sockpuppets_of_Ahmad.Hamade.csv,31,1024246.0,20,11,12,8,0,5.709677419354839,69,22,17.483870967741936,17
Category_Wikipedia_sockpuppets_of_Blah9454.csv,110,5959734.0,22,88,18,4,0,34.736363636363635,210,26,15.2,4
Category_Wikipedia_sockpuppets_of_Ykmyth999.csv,9,8131609.0,4,5,4,0,21,61.77777777777778,151,27,23.0,19
Category_Wikipedia_sockpuppets_of_Haroldpolo.csv,84,2715808.0,31,53,15,16,0,36.416666666666664,242,36,17.035714285714285,8
Category_Wikipedia_sockpuppets_of_Mservi68.csv,14,1122015.0,8,6,5,3,0,43.357142857142854,243,23,18.285714285714285,12
Category_Wikipedia_sockpuppets_of_Alok433.csv,99,31625176.0,56,43,40,16,0,37.38383838383838,284,43,16.03030303030303,12
Category_Wikipedia_sockpuppets_of_DevilBlack69.csv,5262,245190596.0,2356,2906,500,1856,0,29.12010642341315,484,48,18.543519574306348,9
Category_Wikipedia_sockpuppets_of_Geir_Smith.csv,1293,202346157.0,508,785,500,8,0,47.15313225058004,225,62,16.56999226604795,4
Category_Wikipedia_sockpuppets_of_Sunny_singh9128.csv,2336,191525039.0,759,1577,500,259,0,44.81635273972603,251,51,21.659674657534246,5
Category_Wikipedia_sockpuppets_of_Dilshad002.csv,224,122849810.0,82,142,80,2,0,65.11160714285714,324,36,15.013392857142858,6
Category_Wikipedia_sockpuppets_of_Wiki's_Most_Wanted.csv,201,8638400.0,75,126,34,41,0,23.084577114427862,183,32,20.621890547263682,9
Category_Wikipedia_sockpuppets_of_Benjoqld.csv,111,1461170.0,75,36,74,1,0,21.65765765765766,199,36,20.333333333333332,10
Category_Wikipedia_sockpuppets_of_Joeyv1000.csv,44,15485318.0,14,30,5,9,0,55.56818181818182,199,19,14.0,9
Category_Wikipedia_sockpuppets_of_Diabedia.csv,9602,214177784.0,2540,7062,500,2040,0,42.75348885648823,500,63,19.026869402207872,1
Category_Wikipedia_sockpuppets_of_JessicaStewart1986.csv,299,5971398.0,77,222,28,49,0,49.525083612040135,377,41,11.093645484949834,4
Category_Wikipedia_sockpuppets_of_NutHead96.csv,4,106.0,3,1,2,1,0,39.0,144,17,16.25,14
Category_Wikipedia_sockpuppets_of_Rodrigotebani.csv,121,353278634.0,25,96,25,0,0,42.239669421487605,255,25,13.396694214876034,5
Category_Wikipedia_sockpuppets_of_Anomo.csv,3067,76369684.0,1046,2021,500,546,0,34.600260841212915,250,104,26.63156178676231,2
Category_Wikipedia_sockpuppets_of_YOYOYO_YOMAMA.csv,40,3759.0,21,19,21,0,0,41.875,177,18,15.35,10
Category_Wikipedia_sockpuppets_of_Ahwaz.csv,1380,39216311.0,506,874,500,6,0,35.2072463768116,200,72,21.730434782608697,4
Category_Wikipedia_sockpuppets_of_Guilherme_Styles.csv,2929,206172467.0,756,2173,348,408,0,41.77569136223967,346,68,25.402867872994197,6
Category_Wikipedia_sockpuppets_of_Henrycolesmith.csv,115,3532309.0,41,74,20,21,0,63.08695652173913,234,61,18.069565217391304,5
Category_Wikipedia_sockpuppets_of_Randhwasingh.csv,11600,56052805.0,3610,7990,500,3110,0,36.87982758620689,255,64,18.84905172413793,3
Category_Wikipedia_sockpuppets_of_Andrew0711171.csv,254,90883035.0,83,171,48,35,0,45.826771653543304,490,37,30.72047244094488,9
Category_Wikipedia_sockpuppets_of_Vhaslhv.csv,304,15554614.0,125,179,16,109,0,51.3453947368421,238,43,19.154605263157894,7
Category_Wikipedia_sockpuppets_of_Trxch.csv,894,73662990.0,223,671,204,19,0,50.98993288590604,347,50,14.883668903803132,5
Category_Wikipedia_sockpuppets_of_FobTown.csv,5908,60908507.0,1704,4204,500,1204,0,46.62423832092079,500,60,19.55314827352742,3
Category_Wikipedia_sockpuppets_of_Bobe8q8661.csv,3589,18053844.0,1110,2479,500,610,0,43.47422680412371,496,69,17.454444134856505,3
Category_Wikipedia_sockpuppets_of_Santoshdagur.csv,38,6980824.0,9,29,7,2,0,68.05263157894737,234,28,18.05263157894737,9
Category_Wikipedia_sockpuppets_of_JenniferDombrowski.csv,12,5033.0,5,7,5,0,0,26.25,58,28,26.333333333333332,18
Category_Wikipedia_sockpuppets_of_–Ç–æ—Ä—í–µ_–í—É–∫–æ–≤–∏—õ.csv,153,3215705.0,77,76,72,5,0,46.79738562091503,236,25,18.718954248366014,13
Category_Wikipedia_sockpuppets_of_Aduanebrown.csv,30,20112.0,20,10,19,1,0,35.166666666666664,142,49,36.06666666666667,21
Category_Wikipedia_sockpuppets_of_Leaf_it_2_me_green_reader.csv,105,508677.0,75,30,53,22,0,29.933333333333334,186,19,10.333333333333334,10
Category_Wikipedia_sockpuppets_of_Mathiassandell.csv,2299,127180647.0,645,1654,500,145,0,42.840365376250546,255,61,22.277946933449325,6
Category_Wikipedia_sockpuppets_of_Fiet_Nam.csv,2187,9846094.0,518,1669,409,109,0,36.177411979881114,216,49,17.7466849565615,1
Category_Wikipedia_sockpuppets_of_Ligma_36.csv,47,5566610.0,19,28,4,15,0,79.65957446808511,500,37,23.127659574468087,9
Category_Wikipedia_sockpuppets_of_MarceloBerman.csv,65,15528837.0,32,33,16,16,0,52.61538461538461,255,23,20.153846153846153,15
Category_Wikipedia_sockpuppets_of_Sfloren6.csv,2,27.0,2,0,2,0,0,5.5,11,5,5.0,5
Category_Wikipedia_sockpuppets_of_CaliforniaJane7864.csv,69,706240.0,22,47,11,11,0,40.53623188405797,254,32,18.043478260869566,8
Category_Wikipedia_sockpuppets_of_ElizabethCB123.csv,2007,8227364.0,753,1254,296,457,0,43.497259591429994,255,71,22.356751370204286,3
Category_Wikipedia_sockpuppets_of_Skumarsys.csv,553,115227144.0,198,355,57,141,0,49.625678119349004,251,85,16.792043399638338,3
Category_Wikipedia_sockpuppets_of_Washington_Lincoln.csv,2057,26747580.0,518,1539,500,18,0,53.50656295576081,496,97,28.736023334953817,3
Category_Wikipedia_sockpuppets_of_Brianabgc17.csv,24,2213315.0,10,14,7,3,0,30.416666666666668,116,24,19.5,12
Category_Wikipedia_sockpuppets_of_Lukesellers1.csv,2,29.0,2,0,2,0,0,60.0,120,16,16.0,16
Category_Wikipedia_sockpuppets_of_Coffeecupsncrepes.csv,35,6430580.0,27,8,18,9,0,32.714285714285715,218,17,14.714285714285714,13
Category_Wikipedia_sockpuppets_of_Spmenon33.csv,167,103517844.0,67,100,64,3,0,40.74850299401198,268,53,15.467065868263473,12
Category_Wikipedia_sockpuppets_of_Ieditlikeaboss.csv,67,3520466.0,17,50,6,11,0,69.22388059701493,257,22,13.0,9
Category_Wikipedia_sockpuppets_of_Helpful14.csv,1338,7528460.0,463,875,462,1,0,29.679372197309416,314,59,22.50523168908819,5
Category_Wikipedia_sockpuppets_of_Andrews.pabrai.csv,16,3376650.0,10,6,8,2,0,31.0,85,24,16.75,3
Category_Wikipedia_sockpuppets_of_HonestyAlwaysWins.csv,10,243936.0,8,2,7,1,0,33.5,168,14,14.0,14
Category_Wikipedia_sockpuppets_of_RajtheEmperor.csv,4507,50121165.0,1625,2882,500,1125,0,34.42933214998891,255,60,16.7290880852008,3
Category_Wikipedia_sockpuppets_of_Aakpan.csv,229,59438989.0,67,162,17,50,0,48.06113537117904,253,53,23.938864628820962,5
Category_Wikipedia_sockpuppets_of_Sarabjit123.csv,19,2686420.0,6,13,5,1,0,31.05263157894737,145,14,14.0,14
Category_Wikipedia_sockpuppets_of_SK_fanella.csv,164,2366098.0,53,111,32,21,0,60.103658536585364,500,52,15.201219512195122,6
Category_Wikipedia_sockpuppets_of_Morena2610.csv,36,6054551.0,17,19,17,0,0,21.61111111111111,108,54,40.30555555555556,25
Category_Wikipedia_sockpuppets_of_ImSonyR9.csv,2896,37618161.0,1000,1896,500,500,0,38.18646408839779,496,85,28.061809392265193,6
Category_Wikipedia_sockpuppets_of_·Ω≠œÉœÄŒµœÅ_Œ≥·Ω∞œÅ_·ºÄœÜ'_·ºëŒ∫Œ±œÑŒ≠œÅœâŒΩ.csv,811,359587.0,182,629,97,85,0,46.74969173859433,234,40,12.480887792848335,4
Category_Wikipedia_sockpuppets_of_EccellenzaItalia.csv,33,2148091.0,22,11,12,10,0,22.21212121212121,155,52,37.57575757575758,18
Category_Wikipedia_sockpuppets_of_Givemelibertythemovie.csv,4,2056.0,4,0,3,1,0,49.0,196,27,24.0,15
Category_Wikipedia_sockpuppets_of_RohithKumarPatali.csv,1460,107479467.0,480,980,478,2,0,41.903424657534245,263,89,19.165753424657535,3
Category_Wikipedia_sockpuppets_of_U2000saksena.csv,9,254185.0,6,3,5,1,0,46.666666666666664,151,3,2.3333333333333335,2
Category_Wikipedia_sockpuppets_of_Shuppiluliuma.csv,25325,536086496.0,7989,17336,500,7489,0,42.55095755182626,500,56,15.17634748272458,3
Category_Wikipedia_sockpuppets_of_Haroldpretzelstudmaster.csv,23,5025517.0,12,11,8,4,0,62.608695652173914,176,29,13.695652173913043,7
Category_Wikipedia_sockpuppets_of_Rorylyng.csv,1707,359155424.0,401,1306,172,229,0,45.9502050380785,284,47,18.725248974809606,4
Category_Wikipedia_sockpuppets_of_Emmetfoster.csv,26,10875466.0,7,19,3,4,0,75.3076923076923,239,61,13.0,5
Category_Wikipedia_sockpuppets_of_Ihatelonlygirl.csv,51,1744.0,17,34,14,3,0,40.19607843137255,194,53,19.392156862745097,9
Category_Wikipedia_sockpuppets_of_Dr.YovaniChavez.csv,17,16500.0,10,7,6,4,13,66.47058823529412,259,30,16.235294117647058,10
Category_Wikipedia_sockpuppets_of_Osama_chandio.csv,498,31940257.0,168,330,23,145,0,50.636546184738954,255,47,19.05823293172691,5
Category_Wikipedia_sockpuppets_of_Brooks_mesha_gay.csv,304,2342766.0,105,199,41,64,0,48.78947368421053,255,39,24.01644736842105,8
Category_Wikipedia_sockpuppets_of_Benjackson77.csv,265,130019003.0,135,130,116,19,0,55.81509433962264,255,62,22.411320754716982,13
Category_Wikipedia_sockpuppets_of_INQbnx.csv,27,10004006.0,21,6,10,11,0,34.18518518518518,117,25,25.0,25
Category_Wikipedia_sockpuppets_of_Hedgehog59804.csv,52,1179797.0,21,31,21,0,0,56.21153846153846,219,30,15.673076923076923,7
Category_Wikipedia_sockpuppets_of_Gnomsovet.csv,2123,316878228.0,576,1547,318,258,0,46.453132359868114,500,54,21.31700423928403,5
Category_Wikipedia_sockpuppets_of_Rendy_Marciano.csv,211,3764611.0,77,134,71,6,0,34.21327014218009,222,34,21.900473933649288,6
Category_Wikipedia_sockpuppets_of_Azturkk.csv,575,13502797.0,192,383,188,4,0,44.90782608695652,255,31,17.097391304347827,7
Category_Wikipedia_sockpuppets_of_Kumarrao.csv,1955,297119581.0,547,1408,500,47,0,44.972890025575445,255,54,17.591304347826085,5
Category_Wikipedia_sockpuppets_of_Aliabbashiraqi79.csv,662,14001214.0,174,488,75,99,0,45.68429003021148,253,43,15.472809667673715,7
Category_Wikipedia_sockpuppets_of_Joseph_Robert_Neil_James.csv,298,246793248.0,108,190,94,14,0,34.52684563758389,233,36,21.513422818791945,5
Category_Wikipedia_sockpuppets_of_KillAllSpammers.csv,128,53736239.0,51,77,20,31,0,51.890625,199,53,12.2734375,4
Category_Wikipedia_sockpuppets_of_1MDB_Group.csv,74,4678398.0,19,55,15,4,0,38.4054054054054,251,37,26.743243243243242,14
Category_Wikipedia_sockpuppets_of_Mister_Sirloin.csv,15,6907599.0,4,11,2,2,0,30.933333333333334,125,22,12.0,10
Category_Wikipedia_sockpuppets_of_JakecarpenterADBAPI.csv,28,79925.0,26,2,20,6,0,25.464285714285715,176,19,19.0,19
Category_Wikipedia_sockpuppets_of_Bule_Cloud.csv,2608,188504973.0,1045,1563,500,545,0,32.67944785276074,494,62,26.261503067484664,8
Category_Wikipedia_sockpuppets_of_Thson10.csv,100,24465240.0,35,65,15,20,0,32.52,146,53,17.69,10
Category_Wikipedia_sockpuppets_of_Benny_Makamu.csv,24,8019239.0,12,12,12,0,0,41.791666666666664,255,25,20.083333333333332,16
Category_Wikipedia_sockpuppets_of_Custodi2.csv,8508,250064940.0,2471,6037,118,2353,0,44.169487541137755,499,76,21.911259990597085,2
Category_Wikipedia_sockpuppets_of_Kontribut.csv,31,2010797.0,10,21,10,0,0,58.774193548387096,373,30,14.161290322580646,8
Category_Wikipedia_sockpuppets_of_Pamela_Gardiner.csv,1806,131603423.0,596,1210,500,96,0,44.21373200442968,255,47,16.088039867109636,4
Category_Wikipedia_sockpuppets_of_Xindeho.csv,3455,14403484.0,1000,2455,500,500,0,47.64254703328509,499,70,24.673516642547032,3
Category_Wikipedia_sockpuppets_of_Finnedi.csv,641,39134513.0,183,458,102,81,0,52.8798751950078,254,47,24.839313572542903,8
Category_Wikipedia_sockpuppets_of_(Chemistry).csv,31,5576399.0,19,12,3,16,0,92.90322580645162,253,31,22.161290322580644,16
Category_Wikipedia_sockpuppets_of_Buchibaba.csv,720,45931036.0,164,556,76,88,0,56.775,249,49,16.793055555555554,3
Category_Wikipedia_sockpuppets_of_Njc9295.csv,42,16943456.0,14,28,10,4,0,60.785714285714285,199,36,13.285714285714286,3
Category_Wikipedia_sockpuppets_of_Maxxis_Tires.csv,195,196473917.0,39,156,6,33,0,43.88717948717949,231,68,18.682051282051283,3
Category_Wikipedia_sockpuppets_of_Oti_kelechukwu_Godwin_._S.csv,67,2360450.0,40,27,25,15,0,21.73134328358209,135,38,25.567164179104477,6
Category_Wikipedia_sockpuppets_of_Daved_Fitzsmatrik.csv,5,368.0,3,2,1,2,0,6.4,16,9,9.0,9
Category_Wikipedia_sockpuppets_of_Sifthelp.csv,510,54807066.0,115,395,10,105,0,65.33725490196079,487,39,17.172549019607843,2
Category_Wikipedia_sockpuppets_of_Lobismari√±eiro.csv,88,62375493.0,23,65,13,10,0,64.25,254,26,15.227272727272727,12
Category_Wikipedia_sockpuppets_of_Woking123.csv,4010,86968212.0,1530,2480,500,1030,0,31.678553615960098,459,47,19.071072319201996,8
Category_Wikipedia_sockpuppets_of_Alan_Fillings.csv,111,54915940.0,38,73,14,24,0,37.16216216216216,226,45,24.90990990990991,6
Category_Wikipedia_sockpuppets_of_Sabeeel43.csv,2108,14811135.0,910,1198,500,410,0,42.139943074003796,260,65,20.049810246679318,2
Category_Wikipedia_sockpuppets_of_FranTudor32.csv,346,2411224.0,111,235,104,7,0,30.24277456647399,238,31,17.410404624277458,7
Category_Wikipedia_sockpuppets_of_NewEnglandPatriots1998.csv,1654,10447977.0,540,1114,500,40,0,38.83071342200726,397,50,18.587061668681983,8
Category_Wikipedia_sockpuppets_of_Maximzub.csv,169,168298160.0,59,110,56,3,0,48.49704142011834,376,46,18.60355029585799,7
Category_Wikipedia_sockpuppets_of_Saleemsinghbhaikhan.csv,155,32524993.0,83,72,5,78,0,78.34193548387097,255,13,12.212903225806452,12
Category_Wikipedia_sockpuppets_of_Tricolore.csv,359,68777760.0,126,233,46,80,0,62.467966573816156,404,53,16.45682451253482,6
Category_Wikipedia_sockpuppets_of_Fall_Lake_Hill.csv,865,11548024.0,559,306,339,220,0,22.510982658959538,225,52,25.885549132947975,18
Category_Wikipedia_sockpuppets_of_Loserdick.csv,3,50.0,2,1,2,0,0,17.666666666666668,53,12,8.0,6
Category_Wikipedia_sockpuppets_of_ARNOBDAS099.csv,1,0.0,1,0,1,0,29,29.0,29,9,9.0,9
Category_Wikipedia_sockpuppets_of_Colman2000.csv,1578,198036561.0,552,1026,500,52,0,45.128010139416986,424,61,20.457541191381495,6
Category_Wikipedia_sockpuppets_of_Siddesh2345.csv,11,6354737.0,8,3,5,3,0,42.54545454545455,88,51,25.363636363636363,17
Category_Wikipedia_sockpuppets_of_Setswana.csv,2421,23788457.0,767,1654,373,394,0,45.73812474184221,496,71,25.781082197439076,4
Category_Wikipedia_sockpuppets_of_Jobes38.csv,220,32411236.0,61,159,41,20,0,65.05,255,40,17.454545454545453,3
Category_Wikipedia_sockpuppets_of_Dewarw.csv,1527,33185784.0,500,1027,500,0,0,38.876882776686315,259,56,25.12966601178782,3
Category_Wikipedia_sockpuppets_of_Manuelobell.csv,226,13659280.0,77,149,50,27,0,61.98672566371681,417,40,27.411504424778762,6
Category_Wikipedia_sockpuppets_of_Eagleeye321.csv,192,31792027.0,67,125,47,20,0,65.34375,310,60,15.166666666666666,6
Category_Wikipedia_sockpuppets_of_Marmuuuuu.csv,99,3649384.0,37,62,27,10,0,46.39393939393939,337,34,16.636363636363637,12
Category_Wikipedia_sockpuppets_of_StephenMas0.csv,93,10850746.0,28,65,10,18,0,45.58064516129032,219,26,14.903225806451612,5
Category_Wikipedia_sockpuppets_of_Yash_nagare.csv,164,63662440.0,75,89,34,41,0,36.9390243902439,196,43,17.609756097560975,4
Category_Wikipedia_sockpuppets_of_Goochattack.csv,49,271871.0,17,32,9,8,0,33.97959183673469,206,13,10.918367346938776,8
Category_Wikipedia_sockpuppets_of_Cristina0517.csv,25,18045050.0,10,15,9,1,0,31.32,144,12,12.0,12
Category_Wikipedia_sockpuppets_of_Abhirup2441139.csv,81,188987.0,32,49,20,12,0,44.5679012345679,166,53,37.617283950617285,16
Category_Wikipedia_sockpuppets_of_Conlon_Nancarrow.csv,307,220601262.0,101,206,54,47,0,39.74267100977199,239,40,20.41368078175896,7
Category_Wikipedia_sockpuppets_of_SahilGupta-Sahil.csv,123,6650059.0,37,86,16,21,0,54.6910569105691,216,45,21.260162601626018,11
Category_Wikipedia_sockpuppets_of_Sohankowsar.csv,85,11918542.0,41,44,23,18,0,40.36470588235294,301,22,17.623529411764707,8
Category_Wikipedia_sockpuppets_of_Projects.csv,2042,469200432.0,598,1444,500,98,0,45.81635651322233,337,60,17.19588638589618,4
Category_Wikipedia_sockpuppets_of_Emily_Khine.csv,5148,53314237.0,2512,2636,500,2012,0,38.83566433566433,357,86,20.13752913752914,4
Category_Wikipedia_sockpuppets_of_Thrax.csv,987,44513330.0,474,513,446,28,0,42.08915906788247,199,62,23.807497467071936,5
Category_Wikipedia_sockpuppets_of_Bibrrr.csv,10,2087500.0,4,6,2,2,0,61.0,106,28,28.0,28
Category_Wikipedia_sockpuppets_of_MadisonGrundtvig.csv,1597,7400138.0,519,1078,500,19,0,41.7125860989355,255,47,17.830306825297434,2
Category_Wikipedia_sockpuppets_of_PrincessRankStar.csv,323,39334722.0,79,244,50,29,0,50.975232198142415,238,53,21.408668730650156,5
Category_Wikipedia_sockpuppets_of_Ssoetan.csv,31,49858787.0,12,19,8,4,0,50.58064516129032,196,33,21.35483870967742,11
Category_Wikipedia_sockpuppets_of_Clairestandish.csv,1474,12555749.0,622,852,344,278,0,40.594301221166894,255,42,16.799864314789687,10
Category_Wikipedia_sockpuppets_of_Darkred.csv,1578,25997659.0,507,1071,500,7,0,35.165399239543724,200,51,18.427756653992397,4
Category_Wikipedia_sockpuppets_of_Uditanalin.csv,304,361655058.0,101,203,91,10,0,45.48026315789474,254,96,32.62828947368421,16
Category_Wikipedia_sockpuppets_of_Raspor.csv,5070,554933045.0,1279,3791,500,779,0,50.1414201183432,395,60,21.502366863905326,5
Category_Wikipedia_sockpuppets_of_Romg10.csv,43,25788343.0,10,33,6,4,0,56.86046511627907,147,45,19.209302325581394,11
Category_Wikipedia_sockpuppets_of_Bahador_kharazmi.csv,37,48787525.0,15,22,14,1,0,41.24324324324324,254,48,23.43243243243243,11
Category_Wikipedia_sockpuppets_of_Anonymous.scripter1995.csv,133,54055850.0,45,88,32,13,0,55.21052631578947,269,34,16.37593984962406,9
Category_Wikipedia_sockpuppets_of_Noncanonical.csv,244,4326976.0,80,164,57,23,0,46.49180327868852,250,57,27.92622950819672,14
Category_Wikipedia_sockpuppets_of_Sisiluncai.csv,1333,1466092.0,505,828,500,5,0,30.261065266316578,224,52,19.858964741185297,5
Category_Wikipedia_sockpuppets_of_Teriko.csv,88,28341566.0,26,62,15,11,0,40.61363636363637,199,47,19.90909090909091,10
Category_Wikipedia_sockpuppets_of_JoeCostal.csv,38,1663123.0,30,8,25,5,0,42.39473684210526,338,36,17.789473684210527,11
Category_Wikipedia_sockpuppets_of_Nathanevans123.csv,9,86849.0,5,4,4,1,0,40.44444444444444,169,19,11.0,7
Category_Wikipedia_sockpuppets_of_Euro2024.csv,1144,42219380.0,532,612,500,32,0,31.399475524475523,320,54,27.033216783216783,9
Category_Wikipedia_sockpuppets_of_Hobojaks.csv,2586,37783258.0,1432,1154,500,932,0,42.79659706109822,217,129,24.418793503480277,6
Category_Wikipedia_sockpuppets_of_Sok_Chea.csv,321,10425526.0,120,201,117,3,0,19.327102803738317,240,33,16.345794392523363,8
Category_Wikipedia_sockpuppets_of_SAIestate.csv,33,18729026.0,11,22,9,2,0,43.45454545454545,126,20,17.636363636363637,17
Category_Wikipedia_sockpuppets_of_TotoMovie.csv,205,10969770.0,56,149,12,44,0,47.10243902439024,297,43,23.985365853658536,8
Category_Wikipedia_sockpuppets_of_K-ifyouwant.csv,105,205284224.0,30,75,27,3,0,58.78095238095238,395,51,26.942857142857143,14
Category_Wikipedia_sockpuppets_of_Hubier.csv,673,4386034.0,204,469,138,66,0,30.27637444279346,190,58,17.692421991084696,6
Category_Wikipedia_sockpuppets_of_Celldea.csv,1361,5187616.0,292,1069,192,100,0,27.21234386480529,203,51,18.416605437178546,5
Category_Wikipedia_sockpuppets_of_Higuy6153.csv,65,5485.0,53,12,31,22,0,16.73846153846154,198,37,31.046153846153846,19
Category_Wikipedia_sockpuppets_of_Mcdiarmidc.csv,301,29283144.0,73,228,30,43,0,37.96013289036545,217,60,15.843853820598007,3
Category_Wikipedia_sockpuppets_of_Alfaweiss.csv,3652,6104467.0,1129,2523,500,629,0,25.636363636363637,255,46,16.339539978094194,3
Category_Wikipedia_sockpuppets_of_Leslie_Barrenal.csv,7,17346.0,4,3,2,2,17,39.857142857142854,78,29,23.714285714285715,20
Category_Wikipedia_sockpuppets_of_NicAgent.csv,4247,31636569.0,1213,3034,500,713,0,32.01153755592183,255,85,20.74287732517071,2
Category_Wikipedia_sockpuppets_of_Kristin_Aleece_Reinhart.csv,12,261983.0,8,4,6,2,20,53.583333333333336,145,33,30.333333333333332,25
Category_Wikipedia_sockpuppets_of_Mathabelalagusara.csv,91,42852877.0,26,65,7,19,0,57.10989010989011,287,32,10.901098901098901,4
Category_Wikipedia_sockpuppets_of_Hatsle.csv,2759,120965188.0,1105,1654,468,637,0,42.61036607466473,498,62,14.981877491844871,3
Category_Wikipedia_sockpuppets_of_Zoltanfeher.csv,26,2968515.0,10,16,4,6,0,45.57692307692308,191,63,27.26923076923077,10
Category_Wikipedia_sockpuppets_of_Juliasabrina999.csv,187,18828923.0,48,139,2,46,0,53.50267379679144,320,27,15.117647058823529,8
Category_Wikipedia_sockpuppets_of_Rastjoo.csv,50,1162792.0,31,19,29,2,0,68.66,404,39,31.66,13
Category_Wikipedia_sockpuppets_of_Njsample.csv,14,7399.0,6,8,6,0,0,55.285714285714285,175,20,20.0,20
Category_Wikipedia_sockpuppets_of_Guerillafilm.csv,773,1302359.0,308,465,215,93,0,31.283311772315653,200,50,19.14489003880983,9
Category_Wikipedia_sockpuppets_of_Googlean.csv,2877,23729689.0,980,1897,500,480,0,50.91449426485923,250,77,23.488703510601322,3
Category_Wikipedia_sockpuppets_of_TorontoMovement.csv,35,23241206.0,32,3,30,2,0,23.02857142857143,72,43,27.514285714285716,23
Category_Wikipedia_sockpuppets_of_Pna.wpedia.csv,22,20135515.0,15,7,15,0,0,40.77272727272727,245,21,16.454545454545453,16
Category_Wikipedia_sockpuppets_of_Damdes.csv,23,258048.0,6,17,6,0,0,67.26086956521739,207,15,10.043478260869565,3
Category_Wikipedia_sockpuppets_of_Kellydessaint.csv,60,142382291.0,19,41,19,0,0,26.933333333333334,117,26,16.683333333333334,8
Category_Wikipedia_sockpuppets_of_N-g-Efrat.csv,34,37146941.0,23,11,17,6,0,45.970588235294116,200,30,29.529411764705884,14
Category_Wikipedia_sockpuppets_of_Serpentza.csv,122,39227486.0,45,77,37,8,0,43.4344262295082,255,64,16.21311475409836,7
Category_Wikipedia_sockpuppets_of_BagelsbytheDozen.csv,118,19962761.0,34,84,19,15,0,61.652542372881356,216,47,20.661016949152543,11
Category_Wikipedia_sockpuppets_of_Puppetfunny.csv,1670,56105623.0,666,1004,500,166,0,50.73233532934132,255,57,20.891616766467067,3
Category_Wikipedia_sockpuppets_of_GeoJoe1000.csv,1885,240193660.0,691,1194,500,191,0,43.12519893899204,292,72,27.36604774535809,6
Category_Wikipedia_sockpuppets_of_Foxes-cant-nya.csv,17,5287.0,9,8,6,3,0,71.17647058823529,193,12,12.0,12
Category_Wikipedia_sockpuppets_of_FBedits.csv,1284,12864378.0,541,743,487,54,0,35.320093457943926,356,62,18.315420560747665,7
Category_Wikipedia_sockpuppets_of_Kittenpow.csv,52,26355980.0,37,15,36,1,0,58.96153846153846,231,21,17.03846153846154,16
Category_Wikipedia_sockpuppets_of_Lole484.csv,6293,88566329.0,2372,3921,500,1872,0,27.57603686635945,460,63,16.232639440648338,4
Category_Wikipedia_sockpuppets_of_Ultimatebruhmoment.csv,57,21899367.0,16,41,8,8,0,61.92982456140351,380,33,11.789473684210526,7
Category_Wikipedia_sockpuppets_of_Xfactornzedit.csv,951,38211888.0,443,508,427,16,0,38.55625657202944,244,50,29.915878023133544,10
Category_Wikipedia_sockpuppets_of_Helenwolff.csv,100,237498303.0,40,60,33,7,0,38.18,211,34,25.91,15
Category_Wikipedia_sockpuppets_of_Jjonjonjon.csv,66,1034129.0,24,42,24,0,0,36.196969696969695,182,45,18.09090909090909,11
Category_Wikipedia_sockpuppets_of_Wilma_Henderson.csv,34,72769.0,12,22,12,0,0,39.23529411764706,149,47,30.0,14
Category_Wikipedia_sockpuppets_of_Rachel_Josephson.csv,794,132987981.0,381,413,190,191,0,33.37531486146096,233,55,19.93198992443325,7
Category_Wikipedia_sockpuppets_of_Conycapony.csv,6,1633.0,5,1,3,2,12,69.0,196,20,17.166666666666668,13
Category_Wikipedia_sockpuppets_of_Favorhamilton.csv,22,702589.0,17,5,9,8,0,31.5,192,20,19.40909090909091,19
Category_Wikipedia_sockpuppets_of_PaxEquilibrium.csv,6919,562390593.0,2035,4884,500,1535,0,39.838705015175606,468,70,18.574938574938574,3
Category_Wikipedia_sockpuppets_of_Pritam_kumar_roni_das.csv,1757,23915121.0,749,1008,500,249,0,23.21969265793967,496,46,21.095617529880478,5
Category_Wikipedia_sockpuppets_of_Lt._Shahbaz.csv,156,2066888.0,78,78,33,45,0,37.3974358974359,236,57,27.346153846153847,11
Category_Wikipedia_sockpuppets_of_Chicken1997.csv,7,8643.0,3,4,3,0,5,55.857142857142854,172,19,18.142857142857142,17
Category_Wikipedia_sockpuppets_of_Cissypope.csv,95,214263333.0,45,50,28,17,0,45.757894736842104,227,45,29.810526315789474,18
Category_Wikipedia_sockpuppets_of_Mehdifootball1377.csv,1776,21982391.0,667,1109,500,167,0,19.32882882882883,235,56,16.49662162162162,7
Category_Wikipedia_sockpuppets_of_Syarizul_14.csv,44,90959.0,20,24,15,5,0,46.52272727272727,221,18,13.886363636363637,10
Category_Wikipedia_sockpuppets_of_Mathew_Banks.csv,185,21189078.0,62,123,10,52,0,58.49189189189189,255,26,10.87027027027027,2
Category_Wikipedia_sockpuppets_of_SpareSeiko.csv,1188,37182849.0,446,742,129,317,0,50.1557239057239,493,99,27.435185185185187,6
Category_Wikipedia_sockpuppets_of_jbelvford.csv,16,193946.0,11,5,5,6,0,47.1875,190,22,21.5,20
Category_Wikipedia_sockpuppets_of_Galendalia.csv,4578,93045909.0,1593,2985,500,1093,0,66.20620358235037,500,71,22.628440366972477,1
Category_Wikipedia_sockpuppets_of_Yashwardhan_Kachhawaha.csv,204,56315327.0,73,131,53,20,0,43.431372549019606,258,47,14.338235294117647,5
Category_Wikipedia_sockpuppets_of_Rakshit_Banjaria.csv,691,19639181.0,256,435,222,34,0,53.13024602026049,500,42,14.808972503617944,5
Category_Wikipedia_sockpuppets_of_Jyongchul.csv,276,396778.0,92,184,33,59,0,47.98550724637681,203,47,17.746376811594203,6
Category_Wikipedia_sockpuppets_of_Fjcaballes.csv,21,5721364.0,5,16,5,0,0,63.142857142857146,196,18,17.571428571428573,15
Category_Wikipedia_sockpuppets_of_ArmenianJoe.csv,391,9158435.0,113,278,108,5,0,35.549872122762146,199,50,19.542199488491047,4
Category_Wikipedia_sockpuppets_of_Dereks1x.csv,20174,407105417.0,6940,13234,500,6440,0,47.977644492911665,500,96,24.911371071676417,2
Category_Wikipedia_sockpuppets_of_HRA1924.csv,466,195951920.0,145,321,90,55,0,49.182403433476395,234,47,22.182403433476395,6
Category_Wikipedia_sockpuppets_of_Mechanismtongs.csv,509,7012800.0,207,302,112,95,0,21.95088408644401,181,57,19.241650294695482,4
Category_Wikipedia_sockpuppets_of_Anwar_saadat.csv,1976,153005441.0,561,1415,500,61,0,32.046052631578945,249,81,17.635627530364374,5
Category_Wikipedia_sockpuppets_of_Ham2703.csv,3597,31309446.0,1210,2387,500,710,0,41.97970530998054,499,80,15.370864609396719,4
Category_Wikipedia_sockpuppets_of_PCC1924.csv,29,1706208.0,19,10,9,10,0,56.89655172413793,249,21,21.0,21
Category_Wikipedia_sockpuppets_of_HaleluyaT.csv,33,476485.0,16,17,9,7,0,38.878787878787875,229,27,16.727272727272727,12
Category_Wikipedia_sockpuppets_of_BillieKing.csv,74,3660263.0,29,45,14,15,0,25.527027027027028,158,33,14.5,11
Category_Wikipedia_sockpuppets_of_Need1521.csv,586,59478893.0,168,418,31,137,0,63.66382252559727,255,57,20.022184300341298,7
Category_Wikipedia_sockpuppets_of_AllenHiles.csv,1,0.0,1,0,1,0,57,57.0,57,16,16.0,16
Category_Wikipedia_sockpuppets_of_Kadenrussell.csv,22,4525554.0,15,7,8,7,5,36.36363636363637,141,20,15.181818181818182,6
Category_Wikipedia_sockpuppets_of_Lucarias456$.csv,39,2110.0,14,25,14,0,0,67.8974358974359,268,33,18.512820512820515,9
Category_Wikipedia_sockpuppets_of_Blurk56.csv,481,235968003.0,185,296,118,67,0,39.93139293139293,255,62,23.74012474012474,12
Category_Wikipedia_sockpuppets_of_Filiprino.csv,1546,126709076.0,610,936,500,110,0,59.14812419146184,447,55,23.001293661060803,4
Category_Wikipedia_sockpuppets_of_Ceresdaulat.csv,9,1808164.0,4,5,2,2,0,47.77777777777778,182,16,16.0,16
Category_Wikipedia_sockpuppets_of_Thomp.csv,10574,177234379.0,3571,7003,500,3071,0,36.42632873084925,262,75,17.858520900321544,4
Category_Wikipedia_sockpuppets_of_A_Den_Jentyl_Ettien_Avel_Dysklyver.csv,6554,38363940.0,2557,3997,500,2057,0,65.51922490082393,446,111,30.17104058590174,1
Category_Wikipedia_sockpuppets_of_Lewis_at_wildshots.csv,3,44.0,2,1,2,0,12,12.0,12,9,9.0,9
Category_Wikipedia_sockpuppets_of_Rclmr.csv,31,2963070.0,26,5,19,7,0,42.516129032258064,130,21,12.290322580645162,12
Category_Wikipedia_sockpuppets_of_Dublin1994.csv,433,36574343.0,125,308,60,65,0,50.1431870669746,239,60,12.840646651270207,4
Category_Wikipedia_sockpuppets_of_Chrisnadeau1973.csv,211,7806632.0,46,165,19,27,0,52.943127962085306,255,70,30.0,4
Category_Wikipedia_sockpuppets_of_Steinberg2000.csv,424,5389876.0,159,265,93,66,0,46.007075471698116,249,42,25.89622641509434,11
Category_Wikipedia_sockpuppets_of_Gameworldduelist2.csv,5114,65828797.0,1298,3816,500,798,0,35.037739538521706,268,73,19.418654673445445,3
Category_Wikipedia_sockpuppets_of_Ahmed_shahi.csv,2994,21196522.0,873,2121,500,373,0,45.454575818303276,254,54,22.408483633934537,4
Category_Wikipedia_sockpuppets_of_Nuralamin12.csv,49,68260064.0,10,39,6,4,0,41.46938775510204,255,24,16.163265306122447,9
Category_Wikipedia_sockpuppets_of_Drwebnow.csv,1,0.0,1,0,1,0,20,20.0,20,46,46.0,46
Category_Wikipedia_sockpuppets_of_TheRealELander.csv,49,35706152.0,25,24,13,12,0,49.204081632653065,193,50,22.612244897959183,8
Category_Wikipedia_sockpuppets_of_PremierePrush.csv,199,2011553.0,72,127,50,22,0,56.68341708542714,366,61,20.396984924623116,5
Category_Wikipedia_sockpuppets_of_Navjot5551.csv,3,617.0,2,1,2,0,0,30.666666666666668,46,15,15.0,15
Category_Wikipedia_sockpuppets_of_TheInvisibleMachine.csv,792,370235592.0,221,571,47,174,0,47.359848484848484,255,58,19.73611111111111,3
Category_Wikipedia_sockpuppets_of_Avinashkrishnadasa.csv,1,0.0,1,0,1,0,44,44.0,44,18,18.0,18
Category_Wikipedia_sockpuppets_of_Jamal047.csv,2709,55692687.0,743,1966,500,243,0,54.57918050941307,495,59,14.701734957548911,4
Category_Wikipedia_sockpuppets_of_Menellelelele.csv,579,2672430.0,157,422,43,114,0,41.55440414507772,449,72,17.813471502590673,9
Category_Wikipedia_sockpuppets_of_IKnowAlotOfStuff1204.csv,23,67711.0,12,11,7,5,0,20.434782608695652,179,42,28.304347826086957,12
Category_Wikipedia_sockpuppets_of_Amanpreet_Singh_Sokhi.csv,51,354566.0,27,24,13,14,0,46.431372549019606,249,39,21.568627450980394,5
Category_Wikipedia_sockpuppets_of_LSXsound.csv,750,600893.0,258,492,238,20,0,27.597333333333335,200,50,19.089333333333332,3
Category_Wikipedia_sockpuppets_of_Kalarimaster.csv,10287,174296109.0,3141,7146,500,2641,0,43.8034412365121,255,81,18.10877806940799,2
Category_Wikipedia_sockpuppets_of_Jha09.csv,5401,38102260.0,1904,3497,500,1404,0,38.0735049064988,503,59,16.756711720051843,5
Category_Wikipedia_sockpuppets_of_S_M_Jahid_Hasan1971.csv,273,44280496.0,96,177,64,32,0,48.35897435897436,207,53,25.593406593406595,9
Category_Wikipedia_sockpuppets_of_Similar2me.csv,1806,64829318.0,484,1322,170,314,0,41.37375415282392,496,57,15.526024363233665,7
Category_Wikipedia_sockpuppets_of_BZAW31559.csv,1168,8034241.0,432,736,273,159,0,56.832191780821915,300,57,23.01027397260274,4
Category_Wikipedia_sockpuppets_of_Nairspecht.csv,4244,74862311.0,1345,2899,500,845,0,54.30890669180019,255,64,18.82775683317625,3
Category_Wikipedia_sockpuppets_of_Uwdwadafsainainawinfi.csv,1383,6907283.0,505,878,500,5,0,48.506146059291396,490,67,34.466377440347074,4
Category_Wikipedia_sockpuppets_of_JayJasper.csv,16856,210035335.0,5078,11778,500,4578,0,58.685215946843854,255,117,23.746499762695777,3
Category_Wikipedia_sockpuppets_of_BOWLINGBLUERECORDS.csv,21,52366.0,12,9,10,2,10,75.76190476190476,174,22,15.476190476190476,13
Category_Wikipedia_sockpuppets_of_Coryioquiqui.csv,1,0.0,1,0,1,0,0,0.0,0,16,16.0,16
Category_Wikipedia_sockpuppets_of_Artcurator.csv,1041,258395089.0,499,542,308,191,0,40.73102785782901,494,53,18.384245917387126,6
Category_Wikipedia_sockpuppets_of_Simonchakma.csv,27,9586.0,10,17,8,2,8,58.51851851851852,208,25,12.62962962962963,8
Category_Wikipedia_sockpuppets_of_Jjjoooonnn.csv,193,21318333.0,96,97,85,11,0,68.46632124352331,497,38,20.849740932642487,11
Category_Wikipedia_sockpuppets_of_Xaytaw23.csv,115,1206305.0,34,81,26,8,0,39.96521739130435,210,30,15.965217391304348,3
Category_Wikipedia_sockpuppets_of_GregaR89.csv,181,114627844.0,45,136,43,2,0,41.13812154696133,199,45,17.756906077348066,8
Category_Wikipedia_sockpuppets_of_Wanchung_Hu.csv,195,173345036.0,39,156,36,3,0,50.88717948717949,250,50,20.317948717948717,11
Category_Wikipedia_sockpuppets_of_CroDome.csv,306,6041350.0,109,197,76,33,0,26.258169934640524,199,56,17.33986928104575,5
Category_Wikipedia_sockpuppets_of_Wikiabirras.csv,501,74908585.0,145,356,34,111,0,42.81437125748503,322,51,19.241516966067863,3
Category_Wikipedia_sockpuppets_of_Lft6771.csv,2614,59593552.0,822,1792,500,322,0,41.83129303749043,220,100,18.539785768936497,4
Category_Wikipedia_sockpuppets_of_Enoxod.csv,2974,19903546.0,1222,1752,500,722,0,32.03665097511769,263,50,19.060524546065903,3
Category_Wikipedia_sockpuppets_of_Ellidon217.csv,314,101208731.0,110,204,83,27,0,52.12101910828026,330,52,23.101910828025478,6
Category_Wikipedia_sockpuppets_of_HaradaSanosuke.csv,601,4366139.0,167,434,167,0,0,39.05657237936772,200,39,10.843594009983361,5
Category_Wikipedia_sockpuppets_of_Alpha_Beta_Gaga.csv,389,20610532.0,88,301,63,25,0,46.282776349614394,225,33,16.41388174807198,6
Category_Wikipedia_sockpuppets_of_Suhayl0207.csv,23,181790.0,23,0,21,2,0,22.08695652173913,35,20,20.0,20
Category_Wikipedia_sockpuppets_of_Yazidis_are_not_Kurds.csv,74,1643519.0,33,41,25,8,0,51.567567567567565,168,43,19.43243243243243,8
Category_Wikipedia_sockpuppets_of_ROBERTSHST.csv,459,10925410.0,133,326,86,47,0,54.30065359477124,316,53,16.387799564270153,3
Category_Wikipedia_sockpuppets_of_Umertan.csv,650,140787415.0,179,471,147,32,0,59.85076923076923,498,63,18.773846153846154,4
Category_Wikipedia_sockpuppets_of_Nick_Chirco.csv,599,7435520.0,188,411,172,16,0,36.53589315525876,239,49,16.21702838063439,4
Category_Wikipedia_sockpuppets_of_John_Ranchie.csv,57,923225.0,24,33,16,8,0,37.63157894736842,221,55,20.80701754385965,11
Category_Wikipedia_sockpuppets_of_Saguiar50.csv,898,8220146.0,339,559,210,129,0,42.63140311804009,500,47,19.57683741648107,5
Category_Wikipedia_sockpuppets_of_Icomefromfaraway.csv,3518,76210596.0,1090,2428,229,861,0,48.576179647527006,428,53,16.871233655486073,3
Category_Wikipedia_sockpuppets_of_Elianamwiha.csv,1169,204245241.0,503,666,500,3,0,53.194183062446534,224,102,21.679213002566296,3
Category_Wikipedia_sockpuppets_of_BrandonRuanoAlvarez7151977.csv,62,3582817.0,22,40,13,9,0,56.403225806451616,184,14,12.209677419354838,10
Category_Wikipedia_sockpuppets_of_RachelleLin.csv,261,18408695.0,90,171,47,43,0,52.74329501915709,230,33,16.597701149425287,5
Category_Wikipedia_sockpuppets_of_JitsuFighter.csv,3361,91507743.0,787,2574,500,287,0,39.45075870276703,255,58,14.73757810175543,4
Category_Wikipedia_sockpuppets_of_Combsnic.csv,9,1955.0,6,3,5,1,32,142.88888888888889,250,9,9.0,9
Category_Wikipedia_sockpuppets_of_Llalalayay.csv,23,3750.0,17,6,12,5,0,34.78260869565217,193,22,22.0,22
Category_Wikipedia_sockpuppets_of_Skymac207.csv,2105,94960092.0,854,1251,443,411,0,45.96104513064133,200,42,23.322565320665085,5
Category_Wikipedia_sockpuppets_of_Alisharifi0098.csv,52,54894620.0,20,32,9,11,0,56.80769230769231,429,47,16.692307692307693,7
Category_Wikipedia_sockpuppets_of_Mike_rodrin.csv,41,48508273.0,12,29,8,4,0,14.78048780487805,47,36,26.5609756097561,22
Category_Wikipedia_sockpuppets_of_Matthvm.csv,13192,297013813.0,4507,8685,500,4007,0,40.78941782898727,255,67,20.522362037598544,2
Category_Wikipedia_sockpuppets_of_IWEWrestling29.csv,45,942008.0,25,20,23,2,0,38.888888888888886,199,25,23.866666666666667,23
Category_Wikipedia_sockpuppets_of_Turbetuvb.csv,106,2088700.0,28,78,18,10,0,45.35849056603774,255,27,12.283018867924529,5
Category_Wikipedia_sockpuppets_of_Dog-Boy-Girl.csv,153,3537189.0,55,98,44,11,0,52.68627450980392,480,38,22.235294117647058,13
Category_Wikipedia_sockpuppets_of_Biar122.csv,6844,76370533.0,1902,4942,226,1676,0,42.10447106954997,255,53,15.432349503214494,4
Category_Wikipedia_sockpuppets_of_Celtic0106.csv,528,11029593.0,235,293,201,34,0,20.53030303030303,199,57,18.142045454545453,7
Category_Wikipedia_sockpuppets_of_Danniel_Conner.csv,18,1749.0,15,3,10,5,0,20.61111111111111,129,12,12.0,12
Category_Wikipedia_sockpuppets_of_New_England.csv,7669,249609638.0,2214,5455,500,1714,0,52.129091146172904,255,94,24.581692528360932,2
Category_Wikipedia_sockpuppets_of_Jameventski.csv,23,10681559.0,8,15,5,3,0,74.82608695652173,157,20,13.652173913043478,5
Category_Wikipedia_sockpuppets_of_Burner224.csv,12,11849.0,7,5,3,4,0,79.83333333333333,497,9,9.0,9
Category_Wikipedia_sockpuppets_of_FuckYourBirthNameBullshit.csv,36,45748.0,13,23,9,4,0,72.27777777777777,249,22,16.805555555555557,10
Category_Wikipedia_sockpuppets_of_LizScarlett23.csv,315,6179221.0,125,190,54,71,0,53.18412698412698,496,47,19.926984126984127,8
Category_Wikipedia_sockpuppets_of_Ailrix.csv,28,876.0,13,15,13,0,0,29.25,193,13,13.0,13
Category_Wikipedia_sockpuppets_of_Anmolleads258.csv,130,5883293.0,40,90,11,29,0,77.97692307692307,298,45,19.484615384615385,3
Category_Wikipedia_sockpuppets_of_Drughi815.csv,103,8783482.0,27,76,9,18,0,45.71844660194175,229,29,11.932038834951456,4
Category_Wikipedia_sockpuppets_of_Sourav_bhattacharyya.csv,156,15127944.0,68,88,44,24,0,41.27564102564103,218,40,20.25,9
Category_Wikipedia_sockpuppets_of_WestCoastEdits.csv,201,13899249.0,119,82,99,20,0,47.21890547263681,390,29,10.940298507462687,6
Category_Wikipedia_sockpuppets_of_Sylense_night.csv,64,1537128.0,27,37,24,3,0,72.453125,499,34,22.3125,11
Category_Wikipedia_sockpuppets_of_Californika19.csv,305,35590302.0,157,148,151,6,0,37.05573770491803,250,70,24.724590163934426,3
Category_Wikipedia_sockpuppets_of_Rahel25.csv,33,20203129.0,12,21,8,4,0,40.15151515151515,190,58,27.606060606060606,21
Category_Wikipedia_sockpuppets_of_Sanjayagal.csv,20,33699072.0,5,15,5,0,0,64.3,196,27,26.35,26
Category_Wikipedia_sockpuppets_of_Lil_SHER.csv,4,7405.0,3,1,2,1,40,67.5,122,31,23.5,21
Category_Wikipedia_sockpuppets_of_Dan689.csv,1757,30907025.0,597,1160,81,516,0,40.81445645987478,250,71,24.556061468412064,3
Category_Wikipedia_sockpuppets_of_Mehrshad.Adkins.csv,95,6027912.0,41,54,21,20,0,24.010526315789473,233,20,12.715789473684211,12
Category_Wikipedia_sockpuppets_of_Sherepunjab.csv,390,11398866.0,122,268,60,62,0,42.91025641025641,232,47,15.297435897435898,4
Category_Wikipedia_sockpuppets_of_Akashvermadzzz.csv,818,20172178.0,278,540,254,24,0,46.17114914425428,480,41,15.877750611246944,5
Category_Wikipedia_sockpuppets_of_Jeff_Unaegbu.csv,159,6796241.0,63,96,44,19,0,33.918238993710695,199,44,18.842767295597483,12
Category_Wikipedia_sockpuppets_of_Fragments_of_Jade.csv,4744,104172785.0,1673,3071,348,1325,0,37.6966694772344,255,100,24.050590219224283,5
Category_Wikipedia_sockpuppets_of_Zahid_Rahman_BD.csv,20,22948755.0,17,3,15,2,0,36.4,194,25,21.5,20
Category_Wikipedia_sockpuppets_of_Sameva25.csv,18,4452648.0,12,6,6,6,0,36.166666666666664,247,13,12.055555555555555,12
Category_Wikipedia_sockpuppets_of_Bason0.csv,5115,13200205.0,1459,3656,200,1259,0,45.45669599217986,250,56,25.548582600195502,3
Category_Wikipedia_sockpuppets_of_Hingchinghonghin.csv,178,1635616.0,43,135,9,34,0,35.00561797752809,204,37,17.752808988764045,13
Category_Wikipedia_sockpuppets_of_Sjengul.csv,23,878.0,18,5,18,0,0,16.391304347826086,116,16,8.565217391304348,7
Category_Wikipedia_sockpuppets_of_Mwnazzal.csv,4,401.0,3,1,3,0,60,76.0,97,23,12.5,9
Category_Wikipedia_sockpuppets_of_Cbauman12.csv,1019,9690240.0,372,647,97,275,0,60.707556427870465,495,56,22.549558390578998,3
Category_Wikipedia_sockpuppets_of_Dochi6090.csv,65,39380.0,46,19,35,11,0,103.86153846153846,412,23,17.846153846153847,8
Category_Wikipedia_sockpuppets_of_Urboysummy.csv,157,74677143.0,48,109,44,4,0,45.37579617834395,276,51,18.50955414012739,5
Category_Wikipedia_sockpuppets_of_Ndru01.csv,1536,113762680.0,565,971,500,65,0,36.837239583333336,209,56,16.479166666666668,4
Category_Wikipedia_sockpuppets_of_Chacha_igbokwe.csv,56,3714692.0,21,35,20,1,0,42.67857142857143,196,56,23.5,11
Category_Wikipedia_sockpuppets_of_Melleke_voos.csv,103,25103573.0,38,65,37,1,0,45.58252427184466,255,22,20.475728155339805,10
Category_Wikipedia_sockpuppets_of_Ravi.kandy.csv,2048,399847499.0,801,1247,271,530,0,42.2724609375,496,43,12.75,4
Category_Wikipedia_sockpuppets_of_Xstatik.csv,312,150161830.0,91,221,66,25,0,46.95192307692308,212,55,22.51923076923077,5
Category_Wikipedia_sockpuppets_of_Caro_08.csv,663,11062475.0,201,462,131,70,0,49.6998491704374,246,50,17.80241327300151,6
Category_Wikipedia_sockpuppets_of_Kashmircloud.csv,696,5268346.0,288,408,282,6,0,45.91235632183908,232,67,25.89367816091954,3
Category_Wikipedia_sockpuppets_of_Mopswade.csv,2096,379423.0,1000,1096,500,500,0,64.60591603053435,405,78,27.864980916030536,3
Category_Wikipedia_sockpuppets_of_Zabir_Saheel.csv,592,8899160.0,370,222,346,24,0,37.63682432432432,376,27,19.26858108108108,7
Category_Wikipedia_sockpuppets_of_TheChineseGroundnut.csv,1648,31325698.0,842,806,500,342,0,58.12075242718446,496,68,19.206917475728154,4
Category_Wikipedia_sockpuppets_of_Hoggardhigh.csv,2409,26860773.0,730,1679,500,230,0,46.79908675799087,255,69,17.723536737235367,2
Category_Wikipedia_sockpuppets_of_Icastrogarcia.csv,26,45499497.0,16,10,13,3,0,28.153846153846153,119,34,23.076923076923077,13
Category_Wikipedia_sockpuppets_of_Stipe_gojanoviƒá.csv,158,516505.0,65,93,61,4,0,46.75316455696203,246,33,17.025316455696203,7
Category_Wikipedia_sockpuppets_of_Wikibaji.csv,3090,107050538.0,1117,1973,235,882,0,46.540776699029124,418,69,18.118122977346278,3
Category_Wikipedia_sockpuppets_of_NITINDUBEY03.csv,38,21307345.0,14,24,8,6,0,41.71052631578947,195,22,12.105263157894736,5
Category_Wikipedia_sockpuppets_of_Vanillablu.csv,342,29312752.0,128,214,22,106,0,59.08479532163743,499,44,14.786549707602338,4
Category_Wikipedia_sockpuppets_of_SuperColor.csv,7,3305807.0,6,1,2,4,0,15.857142857142858,61,23,18.714285714285715,14
Category_Wikipedia_sockpuppets_of_TseLoveHK.csv,514,3621802.0,274,240,99,175,0,21.90661478599222,229,51,26.671206225680933,9
Category_Wikipedia_sockpuppets_of_Usama302.csv,69,158576881.0,25,44,16,9,0,58.04347826086956,218,44,27.985507246376812,13
Category_Wikipedia_sockpuppets_of_PWeeHurman.csv,842,84386215.0,200,642,19,181,0,53.89904988123516,250,44,15.10332541567696,4
Category_Wikipedia_sockpuppets_of_MasanKorea.csv,50,1094167.0,26,24,25,1,0,50.42,307,43,22.44,12
Category_Wikipedia_sockpuppets_of_Yaktail.csv,15,4767533.0,5,10,2,3,0,36.86666666666667,122,40,14.333333333333334,5
Category_Wikipedia_sockpuppets_of_Fady_Nabil_Ibrahim.csv,75,3339149.0,32,43,31,1,0,28.866666666666667,205,53,38.04,10
Category_Wikipedia_sockpuppets_of_AnddoX.csv,2036,32622652.0,762,1274,500,262,0,41.19548133595285,250,73,26.37426326129666,4
Category_Wikipedia_sockpuppets_of_Sissiyao313.csv,964,113667568.0,310,654,153,157,0,47.725103734439834,500,47,17.984439834024897,1
Category_Wikipedia_sockpuppets_of_The_Ruler_Of_All_Water.csv,1795,22603247.0,660,1135,500,160,0,45.62172701949861,504,56,21.37325905292479,3
Category_Wikipedia_sockpuppets_of_Randeepa.csv,1887,225230988.0,511,1376,500,11,0,48.770535241123476,497,76,22.75940646528882,4
Category_Wikipedia_sockpuppets_of_Opsrea.csv,130,198803030.0,52,78,38,14,0,60.05384615384615,477,50,25.915384615384614,9
Category_Wikipedia_sockpuppets_of_Supersaiyen312.csv,3086,144046374.0,983,2103,500,483,0,50.2349319507453,255,80,24.731367465975374,3
Category_Wikipedia_sockpuppets_of_Antoniclay43.csv,41,22328763.0,11,30,9,2,0,56.97560975609756,230,31,17.170731707317074,9
Category_Wikipedia_sockpuppets_of_Berntboilol.csv,672,12790325.0,193,479,138,55,0,35.05059523809524,494,36,16.19345238095238,5
Category_Wikipedia_sockpuppets_of_Denzcapili09.csv,1177,10295176.0,481,696,300,181,0,35.73491928632116,249,58,23.23874256584537,4
Category_Wikipedia_sockpuppets_of_Himalayanashoka.csv,472,15182900.0,132,340,96,36,0,44.720338983050844,235,38,11.283898305084746,5
Category_Wikipedia_sockpuppets_of_Sockies.csv,364,74624325.0,85,279,51,34,0,44.167582417582416,255,45,20.513736263736263,4
Category_Wikipedia_sockpuppets_of_Nasir_Ghobar.csv,2535,7273413.0,507,2028,500,7,0,43.57159763313609,230,50,22.78264299802761,4
Category_Wikipedia_sockpuppets_of_GRUPO_CALIMA_DIESEL.csv,12,7009268.0,4,8,2,2,0,34.666666666666664,196,28,17.416666666666668,14
Category_Wikipedia_sockpuppets_of_LuisGomez111.csv,3357,25749870.0,1251,2106,500,751,0,41.65892165624069,250,64,13.955019362526064,4
Category_Wikipedia_sockpuppets_of_Theflyerofspace.csv,366,2603005.0,147,219,19,128,0,47.74590163934426,494,46,20.25409836065574,6
Category_Wikipedia_sockpuppets_of_Wiki_En_Wiki.csv,1584,12391251.0,436,1148,106,330,0,33.55934343434343,199,83,21.602272727272727,4
Category_Wikipedia_sockpuppets_of_ThePaintedDesert.csv,49,11491410.0,36,13,24,12,0,11.53061224489796,137,19,17.367346938775512,17
Category_Wikipedia_sockpuppets_of_Gale5050.csv,199,1139722.0,68,131,67,1,0,58.005025125628144,370,64,21.13065326633166,6
Category_Wikipedia_sockpuppets_of_Thewarison101.csv,212,4089864.0,69,143,40,29,0,34.2877358490566,234,53,22.702830188679247,7
Category_Wikipedia_sockpuppets_of_Esoglou.csv,11151,384592787.0,3226,7925,500,2726,0,56.72495740292351,497,85,18.64003228410008,4
Category_Wikipedia_sockpuppets_of_Sahpreemking.csv,65,134230945.0,13,52,7,6,0,33.83076923076923,199,27,16.630769230769232,6
Category_Wikipedia_sockpuppets_of_Redandproud.csv,232,7507872.0,59,173,18,41,0,32.5,188,25,14.34051724137931,4
Category_Wikipedia_sockpuppets_of_Snapworx.csv,102,2867508.0,73,29,72,1,0,25.34313725490196,233,30,25.19607843137255,18
Category_Wikipedia_sockpuppets_of_DD214.csv,189,69381387.0,71,118,54,17,0,45.973544973544975,255,40,17.0,9
Category_Wikipedia_sockpuppets_of_Earth6282.csv,430,4935024.0,158,272,88,70,0,51.41627906976744,496,69,24.42325581395349,8
Category_Wikipedia_sockpuppets_of_Gym_Gordon.csv,115,46138750.0,31,84,29,2,0,65.14782608695653,297,48,18.678260869565218,4
Category_Wikipedia_sockpuppets_of_Einahr2.csv,1972,9418832.0,859,1113,457,402,0,31.73022312373225,500,73,25.60446247464503,4
Category_Wikipedia_sockpuppets_of_Gaurav456.csv,7129,110113958.0,2812,4317,500,2312,0,52.714546219666154,292,70,19.02707252069014,1
Category_Wikipedia_sockpuppets_of_Psikxas.csv,677,30324701.0,218,459,209,9,0,37.42688330871492,196,54,26.738552437223042,6
Category_Wikipedia_sockpuppets_of_Topdiggie.csv,30,2681573.0,8,22,5,3,0,40.733333333333334,160,50,37.733333333333334,14
Category_Wikipedia_sockpuppets_of_Wlo1234.csv,215,33571438.0,90,125,54,36,0,53.674418604651166,232,63,15.948837209302326,4
Category_Wikipedia_sockpuppets_of_Habar_Awal_king.csv,6235,94704112.0,2412,3823,500,1912,0,45.41635926222935,500,51,13.768083400160386,3
Category_Wikipedia_sockpuppets_of_Shakib_ul_hassan.csv,747,13550552.0,303,444,290,13,0,52.945113788487284,495,58,24.9665327978581,5
Category_Wikipedia_sockpuppets_of_Sbs7623hBuses.csv,11,1719352.0,6,5,4,2,0,65.18181818181819,231,12,10.545454545454545,8
Category_Wikipedia_sockpuppets_of_Neetandtidy.csv,435,7597464.0,133,302,28,105,0,51.197701149425285,250,65,21.075862068965517,3
Category_Wikipedia_sockpuppets_of_AustrianFreedom.csv,809,6242584.0,681,128,500,181,0,32.38442521631644,308,28,13.501854140914709,7
Category_Wikipedia_sockpuppets_of_Hyperx1000.csv,603,16232583.0,199,404,145,54,0,51.99004975124378,498,47,23.149253731343283,6
Category_Wikipedia_sockpuppets_of_DustinBr.csv,158,106674436.0,42,116,37,5,0,48.63291139240506,354,54,21.70886075949367,5
Category_Wikipedia_sockpuppets_of_Richard_Daft.csv,1678,321897529.0,513,1165,234,279,0,41.592967818831944,254,61,21.710369487485103,6
Category_Wikipedia_sockpuppets_of_Boohooyayay.csv,120,10461525.0,39,81,30,9,0,43.025,198,13,10.325,6
Category_Wikipedia_sockpuppets_of_Factsforsure44.csv,175,1283510.0,87,88,58,29,0,45.674285714285716,346,36,23.02285714285714,9
Category_Wikipedia_sockpuppets_of_Imsogingerbruv.csv,9,4091.0,6,3,4,2,0,47.44444444444444,159,17,17.0,17
Category_Wikipedia_sockpuppets_of_Chris19910.csv,8634,26181509.0,2836,5798,500,2336,0,54.73059995367153,250,83,20.121496409543663,3
Category_Wikipedia_sockpuppets_of_CalebHughes.csv,19288,218989914.0,5675,13613,500,5175,0,44.15875155537122,500,84,22.382362090418912,4
Category_Wikipedia_sockpuppets_of_BƒÉcƒÉuan.csv,1013,7187467.0,332,681,75,257,0,37.61303060217177,255,61,22.657453109575517,7
Category_Wikipedia_sockpuppets_of_Nickerss.csv,266,623872.0,117,149,61,56,0,29.654135338345863,203,38,22.518796992481203,13
Category_Wikipedia_sockpuppets_of_Sky_Groove.csv,2269,67781530.0,938,1331,500,438,0,36.23887174966946,255,70,20.403261348611725,9
Category_Wikipedia_sockpuppets_of_Ryan_barnes_1963.csv,113,498082.0,38,75,38,0,0,70.76106194690266,223,70,28.008849557522122,7
Category_Wikipedia_sockpuppets_of_TheuddjjdgkUse.csv,10,452.0,5,5,3,2,0,84.5,239,25,18.5,12
Category_Wikipedia_sockpuppets_of_Rikara.csv,2120,58693526.0,769,1351,388,381,0,41.946698113207546,249,83,21.402358490566037,3
Category_Wikipedia_sockpuppets_of_The_Sisser.csv,3289,368292284.0,720,2569,69,651,0,46.15627850410459,309,55,15.28823350562481,4
Category_Wikipedia_sockpuppets_of_Jaimesbean.csv,25,1375847.0,11,14,4,7,0,56.88,356,42,18.64,6
Category_Wikipedia_sockpuppets_of_Culinarycompasssblogger.csv,33,2524293.0,13,20,9,4,0,62.96969696969697,229,15,8.363636363636363,4
Category_Wikipedia_sockpuppets_of_Rodgers_V.csv,2807,38857601.0,802,2005,500,302,0,41.37299608122551,495,78,19.85108656929106,4
Category_Wikipedia_sockpuppets_of_Commission_on_legal_pluralism.csv,1,0.0,1,0,1,0,51,51.0,51,27,27.0,27
Category_Wikipedia_sockpuppets_of_F.222xd.csv,778,16581714.0,412,366,206,206,0,31.988431876606683,500,36,18.37146529562982,10
Category_Wikipedia_sockpuppets_of_Buffalo8.csv,173,19647594.0,47,126,45,2,0,61.70520231213873,306,59,19.30057803468208,5
Category_Wikipedia_sockpuppets_of_McSauce.csv,18,44212.0,11,7,7,4,0,30.38888888888889,179,15,15.0,15
Category_Wikipedia_sockpuppets_of_Jimpearl.csv,59,200630358.0,16,43,10,6,0,54.59322033898305,235,21,13.203389830508474,8
Category_Wikipedia_sockpuppets_of_Sarah.ohanley.csv,18,8382.0,10,8,9,1,0,47.166666666666664,199,37,26.944444444444443,23
Category_Wikipedia_sockpuppets_of_S4shubi.csv,3,2585538.0,3,0,2,1,0,0.0,0,19,18.333333333333332,17
Category_Wikipedia_sockpuppets_of_Darubrub.csv,69,2820489.0,22,47,13,9,0,58.69565217391305,292,26,15.869565217391305,7
Category_Wikipedia_sockpuppets_of_DiegoBot21.csv,2099,19353284.0,659,1440,473,186,0,49.302048594568845,433,56,17.586946164840402,2
Category_Wikipedia_sockpuppets_of_Thorherdyal.csv,202,10978118.0,54,148,12,42,0,64.81188118811882,266,46,20.945544554455445,5
Category_Wikipedia_sockpuppets_of_Jwvoiland.csv,158,2041083.0,64,94,60,4,0,59.06962025316456,200,26,15.253164556962025,12
Category_Wikipedia_sockpuppets_of_Andrewsix.csv,78,375862646.0,22,56,11,11,0,54.705128205128204,231,49,28.743589743589745,20
Category_Wikipedia_sockpuppets_of_Manservigi.csv,37,7773109.0,28,9,25,3,0,39.351351351351354,197,21,11.324324324324325,7
Category_Wikipedia_sockpuppets_of_Havock94.csv,51,6497825.0,24,27,20,4,0,56.627450980392155,217,23,19.92156862745098,10
Category_Wikipedia_sockpuppets_of_Calhounmuse.csv,2011,110505808.0,588,1423,500,88,0,50.42814520139234,425,71,22.932371954251614,3
Category_Wikipedia_sockpuppets_of_MarsHALwaLker.csv,44,10947.0,20,24,20,0,0,44.20454545454545,161,46,29.90909090909091,13
Category_Wikipedia_sockpuppets_of_Sakshamtrance1.csv,6,1198508.0,4,2,3,1,0,44.166666666666664,122,24,18.666666666666668,8
Category_Wikipedia_sockpuppets_of_Syedsajidali8.csv,56,58531782.0,20,36,19,1,0,48.857142857142854,194,46,29.714285714285715,8
Category_Wikipedia_sockpuppets_of_TDFan2006.csv,2134,52791996.0,606,1528,500,106,0,46.38191190253046,249,61,21.674789128397375,4
Category_Wikipedia_sockpuppets_of_Hamzaburgarian.csv,114,82437281.0,28,86,6,22,0,54.75438596491228,232,29,9.956140350877194,5
Category_Wikipedia_sockpuppets_of_Wikihelperbruh.csv,11,58904.0,6,5,5,1,0,82.0909090909091,258,6,6.0,6
Category_Wikipedia_sockpuppets_of_MANCOTTA_TOMTOMTULA.csv,3,513360.0,2,1,1,1,106,166.0,196,29,27.333333333333332,24
Category_Wikipedia_sockpuppets_of_Fumer_tue.csv,782,13912135.0,282,500,123,159,0,40.76086956521739,236,46,21.423273657289002,4
Category_Wikipedia_sockpuppets_of_Youkey123.csv,10,155917.0,7,3,4,3,0,35.2,132,27,16.6,14
Category_Wikipedia_sockpuppets_of_Rexmorgan.csv,1041,233295313.0,233,808,225,8,0,53.4178674351585,255,53,19.16330451488953,4
Category_Wikipedia_sockpuppets_of_Izaaqnewton.csv,1969,120283105.0,753,1216,180,573,0,48.18181818181818,351,47,18.798374809547994,4
Category_Wikipedia_sockpuppets_of_GOALWAY.csv,2248,30302099.0,1157,1091,500,657,0,24.60364768683274,225,55,19.208629893238435,9
Category_Wikipedia_sockpuppets_of_Alexgardner34.csv,27,413891.0,18,9,12,6,0,35.333333333333336,147,23,18.14814814814815,17
Category_Wikipedia_sockpuppets_of_Ztchou.csv,82,40882.0,75,7,26,49,7,34.31707317073171,128,21,16.73170731707317,16
Category_Wikipedia_sockpuppets_of_RDX451.csv,2838,24279214.0,916,1922,500,416,0,38.26990838618745,500,74,19.271317829457363,5
Category_Wikipedia_sockpuppets_of_Rinpoche.csv,6455,130519372.0,2569,3886,500,2069,0,54.0288148721921,255,94,22.349806351665375,4
Category_Wikipedia_sockpuppets_of_Iran_Turkey_war.csv,1550,78548200.0,432,1118,74,358,0,42.43032258064516,424,78,23.551612903225806,4
Category_Wikipedia_sockpuppets_of_Soosim.csv,1887,15538114.0,660,1227,500,160,0,63.08320084790673,255,88,24.19183889772125,5
Category_Wikipedia_sockpuppets_of_Timmy_Polo.csv,1209,45266358.0,422,787,144,278,0,35.50868486352357,246,65,23.173697270471465,8
Category_Wikipedia_sockpuppets_of_Hafiz_001.csv,15,7919.0,9,6,9,0,16,46.93333333333333,162,27,27.0,27
Category_Wikipedia_sockpuppets_of_Gokmen82.csv,112,44840722.0,38,74,24,14,0,49.642857142857146,231,21,12.8125,7
Category_Wikipedia_sockpuppets_of_Nixon2.csv,164,61146267.0,60,104,5,55,0,49.853658536585364,254,38,19.695121951219512,10
Category_Wikipedia_sockpuppets_of_Rogerstephensjonze.csv,1807,386037485.0,372,1435,333,39,0,44.514111787493086,253,49,15.18262313226342,3
Category_Wikipedia_sockpuppets_of_Oyeakd.csv,111,292311777.0,36,75,24,12,0,44.990990990990994,247,37,14.468468468468469,4
Category_Wikipedia_sockpuppets_of_MX.csv,499,1370101.0,247,252,247,0,0,43.36072144288577,250,57,29.65731462925852,15
Category_Wikipedia_sockpuppets_of_Ventus55.csv,2145,49091572.0,1000,1145,500,500,0,45.75524475524475,255,71,19.203263403263403,4
Category_Wikipedia_sockpuppets_of_Pinecode.csv,72,2489139.0,32,40,17,15,0,87.875,464,30,20.416666666666668,14
Category_Wikipedia_sockpuppets_of_Authoristan.csv,91,1545287.0,26,65,20,6,0,44.21978021978022,335,45,16.32967032967033,5
Category_Wikipedia_sockpuppets_of_Anonymous28485.csv,25,81426646.0,5,20,4,1,0,75.8,334,32,12.8,5
Category_Wikipedia_sockpuppets_of_Tsuietopti.csv,112,1654477.0,44,68,27,17,0,54.982142857142854,222,29,13.375,6
Category_Wikipedia_sockpuppets_of_Internart.csv,83,4332756.0,50,33,20,30,0,33.602409638554214,220,23,12.373493975903614,7
Category_Wikipedia_sockpuppets_of_Aa2111.csv,192,9684892.0,54,138,15,39,0,49.552083333333336,275,28,12.453125,5
Category_Wikipedia_sockpuppets_of_NutellaCambridge.csv,153,59549070.0,56,97,48,8,0,56.61437908496732,253,50,18.130718954248366,9
Category_Wikipedia_sockpuppets_of_Cherryrain.csv,2250,128698514.0,653,1597,500,153,0,31.861333333333334,222,61,18.848444444444443,4
Category_Wikipedia_sockpuppets_of_Gilberatalessandro054.csv,676,10461173.0,306,370,270,36,0,43.260355029585796,500,69,24.400887573964496,8
Category_Wikipedia_sockpuppets_of_Missnicollet.csv,21,381297.0,14,7,7,7,0,36.095238095238095,196,22,17.238095238095237,17
Category_Wikipedia_sockpuppets_of_Goldarab.csv,66,886008.0,23,43,13,10,0,81.98484848484848,255,48,24.40909090909091,4
Category_Wikipedia_sockpuppets_of_FindingEllipsoids.csv,1817,279640279.0,448,1369,443,5,0,51.867914144193726,493,81,20.335718216840945,4
Category_Wikipedia_sockpuppets_of_Hpx130.csv,76,555538.0,37,39,26,11,0,28.460526315789473,319,35,26.18421052631579,16
Category_Wikipedia_sockpuppets_of_Wiki.jawad.csv,374,8540266.0,110,264,110,0,0,36.401069518716575,255,29,16.68716577540107,5
Category_Wikipedia_sockpuppets_of_Shashi_1980.csv,66,2623503.0,26,40,12,14,0,43.22727272727273,218,65,33.57575757575758,5
Category_Wikipedia_sockpuppets_of_Talhasenturk.csv,15,7445623.0,5,10,2,3,0,50.266666666666666,138,20,15.8,5
Category_Wikipedia_sockpuppets_of_CA41319.csv,68,791884.0,44,24,27,17,0,25.426470588235293,150,38,21.573529411764707,15
Category_Wikipedia_sockpuppets_of_DilshanTG.csv,43,4491803.0,12,31,7,5,0,40.372093023255815,326,22,17.093023255813954,7
Category_Wikipedia_sockpuppets_of_Demilealouise.csv,334,63853839.0,100,234,51,49,0,36.4940119760479,230,56,28.88622754491018,10
Category_Wikipedia_sockpuppets_of_Dat_Gee.csv,2876,88979003.0,876,2000,500,376,0,66.40403337969401,500,85,20.219401947148818,4
Category_Wikipedia_sockpuppets_of_Syedmurtaza128.csv,90,3267364.0,32,58,16,16,0,29.58888888888889,196,53,39.2,16
Category_Wikipedia_sockpuppets_of_Lovaananda.csv,1960,364608745.0,529,1431,189,340,0,43.51479591836735,278,55,16.107142857142858,3
Category_Wikipedia_sockpuppets_of_Incestun.csv,5,3032.0,3,2,2,1,0,30.0,98,13,13.0,13
Category_Wikipedia_sockpuppets_of_Tnaniua.csv,3420,108530877.0,1025,2395,417,608,0,49.34970760233918,250,74,17.987134502923976,2
Category_Wikipedia_sockpuppets_of_Billy_Liakopoulos.csv,2471,10876140.0,798,1673,500,298,0,30.532173209227032,255,63,24.349656009712668,3
Category_Wikipedia_sockpuppets_of_Korlzor.csv,3133,18417790.0,1169,1964,348,821,0,43.391956591126714,255,76,21.72231088413661,6
Category_Wikipedia_sockpuppets_of_Nileshnilesh.csv,3,523.0,3,0,3,0,0,132.66666666666666,199,22,18.666666666666668,12
Category_Wikipedia_sockpuppets_of_T.D.monitor.csv,305,9685085.0,128,177,126,2,0,35.868852459016395,193,33,24.475409836065573,11
Category_Wikipedia_sockpuppets_of_Steve_from_NYU.csv,137,142762.0,62,75,53,9,0,125.5036496350365,500,51,23.59124087591241,13
Category_Wikipedia_sockpuppets_of_Ear-phone.csv,1587,177222806.0,533,1054,500,33,0,50.93761814744801,500,79,24.288594833018273,5
Category_Wikipedia_sockpuppets_of_Extropian73.csv,27,261676.0,20,7,14,6,17,35.77777777777778,123,49,28.666666666666668,10
Category_Wikipedia_sockpuppets_of_Jake_Picasso.csv,2604,160053013.0,605,1999,63,542,0,38.55145929339478,255,70,17.72043010752688,7
Category_Wikipedia_sockpuppets_of_Tomboyprida.csv,506,83174939.0,235,271,225,10,0,48.573122529644266,496,67,19.889328063241106,5
Category_Wikipedia_sockpuppets_of_Whittakerjames.csv,4,346323.0,2,2,2,0,0,19.0,48,19,18.5,18
Category_Wikipedia_sockpuppets_of_Tsuinyane.csv,8,1448.0,6,2,6,0,27,44.625,146,18,17.25,17
Category_Wikipedia_sockpuppets_of_DPLIVE202.csv,191,39999043.0,48,143,15,33,0,50.952879581151834,364,62,19.465968586387433,2
Category_Wikipedia_sockpuppets_of_Mark.hoppus.ava.182.csv,12,11421.0,4,8,2,2,0,26.75,128,40,20.833333333333332,13
Category_Wikipedia_sockpuppets_of_Parulekar.amey.csv,1,0.0,1,0,1,0,43,43.0,43,33,33.0,33
Category_Wikipedia_sockpuppets_of_E.3.csv,16,3220.0,9,7,9,0,0,34.75,212,31,18.75,17
Category_Wikipedia_sockpuppets_of_Noname_JR.csv,2026,104135376.0,708,1318,189,519,0,51.94126357354393,375,54,18.20533070088845,4
Category_Wikipedia_sockpuppets_of_Streaks111.csv,73,195074.0,21,52,9,12,0,45.863013698630134,181,31,14.767123287671232,4
Category_Wikipedia_sockpuppets_of_Agunter999.csv,282,59439721.0,127,155,97,30,0,41.148936170212764,253,46,28.9645390070922,13
Category_Wikipedia_sockpuppets_of_Alfa_kanima.csv,1760,32675327.0,578,1182,500,78,0,36.17159090909091,259,57,16.860795454545453,7
Category_Wikipedia_sockpuppets_of_Laxmanwathore.csv,72,20723895.0,27,45,21,6,0,41.611111111111114,213,26,13.708333333333334,5
Category_Wikipedia_sockpuppets_of_Editor3050.csv,2611,94341364.0,1000,1611,500,500,0,35.97816928379931,395,61,16.645346610494062,5
Category_Wikipedia_sockpuppets_of_Nk_TheWikipedian.csv,339,1749561.0,144,195,139,5,0,27.870206489675518,235,45,27.315634218289084,15
Category_Wikipedia_sockpuppets_of_Cherry_Benji.csv,349,8621815.0,150,199,92,58,0,34.919770773638966,348,61,20.51862464183381,5
Category_Wikipedia_sockpuppets_of_Recent_Helpful_Contributor.csv,16,1144.0,6,10,6,0,0,57.25,215,44,20.625,13
Category_Wikipedia_sockpuppets_of_Ambelland.csv,257,83870861.0,62,195,56,6,0,48.976653696498055,250,54,20.06614785992218,10
Category_Wikipedia_sockpuppets_of_Verytinybrain.csv,5,5221257.0,2,3,1,1,0,46.6,125,23,22.4,20
Category_Wikipedia_sockpuppets_of_Blitzmichael2.csv,76,44220355.0,27,49,26,1,0,58.78947368421053,259,33,20.81578947368421,14
Category_Wikipedia_sockpuppets_of_Jdbolivar.csv,86,2765520.0,51,35,36,15,0,32.97674418604651,309,45,26.41860465116279,15
Category_Wikipedia_sockpuppets_of_MrMalaga.csv,344,13992610.0,231,113,163,68,0,29.34011627906977,442,35,24.427325581395348,10
Category_Wikipedia_sockpuppets_of_Yonicohen86.csv,42,411020.0,12,30,10,2,0,49.285714285714285,222,37,13.857142857142858,5
Category_Wikipedia_sockpuppets_of_Dr.GregorySnyder.csv,82,257392960.0,39,43,19,20,0,37.26829268292683,228,23,22.829268292682926,16
Category_Wikipedia_sockpuppets_of_Jerryschust.csv,28,3560273.0,11,17,11,0,0,25.142857142857142,131,33,25.0,10
Category_Wikipedia_sockpuppets_of_Sinsen.csv,1811,472902523.0,696,1115,500,196,0,48.21038100496963,375,60,23.395913859745995,5
Category_Wikipedia_sockpuppets_of_Berber.Enjoyer2.csv,2068,21961142.0,991,1077,500,491,0,46.94003868471954,496,58,24.665377176015475,7
Category_Wikipedia_sockpuppets_of_Tasumluke.csv,227,3633279.0,112,115,73,39,0,58.44933920704846,496,38,23.823788546255507,12
Category_Wikipedia_sockpuppets_of_NZMann.csv,441,128316863.0,142,299,74,68,0,54.91836734693877,474,53,18.662131519274375,6
Category_Wikipedia_sockpuppets_of_Alexa_baltodano.csv,27,2070662.0,15,12,9,6,0,31.51851851851852,156,18,9.666666666666666,9
Category_Wikipedia_sockpuppets_of_The_Quixotic_Potato.csv,3596,11847406.0,1000,2596,500,500,0,47.705228031145715,260,58,22.96496106785317,3
Category_Wikipedia_sockpuppets_of_WorldMappings.csv,1555,23481249.0,523,1032,500,23,0,52.987781350482315,494,95,41.10032154340836,8
Category_Wikipedia_sockpuppets_of_Colin_Larkin.csv,2465,139186468.0,577,1888,500,77,0,50.84178498985801,395,80,23.041379310344826,5
Category_Wikipedia_sockpuppets_of_Humayoon_Shams_Khan.csv,97,40147730.0,27,70,14,13,0,45.01030927835052,242,49,19.515463917525775,10
Category_Wikipedia_sockpuppets_of_DylanFaraci98.csv,2553,35534824.0,1000,1553,500,500,0,33.428907168037604,262,60,21.825303564433998,3
Category_Wikipedia_sockpuppets_of_Mikehamilton.csv,219,1076432.0,155,64,109,46,0,20.84931506849315,199,57,29.36986301369863,18
Category_Wikipedia_sockpuppets_of_Sun4hr.csv,221,108459702.0,93,128,72,21,0,51.84615384615385,262,42,22.330316742081447,10
Category_Wikipedia_sockpuppets_of_Begundrew.csv,48,4568593.0,26,22,14,12,0,50.895833333333336,182,31,14.0625,6
Category_Wikipedia_sockpuppets_of_NatsFan4Ever.csv,124,59802287.0,41,83,27,14,0,45.403225806451616,337,59,24.548387096774192,14
Category_Wikipedia_sockpuppets_of_The_Klorg.csv,104,7889134.0,31,73,17,14,0,67.90384615384616,325,38,18.759615384615383,3
Category_Wikipedia_sockpuppets_of_Mobabansos.csv,391,34858853.0,128,263,97,31,0,43.831202046035806,255,26,15.273657289002557,5
Category_Wikipedia_sockpuppets_of_Under_a_Million_Sunfish.csv,19,456.0,7,12,3,4,0,54.05263157894737,156,37,23.157894736842106,8
Category_Wikipedia_sockpuppets_of_Mahavoicenews.csv,2,163.0,2,0,2,0,26,44.0,62,23,23.0,23
Category_Wikipedia_sockpuppets_of_Akhtaradv.csv,2342,116129395.0,813,1529,500,313,0,45.76430401366353,349,57,19.802305721605464,6
Category_Wikipedia_sockpuppets_of_Young'trev.csv,13,3629160.0,6,7,6,0,0,20.46153846153846,51,33,26.076923076923077,23
Category_Wikipedia_sockpuppets_of_Crottney.csv,615,64475.0,508,107,186,322,0,11.284552845528456,286,36,30.28292682926829,8
Category_Wikipedia_sockpuppets_of_TimesGerman.csv,1573,203306752.0,566,1007,500,66,0,60.78321678321678,501,50,11.642085187539733,4
Category_Wikipedia_sockpuppets_of_Colombo_Overseas_School.csv,55,121908874.0,24,31,15,9,0,45.21818181818182,227,33,22.98181818181818,7
Category_Wikipedia_sockpuppets_of_Washim_Rahman.csv,1399,86572419.0,496,903,148,348,0,36.48749106504646,255,59,15.644746247319514,4
Category_Wikipedia_sockpuppets_of_Scottceneje.csv,129,45030251.0,43,86,34,9,0,48.263565891472865,277,47,28.82170542635659,16
Category_Wikipedia_sockpuppets_of_AerospaceAirAviation.csv,81,14595355.0,28,53,28,0,0,54.17283950617284,255,35,19.567901234567902,9
Category_Wikipedia_sockpuppets_of_Isseasa.csv,274,2350221.0,112,162,29,83,0,43.839416058394164,255,29,15.861313868613138,5
Category_Wikipedia_sockpuppets_of_Skyline201.csv,4712,132295941.0,1792,2920,500,1292,0,35.22835314091681,270,81,18.44121392190153,3
Category_Wikipedia_sockpuppets_of_Nukariadda.csv,22,1819718.0,10,12,5,5,16,84.4090909090909,247,23,17.181818181818183,6
Category_Wikipedia_sockpuppets_of_PubMed2015.csv,41,513506.0,17,24,9,8,0,93.0,255,52,15.414634146341463,11
Category_Wikipedia_sockpuppets_of_DeepNikita.csv,4125,519502945.0,1147,2978,500,647,0,47.391030303030306,383,117,14.510060606060605,2
Category_Wikipedia_sockpuppets_of_Philscirel.csv,1740,51873000.0,572,1168,226,346,0,42.59080459770115,214,60,17.87816091954023,4
Category_Wikipedia_sockpuppets_of_Safi_Bhatti.csv,207,36303371.0,104,103,79,25,0,47.47826086956522,500,44,18.03864734299517,7
Category_Wikipedia_sockpuppets_of_Bradford9.csv,350,7694698.0,160,190,131,29,0,45.26571428571429,290,62,26.222857142857144,11
Category_Wikipedia_sockpuppets_of_Basnayaka.csv,1389,57014829.0,552,837,390,162,0,36.365010799136066,255,65,29.150467962562995,5
Category_Wikipedia_sockpuppets_of_Erinmcally.csv,28,482628.0,10,18,10,0,0,72.25,241,59,44.92857142857143,25
Category_Wikipedia_sockpuppets_of_ThedetectivePiash1.csv,1728,35391127.0,696,1032,386,310,0,27.006944444444443,347,64,31.16840277777778,7
Category_Wikipedia_sockpuppets_of_RobertChristain22.csv,759,230896371.0,243,516,63,180,0,57.01185770750988,425,49,16.675889328063242,7
Category_Wikipedia_sockpuppets_of_Elbryan52.csv,221,5070341.0,53,168,10,43,0,53.95475113122172,255,38,18.56561085972851,7
Category_Wikipedia_sockpuppets_of_EzeeWiki.csv,542,27603761.0,152,390,148,4,0,60.71771217712177,339,45,19.088560885608857,4
Category_Wikipedia_sockpuppets_of_Taiyakemi.csv,114,234362096.0,54,60,32,22,0,31.49122807017544,227,38,26.63157894736842,17
Category_Wikipedia_sockpuppets_of_C0untryballs1212.csv,65,8233206.0,26,39,22,4,0,54.2,300,45,18.353846153846153,7
Category_Wikipedia_sockpuppets_of_Mohammedadnan020.csv,56,1862138.0,26,30,12,14,0,52.910714285714285,254,33,23.482142857142858,8
Category_Wikipedia_sockpuppets_of_Chintan_Patoliya.csv,317,62380642.0,106,211,52,54,0,49.170347003154575,315,56,17.141955835962143,7
Category_Wikipedia_sockpuppets_of_Soulspinr.csv,8722,267079260.0,2924,5798,500,2424,0,51.86470992891539,401,74,19.375831231368952,3
Category_Wikipedia_sockpuppets_of_Sankhan02.csv,182,15024722.0,62,120,37,25,0,42.6978021978022,261,47,22.714285714285715,8
Category_Wikipedia_sockpuppets_of_Myironbull.csv,1,0.0,1,0,1,0,0,0.0,0,11,11.0,11
Category_Wikipedia_sockpuppets_of_Seriy333.csv,167,10974875.0,60,107,60,0,0,47.377245508982035,290,45,15.305389221556887,5
Category_Wikipedia_sockpuppets_of_Plusle_is_my_houseboy.csv,45,5101659.0,15,30,14,1,0,41.17777777777778,191,42,27.488888888888887,17
Category_Wikipedia_sockpuppets_of_BeastJ18.csv,2043,214063077.0,623,1420,500,123,0,38.952031326480665,500,70,19.295154185022028,4
Category_Wikipedia_sockpuppets_of_Sivakarthy.csv,1030,22937069.0,356,674,64,292,0,18.434951456310678,304,48,21.03009708737864,7
Category_Wikipedia_sockpuppets_of_Ooodjr.csv,202,6052302.0,102,100,81,21,0,51.7029702970297,320,50,20.980198019801982,9
Category_Wikipedia_sockpuppets_of_Aparna_tutu.csv,76,89646.0,39,37,33,6,0,25.25,194,28,20.013157894736842,7
Category_Wikipedia_sockpuppets_of_Whether_There's_Weather_Underground.csv,151,3195864.0,72,79,32,40,0,44.70860927152318,199,45,21.774834437086092,10
Category_Wikipedia_sockpuppets_of_Theroadisshort.csv,116,709935.0,53,63,26,27,0,46.525862068965516,229,34,20.767241379310345,7
Category_Wikipedia_sockpuppets_of_Orentbyte.csv,2329,14763080.0,801,1528,500,301,0,38.01159295835122,351,50,18.483039931300986,2
Category_Wikipedia_sockpuppets_of_Mr._Zabriskie.csv,121,14357077.0,41,80,23,18,0,37.19834710743802,210,44,24.50413223140496,12
Category_Wikipedia_sockpuppets_of_Alenaahil.csv,85,58149.0,36,49,17,19,0,53.95294117647059,211,35,20.788235294117648,11
Category_Wikipedia_sockpuppets_of_Pauldereck.csv,2721,81416776.0,1055,1666,426,629,0,42.95259095920618,476,39,14.06688717383315,4
Category_Wikipedia_sockpuppets_of_OxiClean_Versatile_Laundry_Stain_Remover.csv,93,344551.0,32,61,18,14,0,56.763440860215056,247,53,18.225806451612904,5
Category_Wikipedia_sockpuppets_of_Skippo10.csv,1009,27939467.0,527,482,500,27,0,32.89494549058474,345,47,20.146679881070366,9
Category_Wikipedia_sockpuppets_of_Perfect756.csv,35,8461527.0,15,20,10,5,0,38.4,143,40,20.942857142857143,8
Category_Wikipedia_sockpuppets_of_Nabasile.csv,3235,10210654.0,1082,2153,500,582,0,41.63647604327666,343,72,27.527357032457495,4
Category_Wikipedia_sockpuppets_of_William_Jeffman.csv,45,24525.0,23,22,15,8,0,39.333333333333336,137,50,29.4,13
Category_Wikipedia_sockpuppets_of_William_Pina.csv,1726,76602035.0,436,1290,112,324,0,49.22016222479722,255,67,16.253186558516802,3
Category_Wikipedia_sockpuppets_of_Justme89.csv,2032,1731709.0,567,1465,500,67,0,33.2121062992126,250,43,14.011811023622048,4
Category_Wikipedia_sockpuppets_of_HipHopVisionary.csv,9534,432933739.0,2541,6993,350,2191,0,47.539752464862595,500,71,17.337843507447033,3
Category_Wikipedia_sockpuppets_of_Avinash_Sindhi.csv,747,15091356.0,277,470,225,52,0,45.693440428380185,442,38,13.294511378848728,5
Category_Wikipedia_sockpuppets_of_PaullyMatthews.csv,9939,86454549.0,2497,7442,71,2426,0,52.31009155850689,501,50,16.72019317838817,3
Category_Wikipedia_sockpuppets_of_Haramayn_Khan.csv,11,12367949.0,7,4,4,3,13,63.18181818181818,141,23,17.545454545454547,8
Category_Wikipedia_sockpuppets_of_Mr._Josiah_Vincent_Olson.csv,192,19380622.0,71,121,39,32,0,45.96875,242,36,21.822916666666668,7
Category_Wikipedia_sockpuppets_of_Kurt4.csv,335,46721107.0,141,194,102,39,0,36.06567164179104,199,47,18.182089552238807,10
Category_Wikipedia_sockpuppets_of_Zsfgseg.csv,72,193075733.0,20,52,15,5,0,56.388888888888886,168,47,32.68055555555556,17
Category_Wikipedia_sockpuppets_of_Jazzster786.csv,165,5865750.0,89,76,48,41,0,37.86060606060606,189,40,11.36969696969697,5
Category_Wikipedia_sockpuppets_of_ThomasMatthewDelonge.csv,165,23882515.0,67,98,33,34,0,64.6969696969697,233,30,12.55151515151515,7
Category_Wikipedia_sockpuppets_of_Cttgaming.csv,356,16952178.0,138,218,112,26,0,69.42134831460675,236,49,17.325842696629213,5
Category_Wikipedia_sockpuppets_of_LlamaAl.csv,2030,236358468.0,518,1512,500,18,0,50.60886699507389,311,74,21.295073891625616,5
Category_Wikipedia_sockpuppets_of_Conorcool2021.csv,252,49840230.0,89,163,45,44,0,47.43650793650794,292,51,22.126984126984127,13
Category_Wikipedia_sockpuppets_of_Saoirse93.csv,120,331608.0,72,48,35,37,0,33.15,252,44,21.791666666666668,11
Category_Wikipedia_sockpuppets_of_Dr.saze.csv,1402,219078946.0,522,880,500,22,0,42.56562054208274,395,62,33.75748930099857,10
"Category_Wikipedia_sockpuppets_of_EXTRATERRESTRIAL_AND_UFO_RESEARCH_ORGANISATION,INTERNATIONAL.csv",2,0.0,1,1,1,0,0,0.0,0,70,70.0,70
Category_Wikipedia_sockpuppets_of_Aamirkhan90100.csv,7,1688.0,4,3,2,2,11,53.714285714285715,145,23,15.857142857142858,14
Category_Wikipedia_sockpuppets_of_Babylon93.csv,12,28051.0,6,6,6,0,15,60.166666666666664,122,26,22.5,17
Category_Wikipedia_sockpuppets_of_Antwerpant.csv,242,55496009.0,94,148,52,42,0,46.67355371900826,502,26,11.15702479338843,6
"Category_Wikipedia_sockpuppets_of_1,001,520,256_edits.csv",104,7081994.0,38,66,25,13,0,54.91346153846154,207,29,16.817307692307693,5
Category_Wikipedia_sockpuppets_of_Ahnalira.csv,665,90352889.0,249,416,218,31,0,42.82857142857143,199,51,27.852631578947367,12
Category_Wikipedia_sockpuppets_of_Dr._Raye_Mitchell.csv,6,2333192.0,4,2,4,0,0,40.5,154,27,24.5,24
Category_Wikipedia_sockpuppets_of_Cokearchive.csv,358,14323224.0,127,231,69,58,0,47.832402234636874,375,51,28.106145251396647,13
Category_Wikipedia_sockpuppets_of_TatiVogue.csv,1340,36857335.0,500,840,500,0,0,45.78731343283582,500,51,21.061940298507462,2
Category_Wikipedia_sockpuppets_of_Temporary_for_Bonaparte.csv,536,61960780.0,226,310,88,138,0,35.350746268656714,247,94,32.66044776119403,4
Category_Wikipedia_sockpuppets_of_Faceplant83.csv,50,45932259.0,10,40,6,4,0,47.94,234,24,20.56,13
Category_Wikipedia_sockpuppets_of_Chesea.csv,65,1288661.0,43,22,43,0,0,41.49230769230769,199,56,23.384615384615383,17
Category_Wikipedia_sockpuppets_of_Noizy_(rapper).csv,2,0.0,1,1,1,0,0,0.0,0,3,3.0,3
Category_Wikipedia_sockpuppets_of_Awlspegs.csv,95,6821951.0,40,55,20,20,0,40.45263157894737,196,36,19.621052631578948,6
Category_Wikipedia_sockpuppets_of_26depth.csv,126,113386752.0,83,43,50,33,0,38.62698412698413,218,52,17.484126984126984,17
Category_Wikipedia_sockpuppets_of_Gazipurnewsmk.csv,34,78678545.0,14,20,7,7,0,41.411764705882355,166,22,15.058823529411764,10
Category_Wikipedia_sockpuppets_of_The_Hollabck_Girl.csv,580,15551624.0,153,427,67,86,0,56.6551724137931,224,39,20.286206896551725,4
Category_Wikipedia_sockpuppets_of_Bustermythmonger.csv,913,183451520.0,314,599,302,12,0,45.88828039430449,250,39,17.478641840087622,3
Category_Wikipedia_sockpuppets_of_Asimbwp.csv,131,240132.0,47,84,24,23,0,42.16793893129771,227,33,21.213740458015266,12
Category_Wikipedia_sockpuppets_of_Windows.dll.csv,1665,15651459.0,432,1233,428,4,0,50.772372372372374,255,58,20.418018018018017,2
Category_Wikipedia_sockpuppets_of_Scoopskidoopski.csv,469,348044302.0,148,321,55,93,0,48.96162046908316,255,90,15.321961620469082,4
Category_Wikipedia_sockpuppets_of_P31132060.csv,54,3942571.0,36,18,19,17,0,71.75925925925925,399,45,19.962962962962962,17
Category_Wikipedia_sockpuppets_of_Drfahrenight.csv,1,0.0,1,0,1,0,64,64.0,64,17,17.0,17
Category_Wikipedia_sockpuppets_of_Cweeks323.csv,145,7685580.0,113,32,102,11,0,26.324137931034482,192,21,15.806896551724138,8
Category_Wikipedia_sockpuppets_of_Michael.alindao28.csv,39,85436.0,18,21,18,0,0,42.61538461538461,189,30,17.384615384615383,16
Category_Wikipedia_sockpuppets_of_Kittychew.csv,234,68647541.0,92,142,62,30,0,58.61538461538461,255,38,17.346153846153847,7
Category_Wikipedia_sockpuppets_of_RecordFarm_Inc..csv,2,0.0,1,1,1,0,0,0.0,0,24,24.0,24
Category_Wikipedia_sockpuppets_of_Ubuntuforum.csv,88,193440312.0,23,65,11,12,0,63.10227272727273,255,47,19.46590909090909,6
Category_Wikipedia_sockpuppets_of_Mateodor.csv,153,4159530.0,68,85,47,21,0,46.509803921568626,252,38,14.81045751633987,6
Category_Wikipedia_sockpuppets_of_Bobdylan111.csv,9,1137.0,4,5,4,0,0,44.666666666666664,142,20,16.22222222222222,3
Category_Wikipedia_sockpuppets_of_Sandhya001.csv,44,7093011.0,24,20,19,5,0,46.47727272727273,229,44,19.272727272727273,7
Category_Wikipedia_sockpuppets_of_Cla√≠omh_Solais.csv,2170,47585496.0,660,1510,500,160,0,48.74470046082949,446,73,22.373732718894008,3
Category_Wikipedia_sockpuppets_of_Sushilver.csv,254,107482155.0,78,176,41,37,0,53.188976377952756,255,23,10.622047244094489,4
Category_Wikipedia_sockpuppets_of_Anonymoushh.csv,5,43651.0,2,3,2,0,15,20.0,32,24,24.0,24
Category_Wikipedia_sockpuppets_of_Sint_Maarten.csv,246,13577667.0,131,115,122,9,0,31.426829268292682,255,40,21.65447154471545,9
Category_Wikipedia_sockpuppets_of_Soulmatrix.csv,21,14299.0,12,9,11,1,0,49.23809523809524,196,60,29.333333333333332,13
Category_Wikipedia_sockpuppets_of_MathandArt.csv,31,116450.0,18,13,16,2,0,54.58064516129032,141,18,15.258064516129032,12
Category_Wikipedia_sockpuppets_of_JJoestar90.csv,70,9316957.0,30,40,15,15,0,57.75714285714286,228,40,21.3,11
Category_Wikipedia_sockpuppets_of_BlackBoxRecorder.csv,39,2691746.0,26,13,9,17,0,59.02564102564103,196,26,16.46153846153846,7
Category_Wikipedia_sockpuppets_of_HKstoryteller.csv,17,49788.0,13,4,13,0,0,21.823529411764707,136,23,23.0,23
Category_Wikipedia_sockpuppets_of_Leslie_Roak.csv,3316,15649410.0,1169,2147,500,669,0,36.99698431845597,255,64,18.896260554885405,5
Category_Wikipedia_sockpuppets_of_Antonio_Rocci.csv,12,83045.0,7,5,4,3,0,29.666666666666668,137,26,23.0,22
Category_Wikipedia_sockpuppets_of_Akaora.csv,255,39552014.0,93,162,86,7,0,56.462745098039214,430,39,13.498039215686275,4
Category_Wikipedia_sockpuppets_of_An_Angry_Beaver_Is_A_Happy_Beaver.csv,172,1275807.0,56,116,39,17,0,26.802325581395348,156,36,19.343023255813954,3
Category_Wikipedia_sockpuppets_of_Registered_Contributor.csv,167,40384795.0,37,130,23,14,0,46.51497005988024,233,32,18.275449101796408,5
Category_Wikipedia_sockpuppets_of_Isad123.csv,89,93757.0,51,38,41,10,0,39.550561797752806,193,45,25.56179775280899,9
Category_Wikipedia_sockpuppets_of_Shahrizal_shahanshah.csv,213,8204258.0,74,139,74,0,0,28.15962441314554,236,43,17.704225352112676,5
Category_Wikipedia_sockpuppets_of_Comminianus.csv,82,38379164.0,48,34,34,14,0,57.9390243902439,255,64,12.524390243902438,8
Category_Wikipedia_sockpuppets_of_Carnival_Fred.csv,55,6316996.0,20,35,10,10,0,58.472727272727276,209,42,27.236363636363638,18
Category_Wikipedia_sockpuppets_of_Malarious.csv,6422,45177992.0,1947,4475,500,1447,0,42.18296480847088,255,62,17.62581750233572,6
Category_Wikipedia_sockpuppets_of_Smith724.csv,43,94734.0,20,23,18,2,12,43.69767441860465,168,19,15.093023255813954,12
Category_Wikipedia_sockpuppets_of_Papeetlov.csv,8,65422.0,6,2,3,3,0,38.25,111,25,21.5,18
Category_Wikipedia_sockpuppets_of_MarkFHand.csv,40,785067.0,33,7,24,9,0,42.325,239,53,18.5,16
Category_Wikipedia_sockpuppets_of_Kylebran10.csv,60,2891547.0,28,32,16,12,0,41.766666666666666,230,24,10.05,5
Category_Wikipedia_sockpuppets_of_Livekarbala.csv,6,1310593.0,3,3,2,1,20,71.83333333333333,169,14,10.5,7
Category_Wikipedia_sockpuppets_of_Zbellos.csv,1,0.0,1,0,1,0,22,22.0,22,52,52.0,52
Category_Wikipedia_sockpuppets_of_CindyRoleder.csv,499,3219641.0,172,327,145,27,0,40.63927855711423,253,38,18.857715430861724,6
Category_Wikipedia_sockpuppets_of_AdamsBHM021.csv,3,53.0,2,1,2,0,15,143.66666666666666,254,26,22.0,14
Category_Wikipedia_sockpuppets_of_Aesthetically_appealing.csv,293,2134141.0,122,171,96,26,0,62.30034129692833,502,47,18.945392491467576,3
Category_Wikipedia_sockpuppets_of_WalrusKingofFinland.csv,230,26595430.0,65,165,14,51,0,49.01304347826087,250,44,21.491304347826087,4
Category_Wikipedia_sockpuppets_of_NewsCorpABC.csv,24,5048.0,13,11,9,4,9,82.75,195,39,13.375,11
Category_Wikipedia_sockpuppets_of_Ronpaulwins.csv,172,9171848.0,56,116,23,33,0,64.11627906976744,250,44,23.046511627906977,13
Category_Wikipedia_sockpuppets_of_Mr_D_Assange118.csv,99,6825998.0,36,63,8,28,0,46.97979797979798,200,51,17.707070707070706,6
Category_Wikipedia_sockpuppets_of_Tajikam123.csv,271,4292320.0,76,195,67,9,0,46.505535055350556,255,34,14.191881918819188,5
Category_Wikipedia_sockpuppets_of_NinaLyons.csv,130,15125490.0,32,98,12,20,0,56.146153846153844,284,46,20.453846153846154,3
Category_Wikipedia_sockpuppets_of_Villa_Tatti.csv,87,21653174.0,34,53,23,11,0,40.35632183908046,209,39,19.35632183908046,13
Category_Wikipedia_sockpuppets_of_Shiva's_Trident.csv,1792,8151170.0,616,1176,500,116,0,36.19252232142857,255,66,20.582589285714285,5
Category_Wikipedia_sockpuppets_of_ManeBit.csv,62,234346062.0,23,39,11,12,0,39.20967741935484,176,44,17.20967741935484,4
Category_Wikipedia_sockpuppets_of_Gelios1.csv,88,16485672.0,41,47,16,25,0,61.43181818181818,249,14,9.397727272727273,9
Category_Wikipedia_sockpuppets_of_Molee4real.csv,290,22208488.0,114,176,74,40,0,40.58620689655172,307,53,22.489655172413794,8
Category_Wikipedia_sockpuppets_of_TotalBlackout.csv,163,1119393.0,64,99,44,20,0,41.828220858895705,199,34,24.085889570552148,11
Category_Wikipedia_sockpuppets_of_Kfiulis.csv,48,4920274.0,20,28,14,6,0,46.208333333333336,244,60,24.75,11
Category_Wikipedia_sockpuppets_of_Truthtell9986.csv,346,4213860.0,128,218,14,114,0,46.65028901734104,237,44,19.23699421965318,5
Category_Wikipedia_sockpuppets_of_Asian_elephant.csv,425,4766729.0,214,211,125,89,0,35.64235294117647,318,52,19.41176470588235,4
Category_Wikipedia_sockpuppets_of_Human_Insider.csv,287,11910259.0,174,113,42,132,0,39.34146341463415,399,40,16.717770034843205,10
Category_Wikipedia_sockpuppets_of_JackWinslow.csv,54,6344943.0,22,32,11,11,0,41.55555555555556,197,46,21.685185185185187,3
Category_Wikipedia_sockpuppets_of_ChicagoNext.csv,128,24932483.0,43,85,10,33,0,56.40625,355,30,16.53125,6
Category_Wikipedia_sockpuppets_of_Wexperts.csv,6,38084.0,5,1,3,2,0,58.5,199,43,25.5,13
Category_Wikipedia_sockpuppets_of_Qpms.csv,412,73759374.0,157,255,153,4,0,36.60436893203884,255,32,19.109223300970875,9
Category_Wikipedia_sockpuppets_of_Brfc97.csv,637,22020849.0,180,457,133,47,0,38.43328100470958,216,54,20.839874411302983,9
Category_Wikipedia_sockpuppets_of_Arfaz_Hossain.csv,2225,40864797.0,514,1711,500,14,0,59.726741573033706,500,77,19.066966292134833,4
Category_Wikipedia_sockpuppets_of_Againstfraud2000.csv,53,803154.0,24,29,17,7,0,53.60377358490566,213,20,13.660377358490566,6
Category_Wikipedia_sockpuppets_of_Valentinapovolo.csv,11,3118096.0,7,4,6,1,0,45.27272727272727,185,18,18.0,18
Category_Wikipedia_sockpuppets_of_Dimelash.csv,11,11865.0,7,4,5,2,0,24.454545454545453,187,25,18.727272727272727,16
Category_Wikipedia_sockpuppets_of_Campycipro.csv,902,16662255.0,256,646,199,57,0,55.65853658536585,500,65,17.083148558758314,3
Category_Wikipedia_sockpuppets_of_Kkinyon.csv,30,16758659.0,7,23,5,2,0,26.1,143,51,32.6,15
Category_Wikipedia_sockpuppets_of_REGENT123456.csv,30,9300945.0,20,10,10,10,0,57.56666666666667,265,32,31.733333333333334,24
Category_Wikipedia_sockpuppets_of_Truth_gatekeeper.csv,492,3709347.0,209,283,97,112,0,46.75406504065041,279,32,13.703252032520325,4
Category_Wikipedia_sockpuppets_of_Anti-Gorgias.csv,2317,53132191.0,753,1564,493,260,0,44.32757876564523,210,58,22.973241260250322,5
Category_Wikipedia_sockpuppets_of_MoronPatrol.csv,68,1570707.0,31,37,14,17,0,55.51470588235294,261,45,20.102941176470587,6
Category_Wikipedia_sockpuppets_of_Kuwikimaster.csv,16,251655.0,9,7,8,1,0,5.5,46,19,19.0,19
Category_Wikipedia_sockpuppets_of_Magnovvig.csv,2251,3720173.0,726,1525,500,226,0,53.775655264326964,465,68,19.773878276321636,3
Category_Wikipedia_sockpuppets_of_NHIF_Communication_Department.csv,21,1559358.0,8,13,5,3,21,85.42857142857143,290,44,38.857142857142854,22
Category_Wikipedia_sockpuppets_of_RRaunak.csv,2436,6647585.0,949,1487,406,543,0,41.70812807881774,234,56,19.497947454844006,5
Category_Wikipedia_sockpuppets_of_IamKhaleb.csv,14,214122.0,6,8,6,0,3,58.642857142857146,185,43,21.928571428571427,9
Category_Wikipedia_sockpuppets_of_Lokeshyadav1408.csv,13,12052703.0,6,7,4,2,0,36.15384615384615,124,14,10.538461538461538,9
Category_Wikipedia_sockpuppets_of_Coconuto.csv,27,70878182.0,8,19,8,0,0,32.25925925925926,152,46,12.296296296296296,8
Category_Wikipedia_sockpuppets_of_Rick22225.csv,370,12655981.0,123,247,67,56,0,41.04864864864865,231,90,26.267567567567568,4
Category_Wikipedia_sockpuppets_of_Clarence_baladjay.csv,254,58648289.0,89,165,13,76,0,46.125984251968504,226,56,20.165354330708663,5
Category_Wikipedia_sockpuppets_of_Snakesyur.csv,15,530.0,8,7,5,3,0,36.86666666666667,150,13,13.0,13
Category_Wikipedia_sockpuppets_of_Fred_newman.csv,390,25557523.0,127,263,38,89,0,53.674358974358974,248,109,33.0025641025641,7
Category_Wikipedia_sockpuppets_of_Franti≈°ek_V√©gfalvi.csv,10,2325640.0,4,6,4,0,16,61.4,236,41,30.2,23
Category_Wikipedia_sockpuppets_of_Theoneandonlyseo.csv,3,225.0,2,1,2,0,11,52.333333333333336,129,27,27.0,27
Category_Wikipedia_sockpuppets_of_You're_the_Reason_Why_I_Sing.csv,39,113625.0,32,7,20,12,0,24.435897435897434,194,33,27.256410256410255,22
Category_Wikipedia_sockpuppets_of_Renilton06.csv,2,65.0,2,0,2,0,0,8.0,16,7,7.0,7
Category_Wikipedia_sockpuppets_of_Leviathan648.csv,2447,9376547.0,885,1562,500,385,0,40.836943195749896,255,54,22.747445852063752,3
Category_Wikipedia_sockpuppets_of_Valvehueme.csv,198,2356685.0,79,119,72,7,0,37.525252525252526,231,24,15.722222222222221,10
Category_Wikipedia_sockpuppets_of_Thewikirap.csv,334,145780848.0,133,201,132,1,0,47.99101796407186,249,49,15.221556886227544,7
Category_Wikipedia_sockpuppets_of_Footballwwerocks.csv,21,96355.0,9,12,8,1,0,72.14285714285714,209,32,16.952380952380953,10
Category_Wikipedia_sockpuppets_of_UnderThirteenAllower_228784.csv,75,517750.0,32,43,20,12,0,44.18666666666667,218,45,15.226666666666667,4
Category_Wikipedia_sockpuppets_of_Siddiqui.csv,8613,93443398.0,2472,6141,500,1972,0,30.11529083942877,238,63,16.394984326018808,3
Category_Wikipedia_sockpuppets_of_TheGreatWikiLord.csv,1936,27399666.0,695,1241,500,195,0,54.59504132231405,468,107,26.28047520661157,3
Category_Wikipedia_sockpuppets_of_Ihrobin41.csv,11,31623.0,11,0,11,0,0,4.636363636363637,51,19,14.636363636363637,13
Category_Wikipedia_sockpuppets_of_Zooombabby.csv,601,19006019.0,211,390,45,166,0,41.30782029950083,250,37,13.777038269550749,4
Category_Wikipedia_sockpuppets_of_Sarah_jason.csv,1475,96492238.0,432,1043,312,120,0,53.60406779661017,518,66,17.633898305084745,4
Category_Wikipedia_sockpuppets_of_Mantanmoreland.csv,12262,188863895.0,3531,8731,500,3031,0,46.70143532865764,261,104,24.33934105366172,3
Category_Wikipedia_sockpuppets_of_Nielsp.csv,116,3892951.0,70,46,70,0,0,55.37931034482759,169,22,15.362068965517242,15
Category_Wikipedia_sockpuppets_of_Ryan_beta.csv,101,25597628.0,33,68,10,23,0,51.51485148514851,209,41,20.81188118811881,13
Category_Wikipedia_sockpuppets_of_Anurag24oct.csv,49,765531.0,25,24,18,7,0,29.73469387755102,138,42,23.387755102040817,16
Category_Wikipedia_sockpuppets_of_Te_Reo_Ahitereiria.csv,10157,74097699.0,3071,7086,500,2571,0,41.99773555183617,496,86,25.72777394900069,1
Category_Wikipedia_sockpuppets_of_Kryptonite1234.csv,158,20351635.0,49,109,34,15,0,48.765822784810126,195,62,28.044303797468356,10
Category_Wikipedia_sockpuppets_of_Garang_Wachbaar.csv,17,4715431.0,6,11,3,3,0,58.411764705882355,242,47,19.58823529411765,14
Category_Wikipedia_sockpuppets_of_Poyoyloar.csv,722,30320501.0,244,478,132,112,0,40.04709141274238,221,55,19.098337950138504,5
Category_Wikipedia_sockpuppets_of_Mnkyblls45.csv,29,53318.0,11,18,4,7,2,58.06896551724138,153,25,14.517241379310345,6
Category_Wikipedia_sockpuppets_of_Trottapiano.csv,1743,100406015.0,539,1204,133,406,0,43.430866322432585,500,86,19.930579460699942,4
Category_Wikipedia_sockpuppets_of_Alex-orotomal.csv,207,16392470.0,67,140,44,23,0,40.768115942028984,255,39,27.47342995169082,11
Category_Wikipedia_sockpuppets_of_I_use_Nookipedia.csv,115,720621.0,48,67,29,19,0,50.10434782608696,273,41,20.965217391304346,8
Category_Wikipedia_sockpuppets_of_Dr._Sugam_Sharma.csv,9,6892253.0,8,1,8,0,0,82.0,182,28,28.0,28
Category_Wikipedia_sockpuppets_of_Kadamskeller.csv,38,132061.0,21,17,13,8,0,32.18421052631579,151,35,29.55263157894737,23
Category_Wikipedia_sockpuppets_of_Arkady_Renkov.csv,811,14386823.0,253,558,85,168,0,36.55363748458693,199,87,19.556103575832307,2
Category_Wikipedia_sockpuppets_of_Gsthae_with_tempo!.csv,31,46402288.0,11,20,11,0,0,55.45161290322581,215,28,16.483870967741936,2
Category_Wikipedia_sockpuppets_of_Olaf_1324.csv,16,613106.0,7,9,3,4,0,53.625,158,25,8.4375,6
Category_Wikipedia_sockpuppets_of_PadmanabaReddiar.csv,20,3992946.0,10,10,10,0,0,69.3,215,32,26.2,24
Category_Wikipedia_sockpuppets_of_Trasel.csv,5884,164759262.0,2232,3652,500,1732,0,52.909415363698166,256,95,20.163834126444595,4
Category_Wikipedia_sockpuppets_of_Identityanddifference.csv,252,16399251.0,80,172,58,22,0,52.46825396825397,288,23,12.968253968253968,5
Category_Wikipedia_sockpuppets_of_Ammg2.csv,13,31255224.0,5,8,5,0,0,26.076923076923077,107,16,4.153846153846154,2
Category_Wikipedia_sockpuppets_of_Sathishcm.csv,544,494826496.0,155,389,91,64,0,53.419117647058826,406,64,20.340073529411764,8
Category_Wikipedia_sockpuppets_of_Dineshs01102000.csv,1321,3346745.0,555,766,500,55,0,47.26419379258138,450,72,24.96442089326268,6
Category_Wikipedia_sockpuppets_of_Annah25.csv,105,135416310.0,21,84,20,1,0,58.48571428571429,382,28,13.323809523809524,9
Category_Wikipedia_sockpuppets_of_The1andonly_Frenchman.csv,2,0.0,1,1,1,0,0,0.0,0,10,10.0,10
Category_Wikipedia_sockpuppets_of_Phil_Fillibuster_Fibbs_Jr..csv,569,56490194.0,255,314,177,78,0,43.384885764499124,368,54,23.133567662565905,5
Category_Wikipedia_sockpuppets_of_Piercetheorganist.csv,1852,8132103.0,560,1292,500,60,0,47.744600431965445,235,70,19.368250539956804,2
Category_Wikipedia_sockpuppets_of_ContentEditman.csv,3007,246678733.0,779,2228,500,279,0,63.446957100099766,358,78,20.04423012969737,4
Category_Wikipedia_sockpuppets_of_Traceguy.csv,258,767419.0,130,128,127,3,0,29.248062015503876,199,26,14.244186046511627,4
Category_Wikipedia_sockpuppets_of_Mukbrain.csv,548,2568158.0,208,340,196,12,0,48.122262773722625,255,45,24.895985401459853,10
Category_Wikipedia_sockpuppets_of_Fiduseo.csv,15,4407572.0,7,8,3,4,0,85.0,232,28,25.266666666666666,22
Category_Wikipedia_sockpuppets_of_Sunny_Prajapatii.csv,1,0.0,1,0,1,0,13,13.0,13,20,20.0,20
Category_Wikipedia_sockpuppets_of_Hotgrabbz.csv,43,44381890.0,12,31,11,1,0,81.09302325581395,255,19,9.883720930232558,7
Category_Wikipedia_sockpuppets_of_Carambolax.csv,1423,41416272.0,528,895,500,28,0,36.73366127898805,500,48,23.50597329585383,6
Category_Wikipedia_sockpuppets_of_Politicato2010.csv,23,761619.0,15,8,7,8,0,12.652173913043478,110,37,16.130434782608695,13
Category_Wikipedia_sockpuppets_of_Ravenkye.csv,1,0.0,1,0,1,0,28,28.0,28,18,18.0,18
Category_Wikipedia_sockpuppets_of_Lara_bran.csv,2214,23612470.0,634,1580,500,134,0,43.1093044263776,216,64,19.009485094850948,4
Category_Wikipedia_sockpuppets_of_Flameviper.csv,3725,49627502.0,1258,2467,500,758,0,37.31973154362416,210,119,22.67194630872483,4
Category_Wikipedia_sockpuppets_of_CrystalizedCheese.csv,258,8965188.0,106,152,42,64,0,38.763565891472865,317,41,19.74031007751938,7
Category_Wikipedia_sockpuppets_of_Gazzer1991.csv,1705,48474645.0,477,1228,392,85,0,22.44574780058651,201,57,17.225806451612904,3
Category_Wikipedia_sockpuppets_of_Vallabharebel.csv,6939,192095153.0,2475,4464,224,2251,0,35.72272661766825,496,52,22.69188643896815,3
Category_Wikipedia_sockpuppets_of_Spike1965.csv,84,24336601.0,38,46,29,9,0,29.607142857142858,186,46,29.904761904761905,6
Category_Wikipedia_sockpuppets_of_Shonnamartell.csv,75,1393138.0,32,43,32,0,0,46.666666666666664,158,42,25.466666666666665,15
Category_Wikipedia_sockpuppets_of_Constantzeanu.csv,2499,575640050.0,703,1796,500,203,0,43.27531012404962,496,74,16.535414165666268,5
Category_Wikipedia_sockpuppets_of_BierHerrwrotethebookoflove.csv,5,2086197.0,2,3,1,1,0,26.6,102,11,11.0,11
Category_Wikipedia_sockpuppets_of_ChinnaRajputJattGujjar.csv,299,18324111.0,96,203,39,57,0,52.08695652173913,500,32,11.180602006688963,4
Category_Wikipedia_sockpuppets_of_Otomixal.csv,354,99085908.0,111,243,81,30,0,54.75423728813559,237,40,18.940677966101696,8
Category_Wikipedia_sockpuppets_of_Steeley789.csv,7,270598.0,4,3,2,2,0,29.857142857142858,156,15,15.0,15
Category_Wikipedia_sockpuppets_of_Az-507.csv,430,8643641.0,158,272,97,61,0,56.46511627906977,255,28,14.013953488372094,6
Category_Wikipedia_sockpuppets_of_Barnecaration.csv,135,343436.0,65,70,52,13,0,29.622222222222224,199,32,20.355555555555554,15
Category_Wikipedia_sockpuppets_of_Sajelsaxena.csv,46,33438839.0,11,35,11,0,0,46.08695652173913,208,53,39.369565217391305,19
Category_Wikipedia_sockpuppets_of_Dingmundson.csv,5040,358181885.0,2514,2526,138,2376,0,68.96646825396826,268,50,18.581150793650792,5
Category_Wikipedia_sockpuppets_of_Larsconks.csv,2350,45522445.0,663,1687,500,163,0,49.062553191489364,276,61,16.95404255319149,2
Category_Wikipedia_sockpuppets_of_Kiptoo05.csv,210,15817774.0,65,145,50,15,0,49.423809523809524,273,53,18.142857142857142,4
Category_Wikipedia_sockpuppets_of_Gafoorshic.csv,5,6521.0,2,3,2,0,13,54.4,119,40,28.0,20
Category_Wikipedia_sockpuppets_of_Forget3.8million.csv,32,81116.0,15,17,5,10,0,42.5,228,28,23.1875,5
Category_Wikipedia_sockpuppets_of_GoogleFanatic2017.csv,409,41586571.0,146,263,69,77,0,53.00488997555012,255,45,15.579462102689487,4
Category_Wikipedia_sockpuppets_of_Faethon.csv,423,72432501.0,145,278,44,101,0,35.342789598108745,216,64,26.1725768321513,6
Category_Wikipedia_sockpuppets_of_Mikanz009.csv,68,1396926.0,35,33,6,29,0,33.3235294117647,164,44,19.0,13
Category_Wikipedia_sockpuppets_of_Hellojeff123.csv,107,1213012.0,57,50,30,27,0,38.13084112149533,229,45,24.05607476635514,10
Category_Wikipedia_sockpuppets_of_Marka_boy.csv,535,27011244.0,158,377,121,37,0,32.598130841121495,193,23,10.889719626168224,5
Category_Wikipedia_sockpuppets_of_Harshil_Anuwadia.csv,3,2766739.0,3,0,2,1,0,12.666666666666666,22,35,31.0,28
Category_Wikipedia_sockpuppets_of_UA85.csv,7161,186415923.0,2117,5044,422,1695,0,57.86217008797654,500,75,19.78522552716101,3
Category_Wikipedia_sockpuppets_of_The_Nerdy_science.csv,251,6004182.0,78,173,45,33,0,62.68525896414343,492,38,13.589641434262948,1
Category_Wikipedia_sockpuppets_of_Quanta4q.csv,103,6931385.0,29,74,6,23,0,54.077669902912625,222,40,21.533980582524272,4
Category_Wikipedia_sockpuppets_of_WikinpgEdwardsScholarIceman.csv,260,21510009.0,79,181,41,38,0,57.64230769230769,200,54,23.65,6
Category_Wikipedia_sockpuppets_of_Kammiiii.csv,7,57208.0,6,1,6,0,21,35.714285714285715,117,10,10.0,10
Category_Wikipedia_sockpuppets_of_Idahocool30.csv,111,7602844.0,58,53,32,26,0,53.054054054054056,501,25,14.72072072072072,4
Category_Wikipedia_sockpuppets_of_Dr_CareBear.csv,1911,123920405.0,519,1392,500,19,0,50.12768184196756,250,61,17.256410256410255,4
Category_Wikipedia_sockpuppets_of_Davidgoodheart.csv,1456,215751727.0,510,946,500,10,0,40.442994505494504,336,89,22.77747252747253,3
Category_Wikipedia_sockpuppets_of_Errnot.csv,51,10342152.0,22,29,18,4,0,38.80392156862745,233,48,18.19607843137255,12
Category_Wikipedia_sockpuppets_of_Melonite.csv,1634,562989331.0,476,1158,452,24,0,47.48286413708691,494,51,18.357405140758875,3
Category_Wikipedia_sockpuppets_of_Signsolid.csv,6745,54905446.0,1568,5177,500,1068,0,43.24032616753151,255,70,16.22979985174203,3
Category_Wikipedia_sockpuppets_of_ZeroesAndOnes.csv,71,4322318.0,27,44,26,1,0,42.521126760563384,194,49,27.323943661971832,5
Category_Wikipedia_sockpuppets_of_Kartiktiwary.csv,2002,25661089.0,778,1224,500,278,0,38.87162837162837,255,48,17.064435564435563,5
Category_Wikipedia_sockpuppets_of_Tanyatong.csv,2144,49065067.0,673,1471,42,631,0,40.23134328358209,304,23,10.730876865671641,5
Category_Wikipedia_sockpuppets_of_Habeshawoman.csv,944,58451458.0,304,640,130,174,0,35.565677966101696,216,46,16.71186440677966,3
Category_Wikipedia_sockpuppets_of_Dimagushy.csv,389,5177601.0,120,269,53,67,0,40.167095115681235,304,45,21.717223650385606,4
Category_Wikipedia_sockpuppets_of_Wikipediafirst.csv,198,16113165.0,64,134,47,17,0,48.494949494949495,250,39,11.45959595959596,4
Category_Wikipedia_sockpuppets_of_Ebfilms.csv,219,53593969.0,80,139,39,41,0,34.406392694063925,200,60,22.068493150684933,9
Category_Wikipedia_sockpuppets_of_Partha_protim_konar.csv,2665,35401733.0,1125,1540,500,625,0,39.134333958724206,495,88,20.863039399624764,4
Category_Wikipedia_sockpuppets_of_MaxAMSC.csv,2067,9936381.0,701,1366,436,265,0,41.83164005805515,232,78,19.748911465892597,5
Category_Wikipedia_sockpuppets_of_Erfsalehi.csv,78,93863903.0,22,56,17,5,0,46.743589743589745,306,41,21.17948717948718,19
Category_Wikipedia_sockpuppets_of_KawaiiCheese^-^.csv,162,1377754.0,58,104,31,27,0,52.58641975308642,196,49,21.19753086419753,10
Category_Wikipedia_sockpuppets_of_Mcfly85.csv,3469,211150322.0,698,2771,500,198,0,34.6935716344768,250,77,16.466128567310463,2
Category_Wikipedia_sockpuppets_of_Pablo_Cepeda-Salas.csv,1779,31948372.0,510,1269,306,204,0,44.72681281618887,500,61,18.144463181562674,6
Category_Wikipedia_sockpuppets_of_Sub2TJY.csv,33,16554.0,20,13,20,0,0,33.75757575757576,179,17,14.121212121212121,6
Category_Wikipedia_sockpuppets_of_Localtvproducer.csv,6,679732.0,2,4,1,1,0,36.0,72,24,20.0,16
Category_Wikipedia_sockpuppets_of_Champak_bora.csv,33,3436563.0,21,12,13,8,0,41.45454545454545,127,23,20.939393939393938,13
Category_Wikipedia_sockpuppets_of_NYyankees51.csv,1637,165169629.0,614,1023,500,114,0,49.532070861331704,255,74,26.01954795357361,7
Category_Wikipedia_sockpuppets_of_AndInFirstPlace.csv,709,9501976.0,210,499,152,58,0,53.62059238363893,418,51,39.42736248236953,6
Category_Wikipedia_sockpuppets_of_Mikebeckbeck.csv,54,17689778.0,26,28,23,3,0,48.81481481481482,157,79,41.666666666666664,16
Category_Wikipedia_sockpuppets_of_J3wman.csv,31,172172.0,10,21,10,0,0,40.25806451612903,212,56,22.032258064516128,13
Category_Wikipedia_sockpuppets_of_Serefsiz102350.csv,15,13699193.0,7,8,4,3,0,59.266666666666666,193,31,20.733333333333334,17
Category_Wikipedia_sockpuppets_of_Toknimol.csv,221,80979927.0,103,118,84,19,0,44.98642533936651,500,29,14.371040723981901,8
Category_Wikipedia_sockpuppets_of_RCB201013.csv,168,18930781.0,52,116,19,33,0,45.958333333333336,302,45,16.31547619047619,5
Category_Wikipedia_sockpuppets_of_RSApatriot.csv,14,58667.0,7,7,6,1,0,65.14285714285714,192,21,12.214285714285714,9
Category_Wikipedia_sockpuppets_of_Banned_in_wiki_truth_on_OXY_and_the_billions_in_profits.csv,17,1411899.0,5,12,3,2,0,94.52941176470588,255,33,14.647058823529411,9
Category_Wikipedia_sockpuppets_of_Hawkvincer.csv,8,1282.0,7,1,4,3,0,21.25,44,20,16.25,15
Category_Wikipedia_sockpuppets_of_Bullofdoom.csv,535,1368280.0,146,389,143,3,0,49.94766355140187,253,48,24.635514018691588,5
Category_Wikipedia_sockpuppets_of_Abc_123_def_456.csv,272,3565807.0,118,154,73,45,0,67.83088235294117,244,36,19.272058823529413,8
Category_Wikipedia_sockpuppets_of_RidhimaSAI.csv,21,429219.0,19,2,16,3,0,32.42857142857143,141,25,25.0,25
Category_Wikipedia_sockpuppets_of_ÁÅ´ÁÉ≠ÊØÅÁÅ≠.csv,183,1018339.0,83,100,56,27,0,57.295081967213115,496,51,21.743169398907103,4
Category_Wikipedia_sockpuppets_of_Emir214.csv,1417,123169817.0,443,974,372,71,0,33.63091037402964,224,55,20.68666196189132,4
Category_Wikipedia_sockpuppets_of_Jedd_Raynier.csv,1156,18116596.0,522,634,500,22,0,52.74913494809689,254,64,24.673010380622838,6
Category_Wikipedia_sockpuppets_of_Halfwite.csv,333,433316.0,147,186,91,56,0,33.6006006006006,223,27,18.64264264264264,12
Category_Wikipedia_sockpuppets_of_Mr.Gold1.csv,1377,35192358.0,508,869,289,219,0,52.8162672476398,473,65,21.524328249818446,2
Category_Wikipedia_sockpuppets_of_Irobertson34.csv,944,20694338.0,302,642,171,131,0,40.52012711864407,384,42,18.800847457627118,5
Category_Wikipedia_sockpuppets_of_Sakhawatay.csv,449,18031650.0,157,292,42,115,0,51.1358574610245,378,47,19.84632516703786,5
Category_Wikipedia_sockpuppets_of_Socool775.csv,193,40902987.0,94,99,65,29,0,51.005181347150256,218,23,14.305699481865284,11
Category_Wikipedia_sockpuppets_of_Brodey.csv,4119,220783447.0,1004,3115,500,504,0,44.11046370478272,255,70,15.226754066521,4
Category_Wikipedia_sockpuppets_of_Muhamamd_Aziz_Saeed.csv,136,2348245.0,64,72,47,17,0,40.279411764705884,179,50,27.727941176470587,12
Category_Wikipedia_sockpuppets_of_Leckson58.csv,279,89906793.0,92,187,53,39,0,52.81362007168459,284,53,16.78494623655914,6
Category_Wikipedia_sockpuppets_of_Ajuk.csv,3357,339955740.0,758,2599,500,258,0,48.45784927018171,340,66,20.90676198987191,3
Category_Wikipedia_sockpuppets_of_Itzsonuch.csv,3,1125893.0,2,1,1,1,0,96.66666666666667,254,18,13.333333333333334,11
Category_Wikipedia_sockpuppets_of_Callumgrainger200.csv,503,8665722.0,149,354,112,37,0,38.135188866799204,244,36,21.318091451292247,7
Category_Wikipedia_sockpuppets_of_Mattopia.csv,935,96211955.0,249,686,243,6,0,35.58395721925134,222,57,17.254545454545454,4
Category_Wikipedia_sockpuppets_of_David_T_Cohen.csv,167,1752559.0,59,108,38,21,0,46.62874251497006,232,47,21.694610778443113,5
Category_Wikipedia_sockpuppets_of_Sakaisinai7.csv,309,1909857.0,96,213,12,84,0,49.116504854368934,237,44,15.779935275080906,4
Category_Wikipedia_sockpuppets_of_Editorofstudy.csv,214,152272402.0,62,152,24,38,0,50.35514018691589,246,63,26.509345794392523,3
Category_Wikipedia_sockpuppets_of_Bpaulsen1980.csv,14,1207516.0,10,4,5,5,0,29.571428571428573,196,46,25.142857142857142,16
Category_Wikipedia_sockpuppets_of_ALefty.csv,2,2053.0,2,0,1,1,29,58.0,87,34,34.0,34
Category_Wikipedia_sockpuppets_of_Bhind85.csv,42,1215896.0,14,28,7,7,0,69.21428571428571,229,42,18.69047619047619,9
Category_Wikipedia_sockpuppets_of_Mohawk121212.csv,68,5949943.0,23,45,9,14,0,44.970588235294116,234,29,12.926470588235293,3
Category_Wikipedia_sockpuppets_of_Fartboxbuncher.csv,3,589.0,2,1,2,0,0,76.33333333333333,196,26,26.0,26
Category_Wikipedia_sockpuppets_of_BritAbroad1022.csv,3,169.0,2,1,2,0,25,56.0,114,13,11.0,10
Category_Wikipedia_sockpuppets_of_Ae√æ_E≈∫abrekƒ±n.csv,158,12505893.0,62,96,40,22,0,46.107594936708864,236,47,19.253164556962027,10
Category_Wikipedia_sockpuppets_of_Wanye04.csv,283,4425416.0,128,155,113,15,0,26.434628975265017,254,33,20.39929328621908,6
Category_Wikipedia_sockpuppets_of_Cra7223.csv,82,12453626.0,19,63,19,0,0,45.46341463414634,194,26,11.487804878048781,7
Category_Wikipedia_sockpuppets_of_Qajar.csv,2606,76204412.0,959,1647,492,467,0,34.509209516500384,255,77,28.074827321565618,4
Category_Wikipedia_sockpuppets_of_Exjames12.csv,27,29091857.0,8,19,6,2,0,41.7037037037037,208,38,17.59259259259259,13
Category_Wikipedia_sockpuppets_of_FIang_Xdot_repasent_aa.csv,329,3622684.0,94,235,25,69,0,64.13981762917933,430,51,17.203647416413375,4
Category_Wikipedia_sockpuppets_of_Sankararamank.csv,798,4503359.0,350,448,304,46,0,36.221804511278194,231,48,17.238095238095237,5
Category_Wikipedia_sockpuppets_of_Abgamingcity.csv,17,1464671.0,7,10,4,3,0,77.76470588235294,235,17,11.882352941176471,5
Category_Wikipedia_sockpuppets_of_Roxstarindia.csv,35,30568419.0,7,28,4,3,0,40.05714285714286,137,53,24.257142857142856,13
Category_Wikipedia_sockpuppets_of_Blazingnikons.csv,28,3544061.0,6,22,5,1,0,33.57142857142857,128,24,14.357142857142858,6
Category_Wikipedia_sockpuppets_of_Gabethesoccerplayer.csv,177,12222372.0,50,127,36,14,0,52.50847457627118,366,47,22.903954802259886,7
Category_Wikipedia_sockpuppets_of_Dmerkurev.csv,86,84141092.0,18,68,7,11,0,57.46511627906977,207,19,15.093023255813954,14
Category_Wikipedia_sockpuppets_of_Jrrao.csv,1011,213674107.0,242,769,194,48,0,39.397626112759646,255,43,16.286844708209692,4
Category_Wikipedia_sockpuppets_of_Captaincold.csv,3999,25182010.0,1420,2579,500,920,0,31.9039759939985,255,73,23.077269317329332,5
Category_Wikipedia_sockpuppets_of_VigilancePrime.csv,3260,14402135.0,1000,2260,500,500,0,43.09386503067485,218,87,21.061349693251532,3
Category_Wikipedia_sockpuppets_of_TortureIsWrong.csv,1614,12758751.0,588,1026,500,88,0,35.60408921933085,200,62,31.527881040892193,4
Category_Wikipedia_sockpuppets_of_Beyonceloverlove.csv,885,56057559.0,322,563,62,260,0,37.811299435028246,234,56,19.242937853107346,7
Category_Wikipedia_sockpuppets_of_Lebo69.csv,32,570783.0,9,23,8,1,0,62.46875,198,26,12.375,4
Category_Wikipedia_sockpuppets_of_Visaliaguy.csv,1399,7780828.0,696,703,389,307,0,27.270192994996425,259,43,20.162973552537526,4
Category_Wikipedia_sockpuppets_of_Drofmicrocaps.csv,425,122616775.0,194,231,151,43,0,47.72470588235294,255,35,19.27764705882353,10
Category_Wikipedia_sockpuppets_of_HaroldSalasI.csv,123,4306034.0,46,77,11,35,0,39.61788617886179,234,47,21.146341463414632,4
Category_Wikipedia_sockpuppets_of_SemThomasson.csv,36,113802.0,29,7,18,11,0,14.027777777777779,127,26,23.555555555555557,22
Category_Wikipedia_sockpuppets_of_Ollield21.csv,5,588.0,4,1,2,2,12,81.0,149,13,12.2,11
Category_Wikipedia_sockpuppets_of_Mr.mubster.csv,314,78640215.0,75,239,42,33,0,62.96496815286624,360,48,18.47452229299363,4
Category_Wikipedia_sockpuppets_of_Korrentevnt.csv,41,2741.0,18,23,2,16,0,81.53658536585365,219,26,20.73170731707317,14
Category_Wikipedia_sockpuppets_of_BlackWhiteSea-snake.csv,354,36895825.0,122,232,30,92,0,51.58474576271186,255,43,19.838983050847457,7
Category_Wikipedia_sockpuppets_of_Bruce01.csv,99,16326912.0,31,68,30,1,0,36.84848484848485,196,58,22.343434343434343,2
Category_Wikipedia_sockpuppets_of_Benswarbricks23.csv,6,15657064.0,5,1,3,2,0,34.833333333333336,80,20,15.0,12
Category_Wikipedia_sockpuppets_of_EVnerd2000.csv,158,90393339.0,50,108,36,14,0,60.221518987341774,373,25,13.49367088607595,6
Category_Wikipedia_sockpuppets_of_Pinkmermaid.csv,525,318357435.0,204,321,204,0,0,46.54666666666667,250,47,15.672380952380953,10
Category_Wikipedia_sockpuppets_of_Zibu057.csv,14,874814.0,8,6,6,2,0,40.92857142857143,196,39,35.357142857142854,22
Category_Wikipedia_sockpuppets_of_RalphDI.csv,60,22661576.0,29,31,8,21,0,42.483333333333334,177,21,15.5,11
Category_Wikipedia_sockpuppets_of_Football_boys.csv,843,8653515.0,269,574,211,58,0,34.23724792408066,234,49,26.64531435349941,8
Category_Wikipedia_sockpuppets_of_NepaliBoy7.csv,1987,33429415.0,806,1181,500,306,0,31.274282838449924,236,48,17.19073980875692,5
Category_Wikipedia_sockpuppets_of_FirstLoverWalking0100101.csv,505,40066567.0,158,347,6,152,0,40.06138613861386,424,42,16.336633663366335,5
Category_Wikipedia_sockpuppets_of_Mbialastoki.csv,1,0.0,1,0,1,0,23,23.0,23,23,23.0,23
Category_Wikipedia_sockpuppets_of_WorldNews.csv,30,6871940.0,15,15,7,8,0,39.766666666666666,149,19,15.466666666666667,14
Category_Wikipedia_sockpuppets_of_YaseenZulfiqar.csv,82,2180404.0,27,55,27,0,0,61.63414634146341,217,37,19.865853658536587,6
Category_Wikipedia_sockpuppets_of_AjoanneWcy.csv,414,3007548.0,125,289,69,56,0,73.0048309178744,231,22,12.333333333333334,4
Category_Wikipedia_sockpuppets_of_Leedezine.csv,27,21556.0,12,15,10,2,0,31.925925925925927,99,64,28.25925925925926,14
Category_Wikipedia_sockpuppets_of_Ana_De_Armani.csv,209,24530268.0,87,122,16,71,0,52.28708133971292,434,47,17.650717703349283,7
Category_Wikipedia_sockpuppets_of_Pegasi_lux.csv,1582,2503541.0,453,1129,440,13,0,66.53603034134008,459,54,18.355246523388118,4
Category_Wikipedia_sockpuppets_of_Maximum023.csv,468,206147358.0,145,323,61,84,0,54.363247863247864,268,72,20.700854700854702,3
Category_Wikipedia_sockpuppets_of_RIMT_UNiversity.csv,14,91598634.0,7,7,7,0,5,43.857142857142854,165,15,15.0,15
Category_Wikipedia_sockpuppets_of_Nscharan007.csv,878,108214494.0,254,624,188,66,0,49.433940774487475,255,71,21.198177676537586,5
Category_Wikipedia_sockpuppets_of_Hollywoodthecracked.csv,406,4293065.0,134,272,126,8,0,31.014778325123153,218,37,17.69704433497537,6
Category_Wikipedia_sockpuppets_of_Diamese.csv,743,13719326.0,259,484,40,219,0,49.940780619111706,246,45,15.269179004037685,8
Category_Wikipedia_sockpuppets_of_GlobzWiki.csv,1559,52030562.0,489,1070,124,365,0,43.88774855676716,499,55,20.988454137267478,3
Category_Wikipedia_sockpuppets_of_Jeas116.csv,433,163047281.0,194,239,133,61,0,34.27944572748268,322,52,41.98614318706697,14
Category_Wikipedia_sockpuppets_of_Wikipedian_Creator.csv,144,10880515.0,56,88,32,24,0,44.708333333333336,230,36,22.868055555555557,11
Category_Wikipedia_sockpuppets_of_Nelsoncsb.csv,104,159426971.0,28,76,19,9,0,67.45192307692308,255,24,19.423076923076923,10
Category_Wikipedia_sockpuppets_of_Yasir72.multan.csv,2749,315269574.0,997,1752,500,497,0,45.23499454347035,395,48,19.715532921062206,4
Category_Wikipedia_sockpuppets_of_Richelieu94.csv,1600,20809918.0,559,1041,500,59,0,39.72875,337,74,44.219375,9
Category_Wikipedia_sockpuppets_of_Zdnf.csv,908,18286163.0,305,603,134,171,0,54.86123348017621,255,58,22.65308370044053,7
Category_Wikipedia_sockpuppets_of_Anubiz.csv,1699,3002697.0,669,1030,500,169,0,27.327839905826956,217,42,23.511477339611535,3
Category_Wikipedia_sockpuppets_of_Rasheed_Hasrat.csv,159,13809917.0,60,99,41,19,0,50.106918238993714,495,31,21.9937106918239,15
Category_Wikipedia_sockpuppets_of_Daffyduck1234.csv,2114,32217223.0,767,1347,127,640,0,35.42857142857143,255,49,16.12724692526017,5
Category_Wikipedia_sockpuppets_of_Svsaikumar189.csv,1227,12488258.0,439,788,240,199,0,37.01711491442543,333,47,17.227383863080686,6
Category_Wikipedia_sockpuppets_of_Kundan_Ravindra_Dhayade.csv,3207,52333941.0,1000,2207,500,500,0,49.168381665107574,500,44,17.044278141565325,4
Category_Wikipedia_sockpuppets_of_Timmy4in.csv,134,7910999.0,57,77,57,0,0,38.94776119402985,211,53,24.83582089552239,6
Category_Wikipedia_sockpuppets_of_Tajik.csv,2326,116548943.0,615,1711,500,115,0,41.85081685296647,229,47,15.878761822871883,4
Category_Wikipedia_sockpuppets_of_Qurdofficial.csv,4,230658.0,3,1,3,0,0,0.0,0,27,21.0,15
Category_Wikipedia_sockpuppets_of_111234aliqo0w.csv,100,6021639.0,30,70,13,17,0,34.98,266,36,25.95,6
Category_Wikipedia_sockpuppets_of_Feloniii.csv,1385,9260721.0,501,884,500,1,0,81.84765342960289,272,70,18.71768953068592,4
Category_Wikipedia_sockpuppets_of_Tom.mevlie.csv,3010,9336133.0,1043,1967,500,543,0,37.62292358803987,248,71,25.204318936877076,5
Category_Wikipedia_sockpuppets_of_Ffswontforget.csv,107,2027419.0,28,79,14,14,0,54.86915887850467,235,42,17.364485981308412,5
Category_Wikipedia_sockpuppets_of_Grenovilla.csv,37,4109.0,14,23,12,2,0,47.270270270270274,309,20,16.216216216216218,13
Category_Wikipedia_sockpuppets_of_Ljtay67.csv,25,27917007.0,5,20,3,2,0,77.76,201,28,28.0,28
Category_Wikipedia_sockpuppets_of_Vinodtiwari2608.csv,1755,223366267.0,633,1122,500,133,0,59.9002849002849,377,66,19.570940170940172,4
Category_Wikipedia_sockpuppets_of_TenretskniB.csv,18,10697.0,11,7,6,5,0,51.611111111111114,239,22,15.88888888888889,11
Category_Wikipedia_sockpuppets_of_Mark_shachov.csv,26,8643628.0,12,14,9,3,0,45.61538461538461,207,49,28.03846153846154,12
Category_Wikipedia_sockpuppets_of_Yosefemet.csv,57,855296.0,18,39,15,3,0,38.29824561403509,149,45,23.68421052631579,13
Category_Wikipedia_sockpuppets_of_TWrestlingA09.csv,144,20575208.0,64,80,38,26,0,42.99305555555556,222,36,20.666666666666668,2
Category_Wikipedia_sockpuppets_of_Monirahmed50.csv,26,7086423.0,16,10,9,7,0,39.65384615384615,196,62,41.92307692307692,17
Category_Wikipedia_sockpuppets_of_Jthj2012.csv,3512,190740900.0,936,2576,500,436,0,42.12386104783599,259,80,18.26366742596811,4
Category_Wikipedia_sockpuppets_of_Vikhyat_Dubey.csv,428,20469388.0,121,307,57,64,0,52.927570093457945,500,51,20.675233644859812,6
Category_Wikipedia_sockpuppets_of_Larry_jefferson.csv,543,9403037.0,243,300,35,208,0,46.331491712707184,225,54,21.03683241252302,6
Category_Wikipedia_sockpuppets_of_Rajesh.kumar.ieiksc.csv,41,142017470.0,18,23,17,1,0,54.53658536585366,235,48,23.804878048780488,17
Category_Wikipedia_sockpuppets_of_XLiquidLimex.csv,87,12310.0,38,49,37,1,0,44.229885057471265,223,47,20.666666666666668,10
Category_Wikipedia_sockpuppets_of_Seung_chan_Kim_1991.csv,3,15154.0,2,1,1,1,40,40.666666666666664,42,29,29.0,29
Category_Wikipedia_sockpuppets_of_OneUpliftmofo.csv,1,0.0,1,0,1,0,0,0.0,0,17,17.0,17
Category_Wikipedia_sockpuppets_of_Darreg.csv,26,340007.0,13,13,13,0,0,55.19230769230769,232,45,35.34615384615385,6
Category_Wikipedia_sockpuppets_of_RANDOMISEDTOOMUCH.csv,282,5978252.0,94,188,64,30,0,50.58156028368794,346,63,19.75886524822695,1
Category_Wikipedia_sockpuppets_of_Silvercar82.csv,89,132532471.0,39,50,37,2,0,43.853932584269664,211,60,25.719101123595507,15
Category_Wikipedia_sockpuppets_of_RedwoodReserves.csv,43,348242.0,12,31,11,1,0,86.93023255813954,485,41,15.13953488372093,8
Category_Wikipedia_sockpuppets_of_JoeyPknowsalotaboutthat.csv,1733,172084621.0,610,1123,500,110,0,57.32256203115984,500,73,17.79861511829198,3
Category_Wikipedia_sockpuppets_of_TV_Guy.csv,1224,265688674.0,414,810,414,0,0,52.34313725490196,489,82,19.98856209150327,5
Category_Wikipedia_sockpuppets_of_Cecegunther.csv,104,4235176.0,39,65,24,15,0,38.03846153846154,232,34,21.615384615384617,13
Category_Wikipedia_sockpuppets_of_Taxsoftwareinformation.csv,24,1043316.0,12,12,12,0,0,31.958333333333332,136,32,14.75,7
Category_Wikipedia_sockpuppets_of_Zektay77.csv,26,42785350.0,8,18,7,1,0,47.73076923076923,196,21,16.115384615384617,13
Category_Wikipedia_sockpuppets_of_Macaroniking.csv,1156,93849971.0,287,869,242,45,0,53.30276816608997,327,56,15.350346020761245,2
Category_Wikipedia_sockpuppets_of_Tiktokinfluencer.csv,6,361813.0,4,2,3,1,0,33.5,68,45,34.666666666666664,13
Category_Wikipedia_sockpuppets_of_Jacksamith12.csv,20,1731618.0,8,12,5,3,0,55.05,154,14,12.05,11
Category_Wikipedia_sockpuppets_of_Accountzero.csv,55,98530.0,17,38,15,2,0,43.018181818181816,199,29,21.0,13
Category_Wikipedia_sockpuppets_of_Jambajew.csv,75,10341603.0,24,51,22,2,0,80.86666666666666,255,41,28.333333333333332,12
Category_Wikipedia_sockpuppets_of_Pprice1.csv,12,1922263.0,10,2,8,2,0,46.75,183,53,31.25,17
Category_Wikipedia_sockpuppets_of_Wikinger.csv,13351,462232981.0,4057,9294,500,3557,0,46.096322372855965,355,77,18.431578158939406,1
Category_Wikipedia_sockpuppets_of_Hel_Hufflepuff.csv,318,7888475.0,86,232,26,60,0,51.056603773584904,229,54,21.79559748427673,6
Category_Wikipedia_sockpuppets_of_Baseballman93.100.csv,2568,197185738.0,990,1578,234,756,0,37.125,390,62,19.843068535825545,4
Category_Wikipedia_sockpuppets_of_Tauqeerriaz.csv,104,246748155.0,28,76,19,9,0,48.49038461538461,319,29,27.567307692307693,10
Category_Wikipedia_sockpuppets_of_Akhileshpalbjp.csv,1,0.0,1,0,1,0,0,0.0,0,14,14.0,14
Category_Wikipedia_sockpuppets_of_Crispy_Wafers.csv,434,30604412.0,125,309,85,40,0,56.714285714285715,322,38,18.36405529953917,6
Category_Wikipedia_sockpuppets_of_Qiwengong.csv,144,16360672.0,78,66,35,43,0,26.694444444444443,199,17,13.340277777777779,12
Category_Wikipedia_sockpuppets_of_Seoulburner.csv,264,498877678.0,71,193,54,17,0,40.208333333333336,499,47,13.102272727272727,8
Category_Wikipedia_sockpuppets_of_Manmountain08.csv,1803,265925803.0,513,1290,500,13,0,41.62063227953411,281,58,19.760399334442596,3
Category_Wikipedia_sockpuppets_of_Mgaisser.csv,561,7126874.0,181,380,173,8,0,34.10338680926916,244,50,31.299465240641712,10
Category_Wikipedia_sockpuppets_of_Metlifecc.csv,268,84610508.0,99,169,25,74,0,48.41417910447761,234,50,24.41044776119403,4
Category_Wikipedia_sockpuppets_of_Maniksha.sharma.csv,310,41849563.0,86,224,37,49,0,50.75806451612903,243,53,21.07741935483871,5
Category_Wikipedia_sockpuppets_of_Kareemelmashad93.csv,14,1724465.0,9,5,6,3,0,35.642857142857146,151,26,18.142857142857142,13
Category_Wikipedia_sockpuppets_of_Anastasia_Quaicoo.csv,26,27317106.0,14,12,12,2,0,35.0,172,24,12.961538461538462,7
Category_Wikipedia_sockpuppets_of_Wirgensein.csv,87,2009482.0,24,63,24,0,0,60.04597701149425,253,31,18.942528735632184,14
Category_Wikipedia_sockpuppets_of_RfCvoter2019.csv,115,7876034.0,37,78,19,18,0,43.92173913043478,203,45,21.51304347826087,3
Category_Wikipedia_sockpuppets_of_The_ultra_a_man.csv,76,1209389.0,28,48,8,20,0,56.35526315789474,254,40,24.486842105263158,14
Category_Wikipedia_sockpuppets_of_Jamalar.csv,2358,12403735.0,592,1766,500,92,0,35.76929601357082,250,35,16.53519932145886,5
Category_Wikipedia_sockpuppets_of_CryptoGirl79.csv,5,1321.0,3,2,2,1,0,23.2,58,51,51.0,51
Category_Wikipedia_sockpuppets_of_Thomastruong158.csv,46,86294.0,22,24,16,6,25,58.04347826086956,160,53,34.84782608695652,20
Category_Wikipedia_sockpuppets_of_Remitbuber.csv,1374,181039501.0,406,968,40,366,0,49.509461426491995,496,77,22.37991266375546,3
Category_Wikipedia_sockpuppets_of_Peter_2009.csv,45,39952446.0,9,36,8,1,0,51.24444444444445,181,31,23.377777777777776,18
Category_Wikipedia_sockpuppets_of_Abhishek4889.csv,3686,222686654.0,1283,2403,409,874,0,44.79083016820402,287,90,18.723548562126968,4
Category_Wikipedia_sockpuppets_of_Gypsydog5150.csv,1105,32325281.0,287,818,89,198,0,50.991855203619906,250,47,16.097737556561086,4
Category_Wikipedia_sockpuppets_of_PPG2007.csv,117,2616774.0,45,72,43,2,0,37.452991452991455,199,59,35.675213675213676,10
Category_Wikipedia_sockpuppets_of_DeepBrainz.csv,7,1124914.0,4,3,3,1,11,75.0,243,34,29.142857142857142,20
Category_Wikipedia_sockpuppets_of_Gabriel601.csv,1043,226334689.0,470,573,428,42,0,54.419942473633746,492,65,28.040268456375838,4
Category_Wikipedia_sockpuppets_of_Cukiger.csv,3171,27978546.0,1162,2009,500,662,0,37.37401450646484,254,81,23.12362030905077,2
Category_Wikipedia_sockpuppets_of_Amoona.csv,324,408320962.0,101,223,45,56,0,39.574074074074076,261,44,16.87037037037037,4
Category_Wikipedia_sockpuppets_of_ANWARTHEWIKIGUY1.csv,2779,232740283.0,796,1983,500,296,0,32.992083483267365,434,51,12.871896365599136,3
"Category_Wikipedia_sockpuppets_of_Kingston,_CA.csv",1067,14464028.0,328,739,179,149,0,51.358950328022495,500,79,15.640112464854733,4
Category_Wikipedia_sockpuppets_of_HGH493.csv,104,12613081.0,48,56,38,10,0,75.1826923076923,250,22,13.346153846153847,6
Category_Wikipedia_sockpuppets_of_Wobbly_Pawn.csv,30,650931.0,16,14,10,6,0,71.96666666666667,410,31,22.9,16
Category_Wikipedia_sockpuppets_of_HedgieMouseMan.csv,115,9500438.0,34,81,25,9,0,58.97391304347826,400,24,10.243478260869566,5
Category_Wikipedia_sockpuppets_of_Skywarp360.csv,212,41904697.0,43,169,38,5,0,53.155660377358494,255,47,16.2688679245283,5
Category_Wikipedia_sockpuppets_of_Tamimomari.csv,722,33500881.0,238,484,238,0,0,23.54016620498615,234,46,22.810249307479225,5
Category_Wikipedia_sockpuppets_of_Kristijh.csv,2496,67524732.0,1014,1482,500,514,0,46.77363782051282,496,55,26.47235576923077,7
Category_Wikipedia_sockpuppets_of_Amrit914.csv,641,239412702.0,209,432,192,17,0,58.26053042121685,254,58,23.84399375975039,10
Category_Wikipedia_sockpuppets_of_Darkness_Shines.csv,2005,279994762.0,556,1449,500,56,0,62.17356608478803,439,64,28.490274314214464,4
Category_Wikipedia_sockpuppets_of_Scooooter.csv,1547,8111400.0,627,920,396,231,0,41.62637362637363,250,59,21.31415643180349,9
Category_Wikipedia_sockpuppets_of_Swegfag12.csv,1,0.0,1,0,1,0,0,0.0,0,14,14.0,14
Category_Wikipedia_sockpuppets_of_MentalSesher99.csv,17,1858.0,5,12,4,1,0,96.0,236,33,14.352941176470589,5
Category_Wikipedia_sockpuppets_of_Docteur.Salhi.csv,37,360539.0,22,15,15,7,0,44.648648648648646,238,16,9.91891891891892,7
Category_Wikipedia_sockpuppets_of_Hassaan201555.csv,461,6380304.0,185,276,100,85,0,26.991323210412148,255,47,23.301518438177876,6
Category_Wikipedia_sockpuppets_of_Michelemassa595959.csv,127,11823285.0,38,89,27,11,0,53.188976377952756,230,45,18.283464566929133,3
Category_Wikipedia_sockpuppets_of_JARCILLA.csv,561,164640196.0,144,417,56,88,0,49.50623885918004,281,50,19.119429590017827,4
Category_Wikipedia_sockpuppets_of_Delaykiller.csv,3,84042.0,3,0,2,1,48,57.0,67,18,15.666666666666666,13
Category_Wikipedia_sockpuppets_of_FD6TFS.csv,179,47446210.0,43,136,39,4,0,38.95530726256983,222,68,20.99441340782123,11
Category_Wikipedia_sockpuppets_of_Koko_Nigel.csv,1505,2435373.0,516,989,500,16,0,37.842524916943525,238,55,17.826578073089703,4
Category_Wikipedia_sockpuppets_of_Kyungseon_Lee.csv,50,5591788.0,13,37,8,5,0,55.34,284,41,16.64,3
Category_Wikipedia_sockpuppets_of_Show-Truth.csv,75,78766.0,41,34,41,0,0,43.06666666666667,199,38,21.813333333333333,12
Category_Wikipedia_sockpuppets_of_Jcourt656.csv,41,34480530.0,19,22,7,12,0,46.21951219512195,185,20,12.707317073170731,9
Category_Wikipedia_sockpuppets_of_Astra1999.csv,733,35408545.0,220,513,186,34,0,43.8731241473397,321,31,13.990450204638472,3
Category_Wikipedia_sockpuppets_of_Gurumayum_Arvind.csv,564,4943420.0,359,205,229,130,0,30.118794326241133,254,58,17.430851063829788,5
Category_Wikipedia_sockpuppets_of_LilLegendGamerz.csv,172,7875101.0,80,92,55,25,0,41.9593023255814,496,51,19.86627906976744,9
Category_Wikipedia_sockpuppets_of_Dataupdater.csv,75,133660387.0,19,56,13,6,0,39.54666666666667,203,60,15.92,6
Category_Wikipedia_sockpuppets_of_Franciscod.csv,123,53226251.0,47,76,28,19,0,52.300813008130085,184,36,16.878048780487806,12
Category_Wikipedia_sockpuppets_of_Luster_Love_(South_African_Rapper).csv,5,838458.0,2,3,1,1,12,28.8,49,44,38.8,18
Category_Wikipedia_sockpuppets_of_Adams1298.csv,96,3470151.0,33,63,22,11,0,32.822916666666664,181,25,16.583333333333332,10
Category_Wikipedia_sockpuppets_of_Babymiffy.csv,153,893115.0,99,54,54,45,0,29.875816993464053,236,31,18.00653594771242,11
Category_Wikipedia_sockpuppets_of_Punk1.csv,79,13085899.0,18,61,11,7,0,29.27848101265823,147,40,24.658227848101266,9
Category_Wikipedia_sockpuppets_of_JJBullet.csv,1234,21183768.0,536,698,500,36,0,54.630470016207454,500,61,23.867909238249595,10
Category_Wikipedia_sockpuppets_of_24Mikhail.csv,22,3823888.0,9,13,5,4,0,59.45454545454545,207,18,16.0,11
Category_Wikipedia_sockpuppets_of_Kshtreya_naidu.csv,64,11134.0,27,37,12,15,0,34.46875,219,17,10.875,6
Category_Wikipedia_sockpuppets_of_Games52010.csv,138,7775150.0,31,107,14,17,0,62.6231884057971,360,50,19.543478260869566,3
Category_Wikipedia_sockpuppets_of_Justmanfrom.csv,362,4742854.0,121,241,28,93,0,43.07734806629834,300,44,13.850828729281767,3
Category_Wikipedia_sockpuppets_of_Wikiaccnt1234.csv,913,78991324.0,296,617,101,195,0,46.151150054764514,255,51,15.73274917853231,4
Category_Wikipedia_sockpuppets_of_Toh_Yu_Heng.csv,371,333993.0,139,232,77,62,0,41.17250673854448,269,29,16.78167115902965,7
Category_Wikipedia_sockpuppets_of_Jvolkblum.csv,17139,266163919.0,5473,11666,500,4973,0,45.095454810665736,266,82,21.719353521208937,2
Category_Wikipedia_sockpuppets_of_Simonpettersen.csv,1314,20023232.0,514,800,500,14,0,28.573820395738203,255,66,19.939117199391173,6
Category_Wikipedia_sockpuppets_of_Maior.csv,939,2525448.0,294,645,193,101,0,26.19275825346113,200,47,18.366347177848777,4
Category_Wikipedia_sockpuppets_of_HarryPotterFan4747.csv,6201,33065579.0,1798,4403,343,1455,0,42.74036445734559,255,66,20.554749233994517,4
Category_Wikipedia_sockpuppets_of_Theroyalnikunj.csv,114,68616692.0,37,77,26,11,0,44.175438596491226,196,66,34.3859649122807,14
Category_Wikipedia_sockpuppets_of_CaptainEagle.csv,1013,1865734.0,252,761,230,22,0,41.381046396841064,223,54,18.808489634748273,3
Category_Wikipedia_sockpuppets_of_Mohammed_aiyaz.csv,1,0.0,1,0,1,0,199,199.0,199,39,39.0,39
Category_Wikipedia_sockpuppets_of_Jooner29.csv,94,5567199.0,38,56,25,13,0,76.07446808510639,235,51,24.20212765957447,15
Category_Wikipedia_sockpuppets_of_Pv.abhinav.csv,3471,210879242.0,1170,2301,500,670,0,45.32353788533564,430,53,14.857389801210026,3
Category_Wikipedia_sockpuppets_of_DW.csv,7967,80415461.0,3152,4815,500,2652,0,15.670892431279025,204,79,17.088866574620308,3
Category_Wikipedia_sockpuppets_of_Pir_Muhammad_Inayat_Ahmad_Naqshbandi.csv,33,444582.0,13,20,13,0,0,52.18181818181818,250,40,23.606060606060606,6
Category_Wikipedia_sockpuppets_of_D97arsenal.csv,274,13669853.0,77,197,58,19,0,39.7956204379562,234,37,16.616788321167885,9
Category_Wikipedia_sockpuppets_of_Canadiansteve.csv,1085,408233489.0,400,685,354,46,0,44.46912442396313,414,47,18.822119815668202,5
Category_Wikipedia_sockpuppets_of_Flyingstarburst.csv,26,3628305.0,9,17,4,5,0,68.38461538461539,236,21,20.153846153846153,19
Category_Wikipedia_sockpuppets_of_Am_Broly.csv,283,12418529.0,94,189,18,76,0,59.50176678445229,414,66,18.42756183745583,5
Category_Wikipedia_sockpuppets_of_Sabuhiguseinov064.csv,93,10360019.0,49,44,49,0,0,32.83870967741935,255,61,26.376344086021504,16
Category_Wikipedia_sockpuppets_of_Trainrobber66.csv,1865,48448246.0,628,1237,500,128,0,43.2343163538874,499,58,19.107774798927615,3
Category_Wikipedia_sockpuppets_of_Nwafor_Andrew.csv,2003,26206325.0,789,1214,213,576,0,39.145781328007985,500,52,18.452321517723416,5
Category_Wikipedia_sockpuppets_of_HemperorOfSmokeLandVillez.dum.csv,620,9551373.0,278,342,275,3,0,58.119354838709675,255,46,17.67258064516129,5
Category_Wikipedia_sockpuppets_of_MikaelArage.csv,51,27056591.0,12,39,12,0,0,71.66666666666667,255,13,12.72549019607843,11
Category_Wikipedia_sockpuppets_of_Newpatek.csv,16,30633819.0,9,7,8,1,0,70.8125,495,22,18.25,18
Category_Wikipedia_sockpuppets_of_Paolatds.csv,4,427.0,3,1,3,0,17,35.25,90,16,15.25,13
Category_Wikipedia_sockpuppets_of_Hoodtv.csv,1,0.0,1,0,1,0,199,199.0,199,16,16.0,16
Category_Wikipedia_sockpuppets_of_Overpopultion12.csv,16,647217.0,5,11,2,3,0,55.8125,171,45,15.375,5
Category_Wikipedia_sockpuppets_of_Mabrials.csv,6,1306.0,5,1,3,2,11,29.333333333333332,85,22,20.0,18
Category_Wikipedia_sockpuppets_of_Anytimeanywhere.csv,19,24119000.0,4,15,3,1,0,49.1578947368421,186,53,51.94736842105263,33
Category_Wikipedia_sockpuppets_of_Zx24.csv,99,5688866.0,36,63,25,11,0,45.61616161616162,448,45,18.91919191919192,5
Category_Wikipedia_sockpuppets_of_Mikewoodall7553.csv,5,5753.0,3,2,2,1,0,79.0,178,27,27.0,27
Category_Wikipedia_sockpuppets_of_ThugIvo.csv,12,681472.0,6,6,5,1,0,53.583333333333336,130,26,18.75,13
Category_Wikipedia_sockpuppets_of_Prashant_Wankhed.csv,64,675500.0,30,34,18,12,0,29.6875,187,46,20.109375,13
Category_Wikipedia_sockpuppets_of_Destinystreet.csv,206,4487612.0,68,138,22,46,0,41.58252427184466,226,38,16.019417475728154,8
Category_Wikipedia_sockpuppets_of_TVMiniuni.csv,81,85257.0,31,50,23,8,0,46.04938271604938,209,27,17.049382716049383,2
Category_Wikipedia_sockpuppets_of_Grgr8.csv,91,3440841.0,37,54,35,2,0,49.07692307692308,254,46,19.505494505494507,6
Category_Wikipedia_sockpuppets_of_Stanley514.csv,46,578573.0,21,25,15,6,0,61.93478260869565,250,12,9.043478260869565,7
Category_Wikipedia_sockpuppets_of_Dasfadsfas.csv,136,367122.0,42,94,11,31,0,60.9485294117647,255,45,20.75,6
Category_Wikipedia_sockpuppets_of_Arnoldburg.csv,1,0.0,1,0,1,0,18,18.0,18,15,15.0,15
Category_Wikipedia_sockpuppets_of_007pranoy.csv,2052,157690431.0,702,1350,500,202,0,30.863060428849902,255,36,14.577972709551657,5
Category_Wikipedia_sockpuppets_of_Heyuio.csv,78,1424877.0,30,48,15,15,0,57.56410256410256,258,60,22.17948717948718,10
Category_Wikipedia_sockpuppets_of_Entertainmentlovers.csv,34,4646612.0,14,20,13,1,0,43.205882352941174,140,47,37.38235294117647,19
Category_Wikipedia_sockpuppets_of_HelpRwanda.csv,15,150545.0,10,5,8,2,0,92.26666666666667,222,20,9.6,6
Category_Wikipedia_sockpuppets_of_Muhammad_Ibrahim_Afkar.csv,4,98101.0,3,1,2,1,0,129.25,196,32,27.5,23
Category_Wikipedia_sockpuppets_of_Dino_nam.csv,1538,39393565.0,568,970,500,68,0,46.00130039011704,284,54,27.30104031209363,13
Category_Wikipedia_sockpuppets_of_Chrisisvpro.csv,35,387218.0,16,19,14,2,0,40.857142857142854,204,19,14.342857142857143,11
Category_Wikipedia_sockpuppets_of_Biscuittin.csv,3818,55993267.0,1356,2462,500,856,0,42.48271346254584,255,80,22.053693033001572,2
Category_Wikipedia_sockpuppets_of_Shlomo909.csv,138,1702109.0,44,94,23,21,0,50.06521739130435,200,54,26.44927536231884,10
Category_Wikipedia_sockpuppets_of_Madvillain2009.csv,3953,174706576.0,1062,2891,500,562,0,35.665570452820646,255,66,19.977485454085503,2
Category_Wikipedia_sockpuppets_of_Wodwdeeee.csv,51,32209.0,44,7,15,29,0,28.372549019607842,142,17,8.647058823529411,6
Category_Wikipedia_sockpuppets_of_Misleadingpromotionaloffensivedisruptive.csv,40,2855520.0,14,26,6,8,0,86.25,490,30,16.875,9
Category_Wikipedia_sockpuppets_of_PornSexAssButtPiss.csv,31,4560021.0,12,19,6,6,0,36.32258064516129,187,45,24.161290322580644,5
Category_Wikipedia_sockpuppets_of_DroidBishop.csv,1355,5345890.0,527,828,500,27,0,53.69667896678967,367,55,16.65018450184502,4
Category_Wikipedia_sockpuppets_of_Abcdefghij12345trfgh.csv,308,1980206.0,80,228,71,9,0,54.23376623376623,249,34,23.025974025974026,7
Category_Wikipedia_sockpuppets_of_FortniteEpicDub.csv,43,319992.0,15,28,8,7,0,50.093023255813954,233,31,19.069767441860463,11
Category_Wikipedia_sockpuppets_of_LuckyWeirdo.csv,6,572242.0,4,2,3,1,0,47.833333333333336,229,17,16.333333333333332,15
Category_Wikipedia_sockpuppets_of_Cato22112211.csv,35,22485.0,29,6,16,13,0,22.771428571428572,195,17,15.6,4
Category_Wikipedia_sockpuppets_of_Invotech.csv,4,13837.0,4,0,4,0,14,36.5,44,18,18.0,18
Category_Wikipedia_sockpuppets_of_Madisonwheaty.csv,10,2356.0,7,3,4,3,0,57.0,210,18,18.0,18
Category_Wikipedia_sockpuppets_of_Polloyaho.csv,34,9242.0,26,8,16,10,0,29.58823529411765,215,15,14.882352941176471,14
Category_Wikipedia_sockpuppets_of_Sobbo.csv,402,84668272.0,131,271,112,19,0,53.2363184079602,255,48,23.084577114427862,3
Category_Wikipedia_sockpuppets_of_SARAHELIZTAYLOR.csv,45,42164213.0,12,33,6,6,0,48.84444444444444,224,61,27.2,10
Category_Wikipedia_sockpuppets_of_Arijeet_Patil.csv,1641,11922012.0,507,1134,363,144,0,58.460694698354665,255,60,21.93418647166362,4
Category_Wikipedia_sockpuppets_of_Raznice.csv,216,7517799.0,63,153,61,2,0,47.523148148148145,223,25,9.24074074074074,3
Category_Wikipedia_sockpuppets_of_Ath.Sn.csv,29,3636219.0,10,19,8,2,0,32.724137931034484,95,48,30.896551724137932,14
Category_Wikipedia_sockpuppets_of_Rrmaticul.csv,2,72.0,2,0,2,0,0,0.0,0,31,31.0,31
Category_Wikipedia_sockpuppets_of_Shay1070.csv,5,1074144.0,5,0,4,1,9,21.8,73,13,13.0,13
Category_Wikipedia_sockpuppets_of_Retro_FG.csv,31,1102392.0,9,22,5,4,0,50.74193548387097,176,35,25.580645161290324,7
Category_Wikipedia_sockpuppets_of_Vinney555.csv,37,32233462.0,9,28,8,1,0,55.45945945945946,161,26,21.972972972972972,14
Category_Wikipedia_sockpuppets_of_Bothe1.csv,29,600285.0,14,15,6,8,0,29.20689655172414,140,39,21.20689655172414,11
Category_Wikipedia_sockpuppets_of_Diligentemu.csv,316,11484569.0,103,213,82,21,0,55.5126582278481,256,51,22.45253164556962,7
Category_Wikipedia_sockpuppets_of_Ali_mansour.csv,443,42836483.0,216,227,43,173,0,34.3882618510158,488,53,22.401805869074494,10
Category_Wikipedia_sockpuppets_of_JLChallengesYouTube.csv,27,4666836.0,6,21,4,2,0,72.74074074074075,272,16,13.74074074074074,9
Category_Wikipedia_sockpuppets_of_Jeancharleszakaria.csv,18,56273.0,9,9,9,0,0,54.27777777777778,196,33,28.666666666666668,23
Category_Wikipedia_sockpuppets_of_Slasher405.csv,2060,28921624.0,501,1559,500,1,0,47.63592233009709,414,48,16.226699029126213,5
Category_Wikipedia_sockpuppets_of_Sckay27.csv,315,19149180.0,110,205,17,93,0,51.87301587301587,255,59,23.126984126984127,6
Category_Wikipedia_sockpuppets_of_Mickeydkop.csv,1502,17011059.0,631,871,500,131,0,29.28761651131824,494,58,26.499334221038616,5
Category_Wikipedia_sockpuppets_of_ISECHIKA.csv,163,105717734.0,119,44,16,103,0,45.97546012269939,251,35,17.7239263803681,13
Category_Wikipedia_sockpuppets_of_72bikers.csv,1599,43072401.0,545,1054,500,45,0,57.62038774233896,491,54,27.47842401500938,9
Category_Wikipedia_sockpuppets_of_Jetarvind438.csv,4,3730108.0,3,1,2,1,2,83.75,196,34,27.25,22
Category_Wikipedia_sockpuppets_of_Jaislejorge64.csv,330,3262863.0,158,172,66,92,0,57.00909090909091,230,40,25.957575757575757,6
Category_Wikipedia_sockpuppets_of_Md_Mehdi_vaiya.csv,31,2458465.0,14,17,7,7,0,60.516129032258064,152,31,22.032258064516128,9
Category_Wikipedia_sockpuppets_of_Acekard.csv,4544,90042094.0,1383,3161,500,883,0,48.893265845070424,500,57,19.250220070422536,4
Category_Wikipedia_sockpuppets_of_Hpyounes.csv,1687,321069806.0,502,1185,499,3,0,27.886188500296385,238,42,17.24896265560166,4
Category_Wikipedia_sockpuppets_of_Thetranslaterofhistory.csv,2631,23317172.0,658,1973,122,536,0,70.10680349676929,496,58,16.3747624477385,3
Category_Wikipedia_sockpuppets_of_Playloudproductions.csv,317,297911390.0,110,207,51,59,0,43.54574132492114,228,46,18.832807570977916,9
Category_Wikipedia_sockpuppets_of_Oldpeoplegodumb42.csv,16,872333.0,6,10,5,1,17,36.375,91,56,34.5625,24
Category_Wikipedia_sockpuppets_of_Jacobkk.csv,18,3226032.0,6,12,3,3,0,69.55555555555556,236,7,7.0,7
Category_Wikipedia_sockpuppets_of_Nessspam.csv,7,685.0,5,2,3,2,0,61.714285714285715,181,17,17.0,17
Category_Wikipedia_sockpuppets_of_BailiwickOfTheChannel.csv,1254,20415478.0,421,833,330,91,0,50.51993620414673,471,67,23.083732057416267,1
Category_Wikipedia_sockpuppets_of_Mandolinryan.csv,53,80512166.0,24,29,19,5,0,59.62264150943396,500,41,28.867924528301888,20
Category_Wikipedia_sockpuppets_of_AramaeanSyriac.csv,1725,38435586.0,671,1054,500,171,0,45.07420289855072,213,67,15.064347826086957,4
Category_Wikipedia_sockpuppets_of_Sion_glyn.csv,1057,50573712.0,385,672,374,11,0,32.51087984862819,211,38,15.887417218543046,5
Category_Wikipedia_sockpuppets_of_Umairsarfrazdogar.csv,77,1470797.0,47,30,32,15,0,31.98701298701299,201,35,14.376623376623376,5
Category_Wikipedia_sockpuppets_of_Amkgp.csv,2521,12365301.0,1000,1521,500,500,0,62.802062673542245,500,63,23.525188417294725,4
Category_Wikipedia_sockpuppets_of_SunSmart_Technologies_Ltd.csv,7,2194.0,4,3,4,0,15,29.0,76,42,42.0,42
Category_Wikipedia_sockpuppets_of_G1234~eswiki.csv,367,4926036.0,107,260,62,45,0,48.321525885558586,255,47,36.33242506811989,8
Category_Wikipedia_sockpuppets_of_Jacobayoub.csv,657,338667.0,525,132,500,25,0,9.800608828006089,221,49,17.797564687975648,15
Category_Wikipedia_sockpuppets_of_Kansas7474.csv,323,14663480.0,119,204,66,53,0,38.845201238390096,215,36,15.594427244582043,6
Category_Wikipedia_sockpuppets_of_Samshersinghbeniyaaz.csv,201,1038495.0,86,115,75,11,0,41.850746268656714,233,56,18.432835820895523,5
Category_Wikipedia_sockpuppets_of_Butmetall.csv,47,53210718.0,23,24,10,13,0,89.53191489361703,234,19,14.914893617021276,12
Category_Wikipedia_sockpuppets_of_THCNVN_Channel.csv,579,7362765.0,274,305,80,194,0,36.88946459412781,448,53,26.955094991364422,18
Category_Wikipedia_sockpuppets_of_Bloodz311.csv,165,27632345.0,51,114,48,3,0,42.38181818181818,225,30,18.951515151515153,12
Category_Wikipedia_sockpuppets_of_Davidwikipedia.csv,140,1370859.0,51,89,49,2,0,34.32857142857143,188,39,11.814285714285715,4
Category_Wikipedia_sockpuppets_of_Malarc77.csv,14,94501.0,6,8,4,2,0,55.642857142857146,199,20,14.857142857142858,9
Category_Wikipedia_sockpuppets_of_Anvita272.csv,126,44581483.0,36,90,13,23,0,35.25396825396825,211,41,16.22222222222222,6
Category_Wikipedia_sockpuppets_of_Believing-two.csv,428,6028382.0,296,132,202,94,0,35.032710280373834,292,29,23.014018691588785,11
Category_Wikipedia_sockpuppets_of_Zippycup.csv,1588,9563283.0,511,1077,124,387,0,36.82178841309824,215,55,18.370277078085643,4
Category_Wikipedia_sockpuppets_of_Houserules22.csv,58,4025.0,20,38,11,9,0,43.48275862068966,204,29,17.224137931034484,5
Category_Wikipedia_sockpuppets_of_Lover80s.csv,104,1245645.0,30,74,24,6,0,39.46153846153846,231,29,16.384615384615383,10
Category_Wikipedia_sockpuppets_of_NateDawg652.csv,1672,41277253.0,652,1020,500,152,0,33.46052631578947,500,56,22.579545454545453,8
Category_Wikipedia_sockpuppets_of_Phanord.csv,2325,134255386.0,952,1373,408,544,0,40.723010752688175,512,67,18.991827956989248,5
Category_Wikipedia_sockpuppets_of_Mariasfixing.csv,136,4512440.0,50,86,20,30,0,67.49264705882354,256,64,17.205882352941178,8
Category_Wikipedia_sockpuppets_of_Rpmohak.csv,493,79960926.0,125,368,113,12,0,38.1683569979716,379,51,21.442190669371197,5
Category_Wikipedia_sockpuppets_of_Frogg92477.csv,342,22376315.0,104,238,39,65,0,43.60526315789474,249,66,18.14327485380117,6
Category_Wikipedia_sockpuppets_of_Shreyjoshi007.csv,24,3542336.0,19,5,14,5,0,14.625,103,23,18.208333333333332,6
Category_Wikipedia_sockpuppets_of_Hammerman_Gunmetal.csv,522,260800645.0,186,336,122,64,0,47.547892720306514,484,37,15.095785440613026,5
Category_Wikipedia_sockpuppets_of_A_-)Brunu≈õ.csv,3,458.0,2,1,2,0,0,42.666666666666664,64,20,20.0,20
Category_Wikipedia_sockpuppets_of_Gnooolsitacgnol.csv,26,7551965.0,10,16,8,2,0,48.03846153846154,171,26,15.192307692307692,9
Category_Wikipedia_sockpuppets_of_Meenakshibadsiwalmeu.csv,40,99202.0,26,14,22,4,0,39.175,179,41,15.425,6
Category_Wikipedia_sockpuppets_of_Prairespark.csv,231,788607.0,112,119,87,25,0,33.60606060606061,255,42,27.813852813852815,14
Category_Wikipedia_sockpuppets_of_Boxorange.csv,14,2278405.0,7,7,7,0,0,30.428571428571427,150,20,14.071428571428571,11
Category_Wikipedia_sockpuppets_of_Qaumrambista.csv,2033,8527282.0,816,1217,500,316,0,45.45007378258731,500,58,28.940482046237086,6
Category_Wikipedia_sockpuppets_of_Sentineloflight05.csv,264,372950134.0,97,167,68,29,0,57.19318181818182,232,50,20.166666666666668,15
Category_Wikipedia_sockpuppets_of_DANIEL_OBUOBI.csv,197,73824564.0,99,98,71,28,0,40.74111675126903,232,71,31.614213197969544,16
Category_Wikipedia_sockpuppets_of_Panchaldeep009.csv,1,0.0,1,0,1,0,28,28.0,28,24,24.0,24
Category_Wikipedia_sockpuppets_of_Adamiraki.csv,86,1852029.0,37,49,37,0,0,37.74418604651163,192,34,19.593023255813954,11
Category_Wikipedia_sockpuppets_of_Mscoree.csv,1,0.0,1,0,1,0,26,26.0,26,15,15.0,15
Category_Wikipedia_sockpuppets_of_ECCCNPRI.csv,29,1110410.0,14,15,6,8,0,52.03448275862069,196,36,25.689655172413794,13
Category_Wikipedia_sockpuppets_of_Cryx88.csv,3433,118020015.0,1356,2077,500,856,0,43.27730847655112,255,86,31.855228662976987,4
Category_Wikipedia_sockpuppets_of_Adrian2526.csv,161,23953820.0,55,106,35,20,0,39.82608695652174,240,34,18.63975155279503,13
Category_Wikipedia_sockpuppets_of_SanchiTachi.csv,1590,135867009.0,519,1071,500,19,0,50.83459119496855,262,93,28.867295597484276,7
Category_Wikipedia_sockpuppets_of_CornHusker12.csv,4,3802302.0,3,1,2,1,12,124.25,181,18,18.0,18
Category_Wikipedia_sockpuppets_of_II.Super_Legendary.II.csv,11,69283.0,8,3,8,0,0,41.09090909090909,140,11,10.636363636363637,9
Category_Wikipedia_sockpuppets_of_Ylogm.csv,6820,65934158.0,2335,4485,500,1835,0,38.12096774193548,500,48,14.873900293255131,4
Category_Wikipedia_sockpuppets_of_Anilnayak8.csv,65,34390380.0,55,10,49,6,0,10.76923076923077,196,37,29.184615384615384,15
Category_Wikipedia_sockpuppets_of_FromSenegal.csv,628,59399018.0,250,378,198,52,0,49.052547770700635,492,51,14.519108280254777,5
Category_Wikipedia_sockpuppets_of_Cosmic_Emperor.csv,8,219.0,5,3,5,0,24,27.0,36,16,16.0,16
Category_Wikipedia_sockpuppets_of_Hellomanimhere.csv,28,353837.0,17,11,10,7,0,30.357142857142858,183,31,23.25,14
Category_Wikipedia_sockpuppets_of_Allthekidsinthestreet.csv,377,4594453.0,122,255,83,39,0,71.6896551724138,241,57,20.02387267904509,8
Category_Wikipedia_sockpuppets_of_Sai_Akash_P.csv,41,37262876.0,17,24,15,2,0,50.21951219512195,255,31,15.024390243902438,7
Category_Wikipedia_sockpuppets_of_Wikileakageproof.csv,15,1259196.0,11,4,5,6,0,24.333333333333332,250,27,18.533333333333335,12
Category_Wikipedia_sockpuppets_of_Desiderius_Megistus.csv,30,3132411.0,14,16,7,7,0,63.9,196,24,14.166666666666666,3
Category_Wikipedia_sockpuppets_of_Parthsiddhpura.csv,115,39316082.0,27,88,11,16,0,56.87826086956522,496,47,18.904347826086955,11
Category_Wikipedia_sockpuppets_of_MudfishHunter.csv,64,11560007.0,20,44,9,11,0,50.6875,213,32,11.515625,3
Category_Wikipedia_sockpuppets_of_NickCassidy.csv,237,13916458.0,115,122,50,65,0,53.05907172995781,479,43,15.658227848101266,8
Category_Wikipedia_sockpuppets_of_Â¢®Áî∞„É¶„Ç≠.csv,36,565603.0,16,20,15,1,0,35.97222222222222,228,31,15.944444444444445,9
Category_Wikipedia_sockpuppets_of_Wittlessgenstein.csv,2800,115186796.0,770,2030,500,270,0,46.23571428571429,250,51,19.330357142857142,5
Category_Wikipedia_sockpuppets_of_Gaydenver.csv,3065,93112291.0,781,2284,230,551,0,46.29004893964111,253,68,23.81011419249592,4
Category_Wikipedia_sockpuppets_of_Bobblehat99.csv,175,1239748.0,60,115,2,58,0,54.90857142857143,213,57,23.21142857142857,9
Category_Wikipedia_sockpuppets_of_Massimocicc.csv,813,228260555.0,233,580,222,11,0,55.456334563345635,255,65,18.59409594095941,1
Category_Wikipedia_sockpuppets_of_ScrewsHirsch.csv,318,97089555.0,91,227,76,15,0,37.4874213836478,255,48,16.09433962264151,4
Category_Wikipedia_sockpuppets_of_Yonogah.csv,3,85655.0,2,1,2,0,32,45.0,65,36,29.666666666666668,17
Category_Wikipedia_sockpuppets_of_PaulRMitchell.csv,26,90929.0,20,6,10,10,0,24.73076923076923,196,22,22.0,22
Category_Wikipedia_sockpuppets_of_Imran_Rajput_Actor.csv,107,64972290.0,35,72,23,12,0,54.06542056074766,255,28,14.57943925233645,6
Category_Wikipedia_sockpuppets_of_Rezet112.csv,66,3013383.0,19,47,12,7,0,69.57575757575758,230,24,16.681818181818183,10
Category_Wikipedia_sockpuppets_of_MSoldi.csv,2381,36218501.0,772,1609,500,272,0,35.406131877362455,264,69,22.375472490550187,3
Category_Wikipedia_sockpuppets_of_Sakura_china.csv,101,44759943.0,28,73,20,8,0,52.415841584158414,217,52,20.346534653465348,10
Category_Wikipedia_sockpuppets_of_MDSTAGRD.csv,10,1015139.0,9,1,7,2,0,25.1,186,42,34.9,13
Category_Wikipedia_sockpuppets_of_Howzat_out.csv,68,38201895.0,18,50,17,1,0,57.1764705882353,225,50,23.88235294117647,14
Category_Wikipedia_sockpuppets_of_Asmaoul_Husna_Mona_Karim.csv,104,1146537.0,52,52,48,4,0,53.59615384615385,237,47,35.41346153846154,21
Category_Wikipedia_sockpuppets_of_Lycoperdon.csv,319,25276111.0,87,232,45,42,0,64.04702194357367,255,60,29.90282131661442,13
Category_Wikipedia_sockpuppets_of_DickyRobert.csv,129,39432827.0,40,89,35,5,0,35.627906976744185,162,24,19.224806201550386,11
Category_Wikipedia_sockpuppets_of_Jookiecookie12.csv,16,436141.0,5,11,4,1,0,32.25,126,16,16.0,16
Category_Wikipedia_sockpuppets_of_Butchre.csv,18,8986.0,10,8,8,2,0,7.888888888888889,49,24,18.666666666666668,13
Category_Wikipedia_sockpuppets_of_TBATlol.csv,23,4214900.0,11,12,11,0,0,66.95652173913044,214,44,21.782608695652176,13
Category_Wikipedia_sockpuppets_of_JLUKACS1.csv,75,41474332.0,26,49,26,0,0,38.946666666666665,196,90,18.506666666666668,6
Category_Wikipedia_sockpuppets_of_Unotretre.csv,288,266923849.0,105,183,51,54,0,49.232638888888886,255,47,28.572916666666668,13
Category_Wikipedia_sockpuppets_of_Animelover3.csv,142,2338014.0,65,77,23,42,0,40.809859154929576,235,36,19.788732394366196,8
Category_Wikipedia_sockpuppets_of_Joshii.csv,1811,57274959.0,529,1282,500,29,0,49.74710104914412,227,104,21.72446162341248,2
Category_Wikipedia_sockpuppets_of_Unitedkingdom2017.csv,37,39647378.0,14,23,10,4,0,47.13513513513514,196,45,26.945945945945947,13
Category_Wikipedia_sockpuppets_of_Montaj13.csv,1755,31356348.0,512,1243,160,352,0,30.96980056980057,221,51,19.226210826210828,5
Category_Wikipedia_sockpuppets_of_Motiva√ß√£o.csv,31840,180642399.0,7348,24492,500,6848,0,51.59657663316583,502,67,17.63505025125628,0
Category_Wikipedia_sockpuppets_of_Theman244.csv,1829,30831033.0,503,1326,500,3,0,54.99617277200656,255,54,15.813559322033898,4
Category_Wikipedia_sockpuppets_of_Homawon_Kabir.csv,8,6923953.0,7,1,5,2,0,16.875,28,23,22.375,19
Category_Wikipedia_sockpuppets_of_Ratulroy12344321.csv,8,510122.0,3,5,2,1,0,53.875,142,20,15.875,11
Category_Wikipedia_sockpuppets_of_Zigali.csv,291,522648.0,82,209,60,22,0,42.92096219931271,467,32,18.57388316151203,8
Category_Wikipedia_sockpuppets_of_Heinz2007.csv,2,39.0,2,0,2,0,0,0.0,0,11,11.0,11
Category_Wikipedia_sockpuppets_of_Lawready.csv,99,8134871.0,28,71,22,6,0,44.666666666666664,205,43,21.535353535353536,8
Category_Wikipedia_sockpuppets_of_Sudheer_Telaprolu.csv,1628,65317703.0,763,865,498,265,0,26.767813267813267,281,51,15.682432432432432,5
Category_Wikipedia_sockpuppets_of_TimeToMakeAStand.csv,223,5526712.0,92,131,78,14,0,51.43946188340807,351,80,23.116591928251122,9
Category_Wikipedia_sockpuppets_of_Usmankhan228.csv,10,874426.0,9,1,7,2,0,56.3,196,56,27.8,17
Category_Wikipedia_sockpuppets_of_FunGuyDevotedToFSL2.csv,70,1205348.0,32,38,6,26,0,59.47142857142857,255,25,20.02857142857143,16
Category_Wikipedia_sockpuppets_of_Borhankhan01.csv,608,99523817.0,225,383,155,70,0,43.84703947368421,244,60,23.15953947368421,9
Category_Wikipedia_sockpuppets_of_Dabojo074.csv,13,1262.0,5,8,5,0,0,27.0,179,15,11.384615384615385,8
Category_Wikipedia_sockpuppets_of_AznNYCer212.csv,781,5392483.0,267,514,66,201,0,32.72599231754161,200,50,19.001280409731113,9
Category_Wikipedia_sockpuppets_of_Mohammed106.csv,386,4335542.0,132,254,52,80,0,44.00259067357513,326,54,25.26683937823834,5
Category_Wikipedia_sockpuppets_of_Yaktat.csv,10,860983.0,5,5,4,1,0,62.7,173,16,10.8,7
Category_Wikipedia_sockpuppets_of_Ajsillo302010.csv,1687,87327783.0,513,1174,500,13,0,33.072317723770006,255,71,27.852400711321874,3
Category_Wikipedia_sockpuppets_of_Gadri.csv,4191,13993306.0,1458,2733,379,1079,0,52.512049630159865,255,92,19.29563350035791,1
Category_Wikipedia_sockpuppets_of_Swissair123.csv,73,3284278.0,32,41,23,9,0,47.83561643835616,208,47,17.684931506849313,10
Category_Wikipedia_sockpuppets_of_LoganThePickle.csv,212,393915.0,66,146,42,24,0,46.136792452830186,234,65,27.70754716981132,12
Category_Wikipedia_sockpuppets_of_Basedch.csv,1762,20281263.0,629,1133,500,129,0,56.058456299659476,496,65,16.841089670828605,3
Category_Wikipedia_sockpuppets_of_HP1Pigtail.csv,2050,70465692.0,523,1527,500,23,0,47.877073170731705,335,54,19.200487804878048,3
Category_Wikipedia_sockpuppets_of_Petter_noca.csv,201,22246626.0,90,111,76,14,0,40.766169154228855,354,23,14.587064676616915,6
Category_Wikipedia_sockpuppets_of_Nyxaros2.csv,2914,45662026.0,884,2030,291,593,0,56.821551132463966,496,61,20.042210020590254,4
Category_Wikipedia_sockpuppets_of_Sankhu01.csv,36,6691028.0,8,28,6,2,0,40.861111111111114,196,27,23.22222222222222,8
Category_Wikipedia_sockpuppets_of_Highyack07.csv,408,59700409.0,113,295,82,31,0,39.7328431372549,233,53,18.79656862745098,5
Category_Wikipedia_sockpuppets_of_Nintendude.csv,2366,17716620.0,590,1776,500,90,0,28.111158072696533,229,81,16.039306846999153,2
Category_Wikipedia_sockpuppets_of_ÿπŸÑŸàŸä_ŸÇÿ≤ŸÑÿ®ÿßÿ¥Ÿä.csv,102,1446823.0,39,63,18,21,0,72.91176470588235,456,38,21.215686274509803,7
Category_Wikipedia_sockpuppets_of_Surfspecz.csv,14,78769.0,10,4,10,0,0,40.214285714285715,123,17,16.214285714285715,14
Category_Wikipedia_sockpuppets_of_TerryJ-Ho.csv,1383,9686132.0,539,844,500,39,0,40.511930585683295,200,120,29.99638467100506,5
Category_Wikipedia_sockpuppets_of_WillardJindal.csv,597,13572203.0,175,422,69,106,0,42.790619765494135,255,75,33.31993299832496,4
Category_Wikipedia_sockpuppets_of_Profwujiang.csv,796,14104697.0,362,434,232,130,0,36.256281407035175,235,27,10.96608040201005,5
Category_Wikipedia_sockpuppets_of_Hydao.csv,2766,139985243.0,1005,1761,500,505,0,43.612075198843094,263,63,22.22885032537961,4
Category_Wikipedia_sockpuppets_of_Acwwqq.csv,40,6418093.0,12,28,9,3,0,37.975,129,54,30.55,15
Category_Wikipedia_sockpuppets_of_Carmena_Seoul.csv,319,32456524.0,92,227,46,46,0,57.529780564263326,364,47,19.219435736677116,9
Category_Wikipedia_sockpuppets_of_Idesignw.csv,264,133545056.0,93,171,38,55,0,39.996212121212125,255,38,16.943181818181817,8
Category_Wikipedia_sockpuppets_of_Iffyfflewo.csv,923,37586427.0,380,543,365,15,0,54.24485373781148,497,62,23.138678223185266,7
Category_Wikipedia_sockpuppets_of_AimKriti.csv,400,33865985.0,216,184,116,100,0,41.8025,324,54,21.705,8
Category_Wikipedia_sockpuppets_of_Ebanksmanagement.csv,409,14696944.0,116,293,13,103,0,47.76772616136919,232,50,14.310513447432763,5
Category_Wikipedia_sockpuppets_of_Lordreeves.csv,36,42426.0,15,21,10,5,0,47.69444444444444,487,31,18.5,7
Category_Wikipedia_sockpuppets_of_Obi-WanKenobi-2005.csv,2952,548489269.0,756,2196,500,256,0,43.90311653116531,507,65,18.769986449864497,6
Category_Wikipedia_sockpuppets_of_Snehilsharma.csv,1521,216050688.0,508,1013,500,8,0,42.79026955950033,255,61,15.982248520710058,3
Category_Wikipedia_sockpuppets_of_AnteaterZot.csv,2902,8468417.0,1067,1835,500,567,0,37.9724328049621,246,101,24.96898690558236,3
Category_Wikipedia_sockpuppets_of_Greatest_goat.csv,413,618251.0,103,310,75,28,0,73.17675544794189,242,44,15.39951573849879,3
Category_Wikipedia_sockpuppets_of_Ajfabien.csv,166,9495004.0,74,92,42,32,0,73.56626506024097,253,39,27.13855421686747,13
Category_Wikipedia_sockpuppets_of_Lem_xytus.csv,57,4731343.0,46,11,44,2,0,25.42105263157895,140,19,18.92982456140351,17
Category_Wikipedia_sockpuppets_of_MARMOT.csv,2740,43527751.0,1092,1648,177,915,0,36.65474452554744,255,69,12.187956204379562,3
Category_Wikipedia_sockpuppets_of_Yoyowhatsup2.csv,405,6449996.0,136,269,64,72,0,48.7037037037037,242,77,22.333333333333332,3
Category_Wikipedia_sockpuppets_of_77willshop.csv,97,21117027.0,25,72,9,16,0,53.78350515463917,274,35,14.31958762886598,6
Category_Wikipedia_sockpuppets_of_TheIrishWarden.csv,1637,48033953.0,512,1125,500,12,0,66.32742822235797,255,112,23.86010995723885,3
Category_Wikipedia_sockpuppets_of_Tanmatra5.csv,642,13969623.0,260,382,88,172,0,42.29127725856698,225,52,23.24454828660436,4
Category_Wikipedia_sockpuppets_of_Richybachvevo.csv,36,7177138.0,9,27,7,2,0,40.22222222222222,152,26,15.277777777777779,6
Category_Wikipedia_sockpuppets_of_Rolusty33.csv,439,120461133.0,167,272,163,4,0,54.466970387243734,236,51,29.28246013667426,11
Category_Wikipedia_sockpuppets_of_ErKaranArora.csv,89,685597.0,30,59,23,7,0,43.87640449438202,196,53,22.651685393258425,6
Category_Wikipedia_sockpuppets_of_ANASKHAN777.csv,3776,224662904.0,1533,2243,500,1033,0,32.282309322033896,494,69,22.7823093220339,4
Category_Wikipedia_sockpuppets_of_Lear_21.csv,2604,76964823.0,865,1739,500,365,0,47.52918586789554,263,71,16.352150537634408,5
Category_Wikipedia_sockpuppets_of_User0987654321a.csv,48,181067.0,16,32,9,7,0,54.145833333333336,207,50,30.895833333333332,3
Category_Wikipedia_sockpuppets_of_Entertainment4u2013.csv,62,95120.0,20,42,18,2,0,56.306451612903224,196,60,20.532258064516128,9
Category_Wikipedia_sockpuppets_of_Fanandthelights.csv,666,5662846.0,268,398,127,141,0,25.01801801801802,344,41,18.073573573573572,7
Category_Wikipedia_sockpuppets_of_Designaccountforher.csv,13,4921.0,8,5,5,3,0,12.153846153846153,72,45,45.0,45
Category_Wikipedia_sockpuppets_of_G63_Digital.csv,6,750548.0,3,3,3,0,0,54.333333333333336,171,21,21.0,21
Category_Wikipedia_sockpuppets_of_Markaveli1031.csv,21,17873.0,16,5,15,1,0,45.285714285714285,198,23,16.80952380952381,10
Category_Wikipedia_sockpuppets_of_Heathnw77.csv,201,47707474.0,77,124,62,15,0,41.95522388059702,254,24,15.099502487562189,8
Category_Wikipedia_sockpuppets_of_Albin_shajin.csv,207,219627579.0,55,152,18,37,0,37.69565217391305,253,33,16.391304347826086,7
Category_Wikipedia_sockpuppets_of_OOODDD.csv,7670,380098646.0,2500,5170,500,2000,0,42.7748370273794,496,88,21.944980443285527,2
Category_Wikipedia_sockpuppets_of_Sarahjjohnson123.csv,26,4660679.0,11,15,9,2,0,45.73076923076923,191,14,13.192307692307692,11
Category_Wikipedia_sockpuppets_of_VaughanWatch.csv,4425,52789766.0,1320,3105,409,911,0,28.20180790960452,250,89,20.524745762711863,4
Category_Wikipedia_sockpuppets_of_Cwf97.csv,8482,81291530.0,1965,6517,500,1465,0,46.60834708795095,496,95,24.58535722706909,4
Category_Wikipedia_sockpuppets_of_Akoroves.csv,130,281323359.0,39,91,37,2,0,56.6,283,48,21.369230769230768,5
Category_Wikipedia_sockpuppets_of_Barek777.csv,110,3247131.0,39,71,24,15,0,42.99090909090909,312,38,19.972727272727273,14
Category_Wikipedia_sockpuppets_of_Insaankhan.csv,125,92121976.0,47,78,21,26,0,60.424,496,46,22.656,14
Category_Wikipedia_sockpuppets_of_Jydppatel.csv,117,22307991.0,59,58,44,15,0,34.94871794871795,164,45,18.427350427350426,6
Category_Wikipedia_sockpuppets_of_Jackadvisor.csv,35,1103176.0,22,13,6,16,0,40.857142857142854,201,46,32.34285714285714,7
Category_Wikipedia_sockpuppets_of_Nikzx.csv,297,165637928.0,127,170,41,86,0,41.44444444444444,494,34,17.144781144781145,9
Category_Wikipedia_sockpuppets_of_Willard84.csv,2418,213679541.0,606,1812,500,106,0,41.15550041356493,271,52,16.681968569065344,4
Category_Wikipedia_sockpuppets_of_NotThatJamesBrown.csv,98,4083678.0,45,53,45,0,0,57.54081632653061,218,37,25.857142857142858,6
Category_Wikipedia_sockpuppets_of_Vannet_Kun.csv,126,9674857.0,67,59,31,36,0,51.92063492063492,496,41,21.72222222222222,11
Category_Wikipedia_sockpuppets_of_Diamonddannyboy.csv,1245,77837633.0,501,744,500,1,0,40.496385542168674,214,66,19.97991967871486,7
Category_Wikipedia_sockpuppets_of_Alisetareh.csv,5,142.0,4,1,4,0,12,23.6,47,18,17.2,17
Category_Wikipedia_sockpuppets_of_Plumoyr.csv,1919,7345278.0,940,979,500,440,0,50.70974465867639,228,68,29.356435643564357,7
Category_Wikipedia_sockpuppets_of_RitaSharan.csv,39,259314.0,13,26,8,5,0,58.41025641025641,288,42,14.923076923076923,8
Category_Wikipedia_sockpuppets_of_Noobhunter.csv,22,61924376.0,7,15,7,0,0,43.86363636363637,179,39,22.545454545454547,14
Category_Wikipedia_sockpuppets_of_Msssansari.csv,721,170312606.0,251,470,147,104,0,45.536754507628295,367,59,19.791955617198337,6
Category_Wikipedia_sockpuppets_of_Claudia_Spatar.csv,13,439.0,4,9,2,2,20,71.92307692307692,211,25,14.23076923076923,7
Category_Wikipedia_sockpuppets_of_Pinkw20.csv,111,187096132.0,41,70,32,9,0,42.1981981981982,255,34,17.135135135135137,14
Category_Wikipedia_sockpuppets_of_Tuzoy87.csv,136,357553.0,121,15,103,18,0,16.75735294117647,161,13,12.845588235294118,10
Category_Wikipedia_sockpuppets_of_Raj_narayan_Rath.csv,2030,6819099.0,535,1495,500,35,0,40.365024630541875,255,36,13.538916256157636,4
Category_Wikipedia_sockpuppets_of_LbUT.csv,84,20028092.0,41,43,22,19,0,39.583333333333336,199,26,17.678571428571427,9
Category_Wikipedia_sockpuppets_of_Zalingeishahpur.csv,1249,29592542.0,405,844,78,327,0,41.168134507606084,255,55,18.34107285828663,4
Category_Wikipedia_sockpuppets_of_Mdd97.csv,3058,66823706.0,1107,1951,500,607,0,41.8466317854807,500,50,20.346958796599086,4
Category_Wikipedia_sockpuppets_of_Decentnil.csv,293,96083117.0,78,215,66,12,0,52.54607508532423,241,38,13.716723549488055,9
Category_Wikipedia_sockpuppets_of_TheRealAnalysis.csv,53,1344486.0,33,20,23,10,0,64.0,379,28,13.150943396226415,4
Category_Wikipedia_sockpuppets_of_Sampeternoel.csv,22,3238333.0,9,13,6,3,0,50.77272727272727,208,25,12.272727272727273,4
Category_Wikipedia_sockpuppets_of_Hebrewdominance.csv,37,426347.0,11,26,7,4,0,51.891891891891895,199,39,21.405405405405407,14
Category_Wikipedia_sockpuppets_of_Borock.csv,11176,465429027.0,3665,7511,500,3165,0,56.09627773801002,440,103,20.949713672154616,3
Category_Wikipedia_sockpuppets_of_BhaiSaab.csv,2437,58826465.0,736,1701,500,236,0,42.51661879359869,246,99,24.798522773902338,3
Category_Wikipedia_sockpuppets_of_Queeninbriefs.csv,635,393353579.0,137,498,108,29,0,54.645669291338585,301,58,21.748031496062993,8
Category_Wikipedia_sockpuppets_of_Sunny251.csv,482,37939949.0,186,296,167,19,0,39.441908713692946,313,17,13.639004149377593,4
Category_Wikipedia_sockpuppets_of_Videogamer!.csv,55,2453674.0,11,44,4,7,0,45.472727272727276,173,22,10.036363636363637,3
Category_Wikipedia_sockpuppets_of_Jessechi.csv,657,255865028.0,202,455,49,153,0,43.78234398782344,476,48,16.410958904109588,4
Category_Wikipedia_sockpuppets_of_Destinyisnow.csv,28,230511.0,11,17,6,5,0,32.92857142857143,122,26,15.071428571428571,5
Category_Wikipedia_sockpuppets_of_Nikgudz.csv,1816,244125511.0,571,1245,500,71,0,40.0352422907489,442,61,26.541299559471366,5
Category_Wikipedia_sockpuppets_of_Kuzhinapurath.csv,1284,287582543.0,414,870,407,7,0,44.03816199376947,255,58,21.851246105919003,5
Category_Wikipedia_sockpuppets_of_Gdandsnahb.csv,1444,12636660.0,526,918,500,26,0,33.4792243767313,248,57,25.33656509695291,12
Category_Wikipedia_sockpuppets_of_Letterboxtv.csv,55,16722.0,36,19,27,9,0,37.8,204,23,21.2,18
Category_Wikipedia_sockpuppets_of_Jackie_Peterson.csv,24,158991.0,12,12,4,8,0,52.041666666666664,206,43,33.5,5
Category_Wikipedia_sockpuppets_of_Dragao2004.csv,446,8106627.0,183,263,171,12,0,51.41928251121076,240,67,23.33408071748879,4
Category_Wikipedia_sockpuppets_of_Sparcus97.csv,164,15255196.0,38,126,28,10,0,57.48780487804878,267,39,12.774390243902438,5
Category_Wikipedia_sockpuppets_of_Djdevious.csv,36,180374309.0,12,24,5,7,0,47.47222222222222,196,46,21.11111111111111,17
Category_Wikipedia_sockpuppets_of_Cguerri1.csv,75,164743551.0,19,56,18,1,0,73.98666666666666,247,27,16.6,9
Category_Wikipedia_sockpuppets_of_ORdeDocsaab.csv,671,13072017.0,228,443,164,64,0,72.84798807749627,500,64,25.496274217585693,6
Category_Wikipedia_sockpuppets_of_Mailersonly.csv,397,20215033.0,105,292,82,23,0,51.61712846347607,236,23,13.226700251889168,7
Category_Wikipedia_sockpuppets_of_Jpate0200.csv,172,106479931.0,42,130,38,4,0,63.03488372093023,248,33,17.38953488372093,4
Category_Wikipedia_sockpuppets_of_Jakesnake13.csv,92,113560837.0,54,38,31,23,0,34.54347826086956,222,65,27.16304347826087,13
Category_Wikipedia_sockpuppets_of_Colofac.csv,992,6915982.0,320,672,317,3,0,57.51310483870968,250,71,31.954637096774192,5
Category_Wikipedia_sockpuppets_of_Subhobratho.csv,35,5518496.0,10,25,8,2,0,91.48571428571428,252,24,14.0,3
Category_Wikipedia_sockpuppets_of_Tri.cwm.csv,6,9246.0,3,3,2,1,42,54.833333333333336,97,68,68.0,68
Category_Wikipedia_sockpuppets_of_Lordcabbageworms.csv,15,127824.0,8,7,5,3,14,162.33333333333334,500,52,10.933333333333334,7
Category_Wikipedia_sockpuppets_of_HomeLPLP.csv,8,174663.0,6,2,4,2,0,83.375,235,28,18.375,11
Category_Wikipedia_sockpuppets_of_Ascii002.csv,1434,281530997.0,513,921,500,13,0,70.51952580195258,461,96,34.14435146443515,5
Category_Wikipedia_sockpuppets_of_Koula_gianulias.csv,5,909.0,2,3,2,0,37,66.0,115,19,17.2,16
Category_Wikipedia_sockpuppets_of_Muirofsara.csv,4918,76262495.0,1088,3830,381,707,0,50.076860512403414,410,71,16.465026433509557,1
Category_Wikipedia_sockpuppets_of_Pierre_Le_Manh.csv,7,4930733.0,6,1,3,3,0,39.285714285714285,146,46,30.0,24
Category_Wikipedia_sockpuppets_of_WikiCheckMtl.csv,349,37419232.0,132,217,58,74,0,45.39541547277937,273,36,15.825214899713467,6
Category_Wikipedia_sockpuppets_of_FreddieFalcon1.csv,11,257540.0,6,5,5,1,0,45.27272727272727,237,54,20.454545454545453,9
Category_Wikipedia_sockpuppets_of_The_News_ZMR.csv,1,0.0,1,0,1,0,16,16.0,16,16,16.0,16
Category_Wikipedia_sockpuppets_of_Asrtyon.csv,3176,18457638.0,1170,2006,387,783,0,39.8617758186398,500,65,30.02109571788413,3
Category_Wikipedia_sockpuppets_of_Gpstudio13.csv,398,189344677.0,158,240,155,3,0,40.06030150753769,255,47,14.396984924623116,4
Category_Wikipedia_sockpuppets_of_Who_R_you_.csv,853,82983994.0,247,606,247,0,0,70.71395076201641,255,85,18.842907385697536,4
Category_Wikipedia_sockpuppets_of_Moe_szylak.csv,1089,56752883.0,240,849,45,195,0,44.49127640036731,407,39,14.418732782369146,4
Category_Wikipedia_sockpuppets_of_Pedro_thy_master.csv,1397,184866693.0,504,893,500,4,0,28.540443808160344,237,76,20.239799570508232,6
Category_Wikipedia_sockpuppets_of_Eliko.csv,2706,415272570.0,702,2004,500,202,0,53.03067257945307,439,63,30.575388026607538,4
Category_Wikipedia_sockpuppets_of_AmirahBreen.csv,1717,287638541.0,671,1046,500,171,0,46.38730343622598,446,59,26.32323820617356,4
Category_Wikipedia_sockpuppets_of_Electronicmusicperson.csv,493,57294176.0,135,358,134,1,0,50.1947261663286,497,43,16.529411764705884,3
Category_Wikipedia_sockpuppets_of_Quiteashtrudel.csv,37,245838820.0,13,24,8,5,0,93.27027027027027,231,16,16.0,16
Category_Wikipedia_sockpuppets_of_Hongseol98.csv,111,5860457.0,40,71,23,17,0,28.153153153153152,201,31,21.08108108108108,7
Category_Wikipedia_sockpuppets_of_Ericf505.csv,529,189609204.0,155,374,155,0,0,72.56710775047259,438,49,17.655954631379963,5
Category_Wikipedia_sockpuppets_of_The_Nbaka_is_a_major_lie.csv,58,8743656.0,18,40,10,8,0,47.810344827586206,195,34,19.775862068965516,11
Category_Wikipedia_sockpuppets_of_Pippalou90.csv,21,932073.0,9,12,6,3,0,55.0,128,46,13.095238095238095,9
Category_Wikipedia_sockpuppets_of_Monkey_Luffy_Portgas_Ace.csv,177,2154845.0,111,66,107,4,0,42.94915254237288,238,50,38.06214689265537,4
Category_Wikipedia_sockpuppets_of_Anitasss.csv,49,17108395.0,18,31,7,11,0,57.857142857142854,255,22,11.10204081632653,4
Category_Wikipedia_sockpuppets_of_Nishant.mkg.csv,13,1198.0,5,8,5,0,0,39.38461538461539,228,11,10.538461538461538,8
Category_Wikipedia_sockpuppets_of_Scarecrow102.csv,1445,14978868.0,430,1015,365,65,0,32.51903114186851,241,45,16.172318339100347,5
Category_Wikipedia_sockpuppets_of_Blayttlyjg.csv,366,10714407.0,134,232,60,74,0,48.89071038251366,340,33,15.937158469945356,3
Category_Wikipedia_sockpuppets_of_Rednova-india.csv,1386,35426950.0,540,846,500,40,0,44.43073593073593,255,59,16.73160173160173,5
Category_Wikipedia_sockpuppets_of_Brokenmiles.csv,23,480.0,5,18,5,0,0,36.73913043478261,155,18,13.043478260869565,11
Category_Wikipedia_sockpuppets_of_Richrakh.csv,3539,53144076.0,1195,2344,500,695,0,52.870019779598756,250,88,27.448996891777337,3
Category_Wikipedia_sockpuppets_of_BabuBhai123.csv,14,1226657.0,12,2,9,3,0,58.42857142857143,149,23,18.071428571428573,15
Category_Wikipedia_sockpuppets_of_WizardWonderWeaver.csv,2784,5404865.0,1018,1766,500,518,0,48.695402298850574,496,80,20.39762931034483,4
Category_Wikipedia_sockpuppets_of_Jzyehoshua.csv,3291,160320445.0,1000,2291,500,500,0,53.67152841081738,255,76,28.67243998784564,3
Category_Wikipedia_sockpuppets_of_GMTV_Chart_Show.csv,2382,493172858.0,576,1806,290,286,0,35.78673383711167,285,77,20.310663308144417,3
Category_Wikipedia_sockpuppets_of_Xdeluna.csv,5928,21002280.0,2308,3620,500,1808,0,32.10509446693657,255,62,16.16312415654521,4
Category_Wikipedia_sockpuppets_of_McKhan.csv,2078,572131406.0,645,1433,500,145,0,84.80991337824831,500,64,16.51924927815207,3
Category_Wikipedia_sockpuppets_of_Cadetrain.csv,1759,11225596.0,533,1226,500,33,0,48.8851620238772,371,60,22.086981239340535,6
Category_Wikipedia_sockpuppets_of_Jacobga.csv,178,1162960.0,89,89,83,6,0,27.089887640449437,227,70,21.747191011235955,8
Category_Wikipedia_sockpuppets_of_AolStartupGuideBot.csv,55,15260.0,16,39,11,5,0,56.85454545454545,197,75,21.618181818181817,7
Category_Wikipedia_sockpuppets_of_Chesterthechest.csv,35,480329.0,15,20,15,0,0,45.74285714285714,494,33,23.885714285714286,9
Category_Wikipedia_sockpuppets_of_FoolsRushIn.csv,70,577268.0,24,46,24,0,0,62.885714285714286,199,51,24.385714285714286,10
Category_Wikipedia_sockpuppets_of_UB_Alumni.csv,91,17108098.0,50,41,23,27,0,41.79120879120879,211,24,24.0,24
Category_Wikipedia_sockpuppets_of_Pande_Dewi.csv,46,2423828.0,15,31,11,4,0,40.47826086956522,136,44,20.847826086956523,13
Category_Wikipedia_sockpuppets_of_Nigerfagois.csv,8,694.0,5,3,4,1,0,49.375,144,34,25.25,20
Category_Wikipedia_sockpuppets_of_Holosh.csv,7,1296149.0,4,3,2,2,0,10.571428571428571,43,38,38.0,38
Category_Wikipedia_sockpuppets_of_Alfred_Nemours.csv,521,7759933.0,250,271,246,4,0,48.59692898272553,251,53,26.3531669865643,12
Category_Wikipedia_sockpuppets_of_MHLU.csv,1,0.0,1,0,1,0,0,0.0,0,9,9.0,9
Category_Wikipedia_sockpuppets_of_Charles_Darnay.csv,158,10371342.0,65,93,44,21,0,39.14556962025316,200,62,28.18354430379747,11
Category_Wikipedia_sockpuppets_of_Meganium.csv,874,1781692.0,191,683,191,0,0,13.187643020594965,200,59,27.176201372997713,13
Category_Wikipedia_sockpuppets_of_Nyc_media_research.csv,140,44419705.0,57,83,39,18,0,48.9,231,47,21.821428571428573,9
Category_Wikipedia_sockpuppets_of_Phl_india_co.csv,57,13837024.0,23,34,13,10,0,167.33333333333334,500,21,13.631578947368421,3
Category_Wikipedia_sockpuppets_of_Aesana0710.csv,14,953147.0,13,1,10,3,0,56.214285714285715,149,20,19.214285714285715,19
Category_Wikipedia_sockpuppets_of_VRAJESH_SHAH.csv,2167,204199879.0,661,1506,500,161,0,44.330872173511764,500,64,16.204891555145363,4
Category_Wikipedia_sockpuppets_of_Rectify_54.csv,1767,112207813.0,500,1267,500,0,0,37.31409168081494,338,53,20.98132427843803,7
Category_Wikipedia_sockpuppets_of_NarlanTheGreat.csv,55,675227.0,19,36,10,9,0,49.70909090909091,200,31,19.327272727272728,6
Category_Wikipedia_sockpuppets_of_Orandelle.csv,1,0.0,1,0,1,0,5,5.0,5,16,16.0,16
Category_Wikipedia_sockpuppets_of_Lovell123.csv,17,1670.0,6,11,6,0,0,31.647058823529413,136,26,16.0,6
Category_Wikipedia_sockpuppets_of_Lisapalomeque.csv,500,3166683.0,200,300,192,8,0,35.668,250,44,15.748,3
Category_Wikipedia_sockpuppets_of_Australianpoets134.csv,76,13224553.0,25,51,13,12,0,34.93421052631579,208,46,20.460526315789473,13
Category_Wikipedia_sockpuppets_of_Bradtherad1.csv,8,89025.0,4,4,3,1,14,57.625,167,70,70.0,70
Category_Wikipedia_sockpuppets_of_Sekwanele_2.csv,2634,119849979.0,907,1727,460,447,0,35.35155656795748,250,77,18.32953682611997,4
Category_Wikipedia_sockpuppets_of_Northernrailwaysfan.csv,978,19029706.0,344,634,259,85,0,43.330265848670756,338,44,22.342535787321065,11
Category_Wikipedia_sockpuppets_of_Goofdawg.csv,272,84418503.0,92,180,73,19,0,56.1764705882353,416,59,22.1875,11
Category_Wikipedia_sockpuppets_of_Babs_king.csv,111,588986.0,38,73,20,18,0,53.486486486486484,238,23,14.693693693693694,8
Category_Wikipedia_sockpuppets_of_Esteban_in_Hemet.csv,2243,35438949.0,595,1648,396,199,0,31.913062862238075,255,72,28.840392331698617,3
Category_Wikipedia_sockpuppets_of_Eios1234.csv,107,890291.0,42,65,39,3,0,50.48598130841121,205,55,23.61682242990654,4
Category_Wikipedia_sockpuppets_of_Ssvlogs369.csv,481,5171858.0,174,307,126,48,0,49.264033264033266,360,63,27.093555093555093,6
Category_Wikipedia_sockpuppets_of_Altacarelab.csv,36,5448220.0,14,22,7,7,0,50.22222222222222,158,52,13.527777777777779,7
Category_Wikipedia_sockpuppets_of_Rishabkv.csv,733,78396949.0,300,433,147,153,0,32.64802182810369,255,46,14.884038199181447,6
Category_Wikipedia_sockpuppets_of_Bhaskarmv.csv,341,98581148.0,114,227,108,6,0,62.504398826979475,236,24,12.956011730205278,6
Category_Wikipedia_sockpuppets_of_KommandoGlizzetron69.csv,15,1010.0,6,9,5,1,0,79.66666666666667,193,14,10.4,7
Category_Wikipedia_sockpuppets_of_Bugdestroyer5.csv,23,768.0,9,14,6,3,0,50.43478260869565,186,23,13.434782608695652,3
Category_Wikipedia_sockpuppets_of_Munnu99.csv,4247,32621685.0,1297,2950,149,1148,0,38.552860842947965,255,41,13.619731575229574,3
Category_Wikipedia_sockpuppets_of_Huff_slush7264.csv,1669,11665254.0,631,1038,500,131,0,54.82504493708808,428,60,25.325344517675255,6
Category_Wikipedia_sockpuppets_of_SailNavy.csv,44,53481.0,38,6,18,20,0,74.72727272727273,395,27,22.136363636363637,20
Category_Wikipedia_sockpuppets_of_Premkoli99.csv,497,30276303.0,162,335,133,29,0,42.29175050301811,236,33,11.58953722334004,5
Category_Wikipedia_sockpuppets_of_Holy_Child_Student.csv,2415,80955501.0,1073,1342,500,573,0,25.80745341614907,255,66,23.804554865424432,4
Category_Wikipedia_sockpuppets_of_AncientEgyptCharacters.csv,1117,4842632.0,424,693,250,174,0,48.934646374216655,502,52,14.783348254252463,3
Category_Wikipedia_sockpuppets_of_LegoAxiom1007.csv,2672,3203957.0,683,1989,354,329,0,38.44086826347306,212,64,27.688622754491018,2
Category_Wikipedia_sockpuppets_of_Al_catten.csv,69,85489.0,22,47,13,9,0,28.89855072463768,206,50,25.405797101449274,11
Category_Wikipedia_sockpuppets_of_Kefir18.csv,665,71614192.0,159,506,104,55,0,30.312781954887217,366,61,31.09172932330827,10
Category_Wikipedia_sockpuppets_of_Tessable.csv,74,4659.0,40,34,4,36,0,55.28378378378378,255,42,24.06756756756757,12
Category_Wikipedia_sockpuppets_of_FabioMaggiAngelini.csv,278,530062.0,234,44,197,37,0,32.87769784172662,312,42,25.946043165467625,17
Category_Wikipedia_sockpuppets_of_Colhsolpl.csv,124,843681.0,41,83,25,16,0,59.66129032258065,244,38,23.120967741935484,7
Category_Wikipedia_sockpuppets_of_UnsungKing123.csv,3580,25418538.0,965,2615,500,465,0,74.38966480446928,451,54,18.925977653631286,2
Category_Wikipedia_sockpuppets_of_Setanlaut.csv,6,135993.0,4,2,3,1,0,37.833333333333336,133,19,18.333333333333332,18
Category_Wikipedia_sockpuppets_of_TimeQueen32.csv,989,39135213.0,341,648,226,115,0,52.211324570273,255,83,19.09706774519717,4
Category_Wikipedia_sockpuppets_of_Michael93555.csv,2954,14064184.0,699,2255,500,199,0,57.26641841570751,234,70,21.6249153689912,2
Category_Wikipedia_sockpuppets_of_Shukri_Ahamed_Mannar.csv,23,7233057.0,16,7,14,2,0,51.65217391304348,183,33,29.26086956521739,28
Category_Wikipedia_sockpuppets_of_Claudio_Antonio_Ruiz.csv,721,23248945.0,251,470,63,188,0,43.82246879334258,494,64,20.17891816920943,4
Category_Wikipedia_sockpuppets_of_Rioseco.csv,517,14932247.0,402,115,101,301,0,24.243713733075435,253,24,15.160541586073501,4
Category_Wikipedia_sockpuppets_of_MunibBinAli.csv,3,254967.0,3,0,3,0,24,35.666666666666664,59,40,27.333333333333332,21
Category_Wikipedia_sockpuppets_of_SunCrow.csv,2810,70366589.0,1000,1810,500,500,0,53.145907473309606,500,59,15.22135231316726,6
Category_Wikipedia_sockpuppets_of_71Demon.csv,1636,135094253.0,500,1136,500,0,0,42.581295843520785,236,60,23.964547677261614,4
Category_Wikipedia_sockpuppets_of_Trzalesny.csv,19,2318.0,9,10,5,4,0,34.578947368421055,244,28,11.157894736842104,8
Category_Wikipedia_sockpuppets_of_Elielilamasabachthani.csv,296,249604158.0,83,213,79,4,0,64.80405405405405,214,69,18.85135135135135,9
Category_Wikipedia_sockpuppets_of_Benjaminvetri.csv,367,123641223.0,94,273,90,4,0,41.19346049046322,247,52,18.408719346049047,8
Category_Wikipedia_sockpuppets_of_Giovanni33.csv,7813,207556337.0,1887,5926,500,1387,0,43.974529630103675,250,107,22.987840778190197,4
Category_Wikipedia_sockpuppets_of_Monirlawbd.csv,17,22572167.0,6,11,4,2,0,56.88235294117647,103,42,23.764705882352942,18
Category_Wikipedia_sockpuppets_of_Agostinafit.csv,1557,60488173.0,681,876,500,181,0,39.26140012845215,499,70,16.06679511881824,5
Category_Wikipedia_sockpuppets_of_Mandarin111.csv,845,51611287.0,342,503,87,255,0,37.78579881656805,496,71,18.085207100591717,5
Category_Wikipedia_sockpuppets_of_Sundiiiaaa.csv,1312,287640209.0,365,947,204,161,0,47.46036585365854,245,59,19.069359756097562,7
Category_Wikipedia_sockpuppets_of_Scavtin.csv,82,48523763.0,39,43,30,9,0,42.390243902439025,195,45,27.390243902439025,17
Category_Wikipedia_sockpuppets_of_QualityControl3533.csv,732,7419502.0,238,494,176,62,0,52.99590163934426,232,56,20.509562841530055,10
Category_Wikipedia_sockpuppets_of_Nolantron.csv,534,63366944.0,185,349,130,55,0,39.662921348314605,255,44,20.029962546816478,11
Category_Wikipedia_sockpuppets_of_Ke_scams.csv,8,161166.0,6,2,4,2,0,42.875,222,17,17.0,17
Category_Wikipedia_sockpuppets_of_Ufc_patrick.csv,632,2003735.0,220,412,164,56,0,39.33069620253165,247,45,15.276898734177216,7
Category_Wikipedia_sockpuppets_of_Juhichawla114.csv,7,3487568.0,4,3,3,1,19,81.42857142857143,160,39,25.0,17
Category_Wikipedia_sockpuppets_of_Sarang_Anil_Nakade.csv,51,3560482.0,20,31,20,0,0,39.470588235294116,142,18,18.0,18
Category_Wikipedia_sockpuppets_of_FishingKing.csv,1544,3683168.0,517,1027,500,17,0,50.060880829015545,250,65,20.52720207253886,4
Category_Wikipedia_sockpuppets_of_HorsesAreNice.csv,1454,20661321.0,502,952,500,2,0,57.27028885832187,376,54,20.09697386519945,3
Category_Wikipedia_sockpuppets_of_Your_Heart_Hacker_003.csv,83,18573370.0,29,54,21,8,0,40.46987951807229,181,53,23.97590361445783,5
Category_Wikipedia_sockpuppets_of_YeetaSkeeta.csv,5228,78272298.0,1802,3426,500,1302,0,45.19127773527161,500,76,15.020466717674063,3
Category_Wikipedia_sockpuppets_of_Sammythesnake4.csv,1079,6978745.0,251,828,174,77,0,30.54124189063948,255,49,19.934198331788693,5
Category_Wikipedia_sockpuppets_of_BenH.csv,1850,21715627.0,541,1309,500,41,0,19.667567567567566,199,59,10.3,3
Category_Wikipedia_sockpuppets_of_Rabbe_Fazle.csv,105,47689176.0,48,57,31,17,0,45.89523809523809,247,49,27.39047619047619,15
Category_Wikipedia_sockpuppets_of_Nlggerz_are_sus.csv,101,341485.0,33,68,13,20,0,73.07920792079207,307,55,40.04950495049505,10
Category_Wikipedia_sockpuppets_of_Rogalski277.csv,3691,23217157.0,1151,2540,500,651,0,44.20400975345435,472,50,18.389325386074233,2
Category_Wikipedia_sockpuppets_of_Wingard.csv,1289,66728027.0,545,744,500,45,0,28.74166020170675,255,43,22.871217998448408,8
Category_Wikipedia_sockpuppets_of_Jd1781a.csv,47,21628823.0,19,28,11,8,0,38.61702127659574,199,19,14.170212765957446,10
Category_Wikipedia_sockpuppets_of_Adnanjavidkhan1.csv,638,128212400.0,228,410,86,142,0,45.6692789968652,262,50,18.952978056426332,5
Category_Wikipedia_sockpuppets_of_Googleisawesome.csv,8,25885.0,2,6,2,0,0,15.75,42,25,19.0,17
Category_Wikipedia_sockpuppets_of_Lulufilia.csv,21,25423430.0,16,5,9,7,0,38.666666666666664,196,49,24.19047619047619,13
Category_Wikipedia_sockpuppets_of_MBernal615.csv,2563,34898566.0,783,1780,500,283,0,40.398361295357006,250,66,19.64845883730004,5
Category_Wikipedia_sockpuppets_of_Musbaunow.csv,1083,378684796.0,575,508,500,75,0,62.82917820867959,249,60,22.233610341643583,5
Category_Wikipedia_sockpuppets_of_Thakor_Sumant_Sinhji_Jhala.csv,11881,273103253.0,4317,7564,500,3817,0,50.28238363774093,496,50,13.529669219762646,3
Category_Wikipedia_sockpuppets_of_1234monkeystar.csv,26,109937.0,16,10,11,5,0,25.615384615384617,143,53,41.84615384615385,7
Category_Wikipedia_sockpuppets_of_Ea87af.csv,8,3550.0,5,3,5,0,0,32.75,81,23,19.75,11
Category_Wikipedia_sockpuppets_of_Innkin.csv,534,55287160.0,135,399,72,63,0,59.51498127340824,255,62,17.265917602996254,3
Category_Wikipedia_sockpuppets_of_Spy_agent_55.csv,2,0.0,1,1,1,0,197,197.0,197,16,16.0,16
Category_Wikipedia_sockpuppets_of_Ggezggez.csv,10,556.0,8,2,5,3,0,35.2,177,15,15.0,15
Category_Wikipedia_sockpuppets_of_WorldCreaterFighter.csv,14727,355699268.0,3816,10911,500,3316,0,52.93162219053439,500,57,15.237794527059144,3
Category_Wikipedia_sockpuppets_of_Watch2507.csv,49,4848.0,19,30,8,11,0,34.285714285714285,225,48,29.020408163265305,8
Category_Wikipedia_sockpuppets_of_Shameerayapa.csv,35,8071127.0,27,8,23,4,0,27.771428571428572,244,11,11.0,11
Category_Wikipedia_sockpuppets_of_Eiko237.csv,261,476097459.0,58,203,33,25,0,50.2183908045977,253,43,19.386973180076627,9
Category_Wikipedia_sockpuppets_of_Without_pants.csv,14,2152169.0,7,7,2,5,0,41.285714285714285,172,20,20.0,20
Category_Wikipedia_sockpuppets_of_Midehao95.csv,1254,19319797.0,438,816,320,118,0,35.740031897926634,242,56,25.535885167464116,8
Category_Wikipedia_sockpuppets_of_SpaceKozak.csv,115,273003167.0,23,92,22,1,0,71.16521739130435,368,27,10.104347826086956,7
Category_Wikipedia_sockpuppets_of_Moneyislife25.csv,38,7173244.0,19,19,12,7,0,30.55263157894737,177,14,8.789473684210526,8
Category_Wikipedia_sockpuppets_of_Futhuer.csv,41,1881776.0,29,12,23,6,0,37.4390243902439,165,32,16.170731707317074,10
Category_Wikipedia_sockpuppets_of_1brnn.csv,29,29556405.0,9,20,5,4,6,54.758620689655174,174,40,21.06896551724138,10
Category_Wikipedia_sockpuppets_of_Deep._123456.csv,7,593308.0,5,2,2,3,0,55.57142857142857,196,25,14.857142857142858,4
Category_Wikipedia_sockpuppets_of_Apbiologyrocks.csv,1626,57809198.0,533,1093,500,33,0,61.67958179581796,250,59,21.437269372693727,2
Category_Wikipedia_sockpuppets_of_Anusmartmirror.csv,68,358356.0,30,38,15,15,0,51.98529411764706,161,53,42.44117647058823,17
Category_Wikipedia_sockpuppets_of_U_Hein_Min_Htet.csv,42,16300167.0,15,27,10,5,0,63.88095238095238,173,47,24.095238095238095,14
Category_Wikipedia_sockpuppets_of_Filmmakershiva.csv,108,81114083.0,44,64,44,0,0,38.69444444444444,196,50,19.85185185185185,8
Category_Wikipedia_sockpuppets_of_Fallgirls.csv,3389,32590130.0,771,2618,500,271,0,51.94098554145766,496,60,13.546768958394807,3
Category_Wikipedia_sockpuppets_of_Theunknownnun.csv,620,25628139.0,230,390,86,144,0,37.04838709677419,250,43,16.62258064516129,7
Category_Wikipedia_sockpuppets_of_IGN_XDROME.csv,113,1630200.0,75,38,33,42,2,45.38053097345133,187,23,18.336283185840706,4
Category_Wikipedia_sockpuppets_of_Cybolton.csv,1994,3034584.0,878,1116,500,378,0,55.09929789368104,230,83,24.203610832497493,5
Category_Wikipedia_sockpuppets_of_Hugh_3476.csv,2261,110244548.0,763,1498,500,263,0,31.465723131357805,255,52,20.285272003538257,5
Category_Wikipedia_sockpuppets_of_GEfan2.csv,77,24162270.0,43,34,19,24,0,46.77922077922078,229,24,16.064935064935064,12
Category_Wikipedia_sockpuppets_of_Arun_Chhibber.csv,13,69205.0,10,3,10,0,0,3.230769230769231,28,18,18.0,18
Category_Wikipedia_sockpuppets_of_TheReferenceChecker.csv,125,496051.0,63,62,61,2,0,56.664,254,54,23.424,3
Category_Wikipedia_sockpuppets_of_Aliyakhann.csv,42,70931372.0,14,28,9,5,0,35.54761904761905,168,39,20.595238095238095,15
Category_Wikipedia_sockpuppets_of_NoWikiNinja.csv,4,1588.0,3,1,2,1,0,66.25,147,20,20.0,20
Category_Wikipedia_sockpuppets_of_HowNoDog.csv,863,1978189.0,506,357,274,232,0,32.03476245654693,452,24,9.652375434530708,4
Category_Wikipedia_sockpuppets_of_Phillip1437A.csv,1478,56246863.0,562,916,271,291,0,40.224627875507444,315,50,14.55277401894452,3
Category_Wikipedia_sockpuppets_of_Jumping_Frog_Man.csv,1619,15797966.0,500,1119,500,0,0,44.29956763434219,298,53,23.600988264360716,5
Category_Wikipedia_sockpuppets_of_XDWALNUTXX.csv,60,1785101.0,46,14,26,20,0,35.733333333333334,268,23,17.85,15
Category_Wikipedia_sockpuppets_of_OrenBochman.csv,2053,341058553.0,574,1479,500,74,0,39.314174378957624,474,96,21.850949829517777,4
Category_Wikipedia_sockpuppets_of_Han_Mi_Nyeo.csv,71,3447542.0,28,43,21,7,0,73.5774647887324,328,41,20.676056338028168,4
Category_Wikipedia_sockpuppets_of_Mirajul786.csv,30,4829775.0,23,7,18,5,0,32.56666666666667,196,19,13.8,12
Category_Wikipedia_sockpuppets_of_Bluebluechicken.csv,312,13542571.0,92,220,49,43,0,42.07692307692308,235,34,29.141025641025642,18
Category_Wikipedia_sockpuppets_of_BrokenTest024.csv,34,1104.0,10,24,9,1,0,84.73529411764706,289,24,12.117647058823529,5
Category_Wikipedia_sockpuppets_of_Zelogan.csv,275,65822116.0,72,203,58,14,0,45.905454545454546,214,54,33.43636363636364,12
Category_Wikipedia_sockpuppets_of_Mkashif311.csv,31,1728616.0,15,16,13,2,0,62.74193548387097,210,23,11.258064516129032,7
Category_Wikipedia_sockpuppets_of_General_Zukov.csv,258,2717714.0,85,173,82,3,0,49.22868217054263,243,69,19.782945736434108,5
Category_Wikipedia_sockpuppets_of_Republic_state_of_dabo.csv,102,11456458.0,28,74,13,15,0,50.8921568627451,467,39,18.19607843137255,7
Category_Wikipedia_sockpuppets_of_Santana_MontanaReal.csv,230,85241783.0,88,142,15,73,0,58.356521739130436,496,41,21.07391304347826,8
Category_Wikipedia_sockpuppets_of_Ketih_King.csv,587,410961903.0,145,442,88,57,0,58.62180579216354,276,87,14.419080068143101,3
Category_Wikipedia_sockpuppets_of_Bmcidol21.csv,365,969125.0,134,231,107,27,0,27.495890410958904,229,49,17.85753424657534,8
Category_Wikipedia_sockpuppets_of_Abilrajz.csv,335,55346017.0,101,234,51,50,0,40.67462686567164,199,55,20.33134328358209,5
Category_Wikipedia_sockpuppets_of_Amerikanhistorylover.csv,1053,36809884.0,309,744,144,165,0,56.358024691358025,380,44,16.22222222222222,4
Category_Wikipedia_sockpuppets_of_Rockster0123.csv,769,54268926.0,204,565,49,155,0,53.12743823146944,250,54,21.301690507152145,6
Category_Wikipedia_sockpuppets_of_Antiv31.csv,715,4043126.0,208,507,194,14,0,57.83076923076923,244,61,22.95944055944056,5
Category_Wikipedia_sockpuppets_of_Prayangshubh.csv,23,15699080.0,6,17,4,2,0,44.47826086956522,194,19,11.695652173913043,10
Category_Wikipedia_sockpuppets_of_Peterl.csv,2376,522691779.0,505,1871,500,5,0,67.04335016835017,465,57,18.54713804713805,3
Category_Wikipedia_sockpuppets_of_Mdandrea.csv,923,294048433.0,301,622,282,19,0,44.99133261105092,255,49,19.543878656554714,4
Category_Wikipedia_sockpuppets_of_Brickcity55.csv,271,103255073.0,71,200,65,6,0,53.5830258302583,255,40,25.88560885608856,12
Category_Wikipedia_sockpuppets_of_Joezone.csv,183,547822.0,66,117,54,12,0,25.40983606557377,217,55,23.78688524590164,10
Category_Wikipedia_sockpuppets_of_Tenkasei_Ryo.csv,184,3450230.0,75,109,38,37,0,46.79347826086956,200,47,20.429347826086957,11
Category_Wikipedia_sockpuppets_of_Ivasyk.csv,216,15563981.0,79,137,71,8,0,24.430555555555557,250,29,14.23611111111111,7
Category_Wikipedia_sockpuppets_of_Alvalade_XXI.csv,3622,42655503.0,1357,2265,500,857,0,45.03975704030922,371,80,17.326891220320267,5
Category_Wikipedia_sockpuppets_of_Blackmagic1234.csv,599,80963669.0,162,437,129,33,0,42.40901502504174,220,47,20.22871452420701,4
Category_Wikipedia_sockpuppets_of_Joshyvjohn.csv,238,51915167.0,90,148,32,58,0,37.80672268907563,257,50,19.285714285714285,4
Category_Wikipedia_sockpuppets_of_Grnrm20.csv,21,2319403.0,16,5,9,7,16,33.333333333333336,141,7,7.0,7
Category_Wikipedia_sockpuppets_of_Squeezdot.csv,224,133959100.0,59,165,34,25,0,25.901785714285715,209,32,12.915178571428571,3
Category_Wikipedia_sockpuppets_of_TheNewYarkov.csv,37,11503113.0,9,28,8,1,0,65.32432432432432,205,25,23.91891891891892,13
Category_Wikipedia_sockpuppets_of_Iraqiesay.csv,49,18916238.0,16,33,15,1,0,39.6530612244898,155,53,35.3469387755102,18
Category_Wikipedia_sockpuppets_of_Kousai_orfahli.csv,329,98862138.0,134,195,111,23,0,41.21884498480243,241,50,19.574468085106382,9
Category_Wikipedia_sockpuppets_of_Truekasun.csv,239,35524886.0,92,147,81,11,0,49.82845188284519,271,34,19.10878661087866,10
Category_Wikipedia_sockpuppets_of_Asgard0392.csv,200,90688645.0,44,156,19,25,0,67.42,282,31,12.8,6
Category_Wikipedia_sockpuppets_of_5dsddddd.csv,826,115784947.0,296,530,288,8,0,38.16585956416465,225,74,23.338983050847457,5
Category_Wikipedia_sockpuppets_of_Rm_manager_Player.csv,211,103213031.0,61,150,43,18,0,51.203791469194314,367,49,14.909952606635072,6
Category_Wikipedia_sockpuppets_of_Azurik.csv,1,0.0,1,0,1,0,52,52.0,52,18,18.0,18
Category_Wikipedia_sockpuppets_of_Sapah3.csv,2134,58407156.0,560,1574,395,165,0,66.20009372071227,500,59,21.254920337394566,4
Category_Wikipedia_sockpuppets_of_BrownyCat.csv,886,91485898.0,288,598,285,3,0,44.60948081264108,237,50,15.72686230248307,4
Category_Wikipedia_sockpuppets_of_Ramalha_Soares.csv,320,3982201.0,77,243,35,42,0,39.79375,237,54,18.953125,3
Category_Wikipedia_sockpuppets_of_Hami2266.csv,164,1984953.0,88,76,46,42,0,37.74390243902439,496,21,16.46951219512195,13
Category_Wikipedia_sockpuppets_of_Otto4711.csv,17078,311139768.0,5499,11579,500,4999,0,44.96644806183394,261,133,23.67139009251669,3
Category_Wikipedia_sockpuppets_of_Joepanikisbae.csv,12,86638.0,8,4,5,3,0,46.25,153,22,11.166666666666666,9
Category_Wikipedia_sockpuppets_of_Gaby_de_wilde.csv,1629,30759148.0,600,1029,500,100,0,44.25230202578269,256,54,21.445672191528544,6
Category_Wikipedia_sockpuppets_of_TCrEoLe89.csv,1012,6532051.0,264,748,253,11,0,30.08201581027668,190,60,14.116600790513834,4
Category_Wikipedia_sockpuppets_of_Chaklalajob.csv,3350,8769009.0,1166,2184,237,929,0,39.274328358208955,255,77,20.518507462686568,3
Category_Wikipedia_sockpuppets_of_Pushanjain.csv,30,5397186.0,13,17,11,2,0,66.53333333333333,238,20,13.733333333333333,12
Category_Wikipedia_sockpuppets_of_Thaurpuransingh.csv,9,964253.0,5,4,3,2,0,79.44444444444444,220,50,34.22222222222222,20
Category_Wikipedia_sockpuppets_of_Spunter_vunter.csv,23,1062.0,12,11,10,2,13,43.69565217391305,198,23,21.26086956521739,13
Category_Wikipedia_sockpuppets_of_RichlandGA.csv,18,39473.0,12,6,10,2,0,82.0,303,20,17.61111111111111,16
Category_Wikipedia_sockpuppets_of_An√∏n òm√∏·πë·π®.csv,2595,8468041.0,1126,1469,500,626,0,39.91946050096339,254,49,18.322928709055876,1
Category_Wikipedia_sockpuppets_of_Gruesome_Foursome.csv,1614,36723918.0,499,1115,335,164,0,50.51920693928129,255,89,30.372986369268897,6
Category_Wikipedia_sockpuppets_of_Akraj.csv,365,132985045.0,87,278,67,20,0,46.54520547945206,211,51,16.257534246575343,3
Category_Wikipedia_sockpuppets_of_S_M_Abu_Sahad.csv,54,65859359.0,18,36,15,3,0,44.888888888888886,255,47,19.203703703703702,7
Category_Wikipedia_sockpuppets_of_CraigSpencerrooster.csv,15,449.0,7,8,7,0,0,36.53333333333333,127,31,20.733333333333334,11
Category_Wikipedia_sockpuppets_of_Ndizzy4glo.csv,28,11140129.0,9,19,9,0,0,54.17857142857143,130,30,20.642857142857142,6
Category_Wikipedia_sockpuppets_of_Zimmermann901.csv,64,112097.0,31,33,25,6,0,31.703125,132,49,34.65625,11
Category_Wikipedia_sockpuppets_of_Slitsallan.csv,11,2077.0,6,5,5,1,0,59.45454545454545,138,20,17.727272727272727,15
Category_Wikipedia_sockpuppets_of_Gfdssfdg.csv,1607,4962457.0,554,1053,225,329,0,27.826384567517113,250,49,19.122588674548847,5
Category_Wikipedia_sockpuppets_of_MWWorld.csv,24,3984.0,20,4,19,1,0,24.916666666666668,177,18,18.0,18
Category_Wikipedia_sockpuppets_of_Ralph2valid.csv,19,906.0,7,12,4,3,0,69.36842105263158,243,13,12.789473684210526,12
Category_Wikipedia_sockpuppets_of_Emma_knows_it_well.csv,1959,19809671.0,540,1419,500,40,0,55.80347115875447,362,63,16.404287901990813,5
Category_Wikipedia_sockpuppets_of_OPALO3.csv,24,72895.0,8,16,6,2,0,70.08333333333333,175,5,4.125,3
Category_Wikipedia_sockpuppets_of_Abitofmoonlight.csv,48,140581026.0,19,29,17,2,0,54.104166666666664,242,20,15.729166666666666,15
Category_Wikipedia_sockpuppets_of_HymnsOfHades.csv,76,26394290.0,18,58,15,3,0,43.1578947368421,171,17,12.223684210526315,4
Category_Wikipedia_sockpuppets_of_Jibon09.csv,27,713005.0,12,15,6,6,0,58.2962962962963,196,45,25.814814814814813,6
Category_Wikipedia_sockpuppets_of_Eashleyfox.csv,731,317271085.0,381,350,341,40,0,39.4172366621067,312,47,15.864569083447332,8
Category_Wikipedia_sockpuppets_of_Dave_rooney_jr.csv,121,1363668.0,35,86,10,25,0,61.52892561983471,234,32,14.96694214876033,5
Category_Wikipedia_sockpuppets_of_MelungeonEire.csv,953,119641527.0,306,647,303,3,0,49.72612801678909,314,56,17.036726128016788,6
Category_Wikipedia_sockpuppets_of_MaisonHorta.csv,464,7518670.0,209,255,203,6,0,38.52801724137931,255,44,18.816810344827587,5
Category_Wikipedia_sockpuppets_of_Sharry99.csv,169,10978921.0,63,106,62,1,0,63.01183431952663,215,46,12.307692307692308,5
Category_Wikipedia_sockpuppets_of_Propolis_Nano.csv,63,42921.0,20,43,18,2,0,63.98412698412698,233,21,11.238095238095237,4
Category_Wikipedia_sockpuppets_of_Mgunetiquette.csv,565,125763920.0,169,396,124,45,0,47.92035398230089,239,29,14.821238938053098,5
Category_Wikipedia_sockpuppets_of_Desbien.csv,112,58730297.0,37,75,37,0,0,57.63392857142857,228,21,13.660714285714286,7
Category_Wikipedia_sockpuppets_of_Xenoradixde.csv,265,16669653.0,74,191,24,50,0,42.46037735849057,255,43,17.10566037735849,3
Category_Wikipedia_sockpuppets_of_Worldchampion2014.csv,189,954567.0,99,90,40,59,0,35.78835978835979,228,44,23.904761904761905,12
Category_Wikipedia_sockpuppets_of_Naufhal_Dhimas.csv,610,25483947.0,257,353,201,56,0,58.614754098360656,360,29,16.970491803278687,6
Category_Wikipedia_sockpuppets_of_CobraMaltase.csv,52,4014467.0,19,33,18,1,0,53.0,219,30,22.0,15
Category_Wikipedia_sockpuppets_of_Chopinxenakis.csv,590,78787126.0,158,432,158,0,0,48.26610169491526,250,29,15.886440677966101,5
Category_Wikipedia_sockpuppets_of_Lepss.csv,332,15903679.0,116,216,93,23,0,33.846385542168676,301,47,25.545180722891565,11
Category_Wikipedia_sockpuppets_of_Bangrubhai.csv,259,8757571.0,79,180,23,56,0,50.293436293436294,271,53,19.544401544401545,7
Category_Wikipedia_sockpuppets_of_Creed_Jack_Ingram.csv,757,165752499.0,192,565,49,143,0,50.12549537648613,496,58,20.653896961690887,7
Category_Wikipedia_sockpuppets_of_SashaVelourFan12.csv,1306,3410428.0,621,685,500,121,0,30.05895865237366,255,53,30.22434915773354,9
Category_Wikipedia_sockpuppets_of_Dictations.csv,189,8948364.0,57,132,22,35,0,45.94708994708995,263,44,18.052910052910054,8
Category_Wikipedia_sockpuppets_of_Kairakairav.csv,3676,68927120.0,1756,1920,500,1256,0,30.121599564744287,494,48,15.085690968443961,5
Category_Wikipedia_sockpuppets_of_Chera_Kongu_Nadu_India.csv,204,2684214.0,64,140,31,33,0,41.82843137254902,268,40,16.745098039215687,7
Category_Wikipedia_sockpuppets_of_Vickle1777.csv,854,28493310.0,258,596,217,41,0,68.11943793911007,250,31,15.901639344262295,4
Category_Wikipedia_sockpuppets_of_Anniebisilolo.csv,449,26419369.0,179,270,161,18,0,43.00890868596882,300,49,18.3630289532294,4
Category_Wikipedia_sockpuppets_of_MilWards.csv,256,132241672.0,110,146,104,6,0,42.40625,238,36,19.3828125,13
Category_Wikipedia_sockpuppets_of_Bugstomper.csv,136,36944087.0,41,95,18,23,0,46.838235294117645,206,40,18.272058823529413,6
Category_Wikipedia_sockpuppets_of_Flynnus.csv,41,613335.0,28,13,7,21,0,24.21951219512195,218,18,13.0,12
Category_Wikipedia_sockpuppets_of_Tevatel.csv,6,6661566.0,4,2,3,1,0,52.833333333333336,154,21,19.0,17
Category_Wikipedia_sockpuppets_of_Dominicblake12222010.csv,229,5534495.0,71,158,32,39,0,50.55458515283843,396,74,15.131004366812228,4
Category_Wikipedia_sockpuppets_of_Mr._Kruzkin.csv,239,157991137.0,54,185,41,13,0,54.32217573221757,234,42,17.832635983263597,7
Category_Wikipedia_sockpuppets_of_Queercan.csv,52,69921476.0,20,32,18,2,0,39.57692307692308,204,46,17.442307692307693,9
Category_Wikipedia_sockpuppets_of_Gourab_Basak.csv,254,174368938.0,120,134,63,57,0,39.476377952755904,282,24,15.208661417322835,5
Category_Wikipedia_sockpuppets_of_Hakimnitsukim.csv,333,12449515.0,72,261,67,5,0,47.15915915915916,493,64,18.81981981981982,5
Category_Wikipedia_sockpuppets_of_EzajHossain786.csv,9,5128701.0,8,1,8,0,0,51.666666666666664,253,22,19.666666666666668,19
Category_Wikipedia_sockpuppets_of_Bardoliwalla_N_C.csv,250,14839982.0,120,130,63,57,0,53.596,255,53,27.14,6
Category_Wikipedia_sockpuppets_of_King_of_Zeroes.csv,162,1252256.0,63,99,26,37,0,51.01851851851852,216,47,29.012345679012345,11
Category_Wikipedia_sockpuppets_of_Trendingbio.csv,40,21086.0,19,21,16,3,6,64.65,205,31,15.325,11
Category_Wikipedia_sockpuppets_of_Hoylong22.csv,509,12635517.0,161,348,17,144,0,39.709233791748524,222,78,20.79960707269155,3
Category_Wikipedia_sockpuppets_of_JackHood.csv,1001,12284493.0,299,702,158,141,0,47.54345654345654,255,59,19.636363636363637,4
Category_Wikipedia_sockpuppets_of_Jujyboy1.csv,70,1310696.0,33,37,24,9,0,47.3,206,33,29.9,13
Category_Wikipedia_sockpuppets_of_Abrish211.csv,1301,3970266.0,324,977,143,181,0,67.25057647963105,255,66,21.39815526518063,3
Category_Wikipedia_sockpuppets_of_Xyz610.csv,183,7389547.0,89,94,86,3,0,53.73224043715847,496,30,17.683060109289617,10
Category_Wikipedia_sockpuppets_of_Pratyush.shrivastava.csv,1308,20145357.0,506,802,500,6,0,43.27064220183486,453,65,22.84862385321101,9
Category_Wikipedia_sockpuppets_of_KIKKU_PRO_UGANDA.csv,12,11780764.0,3,9,2,1,0,39.833333333333336,117,53,40.5,21
Category_Wikipedia_sockpuppets_of_Ajnabh.csv,1084,12116812.0,347,737,232,115,0,42.76383763837639,250,60,16.834870848708487,3
Category_Wikipedia_sockpuppets_of_NORWAY_IS_AWESOME.csv,226,946541.0,78,148,48,30,0,49.65929203539823,321,53,21.0929203539823,5
Category_Wikipedia_sockpuppets_of_Omgitssillyhowsmart.csv,1,0.0,1,0,1,0,197,197.0,197,36,36.0,36
Category_Wikipedia_sockpuppets_of_Raibisu.csv,2293,93652870.0,810,1483,500,310,0,35.422154382904495,372,46,14.25207152202355,3
Category_Wikipedia_sockpuppets_of_Swarup_Kumar_Solanki.csv,1240,30410583.0,502,738,101,401,0,44.11048387096774,385,62,20.408870967741937,4
Category_Wikipedia_sockpuppets_of_DailyEditor.csv,1709,14524386.0,532,1177,291,241,0,40.32884727911059,255,61,23.614979520187244,2
Category_Wikipedia_sockpuppets_of_Friedjof.csv,2720,456964835.0,891,1829,219,672,0,42.88345588235294,496,85,18.31985294117647,3
Category_Wikipedia_sockpuppets_of_Harish_duganapu.csv,10,115729.0,6,4,6,0,0,35.3,92,25,25.0,25
Category_Wikipedia_sockpuppets_of_Isuzu1001.csv,390,426253135.0,78,312,61,17,0,57.06153846153846,265,82,19.294871794871796,5
Category_Wikipedia_sockpuppets_of_Êú≠Âá¶ÂàÜ_ÈÄÜÂÜä.csv,22,795341.0,8,14,4,4,0,50.40909090909091,199,23,18.09090909090909,13
Category_Wikipedia_sockpuppets_of_Guitarherochristopher.csv,9549,75190421.0,3030,6519,500,2530,0,34.88019687925437,250,95,20.51398052152058,2
Category_Wikipedia_sockpuppets_of_June_Parker.csv,1541,39025608.0,455,1086,342,113,0,66.13497728747566,500,53,22.46463335496431,4
Category_Wikipedia_sockpuppets_of_JawakerME1.csv,11,7037469.0,3,8,3,0,0,38.90909090909091,142,17,13.727272727272727,13
Category_Wikipedia_sockpuppets_of_Agastya11.csv,1467,7789037.0,521,946,500,21,0,41.28561690524881,412,60,24.22222222222222,6
Category_Wikipedia_sockpuppets_of_Zhzhw.csv,967,58757417.0,281,686,154,127,0,39.014477766287484,255,54,18.922440537745604,4
Category_Wikipedia_sockpuppets_of_Yeu_aga_maj.csv,4637,24702065.0,1463,3174,500,963,0,33.84494285098124,492,59,19.775501401768384,3
Category_Wikipedia_sockpuppets_of_Drork.csv,1652,22366806.0,590,1062,500,90,0,45.88498789346247,240,80,32.23607748184019,4
Category_Wikipedia_sockpuppets_of_Raw-WikiEditor.csv,116,1367293.0,43,73,27,16,0,52.672413793103445,255,32,12.620689655172415,5
Category_Wikipedia_sockpuppets_of_Geckophantom123!!.csv,16,88437.0,12,4,9,3,0,41.125,200,11,11.0,11
Category_Wikipedia_sockpuppets_of_Mcina9059.csv,20,344231.0,8,12,4,4,0,64.4,189,22,16.5,11
Category_Wikipedia_sockpuppets_of_Qwh.csv,1531,16928471.0,401,1130,391,10,0,50.62181580666231,255,78,20.064663618549968,3
Category_Wikipedia_sockpuppets_of_Krister9000.csv,141,520568.0,82,59,41,41,5,50.5886524822695,196,29,7.156028368794326,5
Category_Wikipedia_sockpuppets_of_Okrydokry.csv,7,14625643.0,5,2,3,2,0,27.0,77,19,18.285714285714285,14
Category_Wikipedia_sockpuppets_of_Walsha13.csv,77,16346515.0,19,58,19,0,0,46.83116883116883,179,26,12.818181818181818,8
Category_Wikipedia_sockpuppets_of_BenJacobs13.csv,96,24795472.0,36,60,22,14,0,46.958333333333336,302,39,16.03125,7
Category_Wikipedia_sockpuppets_of_Velascobrent189.csv,440,18746130.0,123,317,32,91,0,31.4,251,46,24.8,8
Category_Wikipedia_sockpuppets_of_Upendra.Madhav.csv,13,132525.0,9,4,7,2,0,37.53846153846154,196,37,15.153846153846153,6
Category_Wikipedia_sockpuppets_of_Cable_Sankar.csv,22,3073100.0,14,8,12,2,0,19.136363636363637,196,17,10.318181818181818,8
Category_Wikipedia_sockpuppets_of_Shuklakhar.csv,111,94607035.0,34,77,11,23,0,53.306306306306304,254,24,12.531531531531531,7
Category_Wikipedia_sockpuppets_of_Whatsittoya17.csv,13,2334233.0,6,7,3,3,0,62.76923076923077,199,35,24.692307692307693,21
Category_Wikipedia_sockpuppets_of_Ch1p_the_chop.csv,1444,69537906.0,565,879,343,222,0,57.10872576177285,496,69,21.44459833795014,5
Category_Wikipedia_sockpuppets_of_Jasksingh.csv,1499,117508600.0,506,993,500,6,0,71.10140093395597,398,54,18.20146764509673,4
Category_Wikipedia_sockpuppets_of_Mentosuncle.csv,64,2271812.0,18,46,8,10,0,63.0625,264,34,18.6875,9
Category_Wikipedia_sockpuppets_of_Tone.itdown1901.csv,1979,34458729.0,596,1383,500,96,0,54.00252652854977,270,84,27.412834765032844,2
Category_Wikipedia_sockpuppets_of_Referenced.csv,35,18171.0,26,9,26,0,0,27.97142857142857,199,15,13.257142857142858,10
Category_Wikipedia_sockpuppets_of_Parispv.csv,153,12243618.0,82,71,80,2,0,47.26143790849673,354,22,14.169934640522875,11
Category_Wikipedia_sockpuppets_of_Uhooep.csv,5186,309559318.0,1734,3452,500,1234,0,47.27535672965677,457,76,21.997107597377553,4
Category_Wikipedia_sockpuppets_of_Adam9399.csv,1,0.0,1,0,1,0,27,27.0,27,20,20.0,20
Category_Wikipedia_sockpuppets_of_Difulton.csv,179,28833583.0,72,107,42,30,0,57.49162011173184,252,55,27.43016759776536,13
Category_Wikipedia_sockpuppets_of_UnrealSpiritX.csv,738,29649656.0,212,526,121,91,0,34.24390243902439,213,42,16.975609756097562,3
Category_Wikipedia_sockpuppets_of_3GFRIENDSNSD.csv,525,64268538.0,181,344,51,130,0,38.90095238095238,247,48,17.86857142857143,3
Category_Wikipedia_sockpuppets_of_Otakumantra.csv,35,1973456.0,13,22,10,3,0,52.2,231,23,18.742857142857144,6
Category_Wikipedia_sockpuppets_of_WelshDragon18.csv,3580,37836015.0,1040,2540,500,540,0,42.247206703910614,441,57,16.599162011173185,3
Category_Wikipedia_sockpuppets_of_Middayexpress.csv,3718,161941999.0,1208,2510,500,708,0,41.180473372781066,445,50,19.074502420656266,3
Category_Wikipedia_sockpuppets_of_INeeDaFatToke.csv,508,17200935.0,205,303,204,1,0,39.26968503937008,255,61,25.409448818897637,9
Category_Wikipedia_sockpuppets_of_Yay_Dad.csv,2409,127781428.0,804,1605,500,304,0,41.78829389788294,373,67,23.894977168949772,5
Category_Wikipedia_sockpuppets_of_Storm8181.csv,54,2716106.0,20,34,14,6,0,57.7037037037037,232,36,25.444444444444443,14
Category_Wikipedia_sockpuppets_of_Rommelnyk.csv,1938,154646478.0,638,1300,433,205,0,42.714654282765736,500,65,17.604231166150672,4
Category_Wikipedia_sockpuppets_of_The_Dancing_Badger.csv,2122,245594851.0,547,1575,340,207,0,54.710179076343074,496,61,17.26295947219604,3
Category_Wikipedia_sockpuppets_of_Eagle_c5.csv,2455,41538119.0,1291,1164,500,791,0,38.06232179226069,250,61,19.502240325865582,4
Category_Wikipedia_sockpuppets_of_Mriduls.sharma.csv,1979,94689910.0,652,1327,235,417,0,49.658413340070744,255,54,15.873168266801414,6
Category_Wikipedia_sockpuppets_of_Lebanon9.csv,82,18806219.0,31,51,20,11,0,75.23170731707317,482,22,18.573170731707318,16
Category_Wikipedia_sockpuppets_of_Pongsong.csv,171,21935190.0,77,94,57,20,0,41.73099415204678,255,24,11.91812865497076,6
Category_Wikipedia_sockpuppets_of_JawshTehPlank.csv,77,8011582.0,21,56,9,12,0,37.15584415584416,181,30,21.77922077922078,8
Category_Wikipedia_sockpuppets_of_Yongle_the_Great.csv,3008,50287099.0,1181,1827,500,681,0,35.34009308510638,255,51,16.8500664893617,4
Category_Wikipedia_sockpuppets_of_Michaeluzomam.csv,1458,42683454.0,610,848,500,110,0,45.198902606310014,255,34,13.421124828532236,4
Category_Wikipedia_sockpuppets_of_GeorgiPergelov2009.csv,612,13572222.0,142,470,106,36,0,45.52287581699346,500,71,24.109477124183005,4
Category_Wikipedia_sockpuppets_of_Crazy_fries.csv,34,21398.0,11,23,6,5,0,53.1764705882353,184,22,14.764705882352942,7
Category_Wikipedia_sockpuppets_of_Mohammed_Khan_Chowdhury.csv,74,1504651.0,55,19,41,14,0,43.945945945945944,500,33,20.27027027027027,12
Category_Wikipedia_sockpuppets_of_Kyleforsyth.csv,31,356069.0,11,20,8,3,0,53.25806451612903,233,19,8.96774193548387,6
Category_Wikipedia_sockpuppets_of_Hoaeter.csv,8229,132049034.0,2508,5721,500,2008,0,51.79195528010694,500,89,20.55353019807996,3
Category_Wikipedia_sockpuppets_of_Plutonium.messiah.csv,34,3030714.0,17,17,6,11,0,38.05882352941177,145,48,30.529411764705884,6
Category_Wikipedia_sockpuppets_of_Mikhail2022.csv,142,1492161.0,43,99,35,8,0,77.41549295774648,450,21,13.943661971830986,7
Category_Wikipedia_sockpuppets_of_Jagdeepkamboj1313.csv,11,1354.0,5,6,4,1,0,59.45454545454545,168,39,21.181818181818183,8
Category_Wikipedia_sockpuppets_of_Yoshi22222myl.csv,63,430059.0,14,49,11,3,0,57.82539682539682,182,34,18.904761904761905,18
Category_Wikipedia_sockpuppets_of_Mihai000.csv,918,41005802.0,308,610,81,227,0,58.58169934640523,486,48,19.875816993464053,6
Category_Wikipedia_sockpuppets_of_Aronham.csv,80,5890997.0,16,64,16,0,0,44.075,145,25,7.975,2
Category_Wikipedia_sockpuppets_of_Tausor.csv,184,86368888.0,71,113,25,46,0,42.32608695652174,200,51,18.206521739130434,1
Category_Wikipedia_sockpuppets_of_Anderson.csv,4155,38768288.0,1361,2794,500,861,0,51.874608904933815,255,76,23.076774969915764,2
Category_Wikipedia_sockpuppets_of_batman_ded.csv,23,178649.0,21,2,17,4,0,23.956521739130434,131,28,17.47826086956522,17
Category_Wikipedia_sockpuppets_of_PolvoMexicano.csv,2187,158450060.0,1000,1187,500,500,0,34.43850022862369,229,69,18.640603566529492,9
Category_Wikipedia_sockpuppets_of_Badums.csv,732,66462829.0,171,561,89,82,0,46.44535519125683,246,54,16.85792349726776,4
Category_Wikipedia_sockpuppets_of_Razorback216.csv,237,13568554.0,60,177,26,34,0,53.9957805907173,245,39,16.565400843881857,4
Category_Wikipedia_sockpuppets_of_Speedy2169.csv,1835,30489385.0,682,1153,452,230,0,40.50681198910082,256,63,27.543869209809266,5
Category_Wikipedia_sockpuppets_of_Zenkaino_lovelive.csv,1083,101904197.0,528,555,500,28,0,48.28162511542013,387,44,28.897506925207757,15
Category_Wikipedia_sockpuppets_of_Borishuang.csv,40,3013333.0,11,29,7,4,0,62.0,224,29,17.175,6
Category_Wikipedia_sockpuppets_of_ScrupulousScribe.csv,1088,5372301.0,509,579,500,9,0,47.71783088235294,500,100,29.21875,8
Category_Wikipedia_sockpuppets_of_T0mpr1c3.csv,1515,29024348.0,556,959,500,56,0,49.392079207920794,296,100,18.955115511551156,4
Category_Wikipedia_sockpuppets_of_Rovers_Forever.csv,1068,187493063.0,323,745,269,54,0,52.26123595505618,229,57,20.735955056179776,9
Category_Wikipedia_sockpuppets_of_Samrishi24.csv,1,0.0,1,0,1,0,93,93.0,93,27,27.0,27
Category_Wikipedia_sockpuppets_of_Rahulritsofficial.csv,14,94261.0,4,10,2,2,0,39.785714285714285,138,53,48.42857142857143,21
Category_Wikipedia_sockpuppets_of_Master_Pal.csv,13,96468.0,7,6,4,3,0,56.84615384615385,135,30,22.307692307692307,15
Category_Wikipedia_sockpuppets_of_Mrinal_Pandey.csv,468,62318004.0,290,178,19,271,0,66.62393162393163,199,48,26.384615384615383,11
Category_Wikipedia_sockpuppets_of_Sjchin.csv,135,26632400.0,44,91,37,7,0,42.629629629629626,194,53,29.296296296296298,10
Category_Wikipedia_sockpuppets_of_Sport_and_politics.csv,2760,7439216.0,872,1888,500,372,0,55.35217391304348,356,83,29.37355072463768,7
Category_Wikipedia_sockpuppets_of_Frantzedward.cha.csv,3105,11916971.0,1022,2083,500,522,0,26.00966183574879,250,54,20.765539452495975,7
Category_Wikipedia_sockpuppets_of_Fairyspit.csv,19357,76477611.0,6702,12655,500,6202,0,39.30397272304592,255,73,16.605465722994264,2
Category_Wikipedia_sockpuppets_of__Ghgfhc_.csv,18,23496.0,11,7,11,0,0,82.0,191,35,32.333333333333336,11
Category_Wikipedia_sockpuppets_of_Richardmalter.csv,1680,49670262.0,699,981,500,199,0,38.00178571428572,200,72,28.798214285714284,5
Category_Wikipedia_sockpuppets_of_Googleuser.csv,563,41621809.0,174,389,50,124,0,46.48490230905861,303,53,22.538188277087034,6
Category_Wikipedia_sockpuppets_of_Erfurt150.csv,1259,41928406.0,468,791,109,359,0,66.64813343923748,247,57,15.285146942017475,4
Category_Wikipedia_sockpuppets_of_Jamesyboy2468.csv,886,10636580.0,363,523,343,20,0,46.362302483069975,254,67,23.10158013544018,3
Category_Wikipedia_sockpuppets_of_Neiltyson12.csv,90,1755214.0,34,56,21,13,0,59.077777777777776,354,46,21.022222222222222,8
Category_Wikipedia_sockpuppets_of_Grandpathegrandpa.csv,80,692394.0,24,56,10,14,0,66.55,295,33,13.675,7
Category_Wikipedia_sockpuppets_of_Kdbuffalo.csv,9657,350788780.0,3241,6416,500,2741,0,52.744226985606296,255,77,23.761209485347415,1
Category_Wikipedia_sockpuppets_of_Ilovefuturama95.csv,314,213062600.0,102,212,74,28,0,45.4140127388535,496,43,20.65286624203822,3
Category_Wikipedia_sockpuppets_of_„ÅÇ„Åô„Å∫„Çã„Åå„ÅÇ„Åô„Å∫„Åó„ÇÉ„Çä„Åô„Å®.csv,2515,84605681.0,1953,562,40,1913,0,46.551888667992046,435,45,17.39085487077535,2
Category_Wikipedia_sockpuppets_of_Calvin_Ho_Jiang_Lim.csv,2900,8128926.0,1006,1894,500,506,0,36.06793103448276,250,72,16.18655172413793,3
Category_Wikipedia_sockpuppets_of_Traveller-Onlooker.csv,761,52700475.0,364,397,294,70,0,44.961892247043366,255,39,25.69119579500657,7
Category_Wikipedia_sockpuppets_of_Sarsaparilla.csv,12943,378687508.0,4906,8037,500,4406,0,54.03360890056401,514,136,26.55087692188828,2
Category_Wikipedia_sockpuppets_of_Cronel_of_ward.csv,85,518730.0,30,55,29,1,0,82.28235294117647,493,51,20.094117647058823,4
Category_Wikipedia_sockpuppets_of_Marie610.csv,299,28527129.0,106,193,94,12,0,40.79598662207358,238,41,16.183946488294314,4
Category_Wikipedia_sockpuppets_of_Shadrackmarkug.csv,1,0.0,1,0,1,0,50,50.0,50,33,33.0,33
Category_Wikipedia_sockpuppets_of_Slemcal1.csv,233,1977083.0,97,136,97,0,0,46.72532188841202,200,35,20.386266094420602,13
Category_Wikipedia_sockpuppets_of_Conflict_of_laws_junkie.csv,674,85820910.0,253,421,158,95,0,51.78635014836795,255,63,22.894658753709198,10
Category_Wikipedia_sockpuppets_of_Worldsage.csv,1362,1746993.0,459,903,442,17,0,39.94493392070485,250,46,21.30690161527166,8
Category_Wikipedia_sockpuppets_of_Fernando-the-King.csv,2342,214270399.0,948,1394,500,448,0,33.283518360375744,241,56,27.252775405636207,6
Category_Wikipedia_sockpuppets_of_Thorblood.csv,291,209170856.0,106,185,106,0,0,36.670103092783506,228,50,18.9106529209622,6
Category_Wikipedia_sockpuppets_of_GAMTWMV.csv,145,3302411.0,52,93,25,27,0,50.55862068965517,232,46,16.63448275862069,5
Category_Wikipedia_sockpuppets_of_Dhoncarlo.csv,354,6701740.0,348,6,141,207,0,3.330508474576271,152,20,19.87853107344633,19
Category_Wikipedia_sockpuppets_of_TheUser2020.csv,926,63316448.0,300,626,98,202,0,53.08207343412527,496,60,15.713822894168466,3
Category_Wikipedia_sockpuppets_of_Allmyhomieshateengland.csv,60,2592222.0,12,48,9,3,0,73.6,239,23,9.233333333333333,3
Category_Wikipedia_sockpuppets_of_Ramkivi.csv,19,631851.0,9,10,8,1,0,19.42105263157895,39,26,16.05263157894737,14
Category_Wikipedia_sockpuppets_of_DrBat.csv,3571,528328559.0,1055,2516,500,555,0,48.42397087650518,508,78,21.593391206944833,3
Category_Wikipedia_sockpuppets_of_Defender_911.csv,1499,18927932.0,507,992,500,7,0,30.676450967311542,201,79,25.920613742494997,7
Category_Wikipedia_sockpuppets_of_Petepanning.csv,7,81533.0,4,3,3,1,0,111.0,192,12,11.285714285714286,11
Category_Wikipedia_sockpuppets_of_Vemula_Karthik.csv,6,15434.0,3,3,2,1,21,81.0,140,24,16.166666666666668,8
Category_Wikipedia_sockpuppets_of_MokhtarMusheer.csv,58,35509522.0,33,25,31,2,0,55.827586206896555,286,61,21.689655172413794,14
Category_Wikipedia_sockpuppets_of_Mvineetmenon.csv,466,175642050.0,153,313,102,51,0,41.137339055793994,252,52,23.931330472103003,4
Category_Wikipedia_sockpuppets_of_Webgrafix.csv,130,193259648.0,26,104,9,17,0,47.46923076923077,200,25,15.023076923076923,8
Category_Wikipedia_sockpuppets_of_Harsh_N._Patel.csv,204,7968511.0,59,145,18,41,0,42.53921568627451,255,79,26.95098039215686,7
Category_Wikipedia_sockpuppets_of_Abdullah_London.csv,110,3649269.0,37,73,26,11,0,44.527272727272724,222,28,16.87272727272727,7
Category_Wikipedia_sockpuppets_of_Whydopeoplebother.csv,31,42824.0,16,15,16,0,0,85.87096774193549,206,27,20.806451612903224,15
Category_Wikipedia_sockpuppets_of_Behindtheveil.csv,540,180067515.0,164,376,144,20,0,49.19074074074074,320,82,20.742592592592594,4
Category_Wikipedia_sockpuppets_of_YCWebCrawler.csv,47,51059657.0,34,13,14,20,0,57.829787234042556,240,25,20.21276595744681,20
Category_Wikipedia_sockpuppets_of_Rms125a@hotmail.com.csv,6554,572407209.0,1755,4799,500,1255,0,45.237412267317666,500,71,18.390906316753128,4
Category_Wikipedia_sockpuppets_of_Thomasfan5034.csv,1604,59560525.0,490,1114,281,209,0,39.44576059850374,242,58,22.834788029925186,6
Category_Wikipedia_sockpuppets_of_Order_of_the_sword.csv,201,5183133.0,62,139,62,0,0,45.472636815920396,230,60,24.45771144278607,11
Category_Wikipedia_sockpuppets_of_Alikhezrayi.csv,69,59503715.0,30,39,22,8,0,28.985507246376812,199,42,24.985507246376812,14
Category_Wikipedia_sockpuppets_of_Mobility99.csv,180,8535582.0,98,82,88,10,0,53.31666666666667,235,54,27.283333333333335,11
Category_Wikipedia_sockpuppets_of_Mpdt.csv,465,26507486.0,93,372,67,26,0,33.26451612903226,230,37,19.438709677419354,6
Category_Wikipedia_sockpuppets_of_FuckTheJewFaggots.csv,2,0.0,1,1,1,0,16,16.0,16,14,14.0,14
Category_Wikipedia_sockpuppets_of_Lord_kai07.csv,1548,34511355.0,517,1031,500,17,0,43.173772609819125,501,57,22.171188630490956,3
Category_Wikipedia_sockpuppets_of_AlMichaels1727.csv,1389,1394067.0,395,994,392,3,0,76.12886969042476,496,51,22.067674586033117,3
Category_Wikipedia_sockpuppets_of_Abhinand1234.csv,1360,149643580.0,504,856,271,233,0,45.41691176470588,272,56,16.793382352941176,3
Category_Wikipedia_sockpuppets_of_TheEatery.csv,467,21763978.0,119,348,104,15,0,44.569593147751604,226,45,12.9186295503212,4
Category_Wikipedia_sockpuppets_of_JoshFiveWiki.csv,2441,21872400.0,690,1751,278,412,0,40.77918885702581,255,62,17.7304383449406,1
Category_Wikipedia_sockpuppets_of_Algeria_Berber_2961.csv,83,1147360.0,36,47,18,18,0,42.44578313253012,228,35,21.373493975903614,7
Category_Wikipedia_sockpuppets_of_Earflaps.csv,1301,2999806.0,511,790,500,11,0,53.094542659492696,255,61,19.415833973866256,3
Category_Wikipedia_sockpuppets_of_Waterdruid.csv,37,1900403.0,12,25,7,5,0,38.891891891891895,201,45,27.72972972972973,12
Category_Wikipedia_sockpuppets_of_RiaxxYT.csv,15,3436.0,10,5,4,6,7,46.0,206,17,15.2,8
Category_Wikipedia_sockpuppets_of_Iranian86Footballer.csv,2074,216349695.0,525,1549,255,270,0,36.896335583413695,237,58,17.153326904532303,3
Category_Wikipedia_sockpuppets_of_MarthaLyon.csv,76,21760302.0,44,32,37,7,0,45.94736842105263,213,21,14.407894736842104,13
Category_Wikipedia_sockpuppets_of_CBBA12.csv,2160,9909325.0,1090,1070,500,590,0,29.096296296296295,271,52,29.224074074074075,8
Category_Wikipedia_sockpuppets_of_Journalistkashmir.csv,25,241658541.0,5,20,5,0,0,50.6,230,52,28.88,19
Category_Wikipedia_sockpuppets_of_Ianxp.csv,441,3955682.0,181,260,95,86,0,36.55555555555556,222,59,23.43764172335601,12
Category_Wikipedia_sockpuppets_of_Tshavis.csv,152,85598951.0,67,85,22,45,0,55.21052631578947,246,59,22.717105263157894,4
Category_Wikipedia_sockpuppets_of_EvanDanielCollett.csv,598,55740793.0,209,389,186,23,0,50.891304347826086,255,66,20.32441471571906,2
Category_Wikipedia_sockpuppets_of_Talophex.csv,375,180571931.0,75,300,62,13,0,64.06933333333333,253,63,16.898666666666667,4
Category_Wikipedia_sockpuppets_of_SportsEditor518.csv,1383,30721336.0,675,708,500,175,0,29.56832971800434,255,54,25.875632682574114,6
Category_Wikipedia_sockpuppets_of_Ojotaranios2.csv,61,4006966.0,27,34,16,11,0,48.78688524590164,262,50,46.540983606557376,14
Category_Wikipedia_sockpuppets_of_Example2.csv,2,38.0,2,0,2,0,3,7.0,11,18,15.5,13
Category_Wikipedia_sockpuppets_of_Asdreni.csv,147,535907.0,47,100,44,3,0,34.7891156462585,209,27,12.217687074829932,5
Category_Wikipedia_sockpuppets_of_Noradd.csv,83,96883015.0,26,57,12,14,0,53.12048192771084,261,52,24.46987951807229,7
Category_Wikipedia_sockpuppets_of_Kofler_Gianluca_Boris.csv,16,32816.0,11,5,11,0,0,28.125,180,31,8.5,7
Category_Wikipedia_sockpuppets_of_SWAPAN.CHAKROBARTY011112.csv,463,19861683.0,217,246,86,131,0,43.73218142548596,496,54,15.591792656587472,4
Category_Wikipedia_sockpuppets_of_Premloganathan.csv,128,10700295.0,82,46,57,25,0,60.7734375,255,27,15.359375,5
Category_Wikipedia_sockpuppets_of_Rehanzafer123.csv,21,256282.0,11,10,5,6,0,127.14285714285714,500,25,16.428571428571427,8
Category_Wikipedia_sockpuppets_of_Soxgrundy.csv,71,439771.0,59,12,48,11,0,21.408450704225352,196,22,11.577464788732394,11
Category_Wikipedia_sockpuppets_of_ElizaWinwood.csv,143,1480681.0,40,103,14,26,0,77.56643356643356,346,26,14.678321678321678,7
Category_Wikipedia_sockpuppets_of_Trendsies.csv,94,7918681.0,29,65,29,0,0,50.04255319148936,202,56,22.71276595744681,7
Category_Wikipedia_sockpuppets_of_Sfj340sfeoem71.csv,53,54779288.0,20,33,15,5,0,60.509433962264154,255,19,13.037735849056604,7
Category_Wikipedia_sockpuppets_of_Scottish12345678.csv,1272,2219193.0,829,443,500,329,0,28.870283018867923,254,45,30.60927672955975,25
Category_Wikipedia_sockpuppets_of_EducateDworld.csv,87,5614812.0,38,49,19,19,0,56.05747126436781,196,43,22.988505747126435,14
Category_Wikipedia_sockpuppets_of_Sandry_Sm.csv,2394,9495195.0,750,1644,500,250,0,46.02673350041771,413,71,20.060568086883876,4
Category_Wikipedia_sockpuppets_of_Asad_Ali_Palijo.csv,816,100029168.0,269,547,110,159,0,42.806372549019606,500,51,15.218137254901961,3
Category_Wikipedia_sockpuppets_of_Nick_Finnsbury.csv,1984,41653886.0,788,1196,500,288,0,46.09526209677419,250,81,22.383568548387096,4
Category_Wikipedia_sockpuppets_of_GiacomoValenti.csv,1967,22728126.0,678,1289,500,178,0,43.90543975597356,415,49,20.527707168276564,7
Category_Wikipedia_sockpuppets_of_Iamsarbmalhi.csv,16,32154925.0,8,8,7,1,0,29.75,241,22,16.0,13
Category_Wikipedia_sockpuppets_of_Adam1090.csv,1850,10729554.0,500,1350,500,0,0,31.44864864864865,265,57,15.504324324324324,6
Category_Wikipedia_sockpuppets_of_Rudhanani.csv,37,1899184.0,13,24,8,5,0,43.2972972972973,246,20,17.864864864864863,12
Category_Wikipedia_sockpuppets_of_Srabanta_Deb.csv,1065,102287705.0,387,678,185,202,0,49.62159624413145,496,73,20.215962441314552,4
Category_Wikipedia_sockpuppets_of_SarujanSarujan.csv,1062,9340980.0,352,710,159,193,0,37.58286252354049,468,72,25.128060263653484,5
Category_Wikipedia_sockpuppets_of_Pcgmsrich.csv,4713,68482635.0,1190,3523,200,990,0,56.26776999787821,500,55,15.042860173986845,3
Category_Wikipedia_sockpuppets_of_DrewWill2021.csv,191,8900318.0,63,128,60,3,0,42.96335078534032,494,48,20.93193717277487,5
Category_Wikipedia_sockpuppets_of_Wikicarlo89.csv,24,350310.0,15,9,12,3,0,45.583333333333336,374,22,20.333333333333332,14
Category_Wikipedia_sockpuppets_of_SacredGeometry333.csv,1642,18414847.0,572,1070,162,410,0,58.35505481120585,496,59,21.03166869671133,4
Category_Wikipedia_sockpuppets_of_Docking-dave.csv,59,1801351.0,28,31,8,20,0,55.33898305084746,196,35,17.389830508474578,8
Category_Wikipedia_sockpuppets_of_Cmilinds.csv,600,306125041.0,197,403,132,65,0,48.9,260,50,17.171666666666667,4
Category_Wikipedia_sockpuppets_of_BasketFanatik1.csv,89,31908449.0,42,47,29,13,0,34.42696629213483,160,35,23.235955056179776,18
Category_Wikipedia_sockpuppets_of_Kshanti07.csv,1068,120932703.0,269,799,141,128,0,50.96910112359551,255,43,12.408239700374532,4
Category_Wikipedia_sockpuppets_of_Brianmagallano.csv,726,149081605.0,178,548,78,100,0,39.18870523415978,250,71,26.020661157024794,3
Category_Wikipedia_sockpuppets_of_Matthew_Peter-Davis.csv,698,12212971.0,265,433,251,14,0,71.37965616045845,252,68,22.212034383954155,1
Category_Wikipedia_sockpuppets_of_Dreerwin.csv,340,2318366.0,150,190,138,12,0,35.65882352941176,214,63,27.21470588235294,5
Category_Wikipedia_sockpuppets_of_Xiang09.csv,5356,53159804.0,1683,3673,500,1183,0,55.3306572068708,497,60,19.317401045556384,4
Category_Wikipedia_sockpuppets_of_Robertgrant1976.csv,20,4594348.0,7,13,7,0,0,38.55,149,20,16.45,7
Category_Wikipedia_sockpuppets_of_Backendgaming.csv,2757,10441485.0,763,1994,500,263,0,52.41385564018861,484,71,16.224519405150527,4
Category_Wikipedia_sockpuppets_of_Gogetsomestuff.csv,25,25799.0,13,12,13,0,5,48.56,154,24,22.12,11
Category_Wikipedia_sockpuppets_of_Waked_Bold_Ambushed.csv,349,35073512.0,149,200,139,10,0,53.893982808022926,419,29,12.667621776504298,6
Category_Wikipedia_sockpuppets_of_Spa-to-afd-Tseng_Kwong_Chi.csv,127,9623.0,48,79,46,2,0,44.40157480314961,233,63,38.58267716535433,15
Category_Wikipedia_sockpuppets_of_5patrickgilles5.csv,72,2094441.0,29,43,28,1,0,59.68055555555556,291,54,32.111111111111114,16
Category_Wikipedia_sockpuppets_of_Ariobarza.csv,2287,445092304.0,780,1507,500,280,0,55.559685177087886,381,84,24.04940970703979,6
Category_Wikipedia_sockpuppets_of_Cutiejim22.csv,773,15370937.0,241,532,224,17,0,33.27166882276843,255,62,12.310478654592497,4
Category_Wikipedia_sockpuppets_of_Noelthai.csv,1290,83698471.0,344,946,97,247,0,49.63333333333333,252,48,16.546511627906977,3
Category_Wikipedia_sockpuppets_of_HelloImNotAdele.csv,2244,31476219.0,915,1329,500,415,0,34.75222816399287,255,60,22.21657754010695,6
Category_Wikipedia_sockpuppets_of_Geethusivakumar1995.csv,25,239578.0,20,5,11,9,6,59.28,202,49,19.08,15
Category_Wikipedia_sockpuppets_of_Borsycle1.csv,78,186882.0,43,35,30,13,0,52.32051282051282,259,25,17.307692307692307,14
Category_Wikipedia_sockpuppets_of_Hoseinkandovan.csv,1365,7918345.0,525,840,365,160,0,45.68424908424908,500,84,18.755311355311356,4
Category_Wikipedia_sockpuppets_of_Guinevere55hj.csv,16,2872.0,5,11,4,1,0,19.125,51,11,5.25,3
Category_Wikipedia_sockpuppets_of_FrankFakeTurner.csv,19,2788.0,11,8,11,0,0,49.36842105263158,144,31,16.263157894736842,7
Category_Wikipedia_sockpuppets_of_Doughnuthead.csv,1444,192688411.0,452,992,151,301,0,39.590720221606645,241,51,21.3898891966759,3
Category_Wikipedia_sockpuppets_of_Djfitzgerald111.csv,727,4672100.0,502,225,500,2,0,33.73452544704264,249,35,22.50894085281981,11
Category_Wikipedia_sockpuppets_of_Honest1236.csv,338,254451340.0,110,228,89,21,0,37.417159763313606,255,20,12.118343195266272,5
Category_Wikipedia_sockpuppets_of_CltFn.csv,2614,86229108.0,856,1758,500,356,0,39.78347360367253,257,163,16.459066564651874,5
Category_Wikipedia_sockpuppets_of_Soccer114robert.csv,7,539.0,4,3,3,1,0,36.714285714285715,168,30,22.0,7
Category_Wikipedia_sockpuppets_of_Trendmicro.csv,4,417531.0,3,1,3,0,15,29.25,42,20,20.0,20
Category_Wikipedia_sockpuppets_of_Azviz.csv,14506,51687592.0,4682,9824,500,4182,0,38.444505721770305,271,111,21.18750861712395,2
Category_Wikipedia_sockpuppets_of_Humor_Editori_Regimori.csv,793,51935022.0,241,552,236,5,0,56.6733921815889,423,50,18.116015132408574,3
Category_Wikipedia_sockpuppets_of_Souheil_boulos.csv,251,634962.0,85,166,40,45,0,49.08366533864542,241,18,13.474103585657371,8
Category_Wikipedia_sockpuppets_of_Eric_Barragan_V.csv,41,5632042.0,17,24,14,3,0,45.02439024390244,147,29,18.24390243902439,13
Category_Wikipedia_sockpuppets_of_Samsungx635.csv,150,54320087.0,38,112,28,10,0,57.26,255,22,14.113333333333333,9
Category_Wikipedia_sockpuppets_of_Laboj.csv,245,22765390.0,78,167,33,45,0,50.23265306122449,446,57,14.971428571428572,3
Category_Wikipedia_sockpuppets_of_Lar409.csv,3943,37651780.0,1181,2762,500,681,0,40.9122495561755,255,65,19.625412122749175,2
Category_Wikipedia_sockpuppets_of_Elkridge.csv,5959,73266143.0,1660,4299,308,1352,0,59.163785870112434,500,54,15.19768417519718,3
Category_Wikipedia_sockpuppets_of_FightOfTheLivingDeadFan.csv,63,155195296.0,20,43,13,7,0,58.87301587301587,376,33,18.206349206349206,14
Category_Wikipedia_sockpuppets_of_Wordfunk.csv,409,12223940.0,135,274,129,6,0,46.93398533007335,240,45,15.80195599022005,3
Category_Wikipedia_sockpuppets_of_Lewis_Richmon.csv,77,931245.0,33,44,23,10,0,40.22077922077922,254,31,19.324675324675326,7
Category_Wikipedia_sockpuppets_of_MagicJulius00.csv,569,55415793.0,212,357,206,6,0,32.40773286467487,217,55,23.121265377855888,8
Category_Wikipedia_sockpuppets_of_Vision0135.csv,2,113.0,2,0,2,0,38,38.0,38,26,26.0,26
Category_Wikipedia_sockpuppets_of_Jimi_Henderson.csv,4148,245068710.0,1001,3147,500,501,0,65.54676952748312,500,50,17.70178399228544,4
Category_Wikipedia_sockpuppets_of_Nemroyo.csv,529,69327086.0,189,340,181,8,0,58.103969754253306,410,51,18.177693761814744,5
Category_Wikipedia_sockpuppets_of_TheriusRooney.csv,1998,36909157.0,675,1323,500,175,0,39.81481481481482,496,56,20.246746746746748,4
Category_Wikipedia_sockpuppets_of_Avenger2015.csv,3040,18151167.0,1019,2021,500,519,0,39.43092105263158,255,64,23.763486842105262,5
Category_Wikipedia_sockpuppets_of_Bulton36.csv,57,242672.0,20,37,6,14,0,62.45614035087719,239,27,13.24561403508772,5
Category_Wikipedia_sockpuppets_of_Rrjedha.csv,1813,290421964.0,826,987,500,326,0,36.79646993932708,437,49,13.882515168229453,5
Category_Wikipedia_sockpuppets_of_AK19958.csv,79,2142322.0,32,47,29,3,0,40.70886075949367,238,17,15.658227848101266,13
Category_Wikipedia_sockpuppets_of_WWE_Lover_Fan_Forever.csv,32,411819.0,16,16,11,5,0,18.25,145,27,23.5625,22
Category_Wikipedia_sockpuppets_of_ArindamDey_AD.csv,16,581532.0,8,8,6,2,0,58.5625,169,18,12.75,6
Category_Wikipedia_sockpuppets_of_Greekwinker23.csv,14,94700.0,8,6,4,4,0,51.642857142857146,186,45,27.285714285714285,10
Category_Wikipedia_sockpuppets_of_Tripbibo.csv,27,4216580.0,12,15,11,1,0,52.22222222222222,227,19,16.74074074074074,15
Category_Wikipedia_sockpuppets_of_Painting33.csv,144,718013.0,65,79,57,8,0,47.166666666666664,256,66,13.902777777777779,5
Category_Wikipedia_sockpuppets_of_SukaPinakurat.csv,21,4507045.0,7,14,7,0,0,48.142857142857146,162,30,20.571428571428573,19
Category_Wikipedia_sockpuppets_of_Beran111.csv,291,184377234.0,84,207,62,22,0,54.85910652920962,437,52,15.436426116838488,4
Category_Wikipedia_sockpuppets_of_CiaraFan4Ever.csv,1471,43762095.0,584,887,500,84,0,33.265805574439156,258,48,15.77906186267845,4
Category_Wikipedia_sockpuppets_of_WikiEditsAnnon.csv,670,13226442.0,263,407,140,123,0,50.58358208955224,257,50,19.935820895522387,3
Category_Wikipedia_sockpuppets_of_Drosenbe.csv,66,3602313.0,34,32,33,1,0,15.530303030303031,146,10,9.333333333333334,8
Category_Wikipedia_sockpuppets_of_Cokestunt.csv,752,409390343.0,217,535,125,92,0,48.476063829787236,432,54,16.26063829787234,4
Category_Wikipedia_sockpuppets_of_Dan_J._Rocks.csv,552,16596639.0,166,386,92,74,0,40.54891304347826,258,59,21.42572463768116,8
Category_Wikipedia_sockpuppets_of_Ray_Lopez.csv,256,49311558.0,69,187,45,24,0,38.984375,201,47,19.7265625,9
Category_Wikipedia_sockpuppets_of_LukeAwesome93.csv,878,16829620.0,237,641,164,73,0,44.32801822323462,309,78,13.624145785876992,4
Category_Wikipedia_sockpuppets_of_Eli786.csv,790,86996908.0,334,456,97,237,0,39.91772151898734,255,51,15.581012658227849,6
Category_Wikipedia_sockpuppets_of_Samira13690.csv,71,3494615.0,37,34,14,23,0,65.49295774647888,262,29,16.253521126760564,8
Category_Wikipedia_sockpuppets_of_SpideyNZ.csv,5,196932.0,3,2,3,0,0,30.6,138,9,9.0,9
Category_Wikipedia_sockpuppets_of_Wikiwikiwiki413.csv,8,167356.0,5,3,5,0,0,67.0,199,24,19.25,13
Category_Wikipedia_sockpuppets_of_Buffer_v2.csv,1743,127403519.0,508,1235,500,8,0,44.96615031554791,247,57,18.518072289156628,7
Category_Wikipedia_sockpuppets_of_EastWestern.csv,1903,27526371.0,583,1320,500,83,0,39.56857593273778,415,55,19.48397267472412,6
Category_Wikipedia_sockpuppets_of_Indusonline.csv,267,4875977.0,85,182,34,51,0,38.72659176029963,255,26,11.599250936329588,5
Category_Wikipedia_sockpuppets_of_Warmate_Promise.csv,29,6388229.0,9,20,9,0,0,54.41379310344828,196,40,30.06896551724138,22
Category_Wikipedia_sockpuppets_of_PE65000.csv,3801,310030329.0,1475,2326,500,975,0,36.71928439884241,373,88,23.442515127598,5
Category_Wikipedia_sockpuppets_of_Sylvan_wu.csv,179,28693416.0,39,140,38,1,0,43.273743016759774,178,41,17.41899441340782,8
Category_Wikipedia_sockpuppets_of_Rogerreborn.csv,240,97757611.0,48,192,29,19,0,56.833333333333336,375,40,19.358333333333334,3
Category_Wikipedia_sockpuppets_of_Shizzlecraft1.csv,1829,142719558.0,606,1223,238,368,0,46.8720612356479,459,69,20.71295790049207,2
Category_Wikipedia_sockpuppets_of_Pava.csv,1184,386630451.0,273,911,270,3,0,43.054054054054056,254,75,17.83277027027027,3
Category_Wikipedia_sockpuppets_of_Lucywolf1432.csv,3,173328.0,2,1,1,1,0,17.0,51,24,20.333333333333332,13
Category_Wikipedia_sockpuppets_of_Harsh_Anand_Sah.csv,907,139619252.0,207,700,144,63,0,42.89195148842337,300,49,18.921719955898567,3
Category_Wikipedia_sockpuppets_of_Drwho16.csv,1761,21594445.0,605,1156,102,503,0,45.04940374787053,255,77,22.216922203293585,3
Category_Wikipedia_sockpuppets_of_Joey_Andrews.csv,97,12326872.0,21,76,11,10,0,31.010309278350515,196,50,23.36082474226804,10
Category_Wikipedia_sockpuppets_of_Solomon_joe.csv,51,154223.0,19,32,15,4,0,36.11764705882353,147,42,18.058823529411764,5
Category_Wikipedia_sockpuppets_of_Nina_Rassen.csv,79,977548.0,44,35,23,21,0,38.075949367088604,202,29,16.72151898734177,12
Category_Wikipedia_sockpuppets_of_Zaibala.csv,563,77382462.0,229,334,135,94,0,35.710479573712256,472,72,16.213143872113676,5
Category_Wikipedia_sockpuppets_of_Guile222.csv,134,3056677.0,40,94,25,15,0,44.23134328358209,249,29,12.313432835820896,4
Category_Wikipedia_sockpuppets_of_Gollumfanclub.csv,22,9419618.0,11,11,8,3,0,43.81818181818182,169,23,15.590909090909092,12
Category_Wikipedia_sockpuppets_of_Vnonymous.csv,2474,56976288.0,867,1607,500,367,0,50.20776071139854,312,75,23.022635408245755,4
Category_Wikipedia_sockpuppets_of_Sanddude.csv,21,262717.0,13,8,13,0,0,40.23809523809524,199,40,19.333333333333332,11
Category_Wikipedia_sockpuppets_of_ILoveKyrgz.csv,11,5704.0,9,2,5,4,2,79.0909090909091,196,19,11.636363636363637,10
Category_Wikipedia_sockpuppets_of_Connii93.csv,219,10491089.0,72,147,63,9,0,65.8675799086758,502,50,22.168949771689498,5
Category_Wikipedia_sockpuppets_of_Blurviewstudios.csv,17,4328039.0,9,8,8,1,0,62.0,226,23,18.58823529411765,14
Category_Wikipedia_sockpuppets_of_7arazred.csv,1077,22294390.0,424,653,422,2,0,30.99628597957289,260,76,22.142989786443824,7
Category_Wikipedia_sockpuppets_of_WikieditorAddiko.csv,36,2426270.0,14,22,8,6,0,73.30555555555556,403,19,13.916666666666666,11
Category_Wikipedia_sockpuppets_of_Frayten.csv,581,10688515.0,232,349,212,20,0,41.14113597246127,255,34,13.413080895008607,3
Category_Wikipedia_sockpuppets_of_Rajesh-barclays.csv,656,41477749.0,235,421,57,178,0,54.355182926829265,255,55,20.923780487804876,8
Category_Wikipedia_sockpuppets_of_John_Smooth.csv,99,3550588.0,36,63,10,26,0,53.898989898989896,245,32,21.454545454545453,8
Category_Wikipedia_sockpuppets_of_Cool_N_Sexy_Rickz.csv,19,277946.0,9,10,9,0,0,31.05263157894737,171,27,18.473684210526315,13
Category_Wikipedia_sockpuppets_of_James_Bowes.csv,3292,442692744.0,1108,2184,500,608,0,45.60783718104496,273,66,22.09264884568651,3
Category_Wikipedia_sockpuppets_of_JohnValeron.csv,2976,9533275.0,1000,1976,500,500,0,65.82963709677419,255,59,17.670362903225808,4
Category_Wikipedia_sockpuppets_of_Stefanp.csv,1745,30078308.0,798,947,485,313,0,43.47335243553009,255,57,24.817765042979943,9
Category_Wikipedia_sockpuppets_of_blocked.csv,185,88768362.0,49,136,27,22,0,52.637837837837836,239,42,19.437837837837836,5
Category_Wikipedia_sockpuppets_of_Nonenone4.csv,240,1377892.0,79,161,22,57,0,42.520833333333336,220,42,18.3125,5
Category_Wikipedia_sockpuppets_of_Macgrew.csv,149,23509394.0,50,99,39,11,0,46.375838926174495,207,28,19.0,5
Category_Wikipedia_sockpuppets_of_Igor1383.csv,481,222465059.0,156,325,101,55,0,42.103950103950105,309,50,21.848232848232847,5
Category_Wikipedia_sockpuppets_of_Iasson.csv,2588,230991369.0,872,1716,474,398,0,41.008500772797525,255,79,22.814914992272026,4
Category_Wikipedia_sockpuppets_of_JukeMaster84.csv,10,1217.0,4,6,4,0,0,89.1,303,15,12.2,9
Category_Wikipedia_sockpuppets_of_Kimberly_Ashton.csv,951,18321502.0,379,572,266,113,0,22.931650893796004,219,111,20.07570977917981,5
Category_Wikipedia_sockpuppets_of_JkMastru.csv,1255,17802462.0,331,924,74,257,0,57.245418326693226,500,56,19.0796812749004,4
Category_Wikipedia_sockpuppets_of_10JIPN10.csv,973,4624591.0,700,273,500,200,0,30.516957862281604,350,56,15.466598150051388,5
Category_Wikipedia_sockpuppets_of_Smileverse.csv,1190,126452851.0,400,790,373,27,0,40.4672268907563,255,50,17.25378151260504,5
Category_Wikipedia_sockpuppets_of_Hiffy2.csv,5,216906.0,4,1,3,1,0,65.8,152,25,25.0,25
Category_Wikipedia_sockpuppets_of_Eightyeightkeysandhands.csv,162,3441423.0,105,57,100,5,0,35.48148148148148,424,33,18.5,12
Category_Wikipedia_sockpuppets_of_Jiam_Momin.csv,1928,50788553.0,840,1088,154,686,0,43.48651452282158,267,58,20.08350622406639,5
Category_Wikipedia_sockpuppets_of_Trieu_Thuan_Son.csv,108,143896172.0,40,68,22,18,0,47.55555555555556,465,40,12.86111111111111,4
Category_Wikipedia_sockpuppets_of_Master_Beherit.csv,155,26084660.0,60,95,21,39,0,50.33548387096774,254,38,21.683870967741935,8
Category_Wikipedia_sockpuppets_of_Hazarika_MAZ.csv,98,991713.0,29,69,23,6,0,51.5,235,23,15.76530612244898,5
Category_Wikipedia_sockpuppets_of_Bamsi2929.csv,53,4048961.0,20,33,11,9,0,40.81132075471698,237,16,8.830188679245284,4
Category_Wikipedia_sockpuppets_of_Sonofsamrat.csv,14,197515.0,11,3,10,1,0,27.857142857142858,125,21,17.428571428571427,16
Category_Wikipedia_sockpuppets_of_Sahil9610.csv,192,55523496.0,54,138,17,37,0,55.546875,368,56,28.140625,5
Category_Wikipedia_sockpuppets_of_Akash_anand59.csv,43,23502575.0,18,25,5,13,0,48.58139534883721,199,65,29.232558139534884,12
Category_Wikipedia_sockpuppets_of_Bhargavshingala.csv,60,10229771.0,18,42,10,8,0,41.6,205,15,12.733333333333333,10
Category_Wikipedia_sockpuppets_of_Dev_Mahey.csv,1198,183714289.0,527,671,496,31,0,47.8856427378965,496,69,16.676126878130216,4
Category_Wikipedia_sockpuppets_of_Quest1998.csv,582,53293724.0,179,403,64,115,0,48.87285223367697,329,46,17.510309278350515,3
Category_Wikipedia_sockpuppets_of_Tokyo_Metro_6000_series.csv,2922,9083479.0,904,2018,500,404,0,46.40520191649555,500,63,19.430869267624914,2
Category_Wikipedia_sockpuppets_of_12345yup.csv,302,24597.0,100,202,98,2,0,37.77483443708609,252,29,16.423841059602648,9
Category_Wikipedia_sockpuppets_of_Owendayton.csv,67,1812756.0,39,28,20,19,0,40.82089552238806,236,31,19.850746268656717,12
Category_Wikipedia_sockpuppets_of_Ananny.csv,426,395280689.0,134,292,63,71,0,54.2112676056338,243,50,25.4037558685446,8
Category_Wikipedia_sockpuppets_of_Peluches_extronidos.csv,412,37073924.0,132,280,27,105,0,46.890776699029125,496,53,14.53640776699029,3
Category_Wikipedia_sockpuppets_of_Isaacnovicnymy.csv,82,161589445.0,30,52,28,2,0,63.3780487804878,496,42,10.25609756097561,6
Category_Wikipedia_sockpuppets_of_Barrywhite91.csv,5,44273.0,4,1,3,1,0,34.8,130,11,11.0,11
Category_Wikipedia_sockpuppets_of_My_Royal_Young.csv,7781,173505526.0,2044,5737,500,1544,0,60.418326693227094,378,59,18.728826628967997,2
Category_Wikipedia_sockpuppets_of_RNSweb01.csv,51,181840611.0,22,29,19,3,0,52.21568627450981,219,39,25.745098039215687,13
Category_Wikipedia_sockpuppets_of_Fightingliars.csv,20,19234.0,10,10,5,5,0,53.0,196,51,45.45,19
Category_Wikipedia_sockpuppets_of_SimonTrew.csv,1251,109287470.0,569,682,500,69,0,55.42046362909672,279,53,30.919264588329337,4
Category_Wikipedia_sockpuppets_of_The_Triple_M.csv,1650,42820987.0,524,1126,500,24,0,65.91878787878788,255,54,21.613333333333333,3
Category_Wikipedia_sockpuppets_of_Nishantj666.csv,118,9513203.0,41,77,22,19,0,49.05084745762712,236,30,15.033898305084746,4
Category_Wikipedia_sockpuppets_of_Sage_of_the_Six_Paths.csv,2079,25910723.0,678,1401,500,178,0,39.913419913419915,251,82,24.916305916305916,5
Category_Wikipedia_sockpuppets_of_Tommyjacklovesport.csv,45,23226255.0,23,22,14,9,0,57.955555555555556,255,21,14.955555555555556,10
Category_Wikipedia_sockpuppets_of_Darkriser915.csv,706,4139386.0,255,451,156,99,0,38.640226628895185,295,49,18.60198300283286,6
Category_Wikipedia_sockpuppets_of_Sainath_nuvvula.csv,676,34567093.0,242,434,146,96,0,35.167159763313606,243,54,21.75147928994083,7
Category_Wikipedia_sockpuppets_of_Ijust8agrape.csv,22,176134.0,5,17,5,0,0,29.90909090909091,125,111,48.77272727272727,8
Category_Wikipedia_sockpuppets_of_ZachCierzan.csv,1413,43085951.0,551,862,500,51,0,31.750884642604387,255,56,21.462845010615712,6
Category_Wikipedia_sockpuppets_of_Santiago4mom.csv,19,2945000.0,12,7,2,10,0,36.68421052631579,70,13,13.0,13
Category_Wikipedia_sockpuppets_of_Atl1192.csv,143,1019363.0,61,82,43,18,0,45.12587412587413,230,25,16.755244755244757,5
Category_Wikipedia_sockpuppets_of_Chandra_Shekher_Mishra.csv,134,7175905.0,73,61,50,23,0,51.76119402985075,374,32,14.73134328358209,9
Category_Wikipedia_sockpuppets_of_Supersentai.csv,1191,390774303.0,514,677,500,14,0,41.66498740554156,261,31,10.02015113350126,4
Category_Wikipedia_sockpuppets_of_Ace2690.csv,61,609506.0,21,40,10,11,0,41.885245901639344,211,47,19.983606557377048,12
Category_Wikipedia_sockpuppets_of_Thetruthtruth.csv,255,125653408.0,74,181,33,41,0,32.38823529411765,201,46,13.188235294117646,4
Category_Wikipedia_sockpuppets_of_Hasan02011974.csv,170,2076077.0,142,28,120,22,0,25.4,261,39,26.04705882352941,23
Category_Wikipedia_sockpuppets_of_Drummerboy37.csv,150,3890846.0,106,44,104,2,0,21.1,181,39,20.6,18
Category_Wikipedia_sockpuppets_of_PradeepKumar308.csv,2160,2802232.0,1171,989,500,671,0,22.09537037037037,255,36,16.681018518518517,5
Category_Wikipedia_sockpuppets_of_Johntame.csv,62,2516429.0,36,26,15,21,0,39.79032258064516,246,44,25.887096774193548,9
Category_Wikipedia_sockpuppets_of_Barny_Toll.csv,92,1893458.0,40,52,26,14,0,45.02173913043478,205,51,33.630434782608695,17
Category_Wikipedia_sockpuppets_of_Super_World_Champions.csv,1175,6629100.0,289,886,180,109,0,37.774468085106385,255,107,24.288510638297872,3
Category_Wikipedia_sockpuppets_of_Orartu.csv,1623,353977902.0,672,951,500,172,0,43.750462107208875,339,52,20.51879235982748,5
Category_Wikipedia_sockpuppets_of_MF521113.csv,153,121719.0,78,75,74,4,0,26.915032679738562,255,36,23.562091503267975,10
Category_Wikipedia_sockpuppets_of_Waspex.csv,146,85264738.0,42,104,21,21,0,63.513698630136986,476,59,19.732876712328768,7
Category_Wikipedia_sockpuppets_of_Kulsoom_Abrar.csv,254,6517357.0,86,168,24,62,0,42.23622047244095,252,58,28.566929133858267,12
Category_Wikipedia_sockpuppets_of_Ahmetk.csv,55,30648.0,20,35,11,9,0,29.545454545454547,138,26,17.418181818181818,7
Category_Wikipedia_sockpuppets_of_Gaption.csv,33,68096515.0,9,24,8,1,0,66.3030303030303,185,28,12.424242424242424,4
Category_Wikipedia_sockpuppets_of_TheMissingPiece84.csv,107,561634.0,47,60,34,13,0,46.48598130841121,260,42,20.55140186915888,4
Category_Wikipedia_sockpuppets_of_Phil_McClane.csv,90,1628083.0,27,63,8,19,0,43.08888888888889,226,36,24.644444444444446,10
Category_Wikipedia_sockpuppets_of_Randbirsidhu3033.csv,168,7189662.0,49,119,38,11,0,55.607142857142854,314,70,15.755952380952381,4
Category_Wikipedia_sockpuppets_of_Abhih.csv,375,779936.0,120,255,116,4,0,45.81066666666667,212,54,25.14666666666667,6
Category_Wikipedia_sockpuppets_of_Thatwhoiswise.csv,2372,48195144.0,869,1503,500,369,0,40.215008431703204,255,96,24.052276559865092,3
Category_Wikipedia_sockpuppets_of_Teesandhumber.csv,68,756939.0,21,47,15,6,0,64.38235294117646,200,25,14.044117647058824,4
Category_Wikipedia_sockpuppets_of_LunarSpoon.csv,208,1546131.0,90,118,32,58,0,34.375,226,54,19.427884615384617,6
Category_Wikipedia_sockpuppets_of_Kc0293.csv,40,12355816.0,13,27,13,0,0,51.275,131,21,19.05,15
Category_Wikipedia_sockpuppets_of_Kukkuisthebest.csv,830,20239947.0,235,595,70,165,0,47.659036144578316,255,40,15.609638554216868,6
Category_Wikipedia_sockpuppets_of_Glliwian_23.0.csv,44,13862018.0,16,28,11,5,0,81.36363636363636,229,54,17.727272727272727,4
Category_Wikipedia_sockpuppets_of_Marvelous8.csv,197,11593525.0,138,59,137,1,0,41.263959390862944,255,20,12.725888324873097,9
Category_Wikipedia_sockpuppets_of_Davit_Ajith.csv,7,214081.0,3,4,3,0,0,51.42857142857143,156,40,25.0,16
Category_Wikipedia_sockpuppets_of_Aatomic1.csv,1204,21816760.0,509,695,500,9,0,43.41860465116279,213,67,17.454318936877076,4
Category_Wikipedia_sockpuppets_of_Morbiussweepmorbintime.csv,140,2952125.0,37,103,9,28,0,63.07142857142857,275,34,20.642857142857142,9
Category_Wikipedia_sockpuppets_of_Nonamehg16059.csv,305,31191326.0,130,175,108,22,0,41.0,232,23,12.340983606557376,5
Category_Wikipedia_sockpuppets_of_84101e40247.csv,674,140736734.0,140,534,51,89,0,43.324925816023736,292,54,15.362017804154302,4
Category_Wikipedia_sockpuppets_of_Swiftie1313.csv,1855,46476732.0,640,1215,500,140,0,45.747708894878706,425,57,19.801617250673853,5
Category_Wikipedia_sockpuppets_of_Lolnove.csv,8,952.0,7,1,7,0,0,14.875,119,4,4.0,4
Category_Wikipedia_sockpuppets_of_TroubleTroll.csv,20,88685.0,6,14,5,1,14,47.85,165,47,32.05,8
Category_Wikipedia_sockpuppets_of_Kathy_from_Paddington_School.csv,111,3184700.0,53,58,20,33,0,51.828828828828826,279,42,22.063063063063062,5
Category_Wikipedia_sockpuppets_of_Fotznbr√§dl.csv,10,77407.0,7,3,5,2,8,45.0,119,10,10.0,10
Category_Wikipedia_sockpuppets_of_Me_toofy.csv,2,0.0,1,1,1,0,199,199.0,199,18,18.0,18
Category_Wikipedia_sockpuppets_of_BossKoolaid.csv,1936,88560314.0,721,1215,500,221,0,38.81146694214876,496,88,25.892045454545453,9
Category_Wikipedia_sockpuppets_of_Disco79.csv,810,4940562.0,224,586,209,15,0,39.41604938271605,201,47,15.298765432098765,5
Category_Wikipedia_sockpuppets_of_Gregburns83.csv,8,2604180.0,5,3,2,3,0,67.875,226,11,11.0,11
Category_Wikipedia_sockpuppets_of_Lisa_Bathgate.csv,516,2401288.0,168,348,83,85,0,52.218992248062015,255,49,17.337209302325583,5
Category_Wikipedia_sockpuppets_of_AnonymousHistory1919.csv,119,1056815.0,45,74,23,22,0,52.12605042016807,332,50,20.571428571428573,5
Category_Wikipedia_sockpuppets_of_Rockybalboa1976.csv,157,5746309.0,98,59,79,19,0,21.0,250,47,39.86624203821656,34
Category_Wikipedia_sockpuppets_of_Minorview.csv,538,67547158.0,168,370,161,7,0,45.50185873605948,249,53,25.12081784386617,5
Category_Wikipedia_sockpuppets_of_Brennanb4.csv,335,230897701.0,196,139,157,39,0,44.570149253731344,218,37,19.188059701492538,11
Category_Wikipedia_sockpuppets_of_Who_Am_I_Why_Am_I_Here.csv,643,89236897.0,206,437,140,66,0,37.50077760497667,237,100,32.60964230171073,5
Category_Wikipedia_sockpuppets_of_Christopher1981.csv,151,4404679.0,43,108,22,21,0,71.41721854304636,436,41,13.735099337748345,4
Category_Wikipedia_sockpuppets_of_Egela.csv,162,21404560.0,51,111,15,36,0,52.82098765432099,285,46,21.72222222222222,4
Category_Wikipedia_sockpuppets_of_Lotusmediadesign.csv,57,197625196.0,15,42,14,1,0,55.526315789473685,175,26,22.964912280701753,18
Category_Wikipedia_sockpuppets_of_Dylanmayfuller.csv,84,7011425.0,34,50,23,11,0,44.964285714285715,224,38,20.285714285714285,8
Category_Wikipedia_sockpuppets_of_BlueSalo.csv,3179,16443461.0,1047,2132,500,547,0,42.8232148474363,259,92,21.442906574394463,3
Category_Wikipedia_sockpuppets_of_Proletarian_Banner.csv,963,11336809.0,340,623,314,26,0,51.36448598130841,500,87,23.990654205607477,5
Category_Wikipedia_sockpuppets_of_Hamed198766.csv,45,644177.0,15,30,7,8,0,46.577777777777776,194,48,21.0,5
Category_Wikipedia_sockpuppets_of_Ztiep.csv,3,202.0,2,1,2,0,0,35.666666666666664,107,8,8.0,8
Category_Wikipedia_sockpuppets_of_MxsoloInc.csv,221,108918960.0,76,145,53,23,0,51.46606334841629,239,53,15.126696832579185,6
Category_Wikipedia_sockpuppets_of_Stuartzs.csv,1676,349380352.0,563,1113,306,257,0,44.7082338902148,340,79,25.223747016706444,3
Category_Wikipedia_sockpuppets_of_URF1976.csv,19,85340.0,17,2,13,4,0,19.42105263157895,118,23,23.0,23
Category_Wikipedia_sockpuppets_of_Kpaspery.csv,2366,106508711.0,1000,1366,500,500,0,39.430262045646664,313,65,25.12087912087912,6
Category_Wikipedia_sockpuppets_of_Sulmues.csv,4849,150360060.0,1855,2994,500,1355,0,42.28129511239431,255,68,20.198391420911527,3
Category_Wikipedia_sockpuppets_of_Worthadonkey.csv,274,108163000.0,68,206,68,0,0,43.79197080291971,209,44,16.2007299270073,5
Category_Wikipedia_sockpuppets_of_Karki_birahi.csv,22,34387572.0,6,16,5,1,4,28.363636363636363,232,24,23.90909090909091,22
Category_Wikipedia_sockpuppets_of_Flarepath13.csv,220,29365382.0,129,91,96,33,0,33.68181818181818,255,48,13.60909090909091,11
Category_Wikipedia_sockpuppets_of_Dirsmith.csv,239,177460946.0,73,166,20,53,0,59.62761506276151,250,59,20.782426778242677,11
Category_Wikipedia_sockpuppets_of_Rockyyikes.csv,14,15962.0,14,0,12,2,0,3.9285714285714284,20,13,13.0,13
Category_Wikipedia_sockpuppets_of_Ying-Meng_Lin.csv,18,881000.0,9,9,5,4,0,34.333333333333336,94,38,25.333333333333332,17
Category_Wikipedia_sockpuppets_of_Gr8adithya.csv,7,1798033.0,3,4,3,0,0,41.142857142857146,99,20,12.0,6
Category_Wikipedia_sockpuppets_of_Algin_Requilman.csv,568,9648241.0,221,347,197,24,0,29.096830985915492,239,43,17.003521126760564,7
Category_Wikipedia_sockpuppets_of_Jooperscooper.csv,8,74557.0,6,2,4,2,0,42.5,155,38,21.5,16
Category_Wikipedia_sockpuppets_of_GreatTruth123.csv,494,26373932.0,147,347,51,96,0,58.46153846153846,254,61,15.649797570850202,4
Category_Wikipedia_sockpuppets_of_Christoper007.csv,28,720159.0,14,14,14,0,0,50.857142857142854,294,26,19.178571428571427,8
Category_Wikipedia_sockpuppets_of_DeathStar696969696969.csv,12,160201.0,7,5,5,2,0,61.833333333333336,179,31,21.5,8
Category_Wikipedia_sockpuppets_of_ThenShoot.csv,168,3164391.0,48,120,39,9,0,55.595238095238095,303,46,17.547619047619047,5
Category_Wikipedia_sockpuppets_of_Samirdu75.csv,177,84540252.0,60,117,18,42,0,28.875706214689266,308,25,8.903954802259888,3
Category_Wikipedia_sockpuppets_of_Mraids.csv,39,186204.0,22,17,21,1,0,28.871794871794872,129,18,13.153846153846153,10
Category_Wikipedia_sockpuppets_of_Josh_Rumage.csv,5194,113355636.0,1451,3743,500,951,0,41.65768194070081,262,63,13.861185983827493,4
Category_Wikipedia_sockpuppets_of_ChildofMidnight.csv,4932,169951184.0,1805,3127,500,1305,0,42.07846715328467,255,91,20.2617599351176,4
Category_Wikipedia_sockpuppets_of_Railrider12.csv,66,174643.0,37,29,12,25,0,58.68181818181818,494,47,27.696969696969695,12
Category_Wikipedia_sockpuppets_of_Vivekkumarsudhanshu.csv,87,117992.0,26,61,19,7,0,48.747126436781606,243,23,12.344827586206897,6
Category_Wikipedia_sockpuppets_of_Alba_Illyrian.csv,306,2688149.0,148,158,82,66,0,42.310457516339866,242,50,21.098039215686274,3
Category_Wikipedia_sockpuppets_of_Nayinar_Kshatriyas.csv,733,1350045.0,215,518,155,60,0,49.215552523874486,500,43,14.875852660300136,5
Category_Wikipedia_sockpuppets_of_Cerefo.csv,396,52654824.0,121,275,49,72,0,56.17171717171717,253,59,25.482323232323232,6
Category_Wikipedia_sockpuppets_of_Elglaouilegacy.csv,114,62207962.0,65,49,33,32,0,40.01754385964912,266,34,20.605263157894736,12
Category_Wikipedia_sockpuppets_of_Robeca5020.csv,213,262893.0,71,142,35,36,0,70.46478873239437,287,64,39.79342723004695,5
Category_Wikipedia_sockpuppets_of_DillPickle886.csv,2189,19013553.0,574,1615,500,74,0,38.106441297396074,483,56,19.79945180447693,3
Category_Wikipedia_sockpuppets_of_The_MRX_Writter.csv,47,5900359.0,22,25,16,6,0,30.404255319148938,318,51,26.0,10
Category_Wikipedia_sockpuppets_of_Panleung4.csv,45,38926.0,38,7,33,5,0,16.866666666666667,173,14,14.0,14
Category_Wikipedia_sockpuppets_of_Awsomeboy99.csv,91,8218708.0,33,58,28,5,0,36.86813186813187,207,43,27.64835164835165,7
Category_Wikipedia_sockpuppets_of_Kakaart12.csv,101,4299763.0,29,72,20,9,0,54.46534653465346,231,45,26.96039603960396,4
Category_Wikipedia_sockpuppets_of_Raspslews.csv,23,1043227.0,7,16,4,3,0,49.82608695652174,192,21,17.652173913043477,12
Category_Wikipedia_sockpuppets_of_Fodient.csv,2148,519615811.0,507,1641,500,7,0,47.37849162011173,374,73,23.223929236499067,4
Category_Wikipedia_sockpuppets_of_Reeperbahn_Festival.csv,3,2404420.0,2,1,1,1,7,53.0,127,29,25.0,17
Category_Wikipedia_sockpuppets_of_Bryant7728.csv,154,40373267.0,49,105,46,3,0,46.31818181818182,246,38,18.707792207792206,5
Category_Wikipedia_sockpuppets_of_D.R_Neal_G.csv,324,90784.0,147,177,142,5,0,45.43518518518518,245,50,23.098765432098766,9
Category_Wikipedia_sockpuppets_of_Youtubewikiwriter.csv,175,13582133.0,59,116,20,39,0,60.40571428571429,210,56,21.617142857142856,9
Category_Wikipedia_sockpuppets_of_Ahyman69.csv,45,2337684.0,9,36,6,3,0,59.577777777777776,220,15,11.177777777777777,7
Category_Wikipedia_sockpuppets_of_Wgcw.csv,236,23454594.0,133,103,120,13,0,31.24576271186441,255,74,37.813559322033896,5
Category_Wikipedia_sockpuppets_of_IceDom.csv,11,6539923.0,6,5,6,0,7,78.27272727272727,250,29,22.0,11
Category_Wikipedia_sockpuppets_of_Rayhan_raju.csv,1949,16783601.0,1000,949,500,500,0,21.589533093894303,255,32,14.979989738327347,7
Category_Wikipedia_sockpuppets_of_JordanWiki1.csv,168,337089243.0,36,132,19,17,0,59.25595238095238,381,59,22.946428571428573,12
Category_Wikipedia_sockpuppets_of_Fikri_Miftahurahmat.csv,20,1599332.0,12,8,5,7,0,72.1,156,31,28.3,17
Category_Wikipedia_sockpuppets_of_Danton's_Jacobin.csv,1998,9637842.0,636,1362,437,199,0,43.5975975975976,255,80,20.07057057057057,4
Category_Wikipedia_sockpuppets_of_Mukesh_Dhuwaiwal.csv,14,87001.0,6,8,4,2,0,55.0,165,29,23.428571428571427,18
Category_Wikipedia_sockpuppets_of_Anel2020.csv,3,901.0,2,1,2,0,0,21.0,63,53,53.0,53
Category_Wikipedia_sockpuppets_of_ACCOUNT_OF_EMI.csv,40,191332.0,12,28,7,5,0,45.675,161,32,18.875,7
Category_Wikipedia_sockpuppets_of_Shadowyblue09.csv,1063,86161889.0,569,494,496,73,0,30.916274694261524,500,71,25.60112888052681,7
Category_Wikipedia_sockpuppets_of_Po8y4w3.csv,568,7435627.0,199,369,119,80,0,51.59154929577465,255,34,12.28169014084507,3
Category_Wikipedia_sockpuppets_of_Wikiediter007.csv,10,41364.0,6,4,4,2,0,27.1,192,24,24.0,24
Category_Wikipedia_sockpuppets_of_Susana_Hodge.csv,1117,49770426.0,443,674,435,8,0,41.37332139659803,255,68,21.54700089525515,7
Category_Wikipedia_sockpuppets_of_Krishnasaathwik.csv,3,109.0,2,1,2,0,21,36.333333333333336,44,25,23.0,19
Category_Wikipedia_sockpuppets_of_Pumpie.csv,6708,471086111.0,3057,3651,500,2557,0,38.78622540250447,434,59,19.94350029815146,4
Category_Wikipedia_sockpuppets_of_Jack_Coppit.csv,1411,429202461.0,433,978,156,277,0,56.23175053153792,317,60,26.32388377037562,8
Category_Wikipedia_sockpuppets_of_Annaamalia.csv,277,226841091.0,99,178,83,16,0,42.324909747292416,255,42,28.342960288808666,9
Category_Wikipedia_sockpuppets_of_Archie888.csv,35,288566703.0,9,26,6,3,0,51.4,205,48,22.0,14
Category_Wikipedia_sockpuppets_of_Mosiki.csv,7,791.0,6,1,3,3,0,66.14285714285714,199,11,11.0,11
Category_Wikipedia_sockpuppets_of_Poprobeson.csv,6,1342867.0,3,3,2,1,22,35.333333333333336,74,6,6.0,6
Category_Wikipedia_sockpuppets_of_Cornholio3.csv,27,2384.0,16,11,7,9,0,58.629629629629626,232,35,25.333333333333332,10
Category_Wikipedia_sockpuppets_of_LSKIYAPSD.csv,1309,63864084.0,368,941,349,19,0,43.5301757066463,493,62,33.778456837280366,6
Category_Wikipedia_sockpuppets_of_DJManda.csv,67,421796.0,53,14,53,0,0,29.73134328358209,196,37,18.238805970149254,10
Category_Wikipedia_sockpuppets_of_Brazil4Linux.csv,2938,11994465.0,890,2048,500,390,0,25.491831177671887,190,72,18.208304969366917,3
Category_Wikipedia_sockpuppets_of_PsychWardMan.csv,1328,47527639.0,356,972,204,152,0,32.980421686746986,214,51,21.596385542168676,3
Category_Wikipedia_sockpuppets_of_Rainbowwarrior1977.csv,639,94665533.0,191,448,191,0,0,35.341158059467915,219,51,21.89358372456964,4
Category_Wikipedia_sockpuppets_of_Remi.apresdemain.csv,13,3960560.0,3,10,3,0,0,71.0,201,23,21.46153846153846,13
Category_Wikipedia_sockpuppets_of_AkhileshP_writer.csv,46,202100622.0,16,30,6,10,0,63.108695652173914,218,45,23.347826086956523,13
Category_Wikipedia_sockpuppets_of_Takonic.csv,112,1614409.0,37,75,22,15,0,54.598214285714285,222,47,24.169642857142858,12
Category_Wikipedia_sockpuppets_of_Victorespinoza.csv,110,4568386.0,92,18,26,66,0,19.618181818181817,200,21,14.063636363636364,14
Category_Wikipedia_sockpuppets_of_Guildenrich.csv,3387,30572780.0,1360,2027,500,860,0,33.66932388544435,237,77,18.795098907587835,4
Category_Wikipedia_sockpuppets_of_JimmyTwoShoes_fan.csv,513,26620453.0,126,387,57,69,0,37.90643274853801,249,56,21.235867446393762,3
Category_Wikipedia_sockpuppets_of_Felicia112.csv,108,74385438.0,48,60,19,29,0,41.68518518518518,232,56,19.333333333333332,4
Category_Wikipedia_sockpuppets_of_IzzyandBelle.csv,74,1560640.0,29,45,17,12,0,68.64864864864865,200,23,7.675675675675675,3
Category_Wikipedia_sockpuppets_of_UGAWOOD2020.csv,1704,73183351.0,738,966,500,238,0,38.070422535211264,396,80,18.330985915492956,3
Category_Wikipedia_sockpuppets_of_Collabpedia.csv,59,4090544.0,17,42,5,12,0,58.30508474576271,270,25,18.47457627118644,10
Category_Wikipedia_sockpuppets_of_MRINAL2T.csv,228,60233884.0,69,159,40,29,0,55.01315789473684,301,18,10.43859649122807,5
Category_Wikipedia_sockpuppets_of_Koyikkodann.csv,24,5527.0,17,7,13,4,0,17.625,140,63,43.75,10
Category_Wikipedia_sockpuppets_of_Millsstory.csv,49,260908.0,16,33,12,4,0,53.06122448979592,186,23,13.020408163265307,7
Category_Wikipedia_sockpuppets_of_Teertrevo.csv,967,10816108.0,328,639,263,65,0,58.63495346432265,470,53,16.749741468459153,4
Category_Wikipedia_sockpuppets_of_John17587.csv,27,39689.0,17,10,8,9,0,100.74074074074075,212,18,13.074074074074074,11
Category_Wikipedia_sockpuppets_of_Madhawa_thirimanna.csv,32,237192.0,12,20,7,5,0,55.0625,196,46,24.53125,12
Category_Wikipedia_sockpuppets_of_Prateekbudhwar.csv,60,82368604.0,22,38,13,9,0,78.78333333333333,235,24,11.683333333333334,7
Category_Wikipedia_sockpuppets_of_Chetch_the_Letch.csv,24,167576.0,8,16,8,0,0,59.791666666666664,185,34,24.083333333333332,14
Category_Wikipedia_sockpuppets_of_Mukhtar_Musheer_Majeed.csv,60,35509522.0,33,27,31,2,0,56.3,286,61,21.5,14
Category_Wikipedia_sockpuppets_of_Somerfordben.csv,208,269743059.0,69,139,63,6,0,25.990384615384617,235,29,14.490384615384615,10
Category_Wikipedia_sockpuppets_of_JamesF12345.csv,35,6071.0,13,22,13,0,0,55.34285714285714,173,29,14.285714285714286,5
Category_Wikipedia_sockpuppets_of_CelestialDownfall.csv,71,6268200.0,34,37,30,4,0,52.15492957746479,265,22,9.591549295774648,7
Category_Wikipedia_sockpuppets_of_Lidia2024.csv,90,2509113.0,34,56,16,18,0,32.733333333333334,189,47,31.466666666666665,16
Category_Wikipedia_sockpuppets_of_JeffTorado.csv,8,55963.0,5,3,4,1,0,46.375,196,25,24.375,24
Category_Wikipedia_sockpuppets_of_Funnyguy4love.csv,32,5981462.0,11,21,5,6,0,45.40625,199,19,14.15625,7
Category_Wikipedia_sockpuppets_of_Xanferio.csv,43,244120.0,16,27,4,12,0,65.25581395348837,185,44,14.953488372093023,4
Category_Wikipedia_sockpuppets_of_George_Pappas.csv,16,497654.0,5,11,5,0,0,44.25,146,73,44.9375,8
Category_Wikipedia_sockpuppets_of_IM_CS_STUDENT.csv,14,4663.0,7,7,4,3,0,77.07142857142857,211,29,27.714285714285715,25
Category_Wikipedia_sockpuppets_of_Iaarzoo.csv,117,295921351.0,31,86,18,13,0,39.60683760683761,255,42,12.991452991452991,3
Category_Wikipedia_sockpuppets_of_Clairecares.csv,1,0.0,1,0,1,0,0,0.0,0,5,5.0,5
Category_Wikipedia_sockpuppets_of_Desertstarholdingslimited.csv,24,1923569.0,15,9,9,6,0,99.41666666666667,487,20,17.0,16
Category_Wikipedia_sockpuppets_of_Tyrobben.csv,9,107226.0,4,5,3,1,0,62.666666666666664,225,22,22.0,22
Category_Wikipedia_sockpuppets_of_Gangsta15.csv,5,1570030.0,3,2,3,0,21,54.6,106,20,18.8,14
Category_Wikipedia_sockpuppets_of_ColonelHenry.csv,4412,277353862.0,1542,2870,500,1042,0,44.21758839528558,255,89,30.756799637352675,4
Category_Wikipedia_sockpuppets_of_Ê¨∏Ê¨∏ÊâìÈõªÂãïÊúÄÂº∑ÁöÑ.csv,84,501127.0,25,59,15,10,0,23.428571428571427,381,18,16.928571428571427,13
Category_Wikipedia_sockpuppets_of_Han2007.csv,380,18938970.0,106,274,100,6,0,52.78947368421053,235,42,19.67105263157895,7
Category_Wikipedia_sockpuppets_of_Nfwjieqifhqief34i9.csv,10,83288.0,8,2,5,3,0,20.9,118,28,17.6,15
Category_Wikipedia_sockpuppets_of_Brendancox2.csv,26,3061753.0,8,18,5,3,0,64.96153846153847,184,53,27.23076923076923,13
Category_Wikipedia_sockpuppets_of_Renamed_user_jC6jAXNBCg.csv,1846,9800865.0,725,1121,500,225,0,43.37540628385699,260,108,29.913867822318526,4
Category_Wikipedia_sockpuppets_of_Shristy.Rhodee.csv,414,16100123.0,144,270,134,10,0,56.089371980676326,496,66,15.68840579710145,4
Category_Wikipedia_sockpuppets_of_Ranatarakji1.csv,1,0.0,1,0,1,0,195,195.0,195,22,22.0,22
Category_Wikipedia_sockpuppets_of_Sheikhmeer786.csv,17,362658.0,13,4,13,0,0,43.11764705882353,193,25,22.88235294117647,21
Category_Wikipedia_sockpuppets_of_SamHinch.csv,828,222220857.0,211,617,194,17,0,48.60144927536232,494,63,18.06159420289855,7
Category_Wikipedia_sockpuppets_of_Randy_Jaq.csv,20,10122871.0,6,14,4,2,0,38.0,195,63,46.8,13
Category_Wikipedia_sockpuppets_of_Kingdrog.csv,1552,113631446.0,653,899,500,153,0,35.46842783505155,500,35,10.686211340206185,4
Category_Wikipedia_sockpuppets_of_Longoodbye.csv,29,110687.0,21,8,12,9,0,29.103448275862068,138,31,22.724137931034484,10
Category_Wikipedia_sockpuppets_of_MrProEdits.csv,65,74738902.0,19,46,18,1,0,46.30769230769231,213,68,22.876923076923077,13
Category_Wikipedia_sockpuppets_of_Itszaib.csv,53,13439763.0,17,36,12,5,0,48.056603773584904,174,49,17.943396226415093,10
Category_Wikipedia_sockpuppets_of_A_State_Of_Trance.csv,5031,35223368.0,1855,3176,500,1355,0,35.134764460345856,266,68,23.16656728284635,4
Category_Wikipedia_sockpuppets_of_Fred1985.csv,39,365743.0,20,19,14,6,0,55.0,138,19,15.461538461538462,11
Category_Wikipedia_sockpuppets_of_Nambsunil.csv,43,18082486.0,16,27,5,11,11,87.48837209302326,211,33,25.325581395348838,19
Category_Wikipedia_sockpuppets_of_CarlosWagners.csv,141,19039444.0,56,85,52,4,0,43.212765957446805,237,49,23.865248226950353,6
Category_Wikipedia_sockpuppets_of_Dexdunkers.csv,466,84143438.0,140,326,69,71,0,51.302575107296136,465,63,23.59656652360515,7
Category_Wikipedia_sockpuppets_of_Â§çÊó¶Â§ßÂ≠¶Âº†Ë∂Ö.csv,2208,117033256.0,689,1519,431,258,0,42.72373188405797,490,101,16.255434782608695,5
Category_Wikipedia_sockpuppets_of_Rizzler420.csv,13,162737.0,10,3,4,6,0,25.0,114,28,20.615384615384617,17
Category_Wikipedia_sockpuppets_of_Drprinceton.csv,109,13996739.0,39,70,30,9,0,53.211009174311926,225,44,20.568807339449542,7
Category_Wikipedia_sockpuppets_of_MiaPo.csv,8,20805.0,4,4,4,0,15,31.25,112,30,30.0,30
Category_Wikipedia_sockpuppets_of_Jackie91415.csv,45,329333.0,24,21,16,8,0,36.955555555555556,182,21,21.0,21
Category_Wikipedia_sockpuppets_of_Way4743.csv,110,21440985.0,35,75,11,24,0,48.43636363636364,211,51,16.51818181818182,7
Category_Wikipedia_sockpuppets_of_A.Ruslan_88.csv,22,5551259.0,15,7,13,2,7,44.59090909090909,196,30,22.227272727272727,21
Category_Wikipedia_sockpuppets_of_Yudhishthir1947.csv,338,2171849.0,123,215,68,55,0,38.3698224852071,283,37,17.733727810650887,6
Category_Wikipedia_sockpuppets_of_Binkydarling.csv,439,77233876.0,151,288,26,125,0,43.54897494305239,243,61,22.831435079726653,6
Category_Wikipedia_sockpuppets_of_Dudemeister1234.csv,759,65976688.0,278,481,277,1,0,45.45981554677207,261,76,22.297760210803688,6
Category_Wikipedia_sockpuppets_of_Researchonlineabc.csv,56,6444318.0,32,24,19,13,0,37.19642857142857,154,27,17.535714285714285,14
Category_Wikipedia_sockpuppets_of_KarlMWinnoww.csv,82,17602.0,47,35,42,5,0,49.9390243902439,164,50,31.975609756097562,17
Category_Wikipedia_sockpuppets_of_June213.csv,420,7028169.0,168,252,139,29,0,48.588095238095235,398,47,13.485714285714286,5
Category_Wikipedia_sockpuppets_of_WhiteHouseEditor.csv,19,198840.0,7,12,3,4,0,57.26315789473684,243,35,30.36842105263158,23
Category_Wikipedia_sockpuppets_of_Pkschhonkar.csv,321,81085592.0,124,197,119,5,0,42.006230529595015,261,52,16.613707165109034,5
Category_Wikipedia_sockpuppets_of_Theyogeshkaushik.csv,13,786647.0,7,6,4,3,0,73.07692307692308,260,26,20.76923076923077,14
Category_Wikipedia_sockpuppets_of_IeEditor.csv,129,45713316.0,47,82,36,11,0,45.13953488372093,243,47,20.844961240310077,13
Category_Wikipedia_sockpuppets_of_Hussainmakda.csv,205,710129.0,67,138,29,38,0,65.93170731707318,403,51,13.053658536585365,4
Category_Wikipedia_sockpuppets_of_Princeneil.csv,1637,82390643.0,668,969,358,310,0,47.280390959071475,249,91,21.487477092241907,6
Category_Wikipedia_sockpuppets_of_Ryujinjakka.csv,247,30658457.0,57,190,55,2,0,57.02429149797571,248,51,14.631578947368421,4
Category_Wikipedia_sockpuppets_of_Zlykinskyja.csv,1456,66685458.0,513,943,500,13,0,48.75892857142857,250,48,33.64423076923077,9
Category_Wikipedia_sockpuppets_of_Duka_Mostrokol.csv,55,39458750.0,21,34,19,2,0,66.07272727272728,289,20,12.581818181818182,11
Category_Wikipedia_sockpuppets_of_ILAnhisM.csv,476,10381643.0,153,323,49,104,0,49.08403361344538,496,63,21.09453781512605,6
Category_Wikipedia_sockpuppets_of_Payne2thamax.csv,3841,96496985.0,1045,2796,500,545,0,35.6310856547774,260,68,17.25982816974746,3
Category_Wikipedia_sockpuppets_of_Alt_f_in.csv,103,25404467.0,26,77,25,1,0,40.970873786407765,199,30,17.57281553398058,5
Category_Wikipedia_sockpuppets_of_Sreenathr10.csv,32,10463624.0,12,20,12,0,0,43.40625,243,53,28.59375,9
Category_Wikipedia_sockpuppets_of_Fatima_77.csv,271,84544185.0,115,156,70,45,0,51.91881918819188,255,64,24.96309963099631,6
Category_Wikipedia_sockpuppets_of_Aninditagogoi18.csv,112,21586743.0,43,69,31,12,0,35.642857142857146,353,28,14.098214285714286,7
Category_Wikipedia_sockpuppets_of_Ellen_xEren.csv,5,174.0,3,2,2,1,0,72.0,206,21,16.4,11
Category_Wikipedia_sockpuppets_of_Timexway.csv,9,5380223.0,2,7,2,0,0,50.22222222222222,79,20,19.555555555555557,18
Category_Wikipedia_sockpuppets_of_Dly234.csv,15,1836.0,8,7,8,0,0,57.53333333333333,212,8,8.0,8
Category_Wikipedia_sockpuppets_of_Mariam83.csv,1399,10927762.0,504,895,449,55,0,40.99213724088635,221,52,14.993566833452466,5
Category_Wikipedia_sockpuppets_of_Ddddddd1237.csv,68,1115.0,58,10,27,31,99,114.54411764705883,130,14,14.0,14
Category_Wikipedia_sockpuppets_of_Red~Adman.csv,8,93520.0,5,3,5,0,0,31.625,79,56,40.625,15
Category_Wikipedia_sockpuppets_of_LilKane33.csv,137,155220.0,49,88,36,13,0,43.65693430656934,243,28,18.153284671532848,9
Category_Wikipedia_sockpuppets_of_Zrdragon12.csv,1954,3181651.0,605,1349,500,105,0,60.96366427840328,255,87,27.299897645854657,3
Category_Wikipedia_sockpuppets_of_Md._Ashraf_Shameem.csv,64,2554009.0,53,11,45,8,0,22.4375,218,28,11.125,10
Category_Wikipedia_sockpuppets_of_BarackN.csv,10,257.0,3,7,2,1,0,35.4,148,18,11.6,6
Category_Wikipedia_sockpuppets_of_JohnBravely1991.csv,62,2928044.0,19,43,13,6,0,47.24193548387097,160,26,16.225806451612904,3
Category_Wikipedia_sockpuppets_of_Kxena.csv,179,92813057.0,66,113,37,29,0,37.3463687150838,247,92,15.88268156424581,7
Category_Wikipedia_sockpuppets_of_Tr00lr.csv,18,56923.0,11,7,5,6,0,60.44444444444444,198,12,8.666666666666666,8
Category_Wikipedia_sockpuppets_of_Johannes_Chrysostomus_Wolfgangus_Theophilus_Mozart.csv,84,29477801.0,28,56,15,13,0,53.845238095238095,239,24,16.404761904761905,4
Category_Wikipedia_sockpuppets_of_Ddorai1.csv,156,14869198.0,32,124,27,5,0,46.30769230769231,228,32,12.807692307692308,4
Category_Wikipedia_sockpuppets_of_Lahiru_k.csv,2171,274230060.0,575,1596,500,75,0,54.12759097190235,251,73,22.37908797789037,4
Category_Wikipedia_sockpuppets_of_Lesko11.csv,90,254791879.0,34,56,31,3,0,42.022222222222226,214,44,22.11111111111111,12
Category_Wikipedia_sockpuppets_of_Rajendrapppangeni.csv,76,42368324.0,37,39,35,2,0,52.44736842105263,455,62,31.32894736842105,10
Category_Wikipedia_sockpuppets_of_The_lord_of_EEEEE.csv,14,7252325.0,5,9,4,1,0,84.64285714285714,261,21,11.714285714285714,7
Category_Wikipedia_sockpuppets_of_Sunholm.csv,4445,162523916.0,1365,3080,500,865,0,43.67424071991001,250,98,24.056242969628798,3
Category_Wikipedia_sockpuppets_of_Cazique.csv,3104,36245309.0,1072,2032,500,572,0,40.376288659793815,259,74,21.3305412371134,3
Category_Wikipedia_sockpuppets_of_Emmanuel_Ngabirano.csv,26,22447406.0,19,7,9,10,0,42.69230769230769,196,42,24.076923076923077,16
Category_Wikipedia_sockpuppets_of_Zigmund_jhaey_javier.csv,2905,26035472.0,695,2210,146,549,0,41.39311531841652,395,75,24.857142857142858,6
Category_Wikipedia_sockpuppets_of_OfficialSakuraEmad.csv,4,165.0,2,2,2,0,0,71.0,145,28,23.0,18
Category_Wikipedia_sockpuppets_of_Alviennair.csv,51,50098815.0,30,21,17,13,0,26.49019607843137,244,20,11.607843137254902,10
Category_Wikipedia_sockpuppets_of_Saurabhews.csv,74,201411774.0,26,48,21,5,0,73.74324324324324,250,55,22.10810810810811,10
Category_Wikipedia_sockpuppets_of_Davesmith33.csv,1547,94350597.0,501,1046,500,1,0,44.590174531351,224,58,24.100193923723335,7
Category_Wikipedia_sockpuppets_of_Smaj23.csv,567,440266989.0,184,383,169,15,0,50.65079365079365,255,51,17.49029982363316,4
Category_Wikipedia_sockpuppets_of_Ablaa_model_pantyhose.csv,5,1422.0,3,2,3,0,0,28.6,143,6,6.0,6
Category_Wikipedia_sockpuppets_of_B√∫falo_Barreto.csv,2551,190683320.0,1025,1526,500,525,0,43.018816150529204,496,60,23.61152489219914,4
Category_Wikipedia_sockpuppets_of_Kaufman1111.csv,543,26470466.0,203,340,124,79,0,59.40515653775322,244,51,20.25230202578269,3
Category_Wikipedia_sockpuppets_of_Konzara.csv,29,17402749.0,16,13,16,0,0,17.24137931034483,128,26,19.482758620689655,17
Category_Wikipedia_sockpuppets_of_MiCocx.csv,584,109323181.0,356,228,342,14,0,26.815068493150687,255,54,16.59931506849315,3
Category_Wikipedia_sockpuppets_of_Kennethttran.csv,94,149781786.0,23,71,18,5,0,66.52127659574468,208,27,16.159574468085108,3
Category_Wikipedia_sockpuppets_of_Vpha.csv,4492,118022296.0,1268,3224,500,768,0,44.855520926090826,494,59,16.44412288512912,2
Category_Wikipedia_sockpuppets_of_VivaNorthCyprus.csv,2427,32838490.0,1050,1377,116,934,0,80.88463123197363,250,72,19.08117016893284,4
Category_Wikipedia_sockpuppets_of_Davis6969.csv,51,8659387.0,25,26,17,8,0,58.78431372549019,285,56,26.176470588235293,8
Category_Wikipedia_sockpuppets_of_Past0re821.csv,14,6233463.0,7,7,1,6,0,37.785714285714285,181,22,22.0,22
Category_Wikipedia_sockpuppets_of_Vvven.csv,5459,212233387.0,1569,3890,500,1069,0,46.70672284301154,492,76,16.270196006594613,3
Category_Wikipedia_sockpuppets_of_Lalabear1234.csv,9,1878.0,9,0,5,4,0,0.0,0,17,17.0,17
Category_Wikipedia_sockpuppets_of_Miamiboyzinhere.csv,814,18116452.0,245,569,245,0,0,44.522113022113025,211,63,21.793611793611795,5
Category_Wikipedia_sockpuppets_of_Humanist_sam.csv,19,265698.0,12,7,11,1,0,27.36842105263158,130,49,44.63157894736842,20
Category_Wikipedia_sockpuppets_of_MounikaPrasad.csv,233,2207298.0,117,116,94,23,0,42.197424892703864,255,42,20.527896995708154,7
Category_Wikipedia_sockpuppets_of_Emarat_Deira.csv,57,1884437.0,25,32,19,6,0,52.35087719298246,223,25,20.771929824561404,14
Category_Wikipedia_sockpuppets_of_ChaseMcAllister247.csv,54,1559536.0,31,23,29,2,0,61.01851851851852,200,25,19.25925925925926,18
Category_Wikipedia_sockpuppets_of_Joeltmpayne.csv,502,62932424.0,362,140,325,37,0,13.743027888446216,249,46,16.711155378486055,13
Category_Wikipedia_sockpuppets_of_ChinaUpdater.csv,1298,11300172.0,465,833,398,67,0,42.71494607087828,253,60,20.057010785824346,4
Category_Wikipedia_sockpuppets_of_Cdctmom6712.csv,1126,50960987.0,344,782,111,233,0,45.19271758436945,255,71,20.293960923623445,3
Category_Wikipedia_sockpuppets_of_MCBOiS1210.csv,1957,31348447.0,713,1244,377,336,0,47.7843638221768,496,64,23.47828308635667,6
Category_Wikipedia_sockpuppets_of_–§–∞–∏–∑_–ú–∞—Ö–º—É–¥–æ–≤.csv,1296,58671300.0,398,898,49,349,0,41.698302469135804,255,35,13.972993827160494,5
Category_Wikipedia_sockpuppets_of_PieceOfMind83.csv,185,22438612.0,59,126,32,27,0,57.12432432432433,284,38,19.286486486486485,6
Category_Wikipedia_sockpuppets_of_Deballooner.csv,38,12948.0,16,22,13,3,0,74.52631578947368,255,21,10.473684210526315,7
Category_Wikipedia_sockpuppets_of_Pilipinischer.csv,200,2964036.0,72,128,38,34,0,26.605,200,48,19.55,4
Category_Wikipedia_sockpuppets_of_Annemariecarney.csv,73,68099545.0,25,48,12,13,0,60.32876712328767,235,55,19.972602739726028,9
Category_Wikipedia_sockpuppets_of_Zackyusoff78.csv,1469,67323158.0,525,944,500,25,0,37.471749489448605,499,64,21.713410483321987,5
Category_Wikipedia_sockpuppets_of_Kyleain.csv,351,24047018.0,100,251,54,46,0,43.225071225071225,199,30,14.678062678062679,10
Category_Wikipedia_sockpuppets_of_Scottdevine48.csv,670,315418155.0,134,536,97,37,0,41.082089552238806,348,38,17.413432835820895,6
Category_Wikipedia_sockpuppets_of_POOYA_Models.csv,6,2523.0,3,3,2,1,20,54.5,191,25,25.0,25
Category_Wikipedia_sockpuppets_of_Amryose16.csv,1828,9880049.0,474,1354,97,377,0,32.55908096280088,265,46,22.787199124726477,5
Category_Wikipedia_sockpuppets_of_GeraldoAbbson.csv,271,21765829.0,112,159,70,42,0,45.97047970479705,255,100,24.014760147601475,5
Category_Wikipedia_sockpuppets_of_Di1977.csv,91,132460816.0,40,51,32,8,0,46.285714285714285,224,55,22.703296703296704,11
Category_Wikipedia_sockpuppets_of_Sreenubabup.csv,21,179436792.0,5,16,4,1,0,71.71428571428571,311,53,35.61904761904762,15
Category_Wikipedia_sockpuppets_of_Gulbano86.csv,50,2934757.0,33,17,12,21,0,47.42,181,21,6.54,6
Category_Wikipedia_sockpuppets_of_Joey198032.csv,59,123596.0,18,41,10,8,0,55.13559322033898,234,26,14.728813559322035,8
Category_Wikipedia_sockpuppets_of_Helios007.csv,308,8798759.0,124,184,109,15,0,45.26298701298701,387,47,17.818181818181817,12
Category_Wikipedia_sockpuppets_of_ByAppointmentTo.csv,244,14918940.0,59,185,12,47,0,45.40163934426229,217,57,25.065573770491802,5
Category_Wikipedia_sockpuppets_of_Jacquesdurias.csv,3106,15894727.0,1072,2034,500,572,0,24.124919510624597,268,68,23.74372182871861,5
Category_Wikipedia_sockpuppets_of_Shadowwarrior8.csv,2804,104269955.0,722,2082,500,222,0,58.05028530670471,500,64,21.411554921540656,4
Category_Wikipedia_sockpuppets_of_UltraTank.MD.csv,301,3334967.0,210,91,123,87,0,30.182724252491695,222,39,20.196013289036546,4
Category_Wikipedia_sockpuppets_of_Idesz.csv,11,2622183.0,9,2,9,0,1,13.727272727272727,29,19,19.0,19
Category_Wikipedia_sockpuppets_of_Ssabdulhaq.csv,168,9325555.0,90,78,71,19,0,47.660714285714285,177,46,22.303571428571427,7
Category_Wikipedia_sockpuppets_of_Bamborig45.csv,33,1603034.0,29,4,24,5,0,65.60606060606061,197,44,44.0,44
Category_Wikipedia_sockpuppets_of_Johnnyhopkins09878.csv,15,4645067.0,8,7,7,1,0,40.0,136,28,19.933333333333334,5
Category_Wikipedia_sockpuppets_of_Big_Boss_0.csv,1445,67252705.0,509,936,500,9,0,34.89688581314879,205,70,21.561245674740483,8
Category_Wikipedia_sockpuppets_of_Carbonator.csv,689,74640059.0,202,487,176,26,0,53.86937590711176,252,48,19.4833091436865,3
Category_Wikipedia_sockpuppets_of_Dumblydore696969696.csv,75,4839718.0,24,51,4,20,0,69.50666666666666,232,34,14.066666666666666,4
Category_Wikipedia_sockpuppets_of_Yaditiva.csv,753,46140516.0,198,555,184,14,0,55.220451527224434,259,41,12.154050464807437,1
Category_Wikipedia_sockpuppets_of_ChristopherS.Tran1.csv,128,30095038.0,32,96,24,8,0,58.6640625,234,31,18.1484375,8
Category_Wikipedia_sockpuppets_of_Koushik_Shri.csv,7,201100.0,2,5,1,1,22,50.285714285714285,80,27,19.285714285714285,18
Category_Wikipedia_sockpuppets_of_ELreydeEspana.csv,1296,36400341.0,477,819,187,290,0,47.31481481481482,255,54,20.27777777777778,7
Category_Wikipedia_sockpuppets_of_K100unique.csv,101,4485576.0,62,39,54,8,0,27.396039603960396,232,25,14.326732673267326,6
Category_Wikipedia_sockpuppets_of_Nightcrawler44.csv,110,7353675.0,34,76,18,16,0,71.33636363636364,332,24,14.545454545454545,5
Category_Wikipedia_sockpuppets_of___sammy___Dawson..csv,454,19042168.0,134,320,44,90,0,57.59251101321586,283,52,22.303964757709252,9
Category_Wikipedia_sockpuppets_of_Suomi2023.csv,2324,11289422.0,848,1476,440,408,0,65.69148020654045,499,68,26.451807228915662,15
Category_Wikipedia_sockpuppets_of_Maxt.csv,1453,31784542.0,514,939,500,14,0,31.731589814177564,200,39,16.311768754301447,2
Category_Wikipedia_sockpuppets_of_Mowsseep.csv,33,130998.0,20,13,17,3,0,51.696969696969695,147,18,9.93939393939394,4
Category_Wikipedia_sockpuppets_of_79.65.6.232.csv,4,1268.0,3,1,3,0,0,14.0,43,21,18.0,17
Category_Wikipedia_sockpuppets_of_ElleBee56.csv,6,297163.0,2,4,2,0,0,28.166666666666668,124,17,13.666666666666666,12
Category_Wikipedia_sockpuppets_of_Novorack.csv,34,615681.0,16,18,12,4,0,38.85294117647059,229,36,28.147058823529413,14
Category_Wikipedia_sockpuppets_of_Elvinwashere.csv,29,7949000.0,8,21,5,3,0,52.827586206896555,231,38,17.79310344827586,11
Category_Wikipedia_sockpuppets_of_Elishakim62.csv,6,599902.0,4,2,1,3,7,95.5,191,28,21.833333333333332,18
Category_Wikipedia_sockpuppets_of_Leelostboy.csv,330,449946122.0,119,211,103,16,0,49.21818181818182,402,31,17.74848484848485,10
Category_Wikipedia_sockpuppets_of_Isha.Narain.csv,877,17244628.0,309,568,218,91,0,53.193842645381984,496,44,22.2690992018244,4
Category_Wikipedia_sockpuppets_of_Mikkimoore2.csv,82,170656.0,25,57,12,13,0,49.3780487804878,199,30,15.109756097560975,11
Category_Wikipedia_sockpuppets_of_Jm_sigal.csv,1425,23318265.0,412,1013,254,158,0,35.05684210526316,395,37,14.860350877192982,5
Category_Wikipedia_sockpuppets_of_DonDebson.csv,123,17896032.0,62,61,32,30,0,70.41463414634147,427,45,20.089430894308943,9
Category_Wikipedia_sockpuppets_of_Two_kinds_of_pork.csv,3908,185131361.0,1000,2908,500,500,0,59.23004094165814,306,105,24.95675537359263,4
Category_Wikipedia_sockpuppets_of_WebsterThailand.csv,90,201746035.0,39,51,30,9,0,64.9,250,33,27.555555555555557,25
Category_Wikipedia_sockpuppets_of_Zaid_sultan.csv,697,25759161.0,330,367,301,29,0,40.38880918220947,448,81,29.522238163558107,11
Category_Wikipedia_sockpuppets_of_Moseron.csv,86,3017995.0,39,47,39,0,0,51.48837209302326,239,27,13.976744186046512,7
Category_Wikipedia_sockpuppets_of_Slotslover.csv,17,131871062.0,8,9,6,2,0,59.588235294117645,201,23,9.882352941176471,6
Category_Wikipedia_sockpuppets_of_JonDeyan.csv,27,11118.0,14,13,12,2,0,64.62962962962963,220,21,17.74074074074074,16
Category_Wikipedia_sockpuppets_of_DantheWikipedian.csv,1376,15060316.0,593,783,371,222,0,54.909156976744185,490,65,26.155523255813954,10
Category_Wikipedia_sockpuppets_of_Syed_Shial.csv,228,81690171.0,85,143,51,34,0,37.01315789473684,220,53,18.04385964912281,6
Category_Wikipedia_sockpuppets_of_Orlabenson.csv,25,1885223.0,18,7,11,7,0,51.24,196,21,21.0,21
Category_Wikipedia_sockpuppets_of_Titus_Odiase.csv,392,119849645.0,153,239,133,20,0,52.32142857142857,496,67,20.78061224489796,7
Category_Wikipedia_sockpuppets_of_Devinks.csv,178,107824802.0,85,93,31,54,0,40.45505617977528,221,48,23.702247191011235,11
Category_Wikipedia_sockpuppets_of_Flexmaster420.csv,7,3910213.0,6,1,5,1,15,84.57142857142857,110,23,22.142857142857142,17
Category_Wikipedia_sockpuppets_of_User2244.csv,460,25677586.0,121,339,106,15,0,46.56086956521739,267,43,17.506521739130434,5
Category_Wikipedia_sockpuppets_of_Hawyeye_lonestaro1.csv,12,3823483.0,10,2,2,8,0,17.083333333333332,32,78,30.166666666666668,14
Category_Wikipedia_sockpuppets_of_Ajit9899.csv,23,3075149.0,9,14,8,1,0,34.78260869565217,145,44,24.304347826086957,10
Category_Wikipedia_sockpuppets_of_Wikilog007.csv,123,38964330.0,42,81,21,21,0,39.78048780487805,394,48,22.739837398373982,7
Category_Wikipedia_sockpuppets_of_Supertube12.csv,86,2089195.0,54,32,31,23,0,47.73255813953488,187,40,15.616279069767442,7
Category_Wikipedia_sockpuppets_of_Nabinluhagun.csv,1302,37993718.0,372,930,133,239,0,45.675115207373274,494,92,18.016129032258064,4
Category_Wikipedia_sockpuppets_of_Toryblue.csv,294,58230053.0,90,204,71,19,0,43.48639455782313,186,27,15.92517006802721,8
Category_Wikipedia_sockpuppets_of_AdilBaguirov.csv,729,326138521.0,194,535,112,82,0,52.55829903978052,241,47,21.233196159122084,4
Category_Wikipedia_sockpuppets_of_DisneyLover41.csv,409,856914.0,124,285,119,5,0,39.4718826405868,222,43,19.721271393643033,9
Category_Wikipedia_sockpuppets_of_Plenoempleo.csv,492,50737283.0,185,307,61,124,0,41.0020325203252,255,47,16.619918699186993,3
Category_Wikipedia_sockpuppets_of_Binbin0111.csv,701,17605281.0,289,412,271,18,0,40.169757489301,255,46,22.63195435092725,6
Category_Wikipedia_sockpuppets_of_MagellanAquarium.csv,691,13550305.0,320,371,237,83,0,43.75108538350217,496,52,21.675832127351665,4
Category_Wikipedia_sockpuppets_of_royer2356.csv,42,195938824.0,13,29,11,2,0,58.80952380952381,224,30,16.642857142857142,6
Category_Wikipedia_sockpuppets_of_HughEverPulsatingBrainThatRulesFromTheCentreOfTheUltraworld.csv,2362,63523752.0,582,1780,327,255,0,50.51354784081287,485,84,19.88865368331922,4
Category_Wikipedia_sockpuppets_of_Ggtoytalk.csv,114,1156179.0,45,69,17,28,0,58.64912280701754,290,52,17.280701754385966,7
Category_Wikipedia_sockpuppets_of_Fyodor7.csv,1778,15547936.0,634,1144,500,134,0,41.00224971878515,240,54,22.667041619797526,6
Category_Wikipedia_sockpuppets_of_Wikzilla.csv,1318,22275996.0,470,848,383,87,0,54.01138088012139,250,52,22.344461305007588,6
Category_Wikipedia_sockpuppets_of_Cibbba.csv,49,4169938.0,20,29,14,6,0,33.95918367346939,182,54,40.3469387755102,20
Category_Wikipedia_sockpuppets_of_Naucatcone.csv,1640,123922516.0,470,1170,451,19,0,51.52256097560976,403,43,13.934146341463414,4
Category_Wikipedia_sockpuppets_of_Gawkshave.csv,74,763935.0,25,49,7,18,0,47.67567567567568,239,24,14.945945945945946,10
Category_Wikipedia_sockpuppets_of_Arthur_Schaper.csv,41,51592668.0,18,23,17,1,0,138.0,504,24,16.0,14
Category_Wikipedia_sockpuppets_of_Wcpw.csv,33,2621279.0,13,20,11,2,0,32.42424242424242,124,41,14.212121212121213,10
Category_Wikipedia_sockpuppets_of_Ahmed_Aamil.csv,19,2295024.0,7,12,5,2,0,39.10526315789474,242,21,19.36842105263158,15
Category_Wikipedia_sockpuppets_of_Maser_Fletcher.csv,2350,8238022.0,672,1678,500,172,0,45.84297872340426,210,55,23.94468085106383,3
Category_Wikipedia_sockpuppets_of_The_Art_Cafe.csv,3,3683.0,3,0,2,1,29,97.33333333333333,199,22,22.0,22
Category_Wikipedia_sockpuppets_of_Honestbee.csv,19,79742.0,11,8,6,5,0,27.789473684210527,152,21,12.157894736842104,9
Category_Wikipedia_sockpuppets_of_TorontoMapleLeafsFan.csv,349,1467202.0,102,247,65,37,0,70.89684813753581,391,49,20.346704871060172,7
Category_Wikipedia_sockpuppets_of_Mirzefilankes.csv,31,2312419.0,17,14,9,8,0,32.58064516129032,196,51,35.12903225806452,18
Category_Wikipedia_sockpuppets_of_Nillsson.csv,231,56523718.0,74,157,35,39,0,52.16450216450217,697,44,19.58008658008658,6
Category_Wikipedia_sockpuppets_of_FifthHouseGuy.csv,545,70278688.0,228,317,212,16,0,43.7394495412844,276,53,17.172477064220182,7
Category_Wikipedia_sockpuppets_of_Pictureperfect2.csv,4403,43567146.0,1119,3284,500,619,0,45.72564160799455,500,65,15.938223938223938,3
Category_Wikipedia_sockpuppets_of_750editsstrong.csv,889,8435612.0,270,619,108,162,0,61.86726659167604,255,95,24.698537682789652,7
Category_Wikipedia_sockpuppets_of_Ohsunnysgod.csv,21,1259.0,12,9,12,0,0,28.571428571428573,186,19,16.952380952380953,13
Category_Wikipedia_sockpuppets_of_Miopl.csv,171,246578.0,68,103,10,58,0,39.70175438596491,192,41,18.900584795321638,4
Category_Wikipedia_sockpuppets_of_Mridusinha.csv,359,294408968.0,113,246,80,33,0,40.80222841225627,199,50,22.050139275766018,6
Category_Wikipedia_sockpuppets_of_Imgoodatall.csv,55,179961.0,33,22,18,15,0,24.09090909090909,185,14,12.254545454545454,9
Category_Wikipedia_sockpuppets_of_Hermanator1.csv,237,12185551.0,88,149,74,14,0,49.14767932489451,250,87,35.76371308016878,9
Category_Wikipedia_sockpuppets_of_1968_camaro_ss.csv,23,2608.0,7,16,7,0,0,66.47826086956522,193,18,13.782608695652174,12
Category_Wikipedia_sockpuppets_of_Armanvino.csv,19,3446887.0,14,5,6,8,0,37.8421052631579,110,21,18.736842105263158,14
Category_Wikipedia_sockpuppets_of_ReportersWithoutBordersJournalist.csv,118,46314348.0,43,75,28,15,0,61.30508474576271,255,34,18.177966101694917,12
Category_Wikipedia_sockpuppets_of_Great_Khaan.csv,380,772222.0,150,230,140,10,0,46.15263157894737,288,47,34.6,16
Category_Wikipedia_sockpuppets_of_ColdIceFreak.csv,270,19283584.0,97,173,91,6,0,51.93333333333333,255,32,15.62962962962963,5
Category_Wikipedia_sockpuppets_of_Nickyerkes.csv,1,0.0,1,0,1,0,196,196.0,196,28,28.0,28
Category_Wikipedia_sockpuppets_of_TyneGRPR.csv,11,8453393.0,5,6,4,1,0,16.0,30,26,21.636363636363637,10
Category_Wikipedia_sockpuppets_of_Northern_Innovator.csv,5,29222378.0,3,2,3,0,20,58.0,87,30,27.2,23
Category_Wikipedia_sockpuppets_of_Whoopi's_Ghost.csv,8,24450.0,5,3,4,1,13,45.375,136,27,27.0,27
Category_Wikipedia_sockpuppets_of_Sabujeinstein.csv,185,74421432.0,46,139,45,1,0,60.30810810810811,255,60,25.410810810810812,13
Category_Wikipedia_sockpuppets_of_Ge√≥grafo23.csv,16,326408192.0,7,9,6,1,0,81.9375,493,29,18.4375,9
Category_Wikipedia_sockpuppets_of_Harambe345.csv,24,21619.0,18,6,16,2,0,32.583333333333336,170,25,19.25,18
Category_Wikipedia_sockpuppets_of_AHM22.csv,376,7647432.0,208,168,120,88,0,44.79255319148936,255,37,14.539893617021276,7
Category_Wikipedia_sockpuppets_of_Uetz.csv,148,20294908.0,40,108,38,2,0,32.189189189189186,213,38,24.37162162162162,14
Category_Wikipedia_sockpuppets_of_Jay_Bestille.csv,315,6217247.0,103,212,100,3,0,61.86349206349206,294,45,18.358730158730157,9
Category_Wikipedia_sockpuppets_of_Keyser_S√∂zetigho.csv,503,504427.0,270,233,141,129,0,46.09940357852883,248,50,20.526838966202785,5
Category_Wikipedia_sockpuppets_of_FlabberghastedFlimbong.csv,29,12538234.0,7,22,6,1,0,68.96551724137932,251,32,12.758620689655173,6
Category_Wikipedia_sockpuppets_of_GardenSun.csv,20,347504.0,10,10,5,5,0,95.4,254,26,21.25,15
Category_Wikipedia_sockpuppets_of_Endcuts.csv,107,440774.0,93,14,59,34,0,19.523364485981308,194,25,16.654205607476637,7
Category_Wikipedia_sockpuppets_of_Nutana_Mohan.csv,5,2640.0,3,2,3,0,0,84.0,196,25,25.0,25
Category_Wikipedia_sockpuppets_of_Zixuan75.csv,524,2187117.0,192,332,171,21,0,49.25763358778626,238,57,22.72328244274809,4
Category_Wikipedia_sockpuppets_of_Wickkki.csv,49,1989417.0,33,16,31,2,0,68.65306122448979,201,45,26.591836734693878,12
Category_Wikipedia_sockpuppets_of_ÿ£ÿ≠ŸÖÿØ_ŸÖÿ≠ÿ®Ÿàÿ®.csv,86,18360830.0,31,55,16,15,0,74.38372093023256,407,31,11.5,6
Category_Wikipedia_sockpuppets_of_Dalie747.csv,6,1783.0,6,0,6,0,0,10.0,12,6,6.0,6
Category_Wikipedia_sockpuppets_of_Sinclairindex.csv,1344,147584115.0,469,875,351,118,0,47.595982142857146,255,66,18.055059523809526,3
Category_Wikipedia_sockpuppets_of_Ccdude93.csv,67,21589966.0,20,47,19,1,0,43.26865671641791,231,18,13.895522388059701,10
Category_Wikipedia_sockpuppets_of_AL2TB.csv,3895,22634260.0,1541,2354,500,1041,0,40.06777920410783,255,78,24.34865211810013,4
Category_Wikipedia_sockpuppets_of_Alicewond.csv,126,1053267.0,33,93,10,23,0,56.11904761904762,238,43,17.61111111111111,3
Category_Wikipedia_sockpuppets_of_Hoseinrahmanimaneshh.csv,138,63393356.0,47,91,38,9,0,63.13768115942029,496,48,20.652173913043477,8
Category_Wikipedia_sockpuppets_of_Carpatho.csv,1635,9043813.0,719,916,500,219,0,57.07033639143731,494,49,20.29663608562691,8
Category_Wikipedia_sockpuppets_of_Amolshinde143.csv,131,21539254.0,28,103,13,15,0,53.458015267175576,239,53,27.38167938931298,7
Category_Wikipedia_sockpuppets_of_Timrazzall.csv,25,13481842.0,10,15,7,3,0,45.6,190,54,39.52,17
Category_Wikipedia_sockpuppets_of_Major_M_Myanmar_Music_Awards.csv,70,6825439.0,35,35,30,5,0,31.057142857142857,164,38,16.9,12
Category_Wikipedia_sockpuppets_of_Cotton_Rogers.csv,594,3287546.0,259,335,250,9,0,56.60942760942761,250,56,27.116161616161616,9
Category_Wikipedia_sockpuppets_of_Iraqi_man10.csv,3819,26171901.0,1353,2466,500,853,0,44.28567687876407,255,71,21.388845247446977,3
Category_Wikipedia_sockpuppets_of_Bobmack89x.csv,2113,13627710.0,565,1548,500,65,0,41.97633696166588,225,69,18.55229531471841,3
Category_Wikipedia_sockpuppets_of_Zwerrifringweraand.csv,245,1560007.0,77,168,46,31,0,36.97142857142857,199,48,18.726530612244897,8
Category_Wikipedia_sockpuppets_of_Sproat.csv,33,384680.0,17,16,15,2,0,37.90909090909091,173,24,19.454545454545453,16
Category_Wikipedia_sockpuppets_of_Canepole.csv,50,1123136.0,42,8,15,27,0,34.12,202,10,10.0,10
Category_Wikipedia_sockpuppets_of_Vinodhchennu.csv,312,73103712.0,106,206,78,28,0,48.90384615384615,255,68,26.55448717948718,8
Category_Wikipedia_sockpuppets_of_WAREL.csv,995,22457785.0,347,648,326,21,0,27.933668341708543,224,59,17.190954773869347,3
Category_Wikipedia_sockpuppets_of_Crashingthewaves.csv,882,21902506.0,294,588,52,242,0,38.925170068027214,255,91,22.860544217687075,10
Category_Wikipedia_sockpuppets_of_Kaytoepotato.csv,27,3165.0,9,18,6,3,0,37.18518518518518,193,13,13.0,13
Category_Wikipedia_sockpuppets_of_Rachael_murray.csv,323,4971605.0,140,183,94,46,0,42.17956656346749,255,61,24.48297213622291,11
Category_Wikipedia_sockpuppets_of_Queen_Padm√©_Amidala.csv,788,73509206.0,253,535,109,144,0,50.68908629441624,250,51,22.810913705583758,6
Category_Wikipedia_sockpuppets_of_Naqash3000.csv,628,178125567.0,246,382,131,115,0,49.802547770700635,349,44,21.54140127388535,6
Category_Wikipedia_sockpuppets_of_Danrz.csv,2264,106633418.0,722,1542,394,328,0,51.53621908127209,233,58,21.75132508833922,3
Category_Wikipedia_sockpuppets_of_Professorblunt.csv,230,167170962.0,67,163,36,31,0,34.708695652173915,236,41,18.234782608695653,5
Category_Wikipedia_sockpuppets_of_Petergriffin9901.csv,3914,470933325.0,1044,2870,500,544,0,53.018140010219724,445,76,25.078691875319365,5
Category_Wikipedia_sockpuppets_of_Josh_Graze.csv,440,9421718.0,119,321,94,25,0,42.972727272727276,301,47,14.593181818181819,3
Category_Wikipedia_sockpuppets_of_Sonia_Murillo_Perales.csv,2842,45051390.0,1006,1836,500,506,0,39.26002814919071,247,53,15.168543279380717,3
Category_Wikipedia_sockpuppets_of_Notablepeopleandplaces.csv,49,1563121.0,20,29,14,6,0,39.12244897959184,162,49,23.959183673469386,6
Category_Wikipedia_sockpuppets_of_XARyz.csv,1407,16362654.0,639,768,500,139,0,29.20540156361052,480,60,17.580668088130775,5
Category_Wikipedia_sockpuppets_of_FalunGongDisciple.csv,162,2605031.0,63,99,33,30,0,45.79012345679013,199,43,21.160493827160494,5
Category_Wikipedia_sockpuppets_of_Barryispuzzled.csv,2813,124498745.0,1019,1794,500,519,0,45.5037326697476,255,64,28.685033771773906,7
Category_Wikipedia_sockpuppets_of_Kevinwoverstreet.csv,141,48961313.0,61,80,32,29,0,41.94326241134752,238,41,21.347517730496453,11
Category_Wikipedia_sockpuppets_of_Bhushanbush82.csv,204,17262473.0,74,130,45,29,0,62.61274509803921,248,24,9.03921568627451,6
Category_Wikipedia_sockpuppets_of_Davidlawjones.csv,24,2761490.0,12,12,10,2,0,49.166666666666664,196,26,18.666666666666668,3
Category_Wikipedia_sockpuppets_of_Flags33.csv,2012,312567948.0,626,1386,500,126,0,46.57007952286283,450,54,20.250497017892645,6
Category_Wikipedia_sockpuppets_of_Vote_(X)_for_Change.csv,211,212809528.0,97,114,35,62,0,48.170616113744074,253,55,21.796208530805686,4
Category_Wikipedia_sockpuppets_of_SeattliteTungsten.csv,1454,281142856.0,545,909,428,117,0,54.98074277854195,253,65,26.05777166437414,4
Category_Wikipedia_sockpuppets_of_Sixstring1965.csv,2367,10896372.0,840,1527,500,340,0,34.13392479932404,222,48,17.40388677651035,6
Category_Wikipedia_sockpuppets_of_Manzarene.csv,1,0.0,1,0,1,0,20,20.0,20,8,8.0,8
Category_Wikipedia_sockpuppets_of_Osmancancancan.csv,49,2674496.0,18,31,18,0,0,32.48979591836735,199,44,20.6734693877551,10
Category_Wikipedia_sockpuppets_of_Sidetosice.csv,2311,24401734.0,791,1520,500,291,0,40.32540025962787,490,78,19.88446559930766,3
Category_Wikipedia_sockpuppets_of_Vencen1.csv,29,692663.0,12,17,8,4,0,62.96551724137931,253,38,24.482758620689655,10
Category_Wikipedia_sockpuppets_of_Mil403.csv,70,15720394.0,14,56,14,0,0,50.58571428571429,199,16,14.085714285714285,9
Category_Wikipedia_sockpuppets_of_Md.labibsikder.csv,16,30967933.0,11,5,8,3,0,24.4375,86,24,15.9375,11
Category_Wikipedia_sockpuppets_of_MarshallBagramyan.csv,3134,481148438.0,830,2304,500,330,0,53.50989151244416,471,69,18.847798340778557,3
Category_Wikipedia_sockpuppets_of_Bienthegenius.csv,26,1991132.0,13,13,13,0,0,38.34615384615385,221,61,15.923076923076923,12
Category_Wikipedia_sockpuppets_of_Gezza.csv,49,6218110.0,31,18,20,11,0,36.42857142857143,119,16,11.938775510204081,11
Category_Wikipedia_sockpuppets_of_Woshiyiweizhongguoren.csv,4074,120304796.0,1362,2712,500,862,0,60.11610211094747,393,71,24.6453117329406,1
Category_Wikipedia_sockpuppets_of_Z812483032.csv,177,20147856.0,54,123,26,28,0,58.12429378531073,496,122,19.89265536723164,6
Category_Wikipedia_sockpuppets_of_Karkanistan.csv,149,194741734.0,53,96,26,27,0,44.23489932885906,345,53,22.42953020134228,10
Category_Wikipedia_sockpuppets_of_Be_sunf.csv,166,39600687.0,150,16,149,1,0,19.46385542168675,88,20,16.92168674698795,12
Category_Wikipedia_sockpuppets_of_Mondayissuperfunnyonpieyouknow.csv,1,0.0,1,0,1,0,73,73.0,73,30,30.0,30
Category_Wikipedia_sockpuppets_of_Nicknameforgiven.csv,152,1581080.0,86,66,61,25,0,56.63815789473684,342,31,25.80263157894737,7
Category_Wikipedia_sockpuppets_of_Salma_Abdallah_of_Somalia.csv,145,3890832.0,45,100,35,10,0,60.855172413793106,433,70,38.296551724137935,8
Category_Wikipedia_sockpuppets_of_Davidkaron003.csv,83,5109647.0,27,56,17,10,0,53.48192771084337,396,46,16.746987951807228,8
Category_Wikipedia_sockpuppets_of_GM765349.csv,351,12183850.0,125,226,26,99,0,69.41310541310541,222,27,17.512820512820515,9
Category_Wikipedia_sockpuppets_of_IamJoarSabatePH.csv,18,3237967.0,4,14,2,2,0,50.44444444444444,151,53,25.055555555555557,12
Category_Wikipedia_sockpuppets_of_Patrick_F._Matre.csv,113,25399972.0,36,77,30,6,0,53.32743362831859,221,53,31.761061946902654,11
Category_Wikipedia_sockpuppets_of_Andriyrussu.csv,4145,17617190.0,1609,2536,500,1109,0,40.06200241254523,500,99,18.70180940892642,5
Category_Wikipedia_sockpuppets_of_Mooneyjc.csv,307,326696459.0,77,230,56,21,0,56.192182410423456,251,70,28.65798045602606,5
Category_Wikipedia_sockpuppets_of_Joe_Circus.csv,734,56066009.0,238,496,47,191,0,62.12534059945504,255,56,18.264305177111716,6
Category_Wikipedia_sockpuppets_of_Afifamaryam.csv,13,2672934.0,5,8,4,1,20,77.92307692307692,188,25,23.923076923076923,23
Category_Wikipedia_sockpuppets_of_DBrown_SPS.csv,2404,217017552.0,678,1726,500,178,0,51.04908485856905,496,87,18.898086522462563,3
Category_Wikipedia_sockpuppets_of_Uasad4372.csv,42,3198479.0,18,24,15,3,0,74.83333333333333,283,28,22.952380952380953,16
Category_Wikipedia_sockpuppets_of_Ansar_techy.csv,15,22999714.0,14,1,10,4,0,42.46666666666667,331,25,22.066666666666666,21
Category_Wikipedia_sockpuppets_of_Candumb.csv,8,111145.0,7,1,6,1,0,27.125,134,18,16.125,15
Category_Wikipedia_sockpuppets_of_Gareth_Beyers.csv,95,5366248.0,33,62,28,5,0,59.17894736842105,496,53,27.221052631578946,6
Category_Wikipedia_sockpuppets_of_Reianasmiley.csv,170,40275473.0,54,116,33,21,0,43.87647058823529,208,34,14.782352941176471,9
Category_Wikipedia_sockpuppets_of_KlementyNagorny.csv,711,33509687.0,239,472,233,6,0,45.76371308016878,232,78,22.639943741209564,5
Category_Wikipedia_sockpuppets_of_TZLNCTV.csv,2017,271997946.0,840,1177,500,340,0,47.169558750619736,497,87,23.32523549826475,2
Category_Wikipedia_sockpuppets_of_Spqlh.csv,625,52968555.0,151,474,73,78,0,52.728,248,50,11.88,3
Category_Wikipedia_sockpuppets_of_Legacy2015.csv,47,8836533.0,13,34,7,6,0,45.08510638297872,154,20,16.361702127659573,14
Category_Wikipedia_sockpuppets_of_AfghanBios.csv,122,4512762.0,47,75,19,28,0,38.631147540983605,188,43,19.237704918032787,6
Category_Wikipedia_sockpuppets_of_Chumehelepola.csv,12,23686372.0,5,7,5,0,0,41.916666666666664,131,18,13.75,11
Category_Wikipedia_sockpuppets_of_Young_Mahasi.csv,65,68591464.0,24,41,8,16,0,42.52307692307692,230,24,14.323076923076924,5
Category_Wikipedia_sockpuppets_of_GhaintGeet.csv,18,823146.0,10,8,10,0,0,38.333333333333336,162,43,15.333333333333334,10
Category_Wikipedia_sockpuppets_of_Cupcake547.csv,2547,2947711.0,697,1850,500,197,0,59.50922654102866,358,69,20.523360816647035,1
Category_Wikipedia_sockpuppets_of_Crazybob2014.csv,3876,211524288.0,1224,2652,500,724,0,43.98065015479876,496,76,21.57688338493292,4
Category_Wikipedia_sockpuppets_of_Vikas.insan.csv,320,18940326.0,166,154,137,29,0,80.5375,255,50,25.66875,13
Category_Wikipedia_sockpuppets_of_TLCAUS.csv,18,409700.0,10,8,4,6,0,52.94444444444444,272,27,19.61111111111111,13
Category_Wikipedia_sockpuppets_of_TheEdgarBox.csv,1234,52884992.0,472,762,190,282,0,51.74473257698541,496,51,20.955429497568883,7
Category_Wikipedia_sockpuppets_of_Tantan1212.csv,449,67806251.0,150,299,132,18,0,44.51893095768374,437,46,25.40534521158129,6
Category_Wikipedia_sockpuppets_of_Freddy_Cat.csv,10,349.0,5,5,5,0,0,42.9,123,24,21.8,15
Category_Wikipedia_sockpuppets_of_Thmc1.csv,1831,7749053.0,531,1300,500,31,0,45.05406881485527,250,88,16.729109776078644,5
Category_Wikipedia_sockpuppets_of_Eastbayway.csv,1387,53282982.0,364,1023,267,97,0,44.542898341744774,255,69,16.21268925739005,4
Category_Wikipedia_sockpuppets_of_Gameboy6567.csv,63,56077903.0,22,41,19,3,0,47.476190476190474,209,31,17.682539682539684,7
Category_Wikipedia_sockpuppets_of_Doggyman512.csv,48,73348.0,18,30,12,6,0,49.75,196,38,22.9375,11
Category_Wikipedia_sockpuppets_of_Hhood.csv,1,0.0,1,0,1,0,46,46.0,46,15,15.0,15
Category_Wikipedia_sockpuppets_of_Arkellproductions.csv,4,227.0,3,1,3,0,0,46.5,127,44,36.5,29
Category_Wikipedia_sockpuppets_of_Abu_Tayab_Moin.csv,5,311993.0,4,1,3,1,47,139.4,470,36,24.4,15
Category_Wikipedia_sockpuppets_of_Patrick_Matre.csv,113,25399972.0,36,77,30,6,0,49.283185840707965,255,53,30.353982300884955,11
Category_Wikipedia_sockpuppets_of_PShandAllfrey.csv,169,78023845.0,85,84,23,62,0,43.98224852071006,255,29,22.775147928994084,17
Category_Wikipedia_sockpuppets_of_Mohid_Irtiza.csv,754,15886165.0,273,481,247,26,0,32.02254641909814,246,42,17.659151193633953,8
Category_Wikipedia_sockpuppets_of_Brancrandran.csv,2612,4878290.0,757,1855,500,257,0,61.52794793261868,414,49,15.325803981623277,5
Category_Wikipedia_sockpuppets_of_WikiPHemant.csv,72,21168813.0,20,52,16,4,0,54.208333333333336,223,37,23.180555555555557,15
Category_Wikipedia_sockpuppets_of_Jontyjoesph.csv,104,79850.0,68,36,63,5,0,56.07692307692308,209,32,16.451923076923077,7
Category_Wikipedia_sockpuppets_of_Profesionalpretzels.csv,48,1341.0,14,34,6,8,0,90.625,244,19,8.583333333333334,4
Category_Wikipedia_sockpuppets_of_Tajsevelle.csv,80,42526241.0,38,42,32,6,0,43.7125,206,20,13.7375,12
Category_Wikipedia_sockpuppets_of_Arius1996.csv,97,384067.0,64,33,61,3,0,27.77319587628866,199,42,18.8659793814433,12
Category_Wikipedia_sockpuppets_of_Patrik_stur.csv,29,4304475.0,13,16,9,4,5,54.62068965517241,196,47,36.89655172413793,21
Category_Wikipedia_sockpuppets_of_Slaine1.csv,3,404.0,3,0,3,0,0,0.0,0,14,14.0,14
Category_Wikipedia_sockpuppets_of_Ecoggi.csv,65,73001981.0,22,43,13,9,0,57.09230769230769,394,30,14.4,4
Category_Wikipedia_sockpuppets_of_U82a2xivi.csv,67,419938.0,34,33,25,9,0,51.46268656716418,186,51,26.01492537313433,9
Category_Wikipedia_sockpuppets_of_Nakita_Kelley.csv,2269,62679234.0,763,1506,500,263,0,46.41648303217276,508,86,19.91846628470692,3
Category_Wikipedia_sockpuppets_of_DefineDream.csv,209,2912167.0,61,148,42,19,0,52.717703349282296,427,45,22.076555023923444,12
Category_Wikipedia_sockpuppets_of_Ayushsrivastava0.csv,6,23249695.0,2,4,1,1,0,64.5,172,21,18.0,15
Category_Wikipedia_sockpuppets_of_NinjaRya.csv,395,18577849.0,131,264,78,53,0,48.06582278481012,251,64,23.569620253164558,7
Category_Wikipedia_sockpuppets_of_Bbabli69.csv,3,1622.0,3,0,2,1,24,41.0,50,18,18.0,18
Category_Wikipedia_sockpuppets_of_Meredith_McCasley.csv,14,415322.0,6,8,2,4,0,41.5,148,28,20.642857142857142,16
Category_Wikipedia_sockpuppets_of_Worldatlas1989.csv,478,3632827.0,166,312,84,82,0,38.78451882845188,215,54,21.615062761506277,4
Category_Wikipedia_sockpuppets_of_EVC_Librarians.csv,8,681228.0,6,2,4,2,9,22.25,67,24,24.0,24
Category_Wikipedia_sockpuppets_of_Flosswax.csv,190,31789570.0,50,140,50,0,0,68.78421052631579,200,25,12.884210526315789,5
Category_Wikipedia_sockpuppets_of_Suzan_mutesi.csv,34,25127.0,22,12,22,0,0,25.470588235294116,196,35,28.88235294117647,27
Category_Wikipedia_sockpuppets_of_Hapanyc.csv,286,210473551.0,90,196,60,30,0,52.56293706293706,254,50,15.611888111888112,6
Category_Wikipedia_sockpuppets_of_Tanveer_Alam.csv,597,214139255.0,225,372,106,119,0,44.41876046901172,255,54,15.336683417085426,4
Category_Wikipedia_sockpuppets_of_Helpthepeople9.csv,1332,22634244.0,405,927,347,58,0,59.997747747747745,500,68,20.54054054054054,5
Category_Wikipedia_sockpuppets_of_Nareklm.csv,22,534.0,10,12,10,0,0,55.22727272727273,184,37,23.545454545454547,6
Category_Wikipedia_sockpuppets_of_Data2021.csv,62,3715803.0,23,39,13,10,0,76.03225806451613,248,26,14.5,6
Category_Wikipedia_sockpuppets_of_Moovzon.csv,65,1272210.0,23,42,12,11,0,54.66153846153846,188,66,21.26153846153846,12
Category_Wikipedia_sockpuppets_of_Eagle4126.csv,1,0.0,1,0,1,0,0,0.0,0,19,19.0,19
Category_Wikipedia_sockpuppets_of_Jeremytoribio79.csv,152,19435051.0,111,41,50,61,0,29.263157894736842,254,33,30.875,16
Category_Wikipedia_sockpuppets_of_DMRRT.csv,318,43464528.0,114,204,104,10,0,36.83018867924528,238,54,21.0125786163522,4
Category_Wikipedia_sockpuppets_of_Luispw.csv,3,13066.0,2,1,1,1,0,98.33333333333333,192,10,10.0,10
Category_Wikipedia_sockpuppets_of_Gylatshalit.csv,1938,8976038.0,820,1118,500,320,0,42.19762641898865,255,56,28.976780185758514,5
Category_Wikipedia_sockpuppets_of_AutoWeekAM.csv,19,70820133.0,8,11,5,3,0,27.263157894736842,179,8,8.0,8
Category_Wikipedia_sockpuppets_of_19disneyland55.csv,190,42327361.0,67,123,60,7,0,60.5,255,68,19.373684210526317,9
Category_Wikipedia_sockpuppets_of_Dr.SunBD.csv,1680,71730908.0,531,1149,376,155,0,54.03392857142857,495,64,15.475595238095238,3
Category_Wikipedia_sockpuppets_of_Iwikihelper.csv,49,169828.0,25,24,19,6,0,31.6734693877551,192,43,20.408163265306122,10
Category_Wikipedia_sockpuppets_of_Childof12AM.csv,10,47604.0,4,6,4,0,0,23.3,44,25,12.5,4
Category_Wikipedia_sockpuppets_of_Rgalo10.csv,3346,217419114.0,1158,2188,500,658,0,45.215780035863716,496,66,24.419904363419008,3
Category_Wikipedia_sockpuppets_of_Viraj_Alom.csv,477,30784129.0,167,310,68,99,0,55.886792452830186,453,43,21.257861635220127,6
Category_Wikipedia_sockpuppets_of_WorldTop20.csv,25,29847015.0,9,16,9,0,12,57.92,211,96,58.2,23
Category_Wikipedia_sockpuppets_of_Swmkhwrbaro0.csv,7,18281.0,5,2,5,0,0,33.714285714285715,182,15,11.142857142857142,10
Category_Wikipedia_sockpuppets_of_Zhand38.csv,1301,9041562.0,738,563,500,238,0,36.51191391237509,242,47,25.248270561106843,7
Category_Wikipedia_sockpuppets_of_WikiedPedia.csv,31,178484.0,13,18,7,6,0,39.03225806451613,208,42,24.677419354838708,4
Category_Wikipedia_sockpuppets_of_ManjilasDoublehorse.csv,2,1553.0,2,0,2,0,18,18.0,18,29,29.0,29
Category_Wikipedia_sockpuppets_of_Micov.csv,1844,88643362.0,539,1305,500,39,0,35.76681127982646,260,53,16.36984815618221,2
Category_Wikipedia_sockpuppets_of_Johnnystorm456.csv,45,2494465.0,26,19,6,20,0,37.82222222222222,194,21,14.8,7
Category_Wikipedia_sockpuppets_of_Nooijoijjk;m.csv,25,285353.0,11,14,3,8,0,78.44,190,57,20.8,5
Category_Wikipedia_sockpuppets_of_Bnm10.csv,36,23869.0,14,22,13,1,0,63.0,172,13,11.527777777777779,6
Category_Wikipedia_sockpuppets_of_SCVNDL.csv,1,0.0,1,0,1,0,0,0.0,0,14,14.0,14
Category_Wikipedia_sockpuppets_of_Ghost109.csv,1298,22288065.0,316,982,312,4,0,29.678736517719567,219,55,18.646379044684128,1
Category_Wikipedia_sockpuppets_of_RaymannRayy.csv,3,56143.0,3,0,3,0,0,146.33333333333334,369,16,16.0,16
Category_Wikipedia_sockpuppets_of_Aat3cr.csv,30,6336074.0,20,10,17,3,0,66.36666666666666,219,19,18.6,16
Category_Wikipedia_sockpuppets_of_Gandoler_(Gandola).csv,81,11291458.0,37,44,12,25,0,41.407407407407405,214,36,16.85185185185185,9
Category_Wikipedia_sockpuppets_of_RichieAaaaaa.csv,143,2982120.0,55,88,45,10,0,48.70629370629371,226,65,32.49650349650349,15
Category_Wikipedia_sockpuppets_of_Ideabeach.csv,387,9891895.0,188,199,187,1,0,69.81912144702842,255,39,23.56847545219638,9
Category_Wikipedia_sockpuppets_of_Blackhawksfan1445.csv,2368,33349259.0,808,1560,500,308,0,57.15076013513514,376,49,20.24831081081081,5
Category_Wikipedia_sockpuppets_of_Indopaedia.csv,365,7585980.0,121,244,109,12,0,49.726027397260275,376,31,15.26849315068493,6
Category_Wikipedia_sockpuppets_of_Donny_Pearson.csv,288,150466.0,99,189,67,32,0,49.72222222222222,199,40,19.90625,13
Category_Wikipedia_sockpuppets_of_Andouille_Queen.csv,128,355202521.0,26,102,15,11,0,52.265625,257,47,17.171875,9
Category_Wikipedia_sockpuppets_of_Ikshvaku912.csv,215,10466795.0,60,155,45,15,0,69.57209302325582,470,56,19.32093023255814,5
Category_Wikipedia_sockpuppets_of_Bmjc98.csv,1366,27054781.0,510,856,417,93,0,50.120058565153734,500,60,16.780380673499266,3
Category_Wikipedia_sockpuppets_of_Toni_is_here.csv,821,63535820.0,263,558,251,12,0,29.952496954933007,200,45,21.84165651644336,4
Category_Wikipedia_sockpuppets_of_94seulgi.csv,32,174358.0,25,7,21,4,0,45.4375,210,8,8.0,8
Category_Wikipedia_sockpuppets_of_Poundlane36.csv,79,36049193.0,25,54,12,13,0,47.77215189873418,246,24,16.88607594936709,11
Category_Wikipedia_sockpuppets_of_Lepercon.csv,99,84053891.0,28,71,28,0,0,29.87878787878788,200,54,31.80808080808081,9
Category_Wikipedia_sockpuppets_of_Profg.csv,2055,64992873.0,707,1348,456,251,0,43.63065693430657,201,72,20.328953771289537,4
Category_Wikipedia_sockpuppets_of_BillyNorth.csv,94,23701502.0,21,73,17,4,0,71.48936170212765,311,14,9.648936170212766,7
Category_Wikipedia_sockpuppets_of_A_bicyclette.csv,1691,39828819.0,566,1125,500,66,0,47.33234772324069,482,69,21.813719692489652,6
Category_Wikipedia_sockpuppets_of_Avinesh.csv,3331,276710963.0,1000,2331,500,500,0,55.61903332332633,255,73,22.76253377364155,6
Category_Wikipedia_sockpuppets_of_Dcoda89.csv,536,1257321.0,201,335,166,35,0,39.26865671641791,243,55,17.375,4
Category_Wikipedia_sockpuppets_of_Blackstallion55.csv,205,26204407.0,82,123,52,30,0,41.990243902439026,234,64,18.151219512195123,10
Category_Wikipedia_sockpuppets_of_Gl_dili.csv,331,3457901.0,168,163,165,3,0,36.39274924471299,254,25,16.196374622356494,5
Category_Wikipedia_sockpuppets_of_Shankarwar456.csv,214,3796682.0,77,137,25,52,0,47.40654205607477,196,53,29.85981308411215,12
Category_Wikipedia_sockpuppets_of_Mrtnmcc.csv,810,394199343.0,255,555,118,137,0,56.25925925925926,382,50,17.674074074074074,6
Category_Wikipedia_sockpuppets_of_Ratttso.csv,270,21833598.0,72,198,24,48,0,54.53333333333333,213,47,17.114814814814814,3
Category_Wikipedia_sockpuppets_of_NikosSimpson.csv,108,22458480.0,40,68,40,0,0,58.092592592592595,199,33,23.40740740740741,12
Category_Wikipedia_sockpuppets_of_Titanic225.csv,386,2765617.0,156,230,137,19,0,44.67875647668394,253,47,21.16321243523316,2
Category_Wikipedia_sockpuppets_of_Palarbear.csv,37,17260575.0,13,24,10,3,0,60.16216216216216,211,26,12.162162162162161,10
Category_Wikipedia_sockpuppets_of_Moshechongjyang.csv,6,34493.0,3,3,2,1,4,52.666666666666664,196,27,24.5,22
Category_Wikipedia_sockpuppets_of_Zaner25.csv,1029,131954766.0,326,703,78,248,0,49.04956268221574,496,51,20.215743440233236,8
Category_Wikipedia_sockpuppets_of_Anon596.csv,1831,49570605.0,496,1335,134,362,0,59.77771709448389,496,54,16.927362097214637,4
Category_Wikipedia_sockpuppets_of_CACACA368.csv,541,1729876.0,147,394,72,75,0,45.829944547134936,500,54,21.395563770794823,7
Category_Wikipedia_sockpuppets_of_Xffgs.csv,2075,32653181.0,661,1414,500,161,0,53.26457831325301,250,71,26.16,3
Category_Wikipedia_sockpuppets_of_WhiteStarG7.csv,2260,87973708.0,549,1711,300,249,0,44.82743362831859,457,65,23.51991150442478,3
Category_Wikipedia_sockpuppets_of_JusticeforAmerica.csv,5,497158.0,3,2,3,0,0,19.0,39,19,19.0,19
Category_Wikipedia_sockpuppets_of_Angelmunoz50.csv,1555,91987459.0,392,1163,54,338,0,47.42250803858521,494,81,21.013504823151127,4
Category_Wikipedia_sockpuppets_of_Wisdom35.csv,112,7671254.0,38,74,28,10,0,43.75892857142857,183,39,23.410714285714285,7
Category_Wikipedia_sockpuppets_of_Shanghaitang.csv,20,10604.0,16,4,10,6,0,25.55,159,13,13.0,13
Category_Wikipedia_sockpuppets_of_Laurent_Simon.csv,2273,537943517.0,694,1579,358,336,0,49.51825780906291,308,59,20.353277606687197,4
Category_Wikipedia_sockpuppets_of_Geyeroots.csv,95,17444394.0,30,65,23,7,0,54.16842105263158,232,49,16.557894736842105,5
Category_Wikipedia_sockpuppets_of_DMySon.csv,1583,158617346.0,817,766,500,317,0,67.9317751105496,500,87,29.360707517372077,6
Category_Wikipedia_sockpuppets_of_Badass_prick!.csv,13,178935.0,6,7,5,1,22,76.92307692307692,155,38,22.53846153846154,15
Category_Wikipedia_sockpuppets_of_Kazmandu2.csv,38,1825132.0,28,10,28,0,0,25.05263157894737,188,51,18.236842105263158,14
Category_Wikipedia_sockpuppets_of_MUHAMMAD_SAFIULLAH.csv,2143,19480556.0,646,1497,265,381,0,46.13719085394307,255,54,14.681287914139057,3
Category_Wikipedia_sockpuppets_of_XMrxPlease.csv,72,411768.0,25,47,25,0,0,38.90277777777778,219,26,13.805555555555555,5
Category_Wikipedia_sockpuppets_of_RobertTanzi.csv,286,25462096.0,69,217,30,39,0,56.63636363636363,217,41,14.723776223776223,3
Category_Wikipedia_sockpuppets_of_Tanman333.csv,75,3203466.0,34,41,19,15,0,35.733333333333334,176,31,18.426666666666666,9
Category_Wikipedia_sockpuppets_of_Gkomsky.csv,206,808475.0,84,122,83,1,0,29.762135922330096,141,50,23.975728155339805,10
Category_Wikipedia_sockpuppets_of_NintendoFan11.csv,3093,15960521.0,950,2143,500,450,0,48.213061752344004,250,62,25.171354671839637,4
Category_Wikipedia_sockpuppets_of_Roi_Casilana.csv,717,15034646.0,241,476,100,141,0,38.83403068340307,255,45,11.369595536959554,3
Category_Wikipedia_sockpuppets_of_Ivan_Kricancic.csv,439,16681665.0,109,330,88,21,0,30.790432801822323,262,65,20.49886104783599,5
Category_Wikipedia_sockpuppets_of_‡¥ï‡µÅ‡¥¥‡µÇ‡µº.csv,23,2710386.0,19,4,17,2,0,36.69565217391305,194,26,17.130434782608695,6
Category_Wikipedia_sockpuppets_of_Jerry_Jones.csv,7558,75753104.0,1703,5855,500,1203,0,38.05768721884096,255,69,16.30166710770045,4
Category_Wikipedia_sockpuppets_of_Skh_sourav_halder.csv,2672,99544339.0,782,1890,500,282,0,66.34505988023952,431,75,19.447979041916167,3
Category_Wikipedia_sockpuppets_of_Glaewnis.csv,416,109448908.0,103,313,103,0,0,52.75961538461539,218,46,20.127403846153847,7
Category_Wikipedia_sockpuppets_of_Weaversoup.csv,15,1913.0,6,9,5,1,0,38.2,135,45,41.266666666666666,38
Category_Wikipedia_sockpuppets_of_Stop_Hyptonization.csv,5,902.0,3,2,1,2,0,80.0,180,7,7.0,7
Category_Wikipedia_sockpuppets_of_Lotlota.csv,264,1400819.0,82,182,37,45,0,45.196969696969695,255,62,16.90909090909091,6
Category_Wikipedia_sockpuppets_of_Borcker.csv,813,103782404.0,247,566,36,211,0,58.75645756457565,424,47,15.710947109471094,4
Category_Wikipedia_sockpuppets_of_Fizwiz.csv,37,1799107.0,11,26,9,2,0,51.972972972972975,202,39,15.27027027027027,11
Category_Wikipedia_sockpuppets_of_Pjanderson47.csv,168,43131873.0,59,109,59,0,0,66.14285714285714,368,53,20.11904761904762,4
Category_Wikipedia_sockpuppets_of_Debobratomukherjee007.csv,9,13951517.0,3,6,2,1,0,47.666666666666664,128,26,18.22222222222222,16
Category_Wikipedia_sockpuppets_of_MrAfternoon.csv,116,9956884.0,28,88,27,1,0,59.44827586206897,289,67,17.96551724137931,9
Category_Wikipedia_sockpuppets_of_Davomme.csv,1044,23505281.0,500,544,500,0,0,58.12068965517241,476,82,25.915708812260537,4
Category_Wikipedia_sockpuppets_of_AutoMamet.csv,1290,8743409.0,510,780,193,317,0,71.0,255,37,16.173643410852712,5
Category_Wikipedia_sockpuppets_of_Rfcbeach137.csv,256,83282165.0,52,204,52,0,0,35.9609375,209,29,13.9609375,5
Category_Wikipedia_sockpuppets_of_1978_Los_Angeles_Ravagers.csv,2450,31107373.0,686,1764,353,333,0,40.01020408163265,471,44,28.226938775510202,9
Category_Wikipedia_sockpuppets_of_AshwinSanthoshNair.csv,23,122763.0,15,8,9,6,0,34.47826086956522,209,34,31.47826086956522,19
Category_Wikipedia_sockpuppets_of_Friedrch2.csv,85,13016703.0,25,60,21,4,0,60.1764705882353,496,33,16.458823529411763,8
Category_Wikipedia_sockpuppets_of_Debkotz.csv,38,186687.0,30,8,23,7,0,25.157894736842106,186,27,15.447368421052632,13
Category_Wikipedia_sockpuppets_of_Reliable_source_fan.csv,133,10861470.0,42,91,14,28,0,67.18796992481202,499,53,29.661654135338345,11
Category_Wikipedia_sockpuppets_of_Oakboss.csv,33,3173909.0,27,6,12,15,12,32.24242424242424,196,15,9.303030303030303,9
Category_Wikipedia_sockpuppets_of_National_Official.csv,3,1383649.0,2,1,2,0,17,81.66666666666667,195,23,23.0,23
Category_Wikipedia_sockpuppets_of_Sierrajensen.csv,60,3215907.0,29,31,24,5,0,46.38333333333333,231,17,12.85,11
Category_Wikipedia_sockpuppets_of_Juansantos123.csv,893,73196748.0,294,599,131,163,0,57.13661814109742,496,66,20.66181410974244,4
Category_Wikipedia_sockpuppets_of_Hamiltonandrew.csv,20,7604401.0,15,5,6,9,0,17.2,119,15,14.8,13
Category_Wikipedia_sockpuppets_of_Herry_Juma.csv,2,0.0,1,1,1,0,6,6.0,6,23,23.0,23
Category_Wikipedia_sockpuppets_of_Ddum5347.csv,8993,54639077.0,2584,6409,500,2084,0,56.139330590459245,446,76,17.749583009007004,3
Category_Wikipedia_sockpuppets_of_Cholistanbuilders.csv,19,1547.0,8,11,5,3,0,60.89473684210526,204,26,18.473684210526315,6
Category_Wikipedia_sockpuppets_of_Spy89.csv,405,2135607.0,128,277,119,9,0,38.4641975308642,219,27,14.906172839506173,4
Category_Wikipedia_sockpuppets_of_Prahlad_balaji.csv,1586,106480742.0,528,1058,500,28,0,62.05611601513241,322,161,22.62862547288777,3
Category_Wikipedia_sockpuppets_of_Theblogger404.csv,60,2523679.0,26,34,26,0,0,44.5,276,46,20.783333333333335,4
Category_Wikipedia_sockpuppets_of_EDITOR_CAIO.csv,1247,7325973.0,357,890,277,80,0,80.60866078588613,383,58,20.333600641539697,2
Category_Wikipedia_sockpuppets_of_Pingotrimetic.csv,14,2792.0,6,8,4,2,3,53.642857142857146,157,52,29.0,12
Category_Wikipedia_sockpuppets_of_Harmanjit_Singh_Khalsa123s.csv,52,14100472.0,23,29,21,2,0,29.807692307692307,166,22,10.23076923076923,8
Category_Wikipedia_sockpuppets_of_Williammart.csv,117,5373974.0,41,76,5,36,0,52.598290598290596,227,25,12.991452991452991,3
Category_Wikipedia_sockpuppets_of_Krible-krable-bums.csv,53,7452425.0,19,34,10,9,0,40.45283018867924,149,47,24.11320754716981,12
Category_Wikipedia_sockpuppets_of_Mike_tyson11.csv,25,3608791.0,12,13,12,0,0,29.28,189,22,20.6,17
Category_Wikipedia_sockpuppets_of_YurTuk.csv,91,4152953.0,69,22,63,6,0,39.26373626373626,289,66,18.846153846153847,9
Category_Wikipedia_sockpuppets_of_Nareshkv77.csv,91,1470679.0,32,59,32,0,0,50.26373626373626,496,53,23.428571428571427,10
Category_Wikipedia_sockpuppets_of_Epigrammatist.csv,226,6079549.0,76,150,75,1,0,66.23451327433628,254,49,25.238938053097346,7
Category_Wikipedia_sockpuppets_of_Teva123.csv,64,963562.0,36,28,23,13,0,48.703125,255,43,13.9375,10
Category_Wikipedia_sockpuppets_of_Irfaankhanabadosh.csv,1707,35710519.0,674,1033,397,277,0,31.808435852372583,253,62,17.42706502636204,5
Category_Wikipedia_sockpuppets_of_Oboeboy.csv,740,48055399.0,196,544,119,77,0,47.89594594594595,215,60,18.736486486486488,3
Category_Wikipedia_sockpuppets_of_Jvdbeek.csv,42,1662796.0,18,24,11,7,0,42.80952380952381,196,28,18.214285714285715,12
Category_Wikipedia_sockpuppets_of_Jamesallain85.csv,1231,83082934.0,518,713,500,18,0,41.065800162469536,496,61,29.816409423233143,6
Category_Wikipedia_sockpuppets_of_1houstonian.csv,755,203575684.0,272,483,146,126,0,48.76688741721854,255,47,15.46887417218543,5
Category_Wikipedia_sockpuppets_of_Ellinida2006.csv,3,92010.0,3,0,3,0,16,16.0,16,22,22.0,22
Category_Wikipedia_sockpuppets_of_Bgtips1001.csv,3146,39303528.0,1120,2026,500,620,0,54.91195168467896,500,56,20.849332485696124,4
Category_Wikipedia_sockpuppets_of_Rwrobson.csv,308,535408546.0,111,197,95,16,0,42.67857142857143,229,51,15.142857142857142,2
Category_Wikipedia_sockpuppets_of_Bmpower.csv,3845,101574837.0,1105,2740,495,610,0,30.514694408322498,264,60,22.740962288686607,2
Category_Wikipedia_sockpuppets_of_Ronakabhattrz.csv,20,20089.0,9,11,6,3,0,35.05,109,53,33.9,12
Category_Wikipedia_sockpuppets_of_KurdoKardir.csv,1110,159224824.0,291,819,63,228,0,53.27837837837838,333,58,18.54234234234234,4
Category_Wikipedia_sockpuppets_of_Akash_Mamon.csv,185,12589049.0,76,109,32,44,0,37.648648648648646,255,56,26.145945945945947,9
Category_Wikipedia_sockpuppets_of_Kamran1370.csv,33,48008087.0,19,14,13,6,0,31.181818181818183,255,51,27.12121212121212,16
Category_Wikipedia_sockpuppets_of_Nadusally.csv,338,3610606.0,154,184,88,66,0,45.0887573964497,335,50,19.192307692307693,4
Category_Wikipedia_sockpuppets_of_PaintGirl.csv,65,1102184.0,23,42,12,11,0,37.292307692307695,219,32,19.53846153846154,11
Category_Wikipedia_sockpuppets_of_Cyrene12.csv,29,241042.0,19,10,15,4,13,59.724137931034484,140,20,17.24137931034483,15
Category_Wikipedia_sockpuppets_of_Triman_Ranvir.csv,24,200236.0,10,14,8,2,0,57.583333333333336,255,34,25.416666666666668,17
Category_Wikipedia_sockpuppets_of_Tonyjaimy.csv,1439,42034554.0,529,910,500,29,0,45.666435024322446,496,68,19.752605976372482,4
Category_Wikipedia_sockpuppets_of_Clare500.csv,1,0.0,1,0,1,0,36,36.0,36,33,33.0,33
Category_Wikipedia_sockpuppets_of_–†–∞–∫–∞–ª.csv,333,16285484.0,116,217,101,15,0,93.54054054054055,255,43,36.35735735735736,36
Category_Wikipedia_sockpuppets_of_JND_AMD.csv,1310,9497336.0,516,794,500,16,0,25.069465648854962,339,60,26.84885496183206,6
Category_Wikipedia_sockpuppets_of_ParillasAndrie.csv,6280,65485160.0,2130,4150,500,1630,0,33.48614649681529,496,78,22.393152866242037,4
Category_Wikipedia_sockpuppets_of_Tjroberts223.csv,7,84186.0,3,4,2,1,14,154.14285714285714,498,20,12.857142857142858,10
Category_Wikipedia_sockpuppets_of_Joe_Castillo_Dr.__.csv,141,53994634.0,43,98,15,28,0,47.91489361702128,192,44,25.652482269503547,6
Category_Wikipedia_sockpuppets_of_Parsley_Man.csv,2347,19628933.0,776,1571,500,276,0,42.22198551342139,254,85,25.806561567959097,3
Category_Wikipedia_sockpuppets_of_Doworks000.csv,2601,24426976.0,712,1889,332,380,0,44.009227220299884,255,44,13.31757016532103,3
Category_Wikipedia_sockpuppets_of_Noob_saibot_red.csv,7330,19936090.0,2434,4896,500,1934,0,36.151841746248294,253,58,19.089222373806276,4
Category_Wikipedia_sockpuppets_of_Majidii1234.csv,47,9423605.0,15,32,11,4,0,112.65957446808511,499,51,31.23404255319149,13
Category_Wikipedia_sockpuppets_of_MSENDER007.csv,879,51319928.0,551,328,500,51,0,30.65301478953356,195,50,24.498293515358363,7
Category_Wikipedia_sockpuppets_of_TownDown.csv,2335,90516744.0,863,1472,500,363,0,33.11777301927195,226,95,22.306638115631692,1
Category_Wikipedia_sockpuppets_of_WONKAKlD.csv,482,2199745.0,180,302,150,30,0,53.13278008298755,288,50,35.12448132780083,11
Category_Wikipedia_sockpuppets_of_Lolipopz99.csv,3742,40073025.0,1019,2723,500,519,0,31.4748797434527,250,54,16.272314270443612,2
Category_Wikipedia_sockpuppets_of_Werstone.csv,314,93641608.0,98,216,73,25,0,39.37261146496815,312,42,13.971337579617835,3
Category_Wikipedia_sockpuppets_of_BuckeyeBuddha.csv,115,9641908.0,57,58,31,26,0,38.2,224,26,14.339130434782609,7
Category_Wikipedia_sockpuppets_of_S.karamyar.csv,41,845540.0,35,6,27,8,0,21.146341463414632,186,32,20.70731707317073,15
Category_Wikipedia_sockpuppets_of_Himalayrd.csv,128,5255309.0,39,89,23,16,0,38.59375,232,53,18.71875,6
Category_Wikipedia_sockpuppets_of_Akshay_Singh_Rajput_Thakur.csv,1696,52127742.0,752,944,168,584,0,61.01002358490566,504,62,17.617924528301888,4
Category_Wikipedia_sockpuppets_of_JAYSON_AND_AMANDA_304.csv,17,602729.0,9,8,4,5,14,59.294117647058826,209,10,10.0,10
Category_Wikipedia_sockpuppets_of_Dev_joshi_fan.csv,561,9164749.0,215,346,174,41,0,38.51336898395722,286,29,14.14795008912656,6
Category_Wikipedia_sockpuppets_of_Asdfgh1234567.csv,49,5042.0,14,35,8,6,0,38.55102040816327,156,49,13.448979591836734,7
Category_Wikipedia_sockpuppets_of_Crasherisntmydogsname.csv,380,4670073.0,122,258,80,42,0,35.82105263157895,214,48,19.376315789473683,3
Category_Wikipedia_sockpuppets_of_Ashumech527.csv,1174,65371839.0,400,774,294,106,0,41.11839863713799,250,41,11.387563884156728,5
Category_Wikipedia_sockpuppets_of_Adam_Cleary.csv,610,9075537.0,381,229,335,46,0,29.69016393442623,255,53,29.23934426229508,9
Category_Wikipedia_sockpuppets_of_MisterData124.csv,161,18660062.0,50,111,42,8,0,52.732919254658384,283,62,27.52173913043478,7
Category_Wikipedia_sockpuppets_of_Pablo909.csv,23290,316457666.0,8813,14477,500,8313,0,39.19901245169601,260,75,20.45740661227995,1
Category_Wikipedia_sockpuppets_of_Hawaan12.csv,3121,9644217.0,957,2164,500,457,0,48.082986222364624,255,92,17.660044857417493,2
Category_Wikipedia_sockpuppets_of_Dharashan2022.csv,582,2764220.0,179,403,93,86,0,45.63058419243986,322,72,28.333333333333332,8
Category_Wikipedia_sockpuppets_of_Edwardvoly.csv,220,57781440.0,66,154,66,0,0,47.65,251,44,16.881818181818183,8
Category_Wikipedia_sockpuppets_of_Lukeybalukey.csv,81,34166600.0,25,56,25,0,0,65.23456790123457,334,39,19.91358024691358,11
Category_Wikipedia_sockpuppets_of_Iamyoursourav.csv,52,127689960.0,15,37,13,2,0,44.13461538461539,208,22,12.865384615384615,7
Category_Wikipedia_sockpuppets_of_Liuliushan.csv,54,1728885.0,18,36,11,7,0,78.38888888888889,253,23,15.166666666666666,14
Category_Wikipedia_sockpuppets_of_SOPHIAN.csv,3748,19065405.0,1367,2381,500,867,0,44.792422625400214,261,110,20.514941302027747,1
Category_Wikipedia_sockpuppets_of_Blooxo.csv,53,4391027.0,16,37,16,0,0,61.81132075471698,259,38,25.77358490566038,7
Category_Wikipedia_sockpuppets_of_Veoturbex.csv,39,4098654.0,14,25,14,0,0,56.43589743589744,476,22,16.974358974358974,12
Category_Wikipedia_sockpuppets_of_Gd_bakshi.csv,58,112024.0,29,29,20,9,0,54.08620689655172,238,21,13.448275862068966,10
Category_Wikipedia_sockpuppets_of_Cassandra872.csv,6160,36327726.0,1669,4491,500,1169,0,43.69172077922078,500,76,19.362824675324674,3
Category_Wikipedia_sockpuppets_of_Danny_Daniel.csv,851,37890259.0,177,674,36,141,0,34.568742655699175,215,66,30.575793184488838,6
Category_Wikipedia_sockpuppets_of_Sodapoppers.csv,615,114994389.0,215,400,202,13,0,46.68943089430894,496,53,21.227642276422763,7
Category_Wikipedia_sockpuppets_of_WilliamsLazarev.csv,8,2612.0,5,3,5,0,0,62.5,181,23,11.75,5
Category_Wikipedia_sockpuppets_of_PublicSafetyOfficer.csv,23,2160618.0,6,17,6,0,0,31.782608695652176,181,29,12.695652173913043,8
Category_Wikipedia_sockpuppets_of_Lucasraven12.csv,16,5613599.0,8,8,8,0,0,58.8125,320,42,23.5,21
Category_Wikipedia_sockpuppets_of_RedRose333.csv,2470,8500407.0,743,1727,500,243,0,28.860728744939273,223,55,15.629554655870445,3
Category_Wikipedia_sockpuppets_of_Usman_Khalil.csv,2950,228551529.0,884,2066,500,384,0,42.68779661016949,343,62,19.668474576271187,4
Category_Wikipedia_sockpuppets_of_Jamesspancer.csv,55,24193368.0,16,39,9,7,0,76.0909090909091,279,22,9.363636363636363,5
Category_Wikipedia_sockpuppets_of_Insight_3.csv,2303,15418941.0,1000,1303,500,500,0,53.11723838471559,496,91,18.876682587928787,5
Category_Wikipedia_sockpuppets_of_Adrianbigz.csv,9,568159.0,2,7,2,0,0,17.333333333333332,52,17,16.555555555555557,15
Category_Wikipedia_sockpuppets_of_Biger01.csv,15,30909242.0,9,6,7,2,0,93.46666666666667,375,17,7.466666666666667,6
Category_Wikipedia_sockpuppets_of_CoffeeMeAlready.csv,846,1670395.0,235,611,222,13,0,54.73640661938534,499,50,29.602836879432623,4
Category_Wikipedia_sockpuppets_of_LycanrocDusk245.csv,48,5810989.0,19,29,15,4,0,48.0625,213,43,30.9375,20
Category_Wikipedia_sockpuppets_of_Fightersword.csv,358,14989864.0,125,233,37,88,0,50.01675977653631,496,46,17.681564245810055,5
Category_Wikipedia_sockpuppets_of_Dbk0825.csv,17,37284.0,10,7,8,2,0,58.705882352941174,220,25,13.941176470588236,3
Category_Wikipedia_sockpuppets_of_Rectify1233.csv,25,8258.0,10,15,9,1,0,28.16,147,23,15.76,11
Category_Wikipedia_sockpuppets_of_Eagle_Striker.csv,1102,22518055.0,685,417,500,185,0,31.400181488203266,255,52,20.63520871143376,11
Category_Wikipedia_sockpuppets_of_Reba_Roy.csv,505,22291586.0,251,254,109,142,0,28.899009900990098,255,48,18.62178217821782,10
Category_Wikipedia_sockpuppets_of_Lewishnl.csv,58,3471411.0,22,36,19,3,0,44.53448275862069,221,54,29.137931034482758,13
Category_Wikipedia_sockpuppets_of_EranSalu.csv,20,960201.0,10,10,5,5,0,47.2,147,27,20.2,15
Category_Wikipedia_sockpuppets_of_Wonlin23.csv,2697,22455845.0,713,1984,382,331,0,24.813125695216907,223,51,16.098257322951426,3
Category_Wikipedia_sockpuppets_of_Cmf7973.csv,56,4868765.0,27,29,21,6,0,48.767857142857146,232,23,14.553571428571429,5
Category_Wikipedia_sockpuppets_of_NajiimP.csv,33,6669374.0,19,14,9,10,0,47.24242424242424,196,52,18.151515151515152,10
Category_Wikipedia_sockpuppets_of_Adro2000.csv,10,648082.0,10,0,5,5,0,25.0,196,27,26.7,24
Category_Wikipedia_sockpuppets_of_Welbens488.csv,359,16980119.0,96,263,14,82,0,54.440111420612816,440,35,15.532033426183844,5
Category_Wikipedia_sockpuppets_of_VinceB.csv,2268,18097338.0,763,1505,500,263,0,36.0679012345679,248,70,20.40652557319224,3
Category_Wikipedia_sockpuppets_of_Bardia_EsmaeilZadeh.csv,7,4054286.0,4,3,3,1,0,104.71428571428571,500,29,25.571428571428573,21
Category_Wikipedia_sockpuppets_of_Normannnn.csv,20,126246041.0,5,15,5,0,0,43.4,151,27,18.45,16
Category_Wikipedia_sockpuppets_of_Sonny1998.csv,1805,25301944.0,554,1251,500,54,0,31.31135734072022,255,59,22.031024930747922,5
Category_Wikipedia_sockpuppets_of_Bossanueva.csv,1453,33776653.0,340,1113,52,288,0,43.07432897453545,235,80,20.30557467309016,4
Category_Wikipedia_sockpuppets_of_Acorah.csv,97,11103645.0,34,63,14,20,0,36.43298969072165,178,52,19.288659793814432,9
Category_Wikipedia_sockpuppets_of_Pilas69.csv,3090,141542136.0,1044,2046,500,544,0,41.94789644012945,504,65,22.633333333333333,4
Category_Wikipedia_sockpuppets_of_Scamley.csv,36,73033.0,14,22,11,3,0,54.5,201,41,17.38888888888889,9
Category_Wikipedia_sockpuppets_of_Hwang_Sung_Gyung.csv,39,540688.0,22,17,13,9,0,20.53846153846154,143,24,20.82051282051282,16
Category_Wikipedia_sockpuppets_of_Andynotkim.csv,104,1614139.0,40,64,25,15,0,35.79807692307692,204,38,19.528846153846153,8
Category_Wikipedia_sockpuppets_of_Russell.Baobab.csv,53,41385002.0,36,17,21,15,0,44.509433962264154,236,14,14.0,14
Category_Wikipedia_sockpuppets_of_Oneshotofwhiskey.csv,865,13884817.0,296,569,282,14,0,52.83815028901734,255,61,25.157225433526012,12
Category_Wikipedia_sockpuppets_of_Jack_Vixion.csv,1479,20118422.0,488,991,109,379,0,56.72819472616633,376,54,20.145368492224478,4
Category_Wikipedia_sockpuppets_of_Burntout123.csv,722,130348776.0,261,461,257,4,0,41.99445983379501,242,78,26.818559556786703,2
Category_Wikipedia_sockpuppets_of_‡¶è‡¶Æ_‡¶è‡¶∏_‡¶Æ‡¶ø‡¶ú‡¶æ‡¶®‡ßÅ‡¶∞‡¶∞‡¶π‡¶Æ‡¶æ‡¶®.csv,51,104089948.0,23,28,21,2,0,43.76470588235294,255,55,26.372549019607842,16
Category_Wikipedia_sockpuppets_of_Lj25lj24.csv,21,24713051.0,8,13,4,4,0,84.0,195,21,14.047619047619047,11
Category_Wikipedia_sockpuppets_of_TroyDevinny.csv,12253,396963665.0,3231,9022,500,2731,0,55.023259609891454,500,73,21.47359830245654,1
Category_Wikipedia_sockpuppets_of_Qdx.csv,80,367114173.0,16,64,15,1,0,44.8875,201,34,13.3,9
Category_Wikipedia_sockpuppets_of_Rmvnegativelinks17.csv,11,17395454.0,10,1,3,7,0,47.09090909090909,199,29,24.363636363636363,17
Category_Wikipedia_sockpuppets_of_Printmaker2229.csv,17,174930.0,14,3,14,0,0,26.0,196,24,17.823529411764707,9
Category_Wikipedia_sockpuppets_of_86WikiEditor.csv,1929,8869902.0,680,1249,500,180,0,38.66874027993779,255,50,16.935717988595126,4
Category_Wikipedia_sockpuppets_of_Joshikumarav.csv,3,393.0,3,0,3,0,9,20.666666666666668,38,23,23.0,23
Category_Wikipedia_sockpuppets_of_CincinnatiHistory.csv,6,63431.0,4,2,4,0,30,72.0,156,39,31.0,27
Category_Wikipedia_sockpuppets_of_Zhanmiko.csv,33,170553.0,21,12,3,18,33,122.60606060606061,196,30,21.060606060606062,13
Category_Wikipedia_sockpuppets_of_WillyMan2012.csv,31,629038.0,15,16,13,2,0,51.903225806451616,161,34,26.838709677419356,20
Category_Wikipedia_sockpuppets_of_PFW_tournaments.csv,1995,65823314.0,669,1326,500,169,0,36.12280701754386,241,52,20.757894736842104,6
Category_Wikipedia_sockpuppets_of_LilZavier.csv,3,1621.0,3,0,3,0,0,3.3333333333333335,10,20,20.0,20
Category_Wikipedia_sockpuppets_of_AndresHerutJaim.csv,74664,389708220.0,22293,52371,500,21793,0,53.07014089788921,500,126,19.297974927675988,2
Category_Wikipedia_sockpuppets_of_TabbyGarf_Posts_Nudes.csv,33,8893.0,15,18,8,7,0,32.63636363636363,141,41,26.696969696969695,12
Category_Wikipedia_sockpuppets_of_Worldbeats.csv,127,169392840.0,40,87,40,0,0,36.62992125984252,227,42,22.03937007874016,11
Category_Wikipedia_sockpuppets_of_Phancylane.csv,112,9164906.0,44,68,26,18,0,43.294642857142854,241,25,12.928571428571429,5
Category_Wikipedia_sockpuppets_of_Mnnie053.csv,856,8078551.0,327,529,203,124,0,43.674065420560744,305,54,27.863317757009344,4
Category_Wikipedia_sockpuppets_of_Tron4444444.csv,119,778455.0,60,59,41,19,0,43.109243697478995,271,31,24.95798319327731,20
Category_Wikipedia_sockpuppets_of_Abigay_Peraza_Montore.csv,280,9215466.0,164,116,97,67,0,28.6,347,65,25.114285714285714,7
Category_Wikipedia_sockpuppets_of_ATWA_WOLF.csv,31,348166.0,14,17,14,0,0,58.516129032258064,185,25,20.096774193548388,14
Category_Wikipedia_sockpuppets_of_Dan_Petley.csv,299,8366799.0,101,198,101,0,0,61.438127090301,922,51,19.076923076923077,10
Category_Wikipedia_sockpuppets_of_Dragon19010.csv,13,3550.0,5,8,3,2,0,55.23076923076923,172,16,14.76923076923077,11
Category_Wikipedia_sockpuppets_of_SilverLake77.csv,68,7226127.0,18,50,8,10,0,51.89705882352941,216,45,16.220588235294116,9
Category_Wikipedia_sockpuppets_of_Yoyoyoi7.csv,45,47878822.0,17,28,9,8,0,71.37777777777778,236,14,14.0,14
Category_Wikipedia_sockpuppets_of_Belalej188.csv,64,21712.0,33,31,13,20,0,33.03125,169,23,14.578125,11
Category_Wikipedia_sockpuppets_of_UcRoxors.csv,2,20.0,2,0,2,0,0,0.0,0,28,28.0,28
Category_Wikipedia_sockpuppets_of_Sakultah.csv,2514,55363230.0,1247,1267,500,747,0,59.49005568814638,255,66,25.802704852824185,5
Category_Wikipedia_sockpuppets_of_Michaelpcorreale.csv,1,0.0,1,0,1,0,0,0.0,0,26,26.0,26
Category_Wikipedia_sockpuppets_of_Carl_van_Vechten.csv,42,1014.0,9,33,5,4,0,45.476190476190474,192,40,21.047619047619047,13
Category_Wikipedia_sockpuppets_of_Javedsaqib51.csv,193,1334332.0,134,59,110,24,0,22.958549222797927,255,12,11.05699481865285,11
Category_Wikipedia_sockpuppets_of_Suvankar_Bakchi.csv,1,0.0,1,0,1,0,26,26.0,26,21,21.0,21
Category_Wikipedia_sockpuppets_of_Scholarscentral.csv,8113,166272067.0,2972,5141,500,2472,0,45.19142117589055,255,105,23.79477381979539,4
Category_Wikipedia_sockpuppets_of_TheBigMan720.csv,1748,3988157.0,557,1191,500,57,0,57.75400457665904,389,49,20.475972540045767,5
Category_Wikipedia_sockpuppets_of_Oneilm54299.csv,20,10549451.0,10,10,3,7,0,55.4,272,10,10.0,10
Category_Wikipedia_sockpuppets_of_Dimpz42.csv,53,549910.0,25,28,23,2,0,43.301886792452834,255,31,23.452830188679247,16
Category_Wikipedia_sockpuppets_of_Marked4life.csv,938,460869848.0,334,604,332,2,0,51.31876332622601,347,48,22.038379530916846,6
Category_Wikipedia_sockpuppets_of_Info_advocates_1.csv,118,266193791.0,31,87,13,18,0,50.21186440677966,494,35,16.71186440677966,7
Category_Wikipedia_sockpuppets_of_Larrymoney21.csv,38,12740515.0,26,12,25,1,0,20.18421052631579,205,38,34.0,12
Category_Wikipedia_sockpuppets_of_Martinwebb.csv,41,206232547.0,11,30,10,1,0,65.0,324,26,24.4390243902439,18
Category_Wikipedia_sockpuppets_of_Arizona3876.csv,32,9148646.0,18,14,11,7,0,69.75,255,18,12.65625,9
Category_Wikipedia_sockpuppets_of_Truthseekerx.csv,488,18348547.0,147,341,124,23,0,38.91188524590164,231,45,18.71311475409836,4
Category_Wikipedia_sockpuppets_of_Rentmind.csv,6,1892755.0,5,1,4,1,0,36.0,195,14,11.333333333333334,10
Category_Wikipedia_sockpuppets_of_Alex_Mesz.csv,168,89150956.0,44,124,35,9,0,52.857142857142854,498,25,12.892857142857142,3
Category_Wikipedia_sockpuppets_of_Alistarwearmouth.csv,8,339880.0,4,4,4,0,0,67.25,190,26,18.5,16
Category_Wikipedia_sockpuppets_of_Twins11.csv,3,657.0,2,1,1,1,0,123.33333333333333,199,21,11.0,6
Category_Wikipedia_sockpuppets_of_Dreamofdealers.csv,1883,40806134.0,745,1138,357,388,0,36.01009028146574,514,60,24.394052044609666,3
Category_Wikipedia_sockpuppets_of_MintonBrice.csv,173,13478136.0,103,70,99,4,0,43.115606936416185,255,32,15.433526011560694,12
Category_Wikipedia_sockpuppets_of_Slyfox4908.csv,137,13810452.0,46,91,34,12,0,57.89051094890511,227,51,24.759124087591243,14
Category_Wikipedia_sockpuppets_of_SwimDude.csv,193,78108813.0,80,113,44,36,0,40.02590673575129,199,42,18.83937823834197,13
Category_Wikipedia_sockpuppets_of_Rapalot203.csv,21,35123.0,17,4,12,5,0,15.285714285714286,118,50,21.523809523809526,4
Category_Wikipedia_sockpuppets_of_Dougie_Pedia.csv,13,395445.0,3,10,3,0,11,32.23076923076923,91,21,19.846153846153847,18
Category_Wikipedia_sockpuppets_of_The3Kittens.csv,351,17852407.0,141,210,38,103,0,46.3988603988604,390,47,19.074074074074073,7
Category_Wikipedia_sockpuppets_of_Cloudkul.csv,4,327626.0,2,2,1,1,0,45.75,77,25,14.5,4
Category_Wikipedia_sockpuppets_of_Piperpeter806.csv,5,141.0,3,2,2,1,0,52.6,133,18,18.0,18
Category_Wikipedia_sockpuppets_of_Punk_Boi_8.csv,3004,84937940.0,926,2078,500,426,0,36.095872170439414,229,83,29.087882822902795,5
Category_Wikipedia_sockpuppets_of_Guido_Lonchile.csv,634,135162873.0,166,468,160,6,0,39.24447949526814,251,51,16.85646687697161,4
Category_Wikipedia_sockpuppets_of_DrAcHeNWiNgZz.csv,29,347484.0,20,9,20,0,0,23.586206896551722,196,49,30.103448275862068,18
Category_Wikipedia_sockpuppets_of_RajaYuvan.csv,470,13774968.0,163,307,122,41,0,41.08297872340425,252,55,16.438297872340424,7
Category_Wikipedia_sockpuppets_of_Rjeng2000.csv,1061,287810247.0,341,720,320,21,0,42.42884071630537,317,81,19.127238454288406,4
Category_Wikipedia_sockpuppets_of_F121212.csv,1828,163725783.0,649,1179,500,149,0,25.280087527352297,255,63,20.76312910284464,9
Category_Wikipedia_sockpuppets_of_Guitar_Hero_Games_Setlist.csv,145,518279.0,121,24,118,3,0,26.83448275862069,197,32,29.97241379310345,27
Category_Wikipedia_sockpuppets_of_PIO.csv,3201,95224423.0,1140,2061,500,640,0,36.02561699468916,249,68,22.747891283973757,4
Category_Wikipedia_sockpuppets_of_Turmerick.csv,1394,60315925.0,324,1070,160,164,0,52.244619799139166,249,49,15.22883787661406,4
Category_Wikipedia_sockpuppets_of_Holtj.csv,3171,533914346.0,1227,1944,500,727,0,44.038158309681485,381,58,22.03058971933144,4
Category_Wikipedia_sockpuppets_of_Conferences.csv,13,11165.0,8,5,8,0,0,25.923076923076923,145,34,28.76923076923077,21
Category_Wikipedia_sockpuppets_of_Semakikulon.csv,31,1647024.0,9,22,8,1,14,78.09677419354838,255,43,34.61290322580645,21
Category_Wikipedia_sockpuppets_of_Ullashydur.csv,9,2486.0,5,4,3,2,0,56.22222222222222,160,24,24.0,24
Category_Wikipedia_sockpuppets_of_Ihavan2021.csv,176,305464.0,85,91,34,51,0,55.13068181818182,360,50,31.15909090909091,19
Category_Wikipedia_sockpuppets_of_Matthewlamont.csv,181,5195509.0,88,93,76,12,0,34.93370165745856,214,45,15.657458563535911,8
Category_Wikipedia_sockpuppets_of_Paranparan.csv,110,15553700.0,33,77,14,19,0,40.5,273,30,14.281818181818181,6
Category_Wikipedia_sockpuppets_of_Swamiblue.csv,3155,273290906.0,1222,1933,500,722,0,50.687797147385105,494,65,25.816164817749605,4
Category_Wikipedia_sockpuppets_of_Sayerslle.csv,3866,153513824.0,1342,2524,500,842,0,53.205638903259185,494,71,22.188825659596482,5
Category_Wikipedia_sockpuppets_of_UsernameQQ.csv,32,873120.0,12,20,9,3,0,71.625,204,20,13.0625,11
Category_Wikipedia_sockpuppets_of_PaleheadedBrushfinch.csv,1708,2667306.0,528,1180,266,262,0,52.68911007025761,390,77,17.2096018735363,4
Category_Wikipedia_sockpuppets_of_Btibd21.csv,647,7969769.0,261,386,151,110,0,46.938176197836164,496,46,24.62596599690881,8
Category_Wikipedia_sockpuppets_of_Boundarylayer.csv,1671,303148825.0,504,1167,500,4,0,67.74386594853381,498,58,18.560143626570916,7
Category_Wikipedia_sockpuppets_of_Drshaziarehman.csv,20,11813488.0,7,13,5,2,0,34.25,141,49,30.25,11
Category_Wikipedia_sockpuppets_of_THicc.leGend.csv,8,910.0,4,4,3,1,0,44.25,182,12,6.75,5
Category_Wikipedia_sockpuppets_of_Meow1.csv,8,3829.0,5,3,2,3,0,18.875,119,14,14.0,14
Category_Wikipedia_sockpuppets_of_Aminul802.csv,1435,52638334.0,523,912,500,23,0,53.462020905923346,255,58,26.045296167247386,4
Category_Wikipedia_sockpuppets_of_Shokatsu-sensei.csv,1283,10276763.0,524,759,500,24,0,30.901792673421667,203,38,19.723304754481685,3
Category_Wikipedia_sockpuppets_of_SaharZIRIZ.csv,516,8932437.0,117,399,96,21,0,48.72868217054263,255,45,15.187984496124031,4
Category_Wikipedia_sockpuppets_of_Solvelove.csv,21,348959.0,7,14,6,1,1,65.14285714285714,139,37,23.857142857142858,17
Category_Wikipedia_sockpuppets_of_Winterysteppe.csv,17651,124864187.0,5851,11800,500,5351,0,57.11495099427795,499,90,21.575604781598777,3
Category_Wikipedia_sockpuppets_of_Josercs1.csv,8,749.0,6,2,6,0,0,34.75,139,12,12.0,12
Category_Wikipedia_sockpuppets_of_Darrendeng.csv,2047,8303587.0,503,1544,292,211,0,34.00830483634587,199,45,13.160234489496824,3
Category_Wikipedia_sockpuppets_of_Nouman_khan_sherani.csv,1259,18472473.0,464,795,186,278,0,44.64892772041303,255,76,20.30262112787927,4
Category_Wikipedia_sockpuppets_of_Putra_Yudha_Pradana.csv,368,43283652.0,109,259,37,72,0,44.65760869565217,325,39,16.777173913043477,4
Category_Wikipedia_sockpuppets_of_Carmel_African.csv,95,1516330.0,29,66,29,0,0,18.2,199,24,12.852631578947369,7
Category_Wikipedia_sockpuppets_of_DavidVGolden.csv,64,62131853.0,35,29,19,16,0,35.796875,129,26,17.421875,12
Category_Wikipedia_sockpuppets_of_Sjo_2nd_Account.csv,5,452.0,3,2,1,2,17,106.2,195,36,36.0,36
Category_Wikipedia_sockpuppets_of_Leechikai.csv,67,885713.0,47,20,42,5,0,30.970149253731343,252,15,15.0,15
Category_Wikipedia_sockpuppets_of_Mickeltyo.csv,80,141070669.0,31,49,14,17,0,47.7625,208,52,14.7,3
Category_Wikipedia_sockpuppets_of_Baikespwiki.csv,34,462946.0,28,6,28,0,0,33.529411764705884,126,47,29.294117647058822,14
Category_Wikipedia_sockpuppets_of_BalanitisOutbreakIndia.csv,6,87748.0,3,3,1,2,0,102.33333333333333,250,23,22.0,21
Category_Wikipedia_sockpuppets_of_Roon100.csv,114,84916499.0,42,72,36,6,0,41.89473684210526,255,32,17.482456140350877,11
Category_Wikipedia_sockpuppets_of_Mr.V.Andle.csv,110,3090777.0,35,75,22,13,0,25.345454545454544,160,35,15.918181818181818,6
Category_Wikipedia_sockpuppets_of_Krajoyn.csv,10169,158110699.0,2505,7664,296,2209,0,50.95407611367883,500,62,18.853771265611172,4
Category_Wikipedia_sockpuppets_of_85.5_FOR_LA.csv,370,151233232.0,130,240,28,102,0,39.72432432432432,244,45,21.88108108108108,4
Category_Wikipedia_sockpuppets_of_Eon10.csv,21,27682762.0,7,14,4,3,0,45.95238095238095,174,41,18.571428571428573,13
Category_Wikipedia_sockpuppets_of_Zinedine231.csv,35,69512.0,15,20,14,1,0,31.428571428571427,119,37,20.885714285714286,11
Category_Wikipedia_sockpuppets_of_Thurmondt.csv,719,111292208.0,320,399,99,221,0,42.46453407510431,258,57,20.112656467315716,6
Category_Wikipedia_sockpuppets_of_RingWars2007.csv,1654,215048496.0,376,1278,274,102,0,49.55441354292624,248,69,19.422007255139057,5
Category_Wikipedia_sockpuppets_of_Kingchamar.csv,228,18151241.0,108,120,93,15,0,39.473684210526315,254,38,17.57456140350877,6
Category_Wikipedia_sockpuppets_of_Í¥òÍ±∏.csv,248,159416937.0,80,168,46,34,0,38.88306451612903,276,36,17.169354838709676,12
Category_Wikipedia_sockpuppets_of_Pirokiazuma.csv,67,14857950.0,23,44,20,3,0,48.582089552238806,247,59,35.582089552238806,14
Category_Wikipedia_sockpuppets_of_Paras_KC.csv,140,4937109.0,52,88,43,9,0,34.97142857142857,200,48,21.942857142857143,9
Category_Wikipedia_sockpuppets_of_Sibereyre.csv,489,44433017.0,106,383,101,5,0,36.86912065439673,197,47,12.560327198364009,6
Category_Wikipedia_sockpuppets_of_Snazzymike.csv,1603,18640680.0,550,1053,257,293,0,50.29943855271366,488,78,16.312538989394884,3
Category_Wikipedia_sockpuppets_of_Logical_Intervention.csv,95,14603991.0,44,51,35,9,0,120.6,500,30,15.715789473684211,5
Category_Wikipedia_sockpuppets_of_Cosby_fan_lol.csv,12,89004.0,5,7,5,0,0,40.833333333333336,132,10,10.0,10
Category_Wikipedia_sockpuppets_of_P_Tune_Studio_BD.csv,45,8206962.0,32,13,27,5,0,29.555555555555557,204,38,12.955555555555556,6
Category_Wikipedia_sockpuppets_of_Editor2395.csv,39,1297660.0,31,8,15,16,0,27.102564102564102,201,24,23.615384615384617,20
Category_Wikipedia_sockpuppets_of_BillFairclough.csv,234,141654229.0,55,179,46,9,0,53.166666666666664,235,50,16.213675213675213,9
Category_Wikipedia_sockpuppets_of_JoDiaz96.csv,4671,131948143.0,1051,3620,497,554,0,37.006208520659385,255,48,15.709698137443802,2
Category_Wikipedia_sockpuppets_of_Oddmar-it-sjef-ugla1957.csv,107,1104709.0,37,70,18,19,0,56.33644859813084,244,33,11.869158878504672,5
Category_Wikipedia_sockpuppets_of_Lukeyslegends.csv,59,7815701.0,14,45,14,0,0,55.16949152542373,170,29,16.0,5
Category_Wikipedia_sockpuppets_of_TejaswaChaudhary.csv,609,14478920.0,205,404,32,173,0,49.81937602627258,255,53,17.24137931034483,4
Category_Wikipedia_sockpuppets_of_Hussaink.hasn.csv,29,9118196.0,13,16,13,0,0,42.41379310344828,136,48,22.413793103448278,20
Category_Wikipedia_sockpuppets_of_Vedantrusty.csv,32,65981303.0,9,23,7,2,0,78.9375,210,28,14.71875,5
Category_Wikipedia_sockpuppets_of_TBoz2011.csv,137,4493668.0,46,91,30,16,0,55.416058394160586,215,56,18.175182481751825,9
Category_Wikipedia_sockpuppets_of_Ncumberland.csv,289,150868694.0,98,191,69,29,0,57.37370242214533,245,38,19.698961937716263,8
Category_Wikipedia_sockpuppets_of_Sarahlee22273.csv,38,72161.0,32,6,25,7,0,24.81578947368421,204,18,17.105263157894736,17
Category_Wikipedia_sockpuppets_of_Aleksandar_olic.csv,170,164479941.0,38,132,30,8,0,52.33529411764706,327,96,43.5,12
Category_Wikipedia_sockpuppets_of_Corkythehornetfam.csv,1295,1200781.0,823,472,500,323,0,25.501930501930502,253,45,24.067181467181467,11
Category_Wikipedia_sockpuppets_of_Trilokadiponglar_Bhilku.csv,1085,12890061.0,359,726,219,140,0,48.25069124423963,499,66,18.382488479262673,4
Category_Wikipedia_sockpuppets_of_Klevshinko.csv,81,55043577.0,34,47,21,13,0,46.06172839506173,346,31,15.209876543209877,6
Category_Wikipedia_sockpuppets_of_HKyprosEinaiElliniki.csv,131,905329.0,49,82,27,22,0,70.21374045801527,442,54,21.427480916030536,6
Category_Wikipedia_sockpuppets_of_DangerousWomanAri.csv,533,4157437.0,183,350,103,80,0,38.88180112570357,255,49,22.339587242026266,6
Category_Wikipedia_sockpuppets_of_Kyna_Thigpen.csv,14,220624.0,9,5,6,3,0,28.357142857142858,114,19,18.285714285714285,18
"Category_Wikipedia_sockpuppets_of_It's_Britney,_bitch.csv",329,108372270.0,91,238,42,49,0,52.744680851063826,215,53,16.996960486322187,3
Category_Wikipedia_sockpuppets_of_Egorku56.csv,3,9023.0,2,1,1,1,27,39.666666666666664,53,28,22.666666666666668,20
Category_Wikipedia_sockpuppets_of_Bestf123.csv,1703,51705932.0,522,1181,165,357,0,42.51967116852613,500,53,18.73869641808573,6
Category_Wikipedia_sockpuppets_of_Salalina78.csv,2,3279207.0,2,0,1,1,87,141.5,196,20,19.5,19
Category_Wikipedia_sockpuppets_of_Ethan_Barrows.csv,174,3025269.0,53,121,33,20,0,49.706896551724135,280,36,15.551724137931034,4
Category_Wikipedia_sockpuppets_of_Qmbv.csv,3677,32933102.0,1173,2504,500,673,0,44.546097361979875,421,61,24.39869458797933,5
Category_Wikipedia_sockpuppets_of_BillWikiAsk.csv,55,182137502.0,23,32,16,7,0,52.654545454545456,361,28,20.418181818181818,17
Category_Wikipedia_sockpuppets_of_Retvenko123.csv,3,3089.0,2,1,1,1,16,56.0,136,20,20.0,20
Category_Wikipedia_sockpuppets_of_Chennai_Information_Updater.csv,492,120720009.0,156,336,150,6,0,45.61585365853659,260,53,19.599593495934958,4
Category_Wikipedia_sockpuppets_of_Zarapastroso.csv,81,1292864.0,28,53,16,12,0,45.629629629629626,163,37,19.925925925925927,7
Category_Wikipedia_sockpuppets_of_Ed.Vallejo.csv,17,518217.0,13,4,9,4,0,21.764705882352942,77,20,19.41176470588235,18
Category_Wikipedia_sockpuppets_of_FAFFG_Gaming.csv,158,16841119.0,50,108,50,0,0,28.90506329113924,208,46,25.639240506329113,8
Category_Wikipedia_sockpuppets_of_Flanders888.csv,14,428.0,10,4,10,0,0,41.5,124,10,10.0,10
Category_Wikipedia_sockpuppets_of_Thekohser.csv,3270,313447750.0,916,2354,500,416,0,46.41009174311927,250,97,19.751070336391436,1
Category_Wikipedia_sockpuppets_of_Blodhol.csv,695,14237970.0,139,556,56,83,0,47.42158273381295,216,51,16.792805755395683,3
Category_Wikipedia_sockpuppets_of_Love_in_40_Days.csv,1521,4561089.0,577,944,500,77,0,40.696252465483234,491,71,15.128862590401052,4
Category_Wikipedia_sockpuppets_of_Shalsch.csv,4,20159.0,4,0,3,1,15,15.0,15,17,17.0,17
Category_Wikipedia_sockpuppets_of_MNartist.csv,86,826453.0,43,43,41,2,0,34.674418604651166,182,44,23.348837209302324,13
Category_Wikipedia_sockpuppets_of_Democratsunited.csv,38,1050899.0,33,5,26,7,12,64.65789473684211,200,17,8.736842105263158,8
Category_Wikipedia_sockpuppets_of_TheSpicyMeatballs.csv,3,386.0,2,1,2,0,0,15.333333333333334,31,27,27.0,27
Category_Wikipedia_sockpuppets_of_CSOWind.csv,234,208774749.0,89,145,69,20,0,42.19230769230769,234,51,26.431623931623932,8
Category_Wikipedia_sockpuppets_of_Thulaninala.csv,45,1062946.0,14,31,6,8,0,75.35555555555555,500,63,14.311111111111112,4
Category_Wikipedia_sockpuppets_of_Oanabay04.csv,4111,161997173.0,1140,2971,500,640,0,42.66139625395281,262,50,19.758939430795426,3
Category_Wikipedia_sockpuppets_of_Barbara_Osgood.csv,2146,209756180.0,569,1577,500,69,0,37.10391425908667,230,56,16.329450139794968,3
Category_Wikipedia_sockpuppets_of_Kuching7102.csv,1501,35724148.0,581,920,369,212,0,45.81012658227848,434,87,20.907395069953363,4
Category_Wikipedia_sockpuppets_of_Hoveyherd7.csv,89,3385724.0,22,67,5,17,0,59.59550561797753,244,24,17.786516853932586,11
Category_Wikipedia_sockpuppets_of_Lreuveni.csv,98,778493.0,44,54,43,1,0,28.5,221,68,30.806122448979593,11
Category_Wikipedia_sockpuppets_of_Shannon.a.nomad.csv,5,25220.0,4,1,2,2,3,46.6,146,12,12.0,12
Category_Wikipedia_sockpuppets_of_Asher_Heimermann.csv,204,14049040.0,79,125,47,32,0,25.352941176470587,200,53,25.54901960784314,4
Category_Wikipedia_sockpuppets_of_Lukestar1991.csv,165,1846101.0,33,132,32,1,0,44.61818181818182,202,38,18.533333333333335,7
Category_Wikipedia_sockpuppets_of_CrazyNinjaGy.csv,23,2618.0,15,8,9,6,0,53.34782608695652,229,31,19.043478260869566,16
Category_Wikipedia_sockpuppets_of_Jesca_phillson.csv,11,165789.0,8,3,7,1,0,161.27272727272728,496,26,24.09090909090909,19
Category_Wikipedia_sockpuppets_of_Borismule.csv,419,43460795.0,138,281,133,5,0,38.646778042959426,234,54,20.534606205250597,3
Category_Wikipedia_sockpuppets_of_China_Dialogue_Net.csv,3649,18510726.0,1402,2247,500,902,0,36.743217319813645,255,61,21.975335708413265,3
Category_Wikipedia_sockpuppets_of_Mjuyt.csv,45,1908.0,16,29,4,12,0,73.28888888888889,205,37,16.377777777777776,11
Category_Wikipedia_sockpuppets_of_Naarter.csv,228,6904982.0,98,130,92,6,0,65.6842105263158,500,33,16.62280701754386,5
Category_Wikipedia_sockpuppets_of_Anonymous8637873e8848764e7.csv,9,743.0,5,4,3,2,0,73.66666666666667,168,11,10.222222222222221,10
Category_Wikipedia_sockpuppets_of_GeorgeChairson.csv,283,9859424.0,157,126,79,78,0,41.28621908127209,493,33,17.353356890459363,5
Category_Wikipedia_sockpuppets_of_Billiekhalidfan.csv,3150,30413904.0,1073,2077,500,573,0,45.17968253968254,392,55,18.813333333333333,3
Category_Wikipedia_sockpuppets_of_Habiibil.csv,307,8413752.0,103,204,26,77,0,49.31596091205212,243,75,15.90228013029316,5
Category_Wikipedia_sockpuppets_of_Diamond3245.csv,950,443598.0,506,444,500,6,0,22.72,337,36,22.2,15
Category_Wikipedia_sockpuppets_of_Aaaaall123.csv,75,10657205.0,19,56,19,0,0,53.17333333333333,299,34,14.546666666666667,4
Category_Wikipedia_sockpuppets_of_Kumar_girjesh.csv,139,23966.0,45,94,22,23,0,33.45323741007194,234,55,19.302158273381295,6
Category_Wikipedia_sockpuppets_of_Lawson1129.csv,12,2378632.0,5,7,3,2,20,110.0,217,67,31.75,18
Category_Wikipedia_sockpuppets_of_The_siner.csv,244,1311981.0,70,174,48,22,0,32.56147540983606,246,53,18.545081967213115,6
Category_Wikipedia_sockpuppets_of_Gatesservices.csv,1,0.0,1,0,1,0,99,99.0,99,15,15.0,15
Category_Wikipedia_sockpuppets_of_DegenFarang.csv,4667,160100973.0,1635,3032,500,1135,0,52.665523891150634,255,76,26.603814013284765,4
Category_Wikipedia_sockpuppets_of_MrMarino.csv,42,1313526.0,13,29,11,2,0,44.642857142857146,169,22,15.928571428571429,8
Category_Wikipedia_sockpuppets_of_Regnad_kcin75.csv,294,110732798.0,81,213,79,2,0,50.54761904761905,220,41,17.207482993197278,5
Category_Wikipedia_sockpuppets_of_Akatziri.csv,514,3554360.0,194,320,194,0,0,52.54863813229572,496,71,14.270428015564203,4
Category_Wikipedia_sockpuppets_of_Isla_Riordan.csv,1161,24226007.0,286,875,18,268,0,35.47286821705426,255,60,22.659776055124894,6
Category_Wikipedia_sockpuppets_of_Yujufan.csv,641,14655494.0,222,419,143,79,0,34.20748829953198,245,47,13.627145085803432,4
Category_Wikipedia_sockpuppets_of_Shinas.csv,6370,149486164.0,1904,4466,500,1404,0,32.49403453689168,263,81,19.745839874411303,4
Category_Wikipedia_sockpuppets_of_Rosswalker74.csv,95,40110953.0,31,64,18,13,0,50.589473684210525,194,45,15.48421052631579,9
Category_Wikipedia_sockpuppets_of_Aydinyol.csv,715,196647411.0,181,534,177,4,0,53.10489510489511,496,50,19.162237762237762,6
Category_Wikipedia_sockpuppets_of_Coralie44988.csv,13,150.0,13,0,13,0,0,4.076923076923077,53,17,17.0,17
Category_Wikipedia_sockpuppets_of_Judodele.csv,46,168450.0,26,20,14,12,0,47.17391304347826,214,24,17.456521739130434,8
Category_Wikipedia_sockpuppets_of_UltraUsurper.csv,2115,15873369.0,814,1301,435,379,0,50.33664302600473,493,68,22.51536643026005,2
Category_Wikipedia_sockpuppets_of_Metwen2020.csv,9,7256362.0,4,5,2,2,0,85.77777777777777,267,15,12.333333333333334,12
Category_Wikipedia_sockpuppets_of_Wae4r.csv,12,2624323.0,7,5,3,4,0,74.08333333333333,196,16,14.666666666666666,11
Category_Wikipedia_sockpuppets_of_La_v√©rit√©_gagne.csv,1337,70449170.0,424,913,239,185,0,56.10246821241586,500,51,17.979805534779356,2
Category_Wikipedia_sockpuppets_of_Paganchristmas.csv,131,50468044.0,64,67,50,14,0,34.29007633587786,199,46,15.114503816793894,9
Category_Wikipedia_sockpuppets_of_Payalsingh0135.csv,192,108068088.0,54,138,17,37,0,52.666666666666664,267,70,30.979166666666668,9
Category_Wikipedia_sockpuppets_of_GreatMagOBI.csv,62,482102.0,26,36,26,0,0,38.096774193548384,196,44,28.516129032258064,5
Category_Wikipedia_sockpuppets_of_Zoffio.csv,17,4222444.0,9,8,8,1,0,32.05882352941177,109,21,20.294117647058822,18
Category_Wikipedia_sockpuppets_of_AhamBrahmasmi.csv,1633,81084042.0,632,1001,500,132,0,32.356399265156156,319,55,16.701775872627067,4
Category_Wikipedia_sockpuppets_of_Libertarianmoderate.csv,275,13200792.0,92,183,76,16,0,46.63272727272727,249,41,17.08,4
Category_Wikipedia_sockpuppets_of_Neolloa999.csv,64,2512407.0,27,37,23,4,0,110.59375,250,46,20.5,4
Category_Wikipedia_sockpuppets_of_Domain_Flag.csv,47,11996746.0,27,20,25,2,0,32.46808510638298,196,64,36.191489361702125,11
Category_Wikipedia_sockpuppets_of_Menu_maharaj.csv,2618,87118003.0,672,1946,475,197,0,44.878151260504204,500,53,15.991214667685256,3
Category_Wikipedia_sockpuppets_of_Jmcnamera.csv,3945,96887221.0,1016,2929,500,516,0,53.94093789607098,251,82,21.828897338403042,4
Category_Wikipedia_sockpuppets_of_Redsred.csv,103,3633803.0,24,79,23,1,0,48.33009708737864,200,47,21.796116504854368,4
Category_Wikipedia_sockpuppets_of_Alexiod_Palaiologos.csv,4163,34892765.0,1262,2901,500,762,0,47.629594042757624,500,101,24.398991112178717,2
Category_Wikipedia_sockpuppets_of_Ragazzodeitalia.csv,815,134895526.0,382,433,268,114,0,49.229447852760735,496,51,20.8,6
Category_Wikipedia_sockpuppets_of_The_Krusty_Krustacean.csv,2084,97160592.0,552,1532,500,52,0,47.08109404990403,395,64,23.84932821497121,4
Category_Wikipedia_sockpuppets_of_Connectteam19.csv,647,7836309.0,181,466,45,136,0,61.53168469860896,393,67,19.67078825347759,5
Category_Wikipedia_sockpuppets_of_Jess_1000000.csv,19,7774101.0,5,14,3,2,0,67.0,199,70,34.8421052631579,4
Category_Wikipedia_sockpuppets_of_Plucas58.csv,2207,18752028.0,688,1519,500,188,0,57.46760308110557,404,88,18.354780244676032,6
Category_Wikipedia_sockpuppets_of_Swatiumk.csv,1,0.0,1,0,1,0,35,35.0,35,18,18.0,18
Category_Wikipedia_sockpuppets_of_User178.csv,209,49667095.0,95,114,55,40,0,52.239234449760765,240,49,26.598086124401913,5
Category_Wikipedia_sockpuppets_of_Sockie16.csv,1231,189491673.0,514,717,500,14,0,44.30950446791227,496,54,26.80991064175467,7
Category_Wikipedia_sockpuppets_of_Bidoon.csv,471,229497351.0,140,331,84,56,0,52.48407643312102,491,47,16.690021231422506,6
Category_Wikipedia_sockpuppets_of_Briandavidthompson.csv,1,0.0,1,0,1,0,199,199.0,199,23,23.0,23
Category_Wikipedia_sockpuppets_of_Dragonrap2.csv,5914,81726052.0,1821,4093,500,1321,0,66.27358809604328,255,91,22.924078457896517,4
Category_Wikipedia_sockpuppets_of_Westerosi456H.csv,833,16914569.0,317,516,91,226,0,59.355342136854745,454,47,27.565426170468186,9
Category_Wikipedia_sockpuppets_of_TheIndyWay.csv,41,434967.0,30,11,23,7,0,32.21951219512195,202,19,15.365853658536585,11
Category_Wikipedia_sockpuppets_of_Actor_Ravi_Varma.csv,87,19667770.0,32,55,17,15,0,54.08045977011494,492,32,18.7816091954023,6
Category_Wikipedia_sockpuppets_of_Badmachine.csv,2167,142419931.0,696,1471,500,196,0,48.629441624365484,250,75,22.74157821873558,4
Category_Wikipedia_sockpuppets_of_Milljason22.csv,119,2441194.0,38,81,8,30,0,56.8235294117647,238,51,14.453781512605042,4
Category_Wikipedia_sockpuppets_of_Rivugayen.csv,92,41700545.0,32,60,28,4,0,43.119565217391305,210,47,21.945652173913043,7
Category_Wikipedia_sockpuppets_of_Rthkofficer.csv,12,519250.0,9,3,5,4,0,28.333333333333332,173,21,9.666666666666666,4
Category_Wikipedia_sockpuppets_of_Lucasmoura.csv,2215,98761654.0,603,1612,464,139,0,37.58148984198645,255,78,28.225733634311513,5
Category_Wikipedia_sockpuppets_of_Tetovario.csv,2617,387876608.0,739,1878,500,239,0,40.483377913641576,500,53,15.210928544134505,5
Category_Wikipedia_sockpuppets_of_Saleem_Sinai.csv,406,343943137.0,105,301,62,43,0,49.748768472906406,233,39,16.379310344827587,8
Category_Wikipedia_sockpuppets_of_Ekucha_belrima.csv,66,54549512.0,16,50,16,0,0,55.984848484848484,272,31,16.03030303030303,7
Category_Wikipedia_sockpuppets_of_Wolfman5580.csv,539,6689633.0,166,373,108,58,0,50.98886827458256,343,54,13.341372912801484,4
Category_Wikipedia_sockpuppets_of_Samm.jutt.csv,102,102399049.0,28,74,28,0,0,53.03921568627451,194,63,13.617647058823529,6
Category_Wikipedia_sockpuppets_of_Absad.csv,34,281267.0,32,2,6,26,0,83.26470588235294,199,22,11.735294117647058,9
Category_Wikipedia_sockpuppets_of_ASIANPOPCHANNEL.csv,528,67736905.0,174,354,39,135,0,31.210227272727273,280,56,28.068181818181817,3
Category_Wikipedia_sockpuppets_of_Risrockz.csv,2,3541.0,2,0,1,1,23,38.0,53,13,13.0,13
Category_Wikipedia_sockpuppets_of_Topfool16.csv,1338,7565789.0,516,822,500,16,0,32.27204783258595,322,65,24.292974588938716,5
Category_Wikipedia_sockpuppets_of_Ainsley_Louis_I._Mallari.csv,459,32404885.0,120,339,94,26,0,49.40305010893246,255,37,20.333333333333332,4
Category_Wikipedia_sockpuppets_of_Shiwam_Kumar_Sriwastaw.csv,3879,76552329.0,1516,2363,364,1152,0,37.123485434390304,321,68,20.20056715648363,2
Category_Wikipedia_sockpuppets_of_TNHtnh.csv,18,22867568.0,7,11,3,4,0,21.555555555555557,70,22,21.27777777777778,18
Category_Wikipedia_sockpuppets_of_Stu69.csv,16,3142181.0,6,10,4,2,0,51.9375,229,28,14.25,7
Category_Wikipedia_sockpuppets_of_SQRT5P1D2.csv,1148,10139497.0,479,669,447,32,0,41.715156794425084,255,73,32.24651567944251,5
Category_Wikipedia_sockpuppets_of_Serafin.csv,5136,216834847.0,1443,3693,357,1086,0,49.4832554517134,255,65,20.12227414330218,4
Category_Wikipedia_sockpuppets_of_Bloger75.csv,139,165400.0,55,84,18,37,0,48.48201438848921,309,91,47.410071942446045,11
Category_Wikipedia_sockpuppets_of_King_Of_Cable.csv,281,2311700.0,90,191,55,35,0,29.555160142348754,156,49,23.306049822064058,10
Category_Wikipedia_sockpuppets_of_Lindi29.csv,2776,15761006.0,567,2209,500,67,0,59.085014409221905,255,50,33.553674351585016,4
Category_Wikipedia_sockpuppets_of_Coolest_Kid_10.csv,1144,77074343.0,422,722,422,0,0,28.15909090909091,255,50,22.932692307692307,7
Category_Wikipedia_sockpuppets_of_WillNox.csv,3,21322.0,3,0,3,0,0,16.0,25,7,7.0,7
Category_Wikipedia_sockpuppets_of_Ryan_kirkpatrick.csv,12520,430924016.0,3793,8727,500,3293,0,41.36581469648562,449,104,25.555750798722045,5
Category_Wikipedia_sockpuppets_of_Cardawebmaster.csv,1,0.0,1,0,1,0,0,0.0,0,13,13.0,13
Category_Wikipedia_sockpuppets_of_EditingGodguru.csv,4494,102337446.0,1423,3071,500,923,0,51.60280373831776,500,104,22.023364485981308,4
Category_Wikipedia_sockpuppets_of_Anglo_Pyramidologist.csv,4158,167690942.0,1598,2560,500,1098,0,47.87974987974988,255,79,19.43001443001443,5
Category_Wikipedia_sockpuppets_of_Reginmund.csv,3508,24100226.0,1066,2442,500,566,0,37.780216647662485,218,90,18.85290763968073,2
Category_Wikipedia_sockpuppets_of_Camilod.csv,290,43984950.0,70,220,12,58,0,40.91034482758621,238,44,26.848275862068967,5
Category_Wikipedia_sockpuppets_of_Shadowxgov.csv,1,0.0,1,0,1,0,0,0.0,0,27,27.0,27
Category_Wikipedia_sockpuppets_of_Ideal75.csv,1240,5334292.0,575,665,325,250,0,31.075806451612902,255,58,25.126612903225805,4
Category_Wikipedia_sockpuppets_of_Hooman_hatami.csv,83,2925082.0,36,47,19,17,0,28.240963855421686,298,39,13.80722891566265,8
Category_Wikipedia_sockpuppets_of_Leedavis1232.csv,2891,23595634.0,797,2094,500,297,0,43.79176755447942,317,56,16.832929782082324,3
Category_Wikipedia_sockpuppets_of_Betaquest1.csv,2,95544.0,2,0,1,1,18,19.0,20,44,33.0,22
Category_Wikipedia_sockpuppets_of_Teamxrsx.csv,226,9189712.0,77,149,77,0,0,32.95132743362832,216,50,20.45575221238938,4
Category_Wikipedia_sockpuppets_of_HRTokeNstuff.csv,1,0.0,1,0,1,0,35,35.0,35,16,16.0,16
Category_Wikipedia_sockpuppets_of_Akashkunal.csv,1960,19533144.0,731,1229,255,476,0,30.516326530612243,250,46,17.59081632653061,7
Category_Wikipedia_sockpuppets_of_Kyle_Mercadante.csv,76,20062228.0,18,58,12,6,0,24.38157894736842,167,40,15.513157894736842,9
Category_Wikipedia_sockpuppets_of_Kiliopa.csv,78,2216243.0,27,51,19,8,0,62.294871794871796,189,46,16.474358974358974,5
Category_Wikipedia_sockpuppets_of_Viceaa.csv,1,0.0,1,0,1,0,37,37.0,37,20,20.0,20
Category_Wikipedia_sockpuppets_of_Inspect_All_Information.csv,58,215518518.0,21,37,19,2,0,61.775862068965516,255,40,16.103448275862068,12
Category_Wikipedia_sockpuppets_of_Speedrain90.csv,21,35780.0,7,14,7,0,0,23.857142857142858,151,20,11.761904761904763,9
Category_Wikipedia_sockpuppets_of_GenoCool2016.csv,389,16671128.0,148,241,45,103,0,44.084832904884315,247,45,25.37789203084833,10
Category_Wikipedia_sockpuppets_of_Auslli.csv,1987,16708434.0,654,1333,500,154,0,34.19073980875692,220,54,17.708605938600908,4
Category_Wikipedia_sockpuppets_of_Joaj.csv,670,57493259.0,269,401,112,157,0,55.75671641791045,250,54,23.237313432835823,8
Category_Wikipedia_sockpuppets_of_Disruptor_xz.csv,64,111985.0,27,37,24,3,0,48.890625,236,28,15.984375,6
Category_Wikipedia_sockpuppets_of_Mydomainwiki100.csv,97,1442435.0,64,33,41,23,0,24.742268041237114,199,59,23.701030927835053,13
Category_Wikipedia_sockpuppets_of_Leanne.csv,2203,190247591.0,572,1631,500,72,0,33.581479800272355,234,98,22.13753971856559,3
Category_Wikipedia_sockpuppets_of_HARSH_VARDHAN_SHARMA__TARA_.csv,1250,49672493.0,375,875,145,230,0,48.1376,460,53,19.5952,4
Category_Wikipedia_sockpuppets_of_Beliknol.csv,358,25839674.0,109,249,99,10,0,64.21508379888269,461,46,15.40782122905028,5
Category_Wikipedia_sockpuppets_of_Noctorum3520.csv,38,65908876.0,9,29,9,0,0,48.921052631578945,197,39,21.526315789473685,15
Category_Wikipedia_sockpuppets_of_Sardar_Nadir_Ali.csv,3668,30554040.0,1408,2260,500,908,0,40.17748091603053,424,70,19.494274809160306,3
Category_Wikipedia_sockpuppets_of_Sammanson.csv,36,1290605.0,30,6,28,2,0,40.25,247,21,17.61111111111111,10
Category_Wikipedia_sockpuppets_of_Artworldmgt.csv,14,82315.0,7,7,4,3,0,38.142857142857146,203,16,11.928571428571429,11
Category_Wikipedia_sockpuppets_of_Guntur_Irawan.csv,389,69702770.0,99,290,45,54,0,32.73521850899743,233,78,18.087403598971722,4
Category_Wikipedia_sockpuppets_of_Ludivinnee.csv,38,531098.0,16,22,14,2,0,54.026315789473685,179,35,27.710526315789473,12
Category_Wikipedia_sockpuppets_of_Wagner.csv,8495,75424425.0,3004,5491,500,2504,0,45.7343143025309,263,89,21.8554443790465,1
Category_Wikipedia_sockpuppets_of_PolandMEC.csv,352,7033797.0,144,208,74,70,0,50.28409090909091,240,45,27.491477272727273,7
Category_Wikipedia_sockpuppets_of_Starwars1791.csv,947,2866312.0,244,703,132,112,0,55.40443505807814,220,47,17.76451953537487,3
Category_Wikipedia_sockpuppets_of_Ifeomanwaka.csv,21,1626976.0,7,14,6,1,0,42.42857142857143,197,53,46.857142857142854,16
Category_Wikipedia_sockpuppets_of_Itsmywayokok.csv,90,954061.0,28,62,19,9,0,47.733333333333334,293,33,16.333333333333332,9
Category_Wikipedia_sockpuppets_of_Whatab4e.csv,33,27009.0,13,20,8,5,0,48.484848484848484,486,40,30.454545454545453,21
Category_Wikipedia_sockpuppets_of_Shkupi_Kumanova_1234.csv,476,8025363.0,195,281,195,0,0,40.476890756302524,497,53,32.18487394957983,6
Category_Wikipedia_sockpuppets_of_Antuan08.csv,412,14957334.0,164,248,122,42,0,26.024271844660195,262,44,21.512135922330096,3
Category_Wikipedia_sockpuppets_of_Ekonomi_Finans_101.csv,22,1134125.0,12,10,8,4,0,27.636363636363637,192,21,13.727272727272727,11
Category_Wikipedia_sockpuppets_of_Sheynhertz-Unbayg.csv,22413,183815202.0,9292,13121,500,8792,0,38.02534243519386,255,98,15.881318877437202,3
Category_Wikipedia_sockpuppets_of_HarvardLing.csv,188,4417433.0,79,109,18,61,0,42.994680851063826,232,54,20.367021276595743,4
Category_Wikipedia_sockpuppets_of_Noorapedia.csv,183,37332910.0,45,138,15,30,0,56.80874316939891,267,37,13.480874316939891,5
Category_Wikipedia_sockpuppets_of_Rcruzmedia.csv,320,13588459.0,124,196,123,1,0,69.959375,245,77,27.80625,9
Category_Wikipedia_sockpuppets_of_Scheunemann.joshua.csv,249,72034906.0,94,155,44,50,0,54.088353413654616,250,62,26.313253012048193,13
Category_Wikipedia_sockpuppets_of_Anitaraj001.csv,128,1429943.0,46,82,34,12,0,47.7265625,204,39,17.453125,9
Category_Wikipedia_sockpuppets_of_SICDAMNOME.csv,1683,5035237.0,566,1117,500,66,0,42.68568033273915,255,60,20.270944741532976,5
Category_Wikipedia_sockpuppets_of_MathewMcConnell.csv,9,16317286.0,7,2,4,3,74,93.0,135,25,23.666666666666668,22
Category_Wikipedia_sockpuppets_of_Amuroray11.csv,23,766380.0,11,12,7,4,0,29.0,206,32,27.608695652173914,11
Category_Wikipedia_sockpuppets_of_Musicsource87.csv,198,36253317.0,78,120,26,52,0,37.833333333333336,229,59,21.01010101010101,9
Category_Wikipedia_sockpuppets_of_Jonahhaak.csv,40,76620468.0,11,29,9,2,0,61.475,254,29,23.175,12
Category_Wikipedia_sockpuppets_of_Jackstein4665.csv,21,115795779.0,7,14,4,3,0,67.66666666666667,187,25,20.714285714285715,16
Category_Wikipedia_sockpuppets_of_Gzerr.csv,68,491419.0,38,30,20,18,0,33.205882352941174,160,25,19.808823529411764,17
Category_Wikipedia_sockpuppets_of_Stevepeterson.csv,2695,416804420.0,787,1908,500,287,0,46.75769944341373,422,56,22.929499072356215,4
Category_Wikipedia_sockpuppets_of_MiG29VN.csv,5433,253310657.0,1379,4054,312,1067,0,47.9243511871894,479,62,19.465672740658935,4
Category_Wikipedia_sockpuppets_of_Napht.csv,36,243625.0,23,13,23,0,0,52.361111111111114,87,46,14.88888888888889,14
Category_Wikipedia_sockpuppets_of_TheAudioArtistSubmiter.csv,131,294162.0,41,90,38,3,0,54.41984732824427,198,45,16.221374045801525,3
Category_Wikipedia_sockpuppets_of_Elbertbeinstein1.csv,21,184910.0,6,15,3,3,0,64.71428571428571,207,18,14.619047619047619,9
Category_Wikipedia_sockpuppets_of_OR_Tlnoinos.csv,71,2789045.0,26,45,10,16,0,67.8169014084507,197,25,17.35211267605634,5
Category_Wikipedia_sockpuppets_of_Rudra_Tenio_Chakraborty.csv,1397,72720826.0,586,811,500,86,0,38.151037938439515,255,54,25.905511811023622,4
Category_Wikipedia_sockpuppets_of_Lordarchitect.csv,428,104895060.0,155,273,147,8,0,36.58878504672897,248,49,15.843457943925234,5
Category_Wikipedia_sockpuppets_of_Y.oehrli.gms.csv,3,6124.0,2,1,2,0,16,19.333333333333332,26,22,22.0,22
Category_Wikipedia_sockpuppets_of_Aryan790.csv,464,7741511.0,163,301,55,108,0,53.39224137931034,406,32,16.254310344827587,5
Category_Wikipedia_sockpuppets_of_Fardsk.csv,149,43817492.0,37,112,34,3,0,56.52348993288591,432,40,17.161073825503355,11
Category_Wikipedia_sockpuppets_of_Bcnelson13.csv,116,4026544.0,51,65,45,6,0,39.88793103448276,233,46,22.04310344827586,15
Category_Wikipedia_sockpuppets_of_Questwolf.csv,835,2469693.0,510,325,500,10,0,104.33532934131736,249,68,25.689820359281438,5
Category_Wikipedia_sockpuppets_of_Okayama.csv,28,117178.0,12,16,12,0,0,37.785714285714285,159,26,22.535714285714285,17
Category_Wikipedia_sockpuppets_of_Transclusionzombie.csv,14,350021.0,7,7,4,3,0,31.785714285714285,146,36,21.142857142857142,11
Category_Wikipedia_sockpuppets_of_RoadHouse.csv,3454,21081171.0,818,2636,416,402,0,42.468731905037636,249,54,13.13288940359004,3
Category_Wikipedia_sockpuppets_of_Karki173.csv,365,80066974.0,263,102,174,89,0,25.75068493150685,255,23,13.887671232876713,8
Category_Wikipedia_sockpuppets_of_Bobby232332.csv,272,13826943.0,73,199,72,1,0,58.41544117647059,255,45,24.856617647058822,12
Category_Wikipedia_sockpuppets_of_NamanNomad.csv,528,60503900.0,158,370,140,18,0,63.36931818181818,496,63,19.401515151515152,5
Category_Wikipedia_sockpuppets_of_Qingprof.csv,1329,58576518.0,488,841,426,62,0,40.79984951091046,252,47,23.785553047404065,4
Category_Wikipedia_sockpuppets_of_Rich1982.csv,133,12096427.0,69,64,59,10,0,55.06015037593985,255,48,21.954887218045112,5
Category_Wikipedia_sockpuppets_of_Sloppysecondsscott.csv,58,6476245.0,22,36,5,17,0,48.5,230,25,15.913793103448276,9
Category_Wikipedia_sockpuppets_of_Albert14nx05y.csv,1292,8725236.0,402,890,197,205,0,52.93343653250774,250,49,19.73219814241486,5
Category_Wikipedia_sockpuppets_of_Joeillybob.csv,1650,7772060.0,1247,403,500,747,0,9.072121212121212,212,40,27.164242424242424,13
Category_Wikipedia_sockpuppets_of_Dittoalexia.csv,5,359881.0,4,1,2,2,0,30.6,59,21,20.6,20
Category_Wikipedia_sockpuppets_of_Anine_Archer.csv,2,0.0,1,1,1,0,36,36.0,36,15,15.0,15
Category_Wikipedia_sockpuppets_of_Oxyman42.csv,1829,38272919.0,556,1273,500,56,0,36.229633679606344,255,80,26.164024056861674,2
Category_Wikipedia_sockpuppets_of_Iranleo.csv,34,18480143.0,19,15,8,11,0,49.61764705882353,192,17,15.176470588235293,15
Category_Wikipedia_sockpuppets_of_Shaniack77.csv,2187,89075267.0,551,1636,281,270,0,47.40695016003658,255,77,16.483310470964792,3
Category_Wikipedia_sockpuppets_of_Veuveclicquot1.csv,98,13662782.0,44,54,23,21,2,44.55102040816327,194,46,41.09183673469388,18
Category_Wikipedia_sockpuppets_of_Sanghicementseo.csv,3,63559.0,2,1,1,1,0,65.33333333333333,196,25,24.666666666666668,24
Category_Wikipedia_sockpuppets_of_Armani621.csv,12,38978013.0,4,8,3,1,0,40.25,154,44,18.75,6
Category_Wikipedia_sockpuppets_of_HordeFTL.csv,7866,361649418.0,2630,5236,500,2130,0,43.77637935418256,395,73,20.02834986015764,3
Category_Wikipedia_sockpuppets_of_Mr.t.young.csv,154,1242494.0,44,110,19,25,0,63.564935064935064,281,30,15.928571428571429,9
Category_Wikipedia_sockpuppets_of_LionelTechTips.csv,92,3545914.0,42,50,37,5,0,54.73913043478261,496,54,24.97826086956522,15
Category_Wikipedia_sockpuppets_of_AmeOnTheLoose.csv,75,6974268.0,44,31,24,20,0,37.053333333333335,246,36,17.16,12
Category_Wikipedia_sockpuppets_of_Sleepinthestars.csv,1558,122336979.0,690,868,500,190,0,39.33119383825417,492,61,29.12451861360719,8
Category_Wikipedia_sockpuppets_of_Nastar33.csv,655,299445859.0,163,492,42,121,0,40.62900763358778,347,40,14.853435114503817,3
Category_Wikipedia_sockpuppets_of_Keepquickt.csv,228,9096677.0,98,130,59,39,0,54.8640350877193,468,47,17.00438596491228,4
Category_Wikipedia_sockpuppets_of_Hansnarf.csv,288,3853407.0,124,164,76,48,0,58.39930555555556,288,47,28.243055555555557,12
Category_Wikipedia_sockpuppets_of_ScorchingPheonix.csv,191,2081353.0,51,140,38,13,0,54.518324607329845,224,58,24.465968586387433,11
Category_Wikipedia_sockpuppets_of_3Oh_Hexelon.csv,1996,85531415.0,584,1412,500,84,0,47.75200400801603,499,48,13.802605210420841,4
Category_Wikipedia_sockpuppets_of_Detyu15.csv,42,8139444.0,18,24,16,2,0,83.69047619047619,272,22,16.976190476190474,5
Category_Wikipedia_sockpuppets_of_Evergreen2020.csv,151,91925859.0,37,114,30,7,0,57.033112582781456,249,53,22.5364238410596,7
Category_Wikipedia_sockpuppets_of_DatGuy.csv,1132,31990020.0,503,629,500,3,0,72.1386925795053,311,70,25.09010600706714,5
Category_Wikipedia_sockpuppets_of_TransLivesMatter6284.csv,23,3401501.0,14,9,10,4,0,136.8695652173913,498,20,17.0,15
Category_Wikipedia_sockpuppets_of_Italways22.csv,771,5131556.0,264,507,250,14,0,29.931258106355383,219,68,18.82360570687419,4
Category_Wikipedia_sockpuppets_of_XVBAZaStantonXV.csv,65,1828958.0,23,42,8,15,0,64.64615384615385,254,30,16.923076923076923,5
Category_Wikipedia_sockpuppets_of_Chamithar.csv,59,3953636.0,52,7,45,7,0,9.135593220338983,114,31,18.88135593220339,18
Category_Wikipedia_sockpuppets_of_Dialpartners.csv,22,1240003.0,9,13,5,4,10,38.27272727272727,100,43,27.545454545454547,17
Category_Wikipedia_sockpuppets_of_Gaeotjhaoierppqhg5h800qer.csv,11,91755.0,5,6,3,2,0,87.18181818181819,224,32,20.272727272727273,11
Category_Wikipedia_sockpuppets_of_Rda962012.csv,1048,13341231.0,397,651,221,176,0,39.85591603053435,500,47,22.29293893129771,5
Category_Wikipedia_sockpuppets_of_Snap-OnToolGuy.csv,478,4854144.0,140,338,80,60,0,49.11506276150627,419,50,17.234309623430963,7
Category_Wikipedia_sockpuppets_of_Chiyiung.csv,82,225419009.0,39,43,31,8,0,39.670731707317074,225,18,12.804878048780488,12
Category_Wikipedia_sockpuppets_of_Inlinetext.csv,1486,4363754.0,504,982,500,4,0,50.87415881561238,255,78,33.54306864064603,4
Category_Wikipedia_sockpuppets_of_MTV_Hits.csv,783,9329927.0,274,509,66,208,0,46.55555555555556,494,54,20.713920817369093,3
Category_Wikipedia_sockpuppets_of_Alwardamin.csv,279,22261902.0,217,62,198,19,0,26.61648745519713,390,49,33.64874551971326,20
Category_Wikipedia_sockpuppets_of_Smoortsixe.csv,37,1563485.0,11,26,7,4,0,48.648648648648646,139,37,28.0,15
Category_Wikipedia_sockpuppets_of_Jayjg.csv,1988,551906199.0,501,1487,500,1,0,59.343058350100605,353,69,18.101609657947687,4
Category_Wikipedia_sockpuppets_of_Po_Kadzieli.csv,1729,55531459.0,532,1197,500,32,0,46.83111625216888,254,69,18.380566801619434,5
Category_Wikipedia_sockpuppets_of_Record44.csv,92,2355787.0,48,44,20,28,0,73.51086956521739,185,44,26.565217391304348,8
Category_Wikipedia_sockpuppets_of_Rodelyn18.csv,33,1835566.0,14,19,13,1,0,33.36363636363637,152,27,15.212121212121213,11
Category_Wikipedia_sockpuppets_of_Maron55.csv,708,4178309.0,210,498,71,139,0,51.206214689265536,249,42,14.189265536723164,4
Category_Wikipedia_sockpuppets_of_Schadow1.csv,1395,59258077.0,469,926,380,89,0,52.87956989247312,260,71,22.470967741935485,4
Category_Wikipedia_sockpuppets_of_Karadenizlim25.csv,1050,438919320.0,265,785,140,125,0,40.794285714285714,483,49,15.212380952380952,4
Category_Wikipedia_sockpuppets_of_Alexey-spb.csv,219,31279206.0,93,126,62,31,0,37.054794520547944,199,60,22.557077625570777,7
Category_Wikipedia_sockpuppets_of_Sourguy3665.csv,320,12970947.0,94,226,65,29,0,43.203125,234,41,19.603125,8
Category_Wikipedia_sockpuppets_of_Niggradamus.csv,22,230224.0,10,12,4,6,0,49.95454545454545,183,55,39.86363636363637,14
Category_Wikipedia_sockpuppets_of_Bryceia.csv,803,19009800.0,190,613,60,130,0,30.2640099626401,244,47,19.85678704856787,5
Category_Wikipedia_sockpuppets_of_PrinceSong.csv,93,129603381.0,24,69,22,2,0,58.68817204301075,231,46,15.311827956989248,5
Category_Wikipedia_sockpuppets_of_Awolf58.csv,13078,412575496.0,3768,9310,500,3268,0,48.06086557577611,503,111,20.40541367181526,3
Category_Wikipedia_sockpuppets_of_TWCZack.csv,315,27999777.0,115,200,49,66,0,45.70793650793651,490,51,18.663492063492065,4
Category_Wikipedia_sockpuppets_of_Anpang01.csv,6,431.0,4,2,4,0,0,43.666666666666664,129,23,20.666666666666668,16
Category_Wikipedia_sockpuppets_of_Lap777ab.csv,22,533974.0,9,13,7,2,0,56.59090909090909,243,35,30.0,23
Category_Wikipedia_sockpuppets_of_Erwin_Morland.csv,158,29055379.0,53,105,11,42,0,49.379746835443036,248,52,16.069620253164558,6
Category_Wikipedia_sockpuppets_of_Fanofmissworld.csv,804,18365378.0,260,544,208,52,0,41.01990049751244,255,54,16.96144278606965,9
Category_Wikipedia_sockpuppets_of_Lylepri.csv,1,0.0,1,0,1,0,112,112.0,112,19,19.0,19
Category_Wikipedia_sockpuppets_of_Themysterioustroll.csv,12,5071958.0,11,1,7,4,0,25.75,145,42,42.0,42
Category_Wikipedia_sockpuppets_of_Petit_B√©b√©.csv,1239,2515579.0,438,801,434,4,0,51.35351089588378,388,84,23.495560936238903,5
Category_Wikipedia_sockpuppets_of_JohnRamirez.csv,1046,61070431.0,250,796,215,35,0,41.410133843212236,255,57,25.72562141491396,5
Category_Wikipedia_sockpuppets_of_RAJA_NARAYAN_TRIPATHY.csv,51,139085.0,15,36,14,1,0,52.411764705882355,255,43,17.45098039215686,6
Category_Wikipedia_sockpuppets_of_UnnamedUser.csv,4478,62026778.0,1335,3143,500,835,0,65.5413130861992,500,216,23.552702099151407,1
Category_Wikipedia_sockpuppets_of_Quy_wiki123.csv,39,11701356.0,14,25,9,5,0,44.30769230769231,208,24,13.179487179487179,8
Category_Wikipedia_sockpuppets_of_Rcool35.csv,1386,55474804.0,352,1034,199,153,0,35.40548340548341,250,45,14.95093795093795,3
Category_Wikipedia_sockpuppets_of_Ngamtong.csv,6,3934.0,4,2,2,2,0,64.5,272,16,16.0,16
Category_Wikipedia_sockpuppets_of_Genius404.csv,31,18141309.0,12,19,11,1,0,43.38709677419355,158,30,20.35483870967742,16
Category_Wikipedia_sockpuppets_of_Goguryeo.csv,2898,8727839.0,1099,1799,500,599,0,25.476190476190474,203,63,17.750172532781228,3
Category_Wikipedia_sockpuppets_of_UpWithJimmy.csv,883,36747676.0,240,643,232,8,0,51.570781426953566,336,43,17.917327293318234,5
Category_Wikipedia_sockpuppets_of_Mark_Jhonny.csv,1594,20062300.0,645,949,388,257,0,30.534504391468005,495,37,17.90276035131744,4
Category_Wikipedia_sockpuppets_of_Penaamiel.csv,230,17026472.0,82,148,69,13,0,23.86521739130435,222,41,17.213043478260868,7
Category_Wikipedia_sockpuppets_of_Bigpickleman.csv,21,67784.0,17,4,9,8,0,30.428571428571427,153,41,25.38095238095238,14
Category_Wikipedia_sockpuppets_of_Barney83Stinson.csv,667,16577115.0,256,411,160,96,0,41.94302848575712,262,61,18.91454272863568,3
Category_Wikipedia_sockpuppets_of_TruthfulPerson.csv,807,84096271.0,281,526,178,103,0,53.40272614622057,255,52,22.903345724907062,7
Category_Wikipedia_sockpuppets_of_Chiclefriquedubai.csv,51,35073940.0,15,36,13,2,0,43.431372549019606,208,33,19.137254901960784,9
Category_Wikipedia_sockpuppets_of_Esthappanos_Bar_Geevarghese.csv,299,28143895.0,104,195,103,1,0,40.38795986622073,273,51,22.31438127090301,7
Category_Wikipedia_sockpuppets_of_Ciclone.csv,341,10849541.0,139,202,82,57,0,46.624633431085044,234,44,17.98240469208211,6
Category_Wikipedia_sockpuppets_of_Charlie766.csv,273,147793159.0,125,148,70,55,0,39.553113553113555,227,48,14.128205128205128,8
Category_Wikipedia_sockpuppets_of_T.taylor1997.csv,209,26702556.0,78,131,67,11,0,36.73684210526316,324,38,21.904306220095695,10
Category_Wikipedia_sockpuppets_of_J_Strikers.csv,265,784551.0,100,165,66,34,0,20.852830188679246,496,63,32.033962264150944,10
Category_Wikipedia_sockpuppets_of_FlyerfromTO.csv,34,2599470.0,21,13,18,3,0,63.35294117647059,232,21,16.794117647058822,14
Category_Wikipedia_sockpuppets_of_Wroth_of_Groth.csv,724,52944770.0,288,436,25,263,0,35.35497237569061,246,127,24.41988950276243,5
Category_Wikipedia_sockpuppets_of_Madalina_Cristina.csv,12,89253.0,6,6,4,2,11,38.916666666666664,92,21,19.25,18
Category_Wikipedia_sockpuppets_of_Thylacoop5.csv,2321,29050593.0,823,1498,500,323,0,54.57604480827229,426,55,22.121930202498923,3
Category_Wikipedia_sockpuppets_of_The_Real_Punk_Rockers.csv,133,77958973.0,87,46,80,7,0,29.172932330827066,393,43,20.1203007518797,14
Category_Wikipedia_sockpuppets_of_Roscomoner.csv,1644,33880878.0,534,1110,500,34,0,45.496350364963504,252,66,14.807177615571776,4
Category_Wikipedia_sockpuppets_of_Henrywinklestein.csv,342,160294071.0,102,240,83,19,0,45.45614035087719,227,50,25.190058479532162,7
Category_Wikipedia_sockpuppets_of_Penguindude97.csv,509,22691748.0,155,354,149,6,0,38.62082514734774,216,37,19.284872298624755,5
Category_Wikipedia_sockpuppets_of_Lokalkosmopolit.csv,5040,82078761.0,1398,3642,500,898,0,54.39206349206349,255,94,24.47222222222222,3
Category_Wikipedia_sockpuppets_of_Degrinehopper1617.csv,650,14082032.0,278,372,232,46,0,42.244615384615386,254,53,25.267692307692307,11
Category_Wikipedia_sockpuppets_of_PavelStaykov.csv,2341,106201934.0,829,1512,500,329,0,50.00768902178556,356,54,12.809483126868859,4
Category_Wikipedia_sockpuppets_of_Peace555.csv,324,11144667.0,140,184,140,0,0,37.083333333333336,217,30,19.308641975308642,12
Category_Wikipedia_sockpuppets_of_L.z.motloung55.csv,30,7629586.0,10,20,9,1,0,57.6,142,39,19.233333333333334,7
Category_Wikipedia_sockpuppets_of_Baconator.csv,1,0.0,1,0,1,0,13,13.0,13,16,16.0,16
Category_Wikipedia_sockpuppets_of_Karam06.csv,63,14004904.0,24,39,24,0,0,74.82539682539682,201,42,19.904761904761905,8
Category_Wikipedia_sockpuppets_of_Summerfine.csv,285,22649488.0,115,170,67,48,0,44.67719298245614,223,30,12.785964912280702,6
Category_Wikipedia_sockpuppets_of_Iamabhu.csv,45,196685643.0,11,34,6,5,0,56.0,229,40,19.333333333333332,14
Category_Wikipedia_sockpuppets_of_Brucethrillis.csv,499,224509739.0,197,302,177,20,0,37.23246492985972,230,23,13.885771543086172,8
Category_Wikipedia_sockpuppets_of_⁄©Ÿàÿ±Ÿàÿ¥_ÿ™ÿ±ÿ®ÿ™_ÿ≤ÿßÿØŸá.csv,40,180405.0,17,23,9,8,0,46.0,199,30,15.025,7
Category_Wikipedia_sockpuppets_of_Guccibelucci.csv,496,361144434.0,166,330,110,56,0,55.57056451612903,483,51,17.278225806451612,5
Category_Wikipedia_sockpuppets_of_PAVLOVSKIDS.csv,38,1211828.0,15,23,7,8,0,52.78947368421053,193,25,15.447368421052632,10
Category_Wikipedia_sockpuppets_of_Tomatocoffinbranch.csv,32,2409787.0,15,17,5,10,0,57.53125,255,17,13.71875,12
Category_Wikipedia_sockpuppets_of_Nachteilig.csv,117,14699450.0,46,71,45,1,0,46.41880341880342,234,24,15.094017094017094,6
Category_Wikipedia_sockpuppets_of_XTATX.csv,25,17325213.0,16,9,10,6,0,52.76,220,33,33.0,33
Category_Wikipedia_sockpuppets_of_CasBaird.csv,111,3636587.0,37,74,15,22,0,78.1891891891892,301,50,18.333333333333332,8
Category_Wikipedia_sockpuppets_of_Albe23413.csv,3449,18169668.0,1166,2283,500,666,0,34.364453464772396,441,43,18.29747752971876,5
Category_Wikipedia_sockpuppets_of_Strategicasian.csv,318,10984538.0,131,187,77,54,0,41.069182389937104,464,50,19.38679245283019,5
Category_Wikipedia_sockpuppets_of_Essay_editor.csv,8,1691318.0,5,3,5,0,0,8.75,41,55,39.5,24
Category_Wikipedia_sockpuppets_of_WikipediaNOVA.csv,170,45436123.0,72,98,25,47,0,58.688235294117646,255,37,22.66470588235294,14
Category_Wikipedia_sockpuppets_of_Stark_Bollocks.csv,82,1945.0,34,48,34,0,0,77.13414634146342,188,33,14.573170731707316,7
Category_Wikipedia_sockpuppets_of_Wikipedia6791.csv,6,301919.0,4,2,3,1,0,48.333333333333336,153,17,17.0,17
Category_Wikipedia_sockpuppets_of_Askwieuol.csv,197,88163341.0,75,122,53,22,0,45.629441624365484,252,59,23.243654822335024,5
Category_Wikipedia_sockpuppets_of_Freshmangrandcaravan.csv,125,14209934.0,25,100,11,14,0,50.584,212,18,18.0,18
Category_Wikipedia_sockpuppets_of_Citynewsmedia.csv,80,4644441.0,26,54,23,3,0,43.1,250,56,29.475,13
Category_Wikipedia_sockpuppets_of_Talon_Briceington.csv,42,11340920.0,16,26,14,2,0,83.83333333333333,496,30,17.11904761904762,12
Category_Wikipedia_sockpuppets_of_Baxter555.csv,136,13584902.0,67,69,35,32,0,80.44117647058823,500,51,18.830882352941178,12
Category_Wikipedia_sockpuppets_of_Pahlavan_Qahremani.csv,1277,73169885.0,347,930,342,5,0,48.35317149569303,262,31,13.793265465935788,4
Category_Wikipedia_sockpuppets_of_Dr_Ujjwal_Chugh.csv,11,411830.0,5,6,2,3,0,50.72727272727273,144,24,19.09090909090909,15
Category_Wikipedia_sockpuppets_of_XcrimeboosX.csv,9,3619297.0,4,5,3,1,9,87.55555555555556,315,30,22.88888888888889,14
Category_Wikipedia_sockpuppets_of_Themarketinguru.csv,12,1930414.0,9,3,6,3,10,43.5,128,25,21.75,12
Category_Wikipedia_sockpuppets_of_Ikiwaidep666.csv,16,117848.0,9,7,9,0,0,70.0,207,18,8.5,4
Category_Wikipedia_sockpuppets_of_Nigerian_taekwondo_novice.csv,144,815197.0,38,106,15,23,0,54.986111111111114,197,61,18.75,6
Category_Wikipedia_sockpuppets_of_Aulonocara.csv,106,23234134.0,46,60,25,21,0,72.0377358490566,254,50,21.21698113207547,10
Category_Wikipedia_sockpuppets_of_Rmjtha.csv,589,5107219.0,179,410,100,79,0,51.55178268251273,260,74,26.35483870967742,5
Category_Wikipedia_sockpuppets_of_DJdjPollard15.csv,5674,185683229.0,1993,3681,500,1493,0,42.354071201973916,483,67,23.595347197744097,3
Category_Wikipedia_sockpuppets_of_Bollywood_king14.csv,120,786945.0,38,82,33,5,0,29.266666666666666,222,28,15.366666666666667,8
Category_Wikipedia_sockpuppets_of_RabidMelon.csv,2407,274773078.0,776,1631,228,548,0,53.9501454092231,280,77,21.25384295803905,7
Category_Wikipedia_sockpuppets_of_Maypigeon_of_Liberty.csv,1209,7989347.0,322,887,310,12,0,66.24979321753516,227,51,17.70885028949545,3
Category_Wikipedia_sockpuppets_of_Ashleymendes.csv,14,25327.0,4,10,4,0,0,54.785714285714285,184,14,9.785714285714286,5
Category_Wikipedia_sockpuppets_of_Jack.J.Yang.csv,48,75733.0,28,20,14,14,0,31.354166666666668,255,27,15.625,8
Category_Wikipedia_sockpuppets_of_Alex_(Brampton).csv,1791,48814503.0,663,1128,500,163,0,42.39307649357901,470,46,22.65605806811837,2
Category_Wikipedia_sockpuppets_of_Goth_and_Throbb99.csv,532,4326714.0,221,311,219,2,0,25.334586466165412,253,67,18.55639097744361,4
Category_Wikipedia_sockpuppets_of_Beaner22.csv,4,254176.0,3,1,1,2,0,68.25,181,15,15.0,15
Category_Wikipedia_sockpuppets_of_È°ìÂ¶Ç.csv,106,1597400.0,41,65,34,7,0,51.77358490566038,253,92,15.679245283018869,3
Category_Wikipedia_sockpuppets_of_Johnericlee.csv,1563,18585100.0,378,1185,301,77,0,47.29174664107486,255,77,23.461932181701854,4
Category_Wikipedia_sockpuppets_of_Ruhaan_Aditya.csv,198,1842321.0,85,113,56,29,0,35.74747474747475,205,60,26.81313131313131,13
Category_Wikipedia_sockpuppets_of_Norden1990.csv,1486,409148708.0,519,967,500,19,0,47.51951547779273,496,45,18.98384925975774,5
Category_Wikipedia_sockpuppets_of_SquareInARoundHole.csv,1458,5870864.0,566,892,500,66,0,56.08024691358025,496,60,26.783264746227708,9
Category_Wikipedia_sockpuppets_of_Gum123654.csv,9,30045.0,5,4,4,1,13,76.77777777777777,197,11,8.444444444444445,6
Category_Wikipedia_sockpuppets_of_Cresix.csv,2270,29556115.0,540,1730,500,40,0,60.99911894273128,255,82,17.802202643171807,4
Category_Wikipedia_sockpuppets_of_News_Portal_BD.csv,6,1006590.0,3,3,2,1,28,50.0,75,24,21.666666666666668,19
Category_Wikipedia_sockpuppets_of_ËÄÅÂ±±Âì•Âì•.csv,50,4927045.0,37,13,33,4,0,20.16,153,7,7.0,7
Category_Wikipedia_sockpuppets_of_Improved_edits.csv,3,90.0,2,1,2,0,0,90.66666666666667,136,50,50.0,50
Category_Wikipedia_sockpuppets_of_Beatrizburle.csv,4878,82179025.0,1085,3793,500,585,0,40.48790487904879,459,59,20.67609676096761,3
Category_Wikipedia_sockpuppets_of_FREETHEUYGHURS.csv,503,14187991.0,251,252,193,58,0,36.886679920477135,348,48,18.13717693836978,10
Category_Wikipedia_sockpuppets_of_DemitreusFrontwest.csv,1284,304410044.0,270,1014,261,9,0,48.309190031152646,255,47,18.66588785046729,3
Category_Wikipedia_sockpuppets_of_Darkwolfz.csv,466,102973198.0,190,276,182,8,0,55.257510729613735,417,65,20.489270386266096,7
Category_Wikipedia_sockpuppets_of_Jamesnumber2.csv,122,5755855.0,34,88,29,5,0,71.20491803278688,500,50,19.852459016393443,7
Category_Wikipedia_sockpuppets_of_Somethingoranother.csv,1784,5662247.0,518,1266,500,18,0,41.948991031390136,200,52,13.210762331838565,3
Category_Wikipedia_sockpuppets_of_GamingGrape20000.csv,1193,8175837.0,407,786,323,84,0,40.186923721709974,500,34,16.155071248952222,4
Category_Wikipedia_sockpuppets_of_Kolossoni.csv,1936,62201566.0,648,1288,500,148,0,47.914256198347104,490,53,18.902376033057852,4
Category_Wikipedia_sockpuppets_of_Juan90264.csv,95,80374704.0,33,62,33,0,0,56.76842105263158,311,25,15.842105263157896,7
Category_Wikipedia_sockpuppets_of_Wisehelp.csv,305,85901781.0,115,190,107,8,0,47.49508196721312,255,33,17.731147540983606,6
Category_Wikipedia_sockpuppets_of_Ameer_Hamza_Raikoti.csv,179,3713487.0,57,122,16,41,0,43.497206703910614,222,51,21.508379888268156,5
Category_Wikipedia_sockpuppets_of_Anton503.csv,7,1098.0,4,3,3,1,0,12.285714285714286,26,38,38.0,38
Category_Wikipedia_sockpuppets_of_Archtransit.csv,6739,56519187.0,2201,4538,500,1701,0,39.26487609437602,249,102,24.21293960528268,4
Category_Wikipedia_sockpuppets_of_Dmjoshi12.csv,2383,77869030.0,795,1588,398,397,0,36.29836340746957,462,45,16.588753671842216,5
Category_Wikipedia_sockpuppets_of_Big.P.csv,1539,132618231.0,527,1012,500,27,0,35.424301494476936,245,60,19.430799220272906,4
Category_Wikipedia_sockpuppets_of_True_N.csv,230,315595863.0,76,154,38,38,0,42.21304347826087,385,52,19.13478260869565,3
Category_Wikipedia_sockpuppets_of_Dolovis.csv,4578,465671523.0,1499,3079,500,999,0,49.98208824814329,496,122,19.95827872433377,2
Category_Wikipedia_sockpuppets_of_Wioaw.csv,1845,73526757.0,830,1015,500,330,0,40.541463414634144,523,63,21.86341463414634,5
Category_Wikipedia_sockpuppets_of_S_Sharma_24.csv,961,22997566.0,431,530,205,226,0,24.207075962539022,496,45,20.173777315296565,7
Category_Wikipedia_sockpuppets_of_Addinqaisara.csv,245,1144120.0,74,171,38,36,0,43.10612244897959,208,38,20.3265306122449,7
Category_Wikipedia_sockpuppets_of_Dan_d_dog20.csv,512,87263176.0,182,330,163,19,0,33.3125,225,43,22.0078125,11
Category_Wikipedia_sockpuppets_of_Her631.csv,417,2422695.0,165,252,86,79,0,41.11031175059952,234,53,20.014388489208635,5
Category_Wikipedia_sockpuppets_of_Elliotthomaspotts.csv,2202,21890536.0,806,1396,500,306,0,34.641689373297005,394,48,19.057220708446867,8
Category_Wikipedia_sockpuppets_of_Sayaanalam.csv,67,5316051.0,23,44,21,2,0,42.37313432835821,204,37,19.35820895522388,6
Category_Wikipedia_sockpuppets_of_Robin75aw.csv,858,1040425.0,564,294,500,64,0,37.36480186480186,304,54,19.28787878787879,7
Category_Wikipedia_sockpuppets_of_Melvindillinger.csv,1654,764463.0,684,970,500,184,0,38.0441354292624,476,59,41.26420798065296,4
Category_Wikipedia_sockpuppets_of_Jobxavier.csv,1719,546895507.0,687,1032,500,187,0,52.28621291448517,309,68,29.26061663757999,9
Category_Wikipedia_sockpuppets_of_Albert_Ramos_Jr_(Football_Player).csv,127,53308380.0,85,42,35,50,0,33.63779527559055,199,38,23.322834645669293,11
Category_Wikipedia_sockpuppets_of_Hosam3000.csv,2,315.0,2,0,1,1,500,500.0,500,29,24.0,19
Category_Wikipedia_sockpuppets_of_Austereraj.csv,780,98837508.0,318,462,250,68,0,43.01282051282051,246,34,15.743589743589743,3
Category_Wikipedia_sockpuppets_of_Somed00d1997.csv,1756,51729632.0,438,1318,255,183,0,62.94703872437358,497,31,11.351936218678816,3
Category_Wikipedia_sockpuppets_of_Joekhdeir.csv,5,6082.0,2,3,2,0,0,89.2,186,34,19.0,9
Category_Wikipedia_sockpuppets_of_Tonya_Heslet.csv,18,8775.0,8,10,6,2,0,42.611111111111114,187,29,17.333333333333332,7
Category_Wikipedia_sockpuppets_of_Itsmezigapajank.csv,7,5832.0,5,2,5,0,0,15.142857142857142,36,25,22.857142857142858,22
Category_Wikipedia_sockpuppets_of_MentorRC.csv,101,19676086.0,61,40,46,15,0,47.53465346534654,227,65,41.57425742574257,6
Category_Wikipedia_sockpuppets_of_Mr.sandippaul.csv,1282,113917494.0,313,969,306,7,0,51.826053042121686,303,62,15.939157566302653,3
Category_Wikipedia_sockpuppets_of_Mykungfu.csv,2273,53093936.0,840,1433,191,649,0,38.91684997800264,215,71,24.611526616805982,5
Category_Wikipedia_sockpuppets_of_Stimmer16.csv,10,6041739.0,8,2,5,3,0,76.6,197,18,18.0,18
Category_Wikipedia_sockpuppets_of_JohnnyOrgseed.csv,487,9688760.0,162,325,154,8,0,51.94250513347023,238,43,12.632443531827516,3
Category_Wikipedia_sockpuppets_of_Steris_India.csv,45,1499602.0,15,30,5,10,0,69.57777777777778,224,53,19.533333333333335,8
Category_Wikipedia_sockpuppets_of_BlackW76.csv,2873,58120299.0,1051,1822,500,551,0,41.602854159415244,500,70,21.90184476157327,3
Category_Wikipedia_sockpuppets_of_Owlfarm88.csv,17,410707.0,7,10,7,0,0,52.88235294117647,216,20,16.823529411764707,14
Category_Wikipedia_sockpuppets_of_LatinCultureTodat.csv,3273,240182122.0,828,2445,445,383,0,56.04766269477543,504,65,18.194317140238315,4
Category_Wikipedia_sockpuppets_of_Mablu23.csv,860,100661348.0,327,533,72,255,0,38.71860465116279,254,65,17.346511627906978,3
Category_Wikipedia_sockpuppets_of_Balargniyd.csv,9,273938.0,8,1,6,2,0,33.44444444444444,111,23,23.0,23
Category_Wikipedia_sockpuppets_of_Jordanben.csv,385,4069936.0,122,263,96,26,0,52.04935064935065,229,38,18.932467532467534,3
Category_Wikipedia_sockpuppets_of_Utsav_kapadiya.csv,352,102278955.0,105,247,104,1,0,38.08806818181818,376,42,17.235795454545453,5
Category_Wikipedia_sockpuppets_of_Asim143.csv,243,158529074.0,58,185,55,3,0,58.89300411522634,255,33,18.609053497942387,7
Category_Wikipedia_sockpuppets_of_Emerson22.csv,85,9614215.0,33,52,31,2,0,48.63529411764706,188,19,13.435294117647059,11
Category_Wikipedia_sockpuppets_of_Smellypoopyface.csv,1,0.0,1,0,1,0,70,70.0,70,23,23.0,23
Category_Wikipedia_sockpuppets_of_Choftstafd.csv,42,61414732.0,9,33,5,4,0,79.30952380952381,234,23,16.523809523809526,9
Category_Wikipedia_sockpuppets_of_Eirekara.csv,25,876.0,18,7,18,0,0,30.48,148,29,27.68,18
Category_Wikipedia_sockpuppets_of_Selim_Shaikh.csv,229,15750900.0,89,140,20,69,0,39.44978165938865,291,53,19.563318777292576,8
Category_Wikipedia_sockpuppets_of_Antero_ambi.csv,190,41878476.0,82,108,31,51,0,48.28947368421053,495,53,16.389473684210525,4
Category_Wikipedia_sockpuppets_of_Grsdfv.csv,58,11298725.0,12,46,6,6,0,45.241379310344826,178,18,13.310344827586206,4
Category_Wikipedia_sockpuppets_of_Vishnu_Ganeshan_123.csv,190,47540901.0,64,126,56,8,0,52.68421052631579,354,32,17.4,5
Category_Wikipedia_sockpuppets_of_EunSoo.csv,2099,2291412.0,744,1355,500,244,0,36.72606002858504,255,54,20.395902810862314,2
Category_Wikipedia_sockpuppets_of_CUCermaics.csv,1,0.0,1,0,1,0,197,197.0,197,28,28.0,28
Category_Wikipedia_sockpuppets_of_SIeepyBot.csv,43,40285041.0,40,3,17,23,0,18.930232558139537,154,27,23.209302325581394,14
Category_Wikipedia_sockpuppets_of_Braingym1.csv,39,3387787.0,30,9,24,6,0,45.48717948717949,198,28,22.256410256410255,19
Category_Wikipedia_sockpuppets_of_SHRI_JAYANTA_BARUAH.csv,1184,3425133.0,351,833,322,29,0,48.03125,315,59,15.48733108108108,4
Category_Wikipedia_sockpuppets_of_Maxviwe.csv,3202,344275233.0,968,2234,500,468,0,56.10462211118051,419,98,25.91380387257964,4
Category_Wikipedia_sockpuppets_of_Betabum.csv,1154,2553115.0,508,646,500,8,0,42.52686308492201,492,71,21.2157712305026,6
Category_Wikipedia_sockpuppets_of_Jafarfrotan.csv,2915,11817685.0,805,2110,438,367,0,40.599313893653516,474,101,19.24288164665523,3
Category_Wikipedia_sockpuppets_of_Cheesels999.csv,45,7505247.0,11,34,6,5,0,47.15555555555556,181,39,17.2,7
Category_Wikipedia_sockpuppets_of_VedikaThorat.csv,83,6573357.0,41,42,21,20,0,54.265060240963855,288,61,20.072289156626507,15
Category_Wikipedia_sockpuppets_of_Juliusiji.csv,377,66111736.0,127,250,53,74,0,50.53050397877984,321,47,20.387267904509283,6
Category_Wikipedia_sockpuppets_of_Fun_Realms.csv,33,257625.0,16,17,9,7,0,45.81818181818182,229,24,15.333333333333334,11
Category_Wikipedia_sockpuppets_of_Gng1999.csv,3671,10862962.0,966,2705,500,466,0,50.58104058839553,496,61,20.283029147371288,5
Category_Wikipedia_sockpuppets_of_Madhura153.csv,104,2517093.0,34,70,8,26,0,48.97115384615385,209,39,14.76923076923077,4
Category_Wikipedia_sockpuppets_of_LuLu3.csv,214,19012396.0,76,138,14,62,0,31.710280373831775,203,31,16.714953271028037,10
Category_Wikipedia_sockpuppets_of_Quaboagman.csv,1,0.0,1,0,1,0,0,0.0,0,35,35.0,35
Category_Wikipedia_sockpuppets_of_Sakthi_swaroop.csv,583,38629274.0,228,355,197,31,0,41.88507718696398,241,62,22.55746140651801,8
Category_Wikipedia_sockpuppets_of_Einsteindonut.csv,1561,9132076.0,541,1020,500,41,0,48.086483023702755,255,57,32.45035233824471,6
Category_Wikipedia_sockpuppets_of_Vc4137.csv,6751,67581650.0,2383,4368,500,1883,0,44.97689231225004,504,61,18.736187231521257,4
Category_Wikipedia_sockpuppets_of_Sharmaren.csv,69,44686163.0,45,24,23,22,0,24.869565217391305,185,22,15.101449275362318,15
Category_Wikipedia_sockpuppets_of_Swakutty.csv,1019,13318335.0,360,659,328,32,0,39.343473994111875,500,54,23.59666339548577,8
Category_Wikipedia_sockpuppets_of_Clubagroup.csv,4,2950.0,2,2,1,1,0,48.75,74,26,23.0,20
Category_Wikipedia_sockpuppets_of_Shah_Mohi.csv,537,45545027.0,126,411,71,55,0,51.12849162011173,333,39,10.513966480446927,3
Category_Wikipedia_sockpuppets_of_KpopExpert.csv,22,268019.0,6,16,6,0,0,32.22727272727273,163,27,17.318181818181817,12
Category_Wikipedia_sockpuppets_of_Shawn_Storm.csv,192,22987609.0,83,109,38,45,0,39.5,250,23,11.609375,5
Category_Wikipedia_sockpuppets_of_Armsmadglobal.csv,33,1749002.0,12,21,6,6,0,41.666666666666664,158,52,48.24242424242424,21
Category_Wikipedia_sockpuppets_of_Zoonmatt.csv,47,17622628.0,16,31,7,9,0,52.8936170212766,225,22,15.042553191489361,10
Category_Wikipedia_sockpuppets_of_Sedamjedan.csv,495,10178760.0,257,238,205,52,0,40.10909090909091,250,47,20.88282828282828,14
Category_Wikipedia_sockpuppets_of_MARIO1418.csv,12,72365.0,11,1,11,0,0,3.4166666666666665,41,27,27.0,27
Category_Wikipedia_sockpuppets_of_Edgarrr.csv,376,1887788.0,137,239,23,114,0,47.63297872340426,216,54,19.513297872340427,5
Category_Wikipedia_sockpuppets_of_Ahemad_mi.csv,30,523383.0,10,20,5,5,7,58.266666666666666,156,29,17.6,5
Category_Wikipedia_sockpuppets_of_SaiKiran2121.csv,45,218859.0,19,26,12,7,0,68.2,263,33,21.444444444444443,11
Category_Wikipedia_sockpuppets_of_gherkin30.csv,312,3820452.0,99,213,99,0,0,29.166666666666668,199,56,21.778846153846153,2
Category_Wikipedia_sockpuppets_of_MuslimsofUmreka.csv,593,3329071.0,255,338,245,10,0,26.14839797639123,197,47,15.281618887015178,3
Category_Wikipedia_sockpuppets_of_Donny_Frost.csv,101,6539922.0,30,71,12,18,0,68.32673267326733,238,50,27.396039603960396,16
Category_Wikipedia_sockpuppets_of_HEheDicaprio3.csv,38,3024299.0,12,26,5,7,0,65.5,210,27,18.81578947368421,6
Category_Wikipedia_sockpuppets_of_0guests0.csv,701,81437339.0,224,477,66,158,0,49.005706134094154,322,53,35.21112696148359,7
Category_Wikipedia_sockpuppets_of_NAccount.csv,2070,44726349.0,624,1446,233,391,0,37.379710144927536,215,57,17.51497584541063,4
Category_Wikipedia_sockpuppets_of_Nirdis.csv,363,31316006.0,119,244,65,54,0,48.184573002754824,310,53,18.085399449035812,4
Category_Wikipedia_sockpuppets_of_Jinxerz.csv,12,979197.0,7,5,5,2,0,80.33333333333333,199,18,15.75,9
Category_Wikipedia_sockpuppets_of_Agaba_Perez.csv,1180,8777587.0,525,655,500,25,0,81.04152542372881,354,56,17.776271186440677,7
Category_Wikipedia_sockpuppets_of_NOPED_ANEBI_EMMANUEL.csv,10,6775.0,5,5,5,0,0,39.5,151,24,24.0,24
Category_Wikipedia_sockpuppets_of_Dethzone.csv,1353,5451947.0,519,834,366,153,0,26.20177383592018,250,88,24.93422025129342,4
Category_Wikipedia_sockpuppets_of_Iamrealmohsin.csv,41,70933.0,13,28,9,4,0,37.36585365853659,206,30,14.682926829268293,4
Category_Wikipedia_sockpuppets_of_Porkchopsgood.csv,6,188523.0,5,1,3,2,0,67.0,149,17,17.0,17
Category_Wikipedia_sockpuppets_of_SportEdit23.csv,1357,18329491.0,500,857,500,0,0,37.78850405305822,248,49,17.599115696389095,3
Category_Wikipedia_sockpuppets_of_Dineshmahto111.csv,148,109247882.0,79,69,40,39,0,41.972972972972975,255,29,16.594594594594593,5
Category_Wikipedia_sockpuppets_of_Hyperchapex.csv,387,90953202.0,109,278,48,61,0,56.00516795865633,382,54,19.087855297157624,7
Category_Wikipedia_sockpuppets_of_JaySmith2018.csv,1421,61674124.0,488,933,55,433,0,45.54468684025334,255,49,17.960591133004925,6
Category_Wikipedia_sockpuppets_of_Angkorangel.csv,46,3181252.0,22,24,12,10,13,46.34782608695652,199,47,19.456521739130434,8
Category_Wikipedia_sockpuppets_of_Hgrosser.csv,3209,31999651.0,779,2430,500,279,0,52.90557806170146,371,55,17.90370832034902,3
Category_Wikipedia_sockpuppets_of_Lawmander.csv,273,66990415.0,102,171,19,83,0,55.853479853479854,399,37,15.172161172161172,3
Category_Wikipedia_sockpuppets_of_Wangshujuan.csv,19,3124146.0,17,2,7,10,0,34.1578947368421,199,66,53.68421052631579,16
Category_Wikipedia_sockpuppets_of_WikiEditor002.csv,50,1374.0,11,39,8,3,0,54.48,170,22,13.26,9
Category_Wikipedia_sockpuppets_of_Connectbycrossbridge.csv,31,8551401.0,10,21,5,5,0,37.903225806451616,170,30,18.0,12
Category_Wikipedia_sockpuppets_of_Theyuusuf143.csv,452,5914515.0,167,285,96,71,0,55.60398230088496,262,50,16.25221238938053,5
Category_Wikipedia_sockpuppets_of_BreakfastPancake.csv,28,16335389.0,20,8,17,3,0,32.464285714285715,142,46,21.928571428571427,16
Category_Wikipedia_sockpuppets_of_More_correctly.csv,32,1775130.0,8,24,5,3,0,49.71875,158,38,28.5,14
Category_Wikipedia_sockpuppets_of_Nooth57.csv,893,29806765.0,233,660,127,106,0,44.38857782754759,254,53,15.898096304591265,3
Category_Wikipedia_sockpuppets_of_Greg_kai.csv,966,7346951.0,295,671,284,11,0,25.463768115942027,243,45,20.15424430641822,5
Category_Wikipedia_sockpuppets_of_Storritospeaks.csv,161,737299.0,60,101,35,25,0,54.608695652173914,320,59,17.211180124223603,7
Category_Wikipedia_sockpuppets_of_MShelter.csv,84,344622.0,38,46,12,26,0,32.214285714285715,238,22,13.761904761904763,4
Category_Wikipedia_sockpuppets_of_Anonymous_Correcter.csv,39,94236.0,25,14,11,14,0,65.66666666666667,254,25,22.102564102564102,6
Category_Wikipedia_sockpuppets_of_Pkaldone.csv,148,63321500.0,56,92,33,23,0,38.0,214,40,17.533783783783782,4
Category_Wikipedia_sockpuppets_of_Beyoglou.csv,1272,61772099.0,422,850,195,227,0,54.117924528301884,499,60,19.488993710691823,4
Category_Wikipedia_sockpuppets_of_JAVIERPASTORBELDA.csv,33,1893198.0,19,14,19,0,0,37.60606060606061,190,45,30.454545454545453,21
Category_Wikipedia_sockpuppets_of_Slickyrick.csv,39,705019.0,34,5,17,17,0,91.07692307692308,234,11,11.0,11
Category_Wikipedia_sockpuppets_of_GoneMoot00.csv,1113,124847500.0,310,803,141,169,0,45.316262353998205,255,70,18.10242587601078,3
Category_Wikipedia_sockpuppets_of_Do_do_doggy.csv,1635,95160739.0,529,1106,500,29,0,37.8085626911315,249,51,23.424464831804283,7
Category_Wikipedia_sockpuppets_of_Kirtidagautam.csv,266,49472274.0,85,181,70,15,0,45.28195488721804,255,31,22.402255639097746,8
Category_Wikipedia_sockpuppets_of_Cristo_Keith.csv,22,1553293.0,12,10,4,8,0,80.0909090909091,132,15,12.818181818181818,11
Category_Wikipedia_sockpuppets_of_Lilialevine.csv,40,1365904.0,30,10,13,17,0,93.95,199,20,16.475,14
Category_Wikipedia_sockpuppets_of_3_L√∂wi.csv,1933,29936626.0,507,1426,500,7,0,54.64821520951888,500,72,16.56906363166063,3
Category_Wikipedia_sockpuppets_of_Aliyahasan.csv,626,92632451.0,231,395,224,7,0,41.45207667731629,260,59,21.268370607028753,4
Category_Wikipedia_sockpuppets_of_Hal_Clyde.csv,67,33210708.0,20,47,12,8,0,59.40298507462686,321,53,26.567164179104477,3
Category_Wikipedia_sockpuppets_of_Tanveermagdumshaikh.csv,18,879838.0,8,10,5,3,0,29.166666666666668,139,22,18.444444444444443,14
Category_Wikipedia_sockpuppets_of_Edgware_Road_tube_station.csv,14,10185.0,4,10,4,0,0,85.21428571428571,217,28,20.428571428571427,7
Category_Wikipedia_sockpuppets_of_Wisdombuddha.csv,1768,7947289.0,750,1018,378,372,0,47.43608597285068,213,50,19.835972850678733,10
Category_Wikipedia_sockpuppets_of_Zacnascarguy_88_fan.csv,3464,129723668.0,1300,2164,500,800,0,35.661374133949195,500,46,15.773672055427252,7
Category_Wikipedia_sockpuppets_of_Haida_chieftain.csv,804,28787716.0,429,375,312,117,0,49.277363184079604,250,39,18.468905472636816,6
Category_Wikipedia_sockpuppets_of_Jet2006.csv,1137,15065478.0,275,862,275,0,0,29.420404573438873,201,68,16.4221635883905,4
Category_Wikipedia_sockpuppets_of_T-sauce_man.csv,26,7008142.0,11,15,7,4,0,49.26923076923077,214,21,13.076923076923077,11
Category_Wikipedia_sockpuppets_of_FakeVerify.csv,15,164470.0,10,5,5,5,0,212.2,497,19,15.666666666666666,14
Category_Wikipedia_sockpuppets_of_ICarlyous.csv,461,1651079.0,158,303,133,25,0,47.3058568329718,233,54,25.787418655097614,10
Category_Wikipedia_sockpuppets_of_Hkmsaharan01.csv,4,759421.0,2,2,1,1,12,54.25,80,22,21.25,19
Category_Wikipedia_sockpuppets_of_Wkenyon123.csv,61,4372337.0,30,31,22,8,0,41.65573770491803,199,18,13.131147540983607,11
Category_Wikipedia_sockpuppets_of_Devin25505.csv,29,112812.0,10,19,7,3,0,54.758620689655174,228,45,22.517241379310345,1
Category_Wikipedia_sockpuppets_of_HeadleyDown.csv,3509,80283492.0,1430,2079,500,930,0,42.49244799088059,211,72,23.30493017953833,6
Category_Wikipedia_sockpuppets_of_Ranke8.csv,27,75197.0,24,3,17,7,0,22.62962962962963,196,20,13.148148148148149,7
Category_Wikipedia_sockpuppets_of_Hamster_KILL_KILL.csv,331,24007038.0,159,172,126,33,0,44.22658610271903,496,41,20.658610271903324,7
Category_Wikipedia_sockpuppets_of_Shafinusri.csv,1639,45085927.0,580,1059,500,80,0,46.66503965832825,255,83,25.20256253813301,4
Category_Wikipedia_sockpuppets_of_Waov12.csv,712,68565005.0,244,468,192,52,0,46.62921348314607,252,58,20.28932584269663,6
Category_Wikipedia_sockpuppets_of_Googlaran.csv,42,3673.0,13,29,8,5,10,51.642857142857146,193,28,23.0,11
Category_Wikipedia_sockpuppets_of_Fyattcsc1784.csv,56,4500804.0,26,30,4,22,0,45.982142857142854,223,58,28.464285714285715,3
Category_Wikipedia_sockpuppets_of_Stabita22.csv,1,0.0,1,0,1,0,196,196.0,196,18,18.0,18
Category_Wikipedia_sockpuppets_of_JakeValkusky.csv,290,5915114.0,125,165,20,105,0,48.48275862068966,234,48,17.351724137931033,11
Category_Wikipedia_sockpuppets_of_Infamous826.csv,24,2588111.0,13,11,8,5,0,34.875,180,29,9.75,7
Category_Wikipedia_sockpuppets_of_Blight55.csv,2336,26650180.0,901,1435,500,401,0,42.1048801369863,410,32,14.32876712328767,5
Category_Wikipedia_sockpuppets_of_MarkAlexisGabriel.csv,1266,114245819.0,659,607,500,159,0,39.76066350710901,257,77,17.002369668246445,9
Category_Wikipedia_sockpuppets_of_Diplomat592.csv,7,69511.0,3,4,2,1,0,68.0,218,18,18.0,18
Category_Wikipedia_sockpuppets_of_Shark2433086.csv,1939,18673972.0,583,1356,500,83,0,43.451779267663746,500,67,19.897369778236204,3
Category_Wikipedia_sockpuppets_of_Channel_6.csv,424,74710846.0,141,283,26,115,0,37.3938679245283,226,68,22.556603773584907,3
Category_Wikipedia_sockpuppets_of_Anagerman.csv,75,955338.0,49,26,46,3,0,49.78666666666667,218,30,29.626666666666665,16
Category_Wikipedia_sockpuppets_of_Ralphellis.csv,1391,343421571.0,360,1031,186,174,0,54.4097771387491,255,55,18.3882099209202,6
Category_Wikipedia_sockpuppets_of_Wladekimperialny.csv,604,12067932.0,321,283,166,155,0,41.69039735099338,488,57,28.7682119205298,13
Category_Wikipedia_sockpuppets_of_Itukza.csv,47,26152725.0,30,17,26,4,0,23.851063829787233,233,5,5.0,5
Category_Wikipedia_sockpuppets_of_Puvasoca.csv,422,32394380.0,134,288,41,93,0,48.62559241706161,345,68,16.248815165876778,3
Category_Wikipedia_sockpuppets_of_Albert20009.csv,710,181248362.0,179,531,128,51,0,30.198591549295774,255,45,23.876056338028167,4
Category_Wikipedia_sockpuppets_of_Libb_Thims.csv,3463,164615573.0,1054,2409,500,554,0,41.443546058330924,259,68,26.04302627779382,3
Category_Wikipedia_sockpuppets_of_Martinlomax.csv,17,64081.0,10,7,9,1,0,76.94117647058823,243,26,19.294117647058822,15
Category_Wikipedia_sockpuppets_of_Malbin210.csv,2026,65746263.0,572,1454,150,422,0,63.612043435340574,255,50,17.943237907206317,5
Category_Wikipedia_sockpuppets_of_Aaeliaba.csv,1767,47393584.0,543,1224,500,43,0,42.23033389926429,461,49,18.585172608941708,5
Category_Wikipedia_sockpuppets_of_Murraymarc.csv,23,164504.0,13,10,6,7,0,26.608695652173914,154,27,25.695652173913043,25
Category_Wikipedia_sockpuppets_of_Hai2upeeps.csv,17,1038578.0,14,3,7,7,0,52.11764705882353,183,28,28.0,28
Category_Wikipedia_sockpuppets_of_King_kong92.csv,6738,430612965.0,1764,4974,500,1264,0,42.65672306322351,491,59,18.767735233006828,2
Category_Wikipedia_sockpuppets_of_Skybehzad10.csv,365,168109819.0,117,248,52,65,0,66.06027397260274,496,144,19.454794520547946,5
Category_Wikipedia_sockpuppets_of_PavelSolin.csv,1301,132601003.0,425,876,385,40,0,37.55803228285934,233,53,19.711760184473484,4
Category_Wikipedia_sockpuppets_of_Koov.csv,17593,504329013.0,5148,12445,500,4648,0,45.870005115671006,500,109,28.40391064627977,2
Category_Wikipedia_sockpuppets_of_EthiopianEritrean.csv,37,262118.0,18,19,12,6,0,44.945945945945944,307,27,17.7027027027027,12
Category_Wikipedia_sockpuppets_of_Jayblackcar.csv,115,12183475.0,59,56,57,2,0,22.17391304347826,235,37,29.452173913043477,23
Category_Wikipedia_sockpuppets_of_Itrk70.csv,87,14332222.0,37,50,28,9,0,42.724137931034484,205,53,30.24137931034483,3
Category_Wikipedia_sockpuppets_of_Swisstimer452.csv,127,147104128.0,42,85,12,30,0,67.61417322834646,246,38,15.62992125984252,5
Category_Wikipedia_sockpuppets_of_Homerpaca.csv,7,869562.0,4,3,2,2,0,59.857142857142854,135,17,13.142857142857142,11
Category_Wikipedia_sockpuppets_of_Poolroadrunner.csv,110,245906828.0,30,80,26,4,0,49.89090909090909,396,66,24.89090909090909,5
Category_Wikipedia_sockpuppets_of_Bibliophile_Dragon.csv,1747,15624976.0,559,1188,336,223,0,55.2610188895249,497,63,18.00858614768174,4
Category_Wikipedia_sockpuppets_of_Snackbag.csv,513,8373266.0,198,315,109,89,0,53.748538011695906,252,66,24.621832358674464,5
Category_Wikipedia_sockpuppets_of_Slackr.csv,438,567405520.0,97,341,97,0,0,58.10730593607306,406,65,17.04794520547945,6
Category_Wikipedia_sockpuppets_of_Knaveofthewind.csv,44,3376045.0,14,30,6,8,0,84.70454545454545,378,36,17.227272727272727,5
Category_Wikipedia_sockpuppets_of_Kovaceski.csv,36,279594945.0,10,26,8,2,0,38.47222222222222,255,24,19.5,16
Category_Wikipedia_sockpuppets_of_Tkjaros.csv,47,318452673.0,16,31,9,7,0,55.91489361702128,194,24,17.51063829787234,17
Category_Wikipedia_sockpuppets_of_My_MMA_fighters.csv,23,5343822.0,6,17,4,2,0,13.652173913043478,61,32,22.08695652173913,13
Category_Wikipedia_sockpuppets_of_BOLLYWOOD_IS_MY_LIFE.csv,206,61746959.0,77,129,70,7,0,44.689320388349515,255,49,26.174757281553397,9
Category_Wikipedia_sockpuppets_of_Sharmadeep540.csv,35,85454.0,13,22,11,2,0,65.97142857142858,159,38,33.91428571428571,21
Category_Wikipedia_sockpuppets_of_Inforafeesoft.csv,5,28161.0,3,2,3,0,0,35.6,89,23,23.0,23
Category_Wikipedia_sockpuppets_of_SandKitty256.csv,1293,120517587.0,408,885,377,31,0,56.42382057231245,255,54,16.94122196442382,3
Category_Wikipedia_sockpuppets_of_TankMcNeal.csv,91,5441269.0,30,61,20,10,0,49.2967032967033,211,23,17.395604395604394,16
Category_Wikipedia_sockpuppets_of_HealthingLaw360.csv,5,60141.0,4,1,2,2,18,49.2,174,16,16.0,16
Category_Wikipedia_sockpuppets_of_Umezar.csv,79,778361.0,29,50,7,22,0,55.9873417721519,244,59,30.518987341772153,15
Category_Wikipedia_sockpuppets_of_GeorgeFernandez1968.csv,297,1495039.0,147,150,142,5,0,37.96296296296296,231,55,38.592592592592595,7
Category_Wikipedia_sockpuppets_of_Veritat2016.csv,1,0.0,1,0,1,0,0,0.0,0,13,13.0,13
Category_Wikipedia_sockpuppets_of_Ayazshaikhmusic.csv,82,41060437.0,45,37,24,21,0,32.21951219512195,213,32,25.109756097560975,17
Category_Wikipedia_sockpuppets_of_Kelly_at_JLA_Ltd.csv,51,799261.0,36,15,24,12,0,41.05882352941177,191,26,15.490196078431373,13
Category_Wikipedia_sockpuppets_of_Rogue1601.csv,1581,12274229.0,439,1142,320,119,0,45.80075901328273,496,56,19.698292220113853,5
Category_Wikipedia_sockpuppets_of_Mikaela_salas.csv,50,7259414.0,14,36,7,7,0,35.48,196,24,14.04,9
Category_Wikipedia_sockpuppets_of_Ezzabell.csv,32,222977.0,13,19,9,4,0,49.90625,193,54,21.40625,5
Category_Wikipedia_sockpuppets_of_Hstudent.csv,2504,499938173.0,650,1854,500,150,0,46.579073482428115,327,54,19.92611821086262,5
Category_Wikipedia_sockpuppets_of_A_Gounaris.csv,1545,15176621.0,565,980,500,65,0,46.671844660194175,255,45,14.709385113268608,4
Category_Wikipedia_sockpuppets_of_MegaMack02.csv,481,1184183.0,171,310,137,34,0,55.681912681912685,384,53,22.77962577962578,8
Category_Wikipedia_sockpuppets_of_Jeff_Dorlean.csv,48,5945.0,22,26,11,11,0,48.708333333333336,199,30,20.9375,8
Category_Wikipedia_sockpuppets_of_Endgame1.csv,7883,25471363.0,2893,4990,500,2393,0,32.711531142965875,249,93,28.927311937079793,5
Category_Wikipedia_sockpuppets_of_Yathxrth.csv,48,431159.0,13,35,12,1,0,49.291666666666664,162,34,20.5625,9
Category_Wikipedia_sockpuppets_of_Shuki.csv,2088,338652138.0,602,1486,500,102,0,48.95067049808429,353,80,20.827107279693486,3
Category_Wikipedia_sockpuppets_of_NewOrleans4Life.csv,2744,14984618.0,1015,1729,500,515,0,26.80466472303207,229,51,17.99854227405248,4
Category_Wikipedia_sockpuppets_of_Helloandno.csv,263,61163218.0,129,134,120,9,0,42.88973384030418,263,60,19.958174904942965,11
Category_Wikipedia_sockpuppets_of_Wickey.csv,3074,312770782.0,1000,2074,500,500,0,54.56929082628497,427,71,22.82335718932986,3
Category_Wikipedia_sockpuppets_of_Western50.csv,184,10020131.0,47,137,39,8,0,59.04347826086956,248,36,20.88586956521739,6
Category_Wikipedia_sockpuppets_of_GrandTheft2.csv,6,6506836.0,4,2,2,2,16,47.166666666666664,194,28,28.0,28
Category_Wikipedia_sockpuppets_of_CapChecker123.csv,543,6965668.0,162,381,108,54,0,50.70902394106814,284,47,20.449355432780848,6
Category_Wikipedia_sockpuppets_of_Alexcas11.csv,3355,53605753.0,671,2684,68,603,0,38.903725782414305,255,61,18.40387481371088,4
Category_Wikipedia_sockpuppets_of_Vrvrv.csv,1,0.0,1,0,1,0,0,0.0,0,17,17.0,17
Category_Wikipedia_sockpuppets_of_Amitahujapk.csv,270,127552268.0,68,202,37,31,0,77.63333333333334,496,47,14.0,5
Category_Wikipedia_sockpuppets_of_Iberomesornix.csv,680,77508201.0,224,456,137,87,0,51.1985294117647,241,61,27.26029411764706,5
Category_Wikipedia_sockpuppets_of_Baligema.csv,248,27693691.0,83,165,83,0,0,53.181451612903224,221,52,21.758064516129032,6
Category_Wikipedia_sockpuppets_of_Miss_Star_Girl_World.csv,4,254005.0,2,2,1,1,0,122.25,208,32,30.5,30
Category_Wikipedia_sockpuppets_of_Purty.csv,1774,32494983.0,595,1179,230,365,0,37.99718151071026,253,54,12.052987598647125,4
Category_Wikipedia_sockpuppets_of_Seegers.csv,215,5359852.0,56,159,56,0,0,43.13023255813953,255,55,22.75813953488372,5
Category_Wikipedia_sockpuppets_of_Patanjali_Project.csv,300,2727213.0,103,197,38,65,0,126.75666666666666,500,51,18.663333333333334,3
Category_Wikipedia_sockpuppets_of_Tm299.csv,30,6587879.0,13,17,13,0,0,38.3,227,36,13.533333333333333,8
Category_Wikipedia_sockpuppets_of_Guffydrawers.csv,2023,423151187.0,567,1456,500,67,0,49.997034107760754,500,64,15.417202174987642,3
Category_Wikipedia_sockpuppets_of_Ptcloof_khan.csv,907,5678176.0,330,577,121,209,0,32.02425578831312,255,56,16.029768467475193,5
Category_Wikipedia_sockpuppets_of_Lovelacealice.csv,52,1376893.0,29,23,8,21,0,37.88461538461539,223,36,13.096153846153847,11
Category_Wikipedia_sockpuppets_of_Cr√®me3.14159.csv,1962,4297308.0,602,1360,286,316,0,48.32212028542304,255,56,19.625382262996943,4
Category_Wikipedia_sockpuppets_of_Gwang211.csv,13,2237296.0,7,6,6,1,0,54.76923076923077,204,21,19.153846153846153,17
Category_Wikipedia_sockpuppets_of_Hiyob346.csv,1145,32132666.0,454,691,352,102,0,44.91091703056769,254,50,19.707423580786028,4
Category_Wikipedia_sockpuppets_of_Lightwing1988.csv,2137,56663008.0,450,1687,446,4,0,30.31539541413196,213,65,21.19326158165653,3
Category_Wikipedia_sockpuppets_of_Wissamraji.csv,103,56842637.0,23,80,11,12,0,66.83495145631068,254,43,17.57281553398058,12
Category_Wikipedia_sockpuppets_of_Public_Information_CCC.csv,28,5713951.0,20,8,10,10,0,50.107142857142854,122,26,26.0,26
Category_Wikipedia_sockpuppets_of_MetaWiz4331.csv,8175,68906415.0,2226,5949,500,1726,0,41.447094801223244,496,89,17.69834862385321,2
Category_Wikipedia_sockpuppets_of_InvaderDubya.csv,177,1707.0,128,49,56,72,0,22.75141242937853,296,28,14.468926553672317,8
Category_Wikipedia_sockpuppets_of_Derek_Isherwood.csv,20,1167.0,5,15,4,1,0,49.9,187,28,23.9,9
Category_Wikipedia_sockpuppets_of_Budddy35.csv,20,10597806.0,7,13,5,2,0,50.45,156,19,15.65,14
Category_Wikipedia_sockpuppets_of_Ste4k.csv,1199,2171763.0,523,676,500,23,0,31.656380316930775,190,78,27.6255212677231,10
Category_Wikipedia_sockpuppets_of_Poeticoda.csv,226,85198595.0,70,156,29,41,0,46.72566371681416,328,45,17.154867256637168,7
Category_Wikipedia_sockpuppets_of_Rheysterjohndelera.csv,1048,105863917.0,402,646,129,273,0,31.984732824427482,247,64,15.960877862595419,2
Category_Wikipedia_sockpuppets_of_Cordyceps-Zombie.csv,3010,12043584.0,956,2054,500,456,0,48.60232558139535,496,75,28.140531561461795,6
Category_Wikipedia_sockpuppets_of_Tonniez.csv,13,2210.0,12,1,12,0,3,23.923076923076923,29,29,29.0,29
Category_Wikipedia_sockpuppets_of_DinoSoupCanada.csv,1374,38623162.0,576,798,500,76,0,48.71542940320233,496,81,27.756914119359536,2
Category_Wikipedia_sockpuppets_of_BeikMusic.csv,491,19239113.0,182,309,53,129,0,48.17922606924643,379,54,17.19755600814664,6
Category_Wikipedia_sockpuppets_of_Serenesoulnyc.csv,4293,54548588.0,1256,3037,500,756,0,33.27719543442814,224,74,14.654553924994177,3
Category_Wikipedia_sockpuppets_of_Gaurav1250.csv,188,1495048.0,54,134,16,38,0,48.8031914893617,360,67,20.670212765957448,5
Category_Wikipedia_sockpuppets_of_Geosworld2011.csv,953,47477269.0,259,694,205,54,0,37.45225603357817,250,50,20.86778593913956,3
Category_Wikipedia_sockpuppets_of_Rbhu23.csv,1504,122777781.0,511,993,500,11,0,42.087765957446805,304,63,15.912234042553191,5
Category_Wikipedia_sockpuppets_of_Alphamotorcorporation.csv,29,482855.0,21,8,17,4,0,50.13793103448276,294,28,25.93103448275862,23
Category_Wikipedia_sockpuppets_of_Salem_Imam.csv,58,17272507.0,27,31,17,10,0,43.206896551724135,225,54,21.017241379310345,10
Category_Wikipedia_sockpuppets_of_31NGMW.csv,143,55459924.0,54,89,43,11,0,60.3006993006993,419,50,15.853146853146853,7
Category_Wikipedia_sockpuppets_of_Graham_Ceca_Kiwis.csv,173,6818082.0,96,77,71,25,0,30.936416184971097,196,48,21.213872832369944,7
Category_Wikipedia_sockpuppets_of_DachshundsRule.csv,557,7455009.0,186,371,166,20,0,35.89048473967684,255,56,18.59245960502693,3
Category_Wikipedia_sockpuppets_of_Empuerts.csv,817,1803919.0,394,423,214,180,0,32.424724602203185,245,52,24.033047735618116,7
Category_Wikipedia_sockpuppets_of_Maufer123.csv,80,5789951.0,28,52,20,8,0,62.4875,230,26,16.5,5
Category_Wikipedia_sockpuppets_of_Mikepipo.csv,205,6281232.0,65,140,29,36,0,60.390243902439025,217,51,21.692682926829267,7
Category_Wikipedia_sockpuppets_of_GrantEdwards.csv,48,2527032.0,21,27,14,7,0,69.29166666666667,487,22,15.1875,13
Category_Wikipedia_sockpuppets_of_Rodrigo_Moreira_da_Rocha.csv,38,11436686.0,12,26,7,5,0,41.13157894736842,138,52,27.63157894736842,11
Category_Wikipedia_sockpuppets_of_Happysouth.csv,16,2000.0,11,5,5,6,12,85.75,173,17,16.5625,14
Category_Wikipedia_sockpuppets_of_Amkhariya.csv,79,27817002.0,27,52,27,0,0,63.620253164556964,195,33,13.329113924050633,7
Category_Wikipedia_sockpuppets_of_Xksaxbackout.csv,13,3342.0,6,7,6,0,0,37.30769230769231,150,31,15.461538461538462,5
Category_Wikipedia_sockpuppets_of_Huns_With_Guns.csv,118,196654962.0,38,80,37,1,0,51.13559322033898,496,56,34.95762711864407,8
Category_Wikipedia_sockpuppets_of_Suman_Sen_303.csv,2087,128290851.0,764,1323,500,264,0,36.296118830857694,254,85,21.190704360325828,5
Category_Wikipedia_sockpuppets_of_Fineartsfrance.csv,27,60028526.0,12,15,10,2,0,50.925925925925924,267,36,21.48148148148148,10
Category_Wikipedia_sockpuppets_of_Suvarnabhoomi_Developers_Private_Limited.csv,2,0.0,1,1,1,0,36,36.0,36,50,50.0,50
Category_Wikipedia_sockpuppets_of_TheJimiZappa.csv,191,117162570.0,89,102,82,7,0,32.12565445026178,254,36,18.596858638743456,12
Category_Wikipedia_sockpuppets_of_Mhong2011.csv,126,74475277.0,72,54,70,2,0,51.45238095238095,250,27,18.817460317460316,7
Category_Wikipedia_sockpuppets_of_Beekeeper1122.csv,17,2581398.0,8,9,5,3,0,52.05882352941177,261,20,9.647058823529411,9
Category_Wikipedia_sockpuppets_of_Kevingamer9.csv,1865,12968884.0,541,1324,254,287,0,47.371581769437,499,53,19.02573726541555,3
Category_Wikipedia_sockpuppets_of_Thatlife.csv,1016,23742978.0,244,772,70,174,0,32.563976377952756,243,47,15.229330708661417,4
Category_Wikipedia_sockpuppets_of_Renmararnejo13.csv,23,132187679.0,6,17,6,0,0,58.0,241,40,19.47826086956522,11
Category_Wikipedia_sockpuppets_of_Prestonwood.csv,701,452866153.0,275,426,104,171,0,54.646219686162624,288,55,26.216833095577748,12
Category_Wikipedia_sockpuppets_of_Simeonscott.csv,6,163554.0,4,2,3,1,1,84.66666666666667,209,47,31.666666666666668,13
Category_Wikipedia_sockpuppets_of_Crompton_editz.csv,809,8343875.0,364,445,127,237,0,42.15203955500618,384,46,18.061804697156983,3
Category_Wikipedia_sockpuppets_of_IRishab0.csv,46,998503.0,14,32,12,2,0,64.19565217391305,229,23,12.304347826086957,4
Category_Wikipedia_sockpuppets_of_SkimmedMilk.csv,1395,16301086.0,462,933,193,269,0,46.57347670250896,255,57,21.459498207885304,3
Category_Wikipedia_sockpuppets_of_Mattmclaren.csv,60,32672932.0,19,41,16,3,0,40.3,224,39,28.033333333333335,17
Category_Wikipedia_sockpuppets_of_Barts1a.csv,1585,370323757.0,500,1085,500,0,0,54.10914826498423,307,78,24.197476340694006,3
Category_Wikipedia_sockpuppets_of_Janglyguitars.csv,1937,41142847.0,550,1387,337,213,0,63.799690242643265,500,56,19.228704181724314,5
Category_Wikipedia_sockpuppets_of_Dean12065.csv,1654,9896256.0,626,1028,500,126,0,51.0229746070133,439,48,14.897218863361548,5
Category_Wikipedia_sockpuppets_of_EruTheLord.csv,2208,8570978.0,897,1311,500,397,0,52.79891304347826,485,54,18.473731884057973,4
Category_Wikipedia_sockpuppets_of_Alfa0151991.csv,308,37252058.0,105,203,79,26,0,68.67857142857143,486,54,23.042207792207794,7
Category_Wikipedia_sockpuppets_of_Jstowmoulden.csv,46,16297277.0,19,27,15,4,0,70.65217391304348,249,52,39.58695652173913,17
Category_Wikipedia_sockpuppets_of_BBbbORN.csv,2015,28868398.0,641,1374,500,141,0,41.17468982630273,271,52,15.757816377171215,4
Category_Wikipedia_sockpuppets_of_SavEyChauhan.csv,12,20064335.0,4,8,3,1,0,52.25,173,22,16.0,13
Category_Wikipedia_sockpuppets_of_JohnMcClaneSr.csv,251,46477472.0,93,158,89,4,0,60.9601593625498,400,45,17.05577689243028,5
Category_Wikipedia_sockpuppets_of_Verlerman.csv,130,69809302.0,27,103,10,17,0,39.19230769230769,201,44,19.23846153846154,7
Category_Wikipedia_sockpuppets_of_Khursheed_Khan_Pictures.csv,71,92854582.0,23,48,4,19,0,45.33802816901409,199,50,27.267605633802816,12
Category_Wikipedia_sockpuppets_of_George_S._C._T._Bush.csv,341,15609845.0,108,233,46,62,0,49.41642228739003,252,45,21.131964809384165,4
Category_Wikipedia_sockpuppets_of_Muthuwella.csv,295,13937930.0,112,183,92,20,0,42.41694915254237,223,66,25.440677966101696,16
Category_Wikipedia_sockpuppets_of_Walamba.kana.csv,312,62560727.0,105,207,32,73,0,51.81410256410256,491,50,16.041666666666668,6
Category_Wikipedia_sockpuppets_of_ÿπŸÑ€åÿ±ÿ∂ÿß_ŸÜ€å⁄©_ŸÜ⁄òÿßÿØ.csv,421,428695.0,114,307,68,46,0,38.48456057007126,224,40,15.403800475059382,8
Category_Wikipedia_sockpuppets_of_Oheypete.csv,1,0.0,1,0,1,0,36,36.0,36,18,18.0,18
Category_Wikipedia_sockpuppets_of_Movie_Time_Cinemas_(India).csv,20,57891.0,8,12,6,2,0,12.4,63,36,26.15,17
Category_Wikipedia_sockpuppets_of_Harrshitmkansal.csv,30,1062484.0,24,6,22,2,0,16.2,199,35,30.833333333333332,20
Category_Wikipedia_sockpuppets_of_22factual.csv,40,4327302.0,28,12,14,14,0,52.2,242,19,10.225,10
Category_Wikipedia_sockpuppets_of_MJenko.csv,17,611691.0,11,6,11,0,0,48.294117647058826,197,26,20.647058823529413,19
Category_Wikipedia_sockpuppets_of_Dsfsswec.csv,390,22213685.0,143,247,115,28,0,59.47179487179487,256,61,12.4,6
Category_Wikipedia_sockpuppets_of_PilgrimRose.csv,1082,33067141.0,542,540,500,42,0,46.84195933456562,219,59,30.11090573012939,16
Category_Wikipedia_sockpuppets_of_DictatorOfJupiter.csv,231,338203.0,109,122,44,65,0,62.502164502164504,370,40,20.151515151515152,13
Category_Wikipedia_sockpuppets_of_Rachiddebbagh.csv,173,26329494.0,80,93,74,6,0,28.514450867052023,218,52,14.208092485549132,4
Category_Wikipedia_sockpuppets_of_Johngalea24.csv,223,145325381.0,69,154,25,44,0,46.32286995515695,227,68,22.52017937219731,7
Category_Wikipedia_sockpuppets_of_Adamneat.csv,14,3716201.0,13,1,10,3,0,19.285714285714285,196,19,18.714285714285715,18
Category_Wikipedia_sockpuppets_of_Panism.csv,22,107860.0,15,7,9,6,0,24.045454545454547,85,42,25.59090909090909,6
Category_Wikipedia_sockpuppets_of_Donnie_Juanito.csv,2801,49960394.0,1172,1629,364,808,0,54.27668689753659,412,72,18.629418064976793,4
Category_Wikipedia_sockpuppets_of_Float954.csv,572,597788.0,342,230,318,24,0,14.683566433566433,184,38,13.494755244755245,5
Category_Wikipedia_sockpuppets_of_Funtime2017.csv,768,10372116.0,248,520,140,108,0,38.08984375,235,40,20.497395833333332,3
Category_Wikipedia_sockpuppets_of_Band1301.csv,1795,37923295.0,528,1267,500,28,0,46.44401114206128,372,73,20.15933147632312,4
Category_Wikipedia_sockpuppets_of_Burakcanogut.csv,1,0.0,1,0,1,0,23,23.0,23,4,4.0,4
Category_Wikipedia_sockpuppets_of_Harrietthespy88.csv,35,33360508.0,7,28,5,2,0,47.114285714285714,219,29,13.971428571428572,10
Category_Wikipedia_sockpuppets_of_AbdulRahman14.csv,1497,28952393.0,547,950,500,47,0,32.19839679358717,253,64,19.798931195724784,4
Category_Wikipedia_sockpuppets_of_NasirRanjhyWala.csv,298,53410754.0,105,193,34,71,0,56.59731543624161,494,59,29.459731543624162,10
Category_Wikipedia_sockpuppets_of_Gascat.csv,5,165673.0,5,0,3,2,0,14.8,34,20,20.0,20
Category_Wikipedia_sockpuppets_of_Erhfb.csv,9,6176.0,4,5,4,0,0,28.11111111111111,84,19,15.666666666666666,13
Category_Wikipedia_sockpuppets_of_Ravens1985.csv,467,23098151.0,131,336,36,95,0,45.16059957173447,246,46,17.62740899357602,7
Category_Wikipedia_sockpuppets_of_Ncrouch25.csv,21,5293.0,13,8,6,7,0,74.47619047619048,165,15,15.0,15
Category_Wikipedia_sockpuppets_of_Jkmarold55.csv,843,221868397.0,303,540,182,121,0,47.568208778173194,369,60,21.6429418742586,4
Category_Wikipedia_sockpuppets_of_Tunathebig.csv,28,910723.0,25,3,9,16,0,9.321428571428571,129,16,16.0,16
Category_Wikipedia_sockpuppets_of_Timmy96.csv,2075,181594586.0,532,1543,500,32,0,52.76578313253012,496,47,14.84,8
Category_Wikipedia_sockpuppets_of_Smh_tbh_fam666.csv,27,6083476.0,8,19,3,5,0,43.7037037037037,154,49,29.925925925925927,6
Category_Wikipedia_sockpuppets_of_Edward.jones.1967.csv,228,2762559.0,81,147,79,2,0,44.01315789473684,204,29,13.364035087719298,5
Category_Wikipedia_sockpuppets_of_WebTV33.csv,108,970939.0,37,71,19,18,0,79.5925925925926,250,57,19.76851851851852,4
Category_Wikipedia_sockpuppets_of_Storkclub.csv,27,1468645.0,13,14,13,0,0,31.40740740740741,154,21,13.407407407407407,10
Category_Wikipedia_sockpuppets_of_ShinySquire.csv,510,7587442.0,163,347,52,111,0,51.54705882352941,255,47,19.68235294117647,3
Category_Wikipedia_sockpuppets_of_Tiladeepside.csv,8,740.0,4,4,4,0,0,88.125,206,21,16.125,8
Category_Wikipedia_sockpuppets_of_Badmintonhist.csv,3091,211311517.0,861,2230,500,361,0,63.10158524749272,500,87,21.874797800064705,5
Category_Wikipedia_sockpuppets_of_JuStar.csv,2671,50965103.0,898,1773,500,398,0,36.15200299513291,262,95,25.311119430924748,6
Category_Wikipedia_sockpuppets_of_Dimpletisha.csv,7381,141982368.0,2587,4794,500,2087,0,35.139682969787295,500,63,18.61739601679989,5
Category_Wikipedia_sockpuppets_of_Ricalston.csv,1622,159853846.0,563,1059,145,418,0,47.08384710234279,496,59,20.586929716399506,4
Category_Wikipedia_sockpuppets_of_Ganesh_Dhanware.csv,140,53064224.0,64,76,23,41,0,42.628571428571426,257,88,19.707142857142856,6
Category_Wikipedia_sockpuppets_of_F√™te.csv,2405,285711108.0,554,1851,500,54,0,45.42203742203742,454,48,18.05280665280665,5
Category_Wikipedia_sockpuppets_of_Oopeee55.csv,3,412.0,3,0,2,1,0,6.0,18,14,14.0,14
Category_Wikipedia_sockpuppets_of_Thehuntison.csv,844,21768751.0,261,583,237,24,0,40.425355450236964,395,71,17.58175355450237,8
Category_Wikipedia_sockpuppets_of_Paradise_lost_90.csv,366,4573101.0,178,188,171,7,0,33.31147540983606,368,30,16.098360655737704,5
Category_Wikipedia_sockpuppets_of_Dimension31.csv,2785,172102407.0,867,1918,498,369,0,44.72351885098743,263,64,20.64488330341113,4
Category_Wikipedia_sockpuppets_of_Prof._R_V_Raja_Kumar.csv,16,4452901.0,11,5,5,6,0,36.375,196,24,19.5,15
Category_Wikipedia_sockpuppets_of_Isaacwright.05.csv,61,24004487.0,42,19,33,9,0,43.622950819672134,172,39,31.557377049180328,12
Category_Wikipedia_sockpuppets_of_WhichUserAmI.csv,19,1207398.0,14,5,9,5,0,58.31578947368421,329,95,60.8421052631579,20
Category_Wikipedia_sockpuppets_of_Tarim116.csv,259,8543096.0,70,189,57,13,0,43.335907335907336,247,46,18.633204633204635,5
Category_Wikipedia_sockpuppets_of_Masai_giraffe.csv,686,236431115.0,224,462,75,149,0,50.708454810495624,301,50,20.537900874635568,9
Category_Wikipedia_sockpuppets_of_Hecxav10.csv,4,1539244.0,2,2,1,1,18,42.25,62,30,25.0,20
Category_Wikipedia_sockpuppets_of_CaeserKaiser.csv,1580,305867247.0,505,1075,500,5,0,41.19746835443038,478,61,12.818987341772152,3
Category_Wikipedia_sockpuppets_of_Shakira111.csv,1770,50542049.0,663,1107,500,163,0,45.72768361581921,500,61,22.736158192090397,6
Category_Wikipedia_sockpuppets_of_The_Penfield_Homunculus.csv,3548,30535812.0,1394,2154,500,894,0,49.02452085682074,500,59,19.89120631341601,4
Category_Wikipedia_sockpuppets_of_Sushilxxx.csv,287,78761742.0,97,190,86,11,0,40.11498257839721,233,33,15.533101045296167,7
Category_Wikipedia_sockpuppets_of_TexasTerror.csv,191,257636088.0,53,138,36,17,0,52.25130890052356,237,54,27.712041884816752,4
Category_Wikipedia_sockpuppets_of_GabbassMo.csv,1,0.0,1,0,1,0,14,14.0,14,40,40.0,40
Category_Wikipedia_sockpuppets_of_Vaishak1234.csv,720,10009103.0,277,443,146,131,0,30.540277777777778,395,39,16.413888888888888,8
Category_Wikipedia_sockpuppets_of_AbacusQwerty.csv,20,1629187.0,12,8,5,7,0,48.15,128,23,20.15,12
Category_Wikipedia_sockpuppets_of_Movietips.csv,84,3021533.0,19,65,17,2,0,29.023809523809526,199,27,21.75,8
Category_Wikipedia_sockpuppets_of_Phat14082005.csv,1160,7715326.0,458,702,228,230,0,35.39310344827586,478,50,21.495689655172413,4
Category_Wikipedia_sockpuppets_of_Lunaskarsgard.csv,59,420779.0,27,32,12,15,0,56.83050847457627,186,47,33.016949152542374,17
Category_Wikipedia_sockpuppets_of_Visualreverb.csv,218,34924332.0,59,159,28,31,0,56.68807339449541,397,53,17.660550458715598,6
Category_Wikipedia_sockpuppets_of_Andreinaepa93.csv,21,516974.0,8,13,8,0,14,48.095238095238095,231,25,20.333333333333332,17
Category_Wikipedia_sockpuppets_of_Frontierfoundry.csv,3,373.0,2,1,2,0,32,32.666666666666664,33,36,36.0,36
Category_Wikipedia_sockpuppets_of_Empress_Jodha_Begum.csv,259,11028508.0,79,180,58,21,0,39.75289575289575,229,38,16.084942084942085,5
Category_Wikipedia_sockpuppets_of_RichardPDavis.csv,233,138436200.0,85,148,56,29,0,52.39914163090129,255,53,25.012875536480685,8
Category_Wikipedia_sockpuppets_of_AManCalledGoo.csv,85,3180882.0,28,57,10,18,0,60.34117647058824,173,35,20.858823529411765,11
Category_Wikipedia_sockpuppets_of_Arthur_Ellis.csv,4976,132144105.0,1468,3508,500,968,0,37.35229099678457,250,91,22.623794212218648,3
Category_Wikipedia_sockpuppets_of_Redheadchick46.csv,148,33853607.0,71,77,67,4,0,43.53378378378378,231,43,20.574324324324323,11
Category_Wikipedia_sockpuppets_of_Patrickmcassidy.csv,56,161043273.0,21,35,12,9,0,52.267857142857146,231,45,17.089285714285715,9
Category_Wikipedia_sockpuppets_of_QuracVepi.csv,134,6241934.0,40,94,36,4,0,47.02238805970149,255,48,28.074626865671643,12
Category_Wikipedia_sockpuppets_of_Bsubprime7.csv,922,7862521.0,292,630,153,139,0,62.00325379609544,498,50,19.492407809110627,8
Category_Wikipedia_sockpuppets_of_Anonymous693.csv,14,488840.0,14,0,14,0,0,13.785714285714286,21,33,33.0,33
Category_Wikipedia_sockpuppets_of_SageMab.csv,1233,25272178.0,510,723,500,10,0,55.907542579075425,250,72,23.371451743714516,9
Category_Wikipedia_sockpuppets_of_Rider_Value.csv,22,278025.0,11,11,4,7,0,46.0,194,18,15.409090909090908,15
Category_Wikipedia_sockpuppets_of_Mike_Littlejohn.csv,1605,24385446.0,490,1115,485,5,0,36.358878504672894,255,67,28.325233644859814,4
Category_Wikipedia_sockpuppets_of_DarkBlade4658.csv,637,12266094.0,133,504,117,16,0,33.33281004709576,226,50,22.087912087912088,7
Category_Wikipedia_sockpuppets_of_Jackhoffman.csv,9,883.0,6,3,4,2,10,91.33333333333333,175,49,49.0,49
Category_Wikipedia_sockpuppets_of_Adrenalinbrust.csv,7,16456.0,6,1,5,1,11,46.857142857142854,152,30,23.571428571428573,16
Category_Wikipedia_sockpuppets_of_Dilmun.csv,120,6496296.0,40,80,36,4,0,31.558333333333334,208,37,15.458333333333334,5
Category_Wikipedia_sockpuppets_of_BOX_in_snake√∂.csv,1507,18144187.0,547,960,449,98,0,39.21300597213006,250,66,23.550099535500994,4
Category_Wikipedia_sockpuppets_of_Iamvishnugnair.csv,22,1949519.0,8,14,7,1,0,53.90909090909091,228,19,17.09090909090909,9
Category_Wikipedia_sockpuppets_of_Xubuli1993.csv,85,926851.0,29,56,21,8,0,59.89411764705882,266,16,11.764705882352942,5
Category_Wikipedia_sockpuppets_of_EditorF.csv,190,24365838.0,64,126,35,29,0,46.473684210526315,475,53,25.91578947368421,4
Category_Wikipedia_sockpuppets_of_Jacobwsl.csv,1025,458914086.0,417,608,409,8,0,49.625365853658536,299,44,22.39121951219512,9
Category_Wikipedia_sockpuppets_of_OE1995.csv,1319,8931790.0,532,787,500,32,0,30.573919636087947,496,29,16.480667172100077,6
Category_Wikipedia_sockpuppets_of_Krish!.csv,1824,182969726.0,626,1198,500,126,0,47.30482456140351,395,63,23.70888157894737,6
Category_Wikipedia_sockpuppets_of_France_a.csv,2021,87610733.0,701,1320,118,583,0,39.29985155863434,217,54,22.63681345868382,4
Category_Wikipedia_sockpuppets_of_Szhaider.csv,4936,154226874.0,1190,3746,500,690,0,42.51742301458671,255,72,16.7895056726094,3
Category_Wikipedia_sockpuppets_of_Thatbombayboy.csv,3641,329184676.0,1415,2226,500,915,0,37.63334248832738,496,59,20.93106289480912,4
Category_Wikipedia_sockpuppets_of_Frional_Leeman.csv,1138,41201027.0,370,768,84,286,0,61.10369068541301,477,77,20.839191564147626,2
Category_Wikipedia_sockpuppets_of_◊ê÷∂◊§÷∞◊®÷∏◊™÷∏◊î.csv,7511,78855268.0,2618,4893,500,2118,0,46.72693383038211,263,125,18.385967248036213,4
Category_Wikipedia_sockpuppets_of_SajidKhan1235.csv,37,165646.0,14,23,14,0,0,58.13513513513514,285,51,33.54054054054054,11
Category_Wikipedia_sockpuppets_of_Stratovariusfan665.csv,210,3191885.0,63,147,19,44,0,51.852380952380955,211,29,14.90952380952381,3
Category_Wikipedia_sockpuppets_of_67longfellow.csv,70,5596277.0,36,34,28,8,0,57.41428571428571,223,50,23.3,13
Category_Wikipedia_sockpuppets_of_HEAVEN_QUEEN.csv,87,3500506.0,22,65,18,4,0,42.310344827586206,204,49,16.908045977011493,4
Category_Wikipedia_sockpuppets_of_Adamglass3000.csv,73,786477.0,24,49,16,8,0,40.78082191780822,159,35,21.15068493150685,4
Category_Wikipedia_sockpuppets_of_Cyberllamamusic.csv,581,42326757.0,122,459,99,23,0,68.7710843373494,500,53,22.395869191049915,5
Category_Wikipedia_sockpuppets_of_Smikefoley.csv,83,332511.0,46,37,45,1,0,32.34939759036145,222,40,26.566265060240966,8
Category_Wikipedia_sockpuppets_of_Bhural.csv,232,130871284.0,82,150,61,21,0,47.064655172413794,238,32,17.57758620689655,7
Category_Wikipedia_sockpuppets_of_The_Princess_of_Scarborough_Fair.csv,145,69535176.0,43,102,8,35,0,65.30344827586207,324,40,17.075862068965517,11
Category_Wikipedia_sockpuppets_of_English_Patriot_Man.csv,7315,163429570.0,1945,5370,500,1445,0,51.071633629528364,375,57,17.86643882433356,4
Category_Wikipedia_sockpuppets_of_Ws95684.csv,440,75339501.0,139,301,83,56,0,48.49090909090909,232,46,17.986363636363638,4
Category_Wikipedia_sockpuppets_of_Ferahgo_the_Assassin.csv,1983,334810098.0,669,1314,500,169,0,56.989914271306105,500,79,22.46646495209279,3
Category_Wikipedia_sockpuppets_of_Desperado1995.csv,22,184504.0,7,15,1,6,0,76.95454545454545,282,23,20.181818181818183,13
Category_Wikipedia_sockpuppets_of_Priyadalton.csv,49,24689903.0,18,31,15,3,0,35.6530612244898,210,45,20.489795918367346,7
Category_Wikipedia_sockpuppets_of_SHEIKH_GOUS_UDDIN_AHMED.csv,880,2330460.0,302,578,252,50,0,27.179545454545455,239,48,17.931818181818183,5
Category_Wikipedia_sockpuppets_of_HoboJones.csv,1757,10625789.0,730,1027,500,230,0,36.642003414911784,215,59,24.767216846898123,3
Category_Wikipedia_sockpuppets_of_ÂèçÊí•.csv,74,14996642.0,33,41,22,11,0,53.82432432432432,213,27,14.635135135135135,4
Category_Wikipedia_sockpuppets_of_ScoutCruft.csv,848,13906831.0,275,573,133,142,0,35.369103773584904,214,62,21.048349056603772,5
Category_Wikipedia_sockpuppets_of_ThirstyCamel20.csv,54,256196.0,16,38,11,5,0,52.388888888888886,192,25,16.22222222222222,12
Category_Wikipedia_sockpuppets_of_GenerationRescue.csv,68,8744638.0,30,38,15,15,0,41.544117647058826,186,38,23.014705882352942,17
Category_Wikipedia_sockpuppets_of_Hello4321.csv,2479,40127783.0,607,1872,331,276,0,41.30375151270674,250,52,16.423557886244453,4
Category_Wikipedia_sockpuppets_of_Krause_noah.csv,124,29056501.0,40,84,26,14,0,56.79032258064516,253,51,20.927419354838708,10
Category_Wikipedia_sockpuppets_of_Izmir_lee.csv,4570,58881323.0,1313,3257,500,813,0,39.33457330415755,261,79,22.54288840262582,3
Category_Wikipedia_sockpuppets_of_ArsenalMD.csv,3,406422.0,2,1,1,1,0,42.0,126,24,22.0,21
Category_Wikipedia_sockpuppets_of_Jamezles.csv,1,0.0,1,0,1,0,25,25.0,25,25,25.0,25
Category_Wikipedia_sockpuppets_of_Neights.csv,373,276621134.0,87,286,58,29,0,57.871313672922255,247,30,19.254691689008045,9
Category_Wikipedia_sockpuppets_of_Shane_Cyrus.csv,1960,89698059.0,678,1282,500,178,0,45.79897959183673,261,85,22.968367346938777,2
Category_Wikipedia_sockpuppets_of_Turkspasha.csv,2514,42688378.0,704,1810,500,204,0,37.99920445505171,255,55,16.177008750994432,3
Category_Wikipedia_sockpuppets_of_Madere.csv,1569,16494859.0,469,1100,221,248,0,53.376673040152966,255,61,22.683875079668578,5
Category_Wikipedia_sockpuppets_of_Hardenpartners.csv,28,3810044.0,24,4,16,8,0,46.17857142857143,243,13,9.785714285714286,9
Category_Wikipedia_sockpuppets_of_Owais_Khursheed.csv,2147,276313610.0,653,1494,500,153,0,54.251979506287846,447,76,20.677224033535165,4
Category_Wikipedia_sockpuppets_of_MechMaster_Katzenstein.csv,1843,12869642.0,631,1212,500,131,0,54.10255018990776,255,64,23.30710797612588,4
Category_Wikipedia_sockpuppets_of_Mawile2822.csv,10,166518.0,7,3,7,0,0,79.3,238,30,21.0,18
Category_Wikipedia_sockpuppets_of_Pkavinda.csv,37,278420.0,19,18,13,6,0,39.13513513513514,249,32,18.972972972972972,17
Category_Wikipedia_sockpuppets_of_Kalorama20008.csv,229,5743020.0,100,129,51,49,0,46.38864628820961,260,48,18.436681222707424,7
Category_Wikipedia_sockpuppets_of_Csweaver.csv,481,339438826.0,136,345,107,29,0,49.553014553014556,255,59,22.064449064449065,2
Category_Wikipedia_sockpuppets_of_Albinjose636.csv,318,32098972.0,124,194,70,54,0,35.5314465408805,522,68,22.89937106918239,6
Category_Wikipedia_sockpuppets_of_OxfordHistorianScientist.csv,101,1880405.0,37,64,20,17,0,46.742574257425744,228,36,21.702970297029704,11
Category_Wikipedia_sockpuppets_of_Hashtagshiva.csv,93,960454.0,42,51,38,4,0,52.236559139784944,287,16,9.505376344086022,4
Category_Wikipedia_sockpuppets_of_Musiclover923.csv,11,40664.0,6,5,5,1,0,62.18181818181818,190,41,32.09090909090909,17
Category_Wikipedia_sockpuppets_of_BlackJack.csv,7032,488642230.0,2306,4726,500,1806,0,58.14206484641638,462,96,22.031285551763368,3
Category_Wikipedia_sockpuppets_of_CrackAPlanes.csv,51,3326516.0,20,31,19,1,0,29.274509803921568,248,52,33.90196078431372,10
Category_Wikipedia_sockpuppets_of_Olivettilly.csv,1152,135571625.0,478,674,467,11,0,49.87934027777778,420,84,24.80815972222222,4
Category_Wikipedia_sockpuppets_of_Iamnotstoopid.csv,6,2322.0,5,1,3,2,0,78.33333333333333,131,25,22.0,14
Category_Wikipedia_sockpuppets_of_RAJVIR_PRATAPSHARMA_IPS.csv,2,0.0,1,1,1,0,32,32.0,32,29,29.0,29
Category_Wikipedia_sockpuppets_of_Valkyried.csv,1315,17887781.0,413,902,368,45,0,40.44030418250951,410,100,22.96577946768061,7
Category_Wikipedia_sockpuppets_of_Voice_of_Britain.csv,1053,10692223.0,456,597,389,67,0,45.058879392212724,227,54,26.95536562203229,7
Category_Wikipedia_sockpuppets_of_137.240.136.80.csv,1527,116042911.0,352,1175,352,0,0,42.8218729535036,250,62,18.639816633922724,1
Category_Wikipedia_sockpuppets_of_Jihaeng.csv,15,464.0,10,5,7,3,12,52.2,173,16,16.0,16
Category_Wikipedia_sockpuppets_of_Technajunky.csv,957,20592461.0,312,645,234,78,0,29.62173458725183,204,107,16.251828631138977,5
Category_Wikipedia_sockpuppets_of_Ross_kramerov.csv,2731,277178587.0,978,1753,395,583,0,50.649212742585135,500,56,18.919077261076527,5
Category_Wikipedia_sockpuppets_of_Alanmartin98714.csv,21,92951.0,15,6,6,9,0,55.95238095238095,217,22,22.0,22
Category_Wikipedia_sockpuppets_of_ÊØîËøûÁ≠âË∞à.csv,518,11072700.0,142,376,111,31,0,44.66795366795367,301,33,11.430501930501931,5
Category_Wikipedia_sockpuppets_of_Shobair2012.csv,659,189308784.0,241,418,199,42,0,45.31411229135053,254,74,19.781487101669196,4
Category_Wikipedia_sockpuppets_of_Brianwazere.csv,2302,69437311.0,732,1570,500,232,0,37.56863596872285,250,68,25.486967854039964,6
Category_Wikipedia_sockpuppets_of_Americandollarband.csv,80,134018362.0,33,47,19,14,0,50.75,175,50,29.05,17
Category_Wikipedia_sockpuppets_of_Oldhouse2012.csv,2514,12556274.0,893,1621,369,524,0,38.99562450278441,253,86,18.087509944311854,3
Category_Wikipedia_sockpuppets_of_Egebers.csv,524,174683416.0,186,338,166,20,0,28.84732824427481,238,50,15.76908396946565,3
Category_Wikipedia_sockpuppets_of_Manorathan.csv,91,320084728.0,33,58,29,4,0,57.395604395604394,303,52,23.52747252747253,10
Category_Wikipedia_sockpuppets_of_JRM2018.csv,3305,183825030.0,1239,2066,500,739,0,36.36520423600605,500,68,21.290771558245083,3
Category_Wikipedia_sockpuppets_of_HimuTheEditor.csv,735,11937032.0,256,479,164,92,0,63.45034013605442,468,63,22.589115646258502,6
Category_Wikipedia_sockpuppets_of_JAT6634.csv,1526,81887989.0,506,1020,84,422,0,36.16579292267366,243,61,22.975753604193972,4
Category_Wikipedia_sockpuppets_of_A_stoodent_at_wilson.csv,72,2278885.0,30,42,25,5,0,20.958333333333332,158,41,25.666666666666668,11
Category_Wikipedia_sockpuppets_of_Outoftuneviolin.csv,623,6207873.0,169,454,25,144,0,34.03370786516854,191,54,11.842696629213483,4
Category_Wikipedia_sockpuppets_of_Zes12.csv,221,2199128.0,77,144,61,16,0,52.64253393665158,500,79,25.266968325791854,9
Category_Wikipedia_sockpuppets_of_Leonardo.G_G.csv,937,20540583.0,369,568,360,9,0,39.865528281750265,247,63,19.233724653148347,4
Category_Wikipedia_sockpuppets_of_Keeleduck.csv,30,773444.0,17,13,12,5,0,32.93333333333333,124,22,13.166666666666666,5
Category_Wikipedia_sockpuppets_of_Shaheda_Yesmin.csv,21,8391087.0,6,15,4,2,25,56.04761904761905,136,25,20.476190476190474,18
Category_Wikipedia_sockpuppets_of_No_barometer_of_intelligence.csv,3547,204816411.0,843,2704,329,514,0,62.73188610093036,255,74,20.489991542148296,5
Category_Wikipedia_sockpuppets_of_Kimley_Labasan.csv,5526,132756520.0,1546,3980,500,1046,0,44.408975750995296,429,68,23.17734346724575,4
Category_Wikipedia_sockpuppets_of_Debearing_egu.csv,139,4397992.0,45,94,20,25,0,51.18705035971223,254,47,17.798561151079138,6
Category_Wikipedia_sockpuppets_of_Bonarov.csv,1462,131613373.0,431,1031,382,49,0,42.597127222982216,254,60,21.85841313269494,4
Category_Wikipedia_sockpuppets_of_AlanJacksonKilledCountry.csv,492,7601818.0,217,275,63,154,0,59.26219512195122,377,46,23.33130081300813,8
Category_Wikipedia_sockpuppets_of_Marioswiki2.csv,31,164800.0,22,9,11,11,0,44.45161290322581,182,17,13.516129032258064,13
Category_Wikipedia_sockpuppets_of_Petahbread225.csv,8,4343.0,7,1,7,0,0,40.0,199,15,12.625,11
Category_Wikipedia_sockpuppets_of_Konob.csv,117,6538269.0,57,60,57,0,0,36.29059829059829,184,15,11.64102564102564,8
Category_Wikipedia_sockpuppets_of_Connor_fisk.csv,32,201564.0,21,11,10,11,0,46.65625,178,13,12.0,11
Category_Wikipedia_sockpuppets_of_Bearsandbullsfan.csv,16,260139.0,6,10,3,3,0,21.25,82,24,15.9375,11
Category_Wikipedia_sockpuppets_of_Unknown13579.csv,15,2622.0,6,9,4,2,0,81.66666666666667,177,24,13.8,7
Category_Wikipedia_sockpuppets_of_Meganbarkermusic.csv,1,0.0,1,0,1,0,12,12.0,12,16,16.0,16
Category_Wikipedia_sockpuppets_of_Waw_mart2.csv,43,491100.0,10,33,8,2,0,49.093023255813954,222,55,20.74418604651163,6
Category_Wikipedia_sockpuppets_of_RafikiSykes.csv,9750,68265161.0,2677,7073,500,2177,0,53.653128205128205,255,77,18.78153846153846,3
Category_Wikipedia_sockpuppets_of_I'm_NOT_with_stupid..csv,2736,2897671.0,804,1932,500,304,0,56.405701754385966,250,77,18.01206140350877,2
Category_Wikipedia_sockpuppets_of_Rashmirparida.csv,459,42802976.0,159,300,66,93,0,40.01525054466231,379,42,18.235294117647058,6
Category_Wikipedia_sockpuppets_of_Moroccan_me.csv,92,11151342.0,31,61,26,5,0,72.8695652173913,269,50,34.391304347826086,5
Category_Wikipedia_sockpuppets_of_Hankdong123.csv,9,2440094.0,5,4,1,4,0,55.888888888888886,111,17,17.0,17
Category_Wikipedia_sockpuppets_of_DIALLOG_PK.csv,107,3106668.0,36,71,14,22,0,27.242990654205606,185,35,23.49532710280374,8
Category_Wikipedia_sockpuppets_of_Himmer_Ariel.csv,946,9940003.0,437,509,270,167,0,41.66067653276956,495,78,24.707188160676534,3
Category_Wikipedia_sockpuppets_of_Jaggu5239.csv,1389,3355826.0,535,854,500,35,0,35.86393088552916,499,56,23.203023758099352,6
Category_Wikipedia_sockpuppets_of_Ramesh_Bhandari678.csv,2,0.0,1,1,1,0,64,64.0,64,28,28.0,28
Category_Wikipedia_sockpuppets_of_Sylheti_Soldier.csv,417,1630306.0,257,160,235,22,0,26.827338129496404,227,51,30.297362110311752,6
Category_Wikipedia_sockpuppets_of_JH2018.csv,43,1892941.0,12,31,4,8,0,74.79069767441861,395,28,15.209302325581396,10
Category_Wikipedia_sockpuppets_of_FedTruther.csv,100,17442844.0,36,64,20,16,0,63.84,255,33,14.46,0
Category_Wikipedia_sockpuppets_of_Greg3696.csv,11,3876.0,8,3,8,0,0,32.81818181818182,159,37,37.0,37
Category_Wikipedia_sockpuppets_of_UralKazan1985.csv,129,24193769.0,38,91,30,8,0,55.689922480620154,473,37,23.790697674418606,11
Category_Wikipedia_sockpuppets_of_Jets100.csv,2592,50387254.0,606,1986,170,436,0,46.336033950617285,255,62,19.813271604938272,6
Category_Wikipedia_sockpuppets_of_Masoomiyat.csv,20,6156119.0,13,7,7,6,20,73.0,175,14,14.0,14
Category_Wikipedia_sockpuppets_of_JudgePatrickMay.csv,112,4099398.0,33,79,13,20,0,65.45535714285714,222,71,16.535714285714285,9
Category_Wikipedia_sockpuppets_of_Keijhae.csv,1403,14413434.0,547,856,500,47,0,44.332145402708484,257,75,24.00712758374911,3
Category_Wikipedia_sockpuppets_of_Desanimade.csv,3497,133940179.0,1048,2449,500,548,0,40.94881326851587,492,72,19.808121246782957,4
Category_Wikipedia_sockpuppets_of_Cytheriachen.csv,95,10363667.0,26,69,15,11,0,50.45263157894737,201,53,29.105263157894736,19
Category_Wikipedia_sockpuppets_of_Callmeparadise.csv,213,3691027.0,68,145,61,7,0,47.708920187793424,242,60,19.849765258215964,4
Category_Wikipedia_sockpuppets_of_GKumar0909.csv,1256,172462288.0,331,925,153,178,0,46.7515923566879,255,58,16.344745222929937,5
Category_Wikipedia_sockpuppets_of_Gary_Punch.csv,4,92759.0,2,2,2,0,19,45.75,120,20,20.0,20
Category_Wikipedia_sockpuppets_of_Kolkhianboy.csv,299,9375976.0,125,174,117,8,0,32.0,200,31,13.719063545150501,4
Category_Wikipedia_sockpuppets_of_Azkaibrahim.csv,881,49370268.0,298,583,188,110,0,31.072644721906926,249,49,14.784335981838819,6
Category_Wikipedia_sockpuppets_of_Akashantony.csv,406,59095326.0,183,223,178,5,0,39.241379310344826,255,32,13.25615763546798,9
Category_Wikipedia_sockpuppets_of_Dust_362.csv,197,1310322.0,51,146,3,48,0,55.51776649746193,247,21,9.47715736040609,2
Category_Wikipedia_sockpuppets_of_Tehtaryn.csv,96,89190.0,47,49,31,16,0,50.354166666666664,249,22,15.15625,9
Category_Wikipedia_sockpuppets_of_Abhijit_puranik.csv,3414,59828664.0,1383,2031,500,883,0,27.429994141769185,255,56,17.435559461042764,2
Category_Wikipedia_sockpuppets_of_Solowing106.csv,352,246718683.0,141,211,134,7,0,44.57670454545455,213,43,20.69034090909091,9
Category_Wikipedia_sockpuppets_of_Cor32ed.csv,4,687895.0,3,1,3,0,0,21.75,48,17,17.0,17
Category_Wikipedia_sockpuppets_of_Unionvillian.csv,279,36801802.0,99,180,76,23,0,42.68458781362007,253,30,17.35483870967742,7
Category_Wikipedia_sockpuppets_of_Manchester_boy.csv,412,34484105.0,191,221,92,99,0,36.49514563106796,222,37,10.70873786407767,6
Category_Wikipedia_sockpuppets_of_Milag_Bal.csv,11,11949.0,3,8,3,0,15,36.54545454545455,125,25,21.727272727272727,15
Category_Wikipedia_sockpuppets_of_Marwell_Zoological_Park.csv,39,10108375.0,20,19,20,0,0,37.717948717948715,138,34,23.58974358974359,13
Category_Wikipedia_sockpuppets_of_Josetoom.csv,178,5867923.0,64,114,26,38,0,45.943820224719104,240,53,16.286516853932586,6
Category_Wikipedia_sockpuppets_of_F2xe7kp9.csv,8,12012134.0,5,3,2,3,6,28.5,138,27,27.0,27
Category_Wikipedia_sockpuppets_of_Mangalath_jr.csv,40,9557362.0,15,25,9,6,0,35.925,139,33,25.45,12
Category_Wikipedia_sockpuppets_of_ElisaEXPLOSiON.csv,1595,79832668.0,539,1056,500,39,0,38.31849529780564,250,65,19.666457680250783,3
Category_Wikipedia_sockpuppets_of_Commoncase.csv,1000,58136105.0,300,700,219,81,0,41.879,218,54,17.863,7
Category_Wikipedia_sockpuppets_of_Brexx.csv,37328,187345301.0,14839,22489,500,14339,0,37.041738105443635,267,73,19.662264252036007,4
Category_Wikipedia_sockpuppets_of_MobyPaul.csv,96,57280221.0,30,66,14,16,0,50.114583333333336,203,31,16.583333333333332,3
Category_Wikipedia_sockpuppets_of_MSJ1958.csv,250,437778.0,103,147,103,0,0,49.004,172,50,23.144,8
Category_Wikipedia_sockpuppets_of_Usertowiki200300500.csv,9,258137.0,7,2,5,2,0,49.77777777777778,223,6,6.0,6
Category_Wikipedia_sockpuppets_of_Truhomieg123.csv,10,124715.0,10,0,6,4,10,14.3,17,25,25.0,25
Category_Wikipedia_sockpuppets_of_Haunted331.csv,3547,294455086.0,1070,2477,500,570,0,63.58556526642233,500,54,23.72737524668734,3
Category_Wikipedia_sockpuppets_of_Jazzper.csv,1434,52891765.0,512,922,278,234,0,29.35774058577406,200,72,27.97768479776848,8
Category_Wikipedia_sockpuppets_of_Sundae1970.csv,22,3340292.0,11,11,5,6,0,43.81818181818182,209,45,27.772727272727273,14
Category_Wikipedia_sockpuppets_of_Flippityflop.csv,138,10578907.0,46,92,15,31,0,33.68840579710145,181,30,17.58695652173913,5
Category_Wikipedia_sockpuppets_of_Mohammed_Samiul_Ali.csv,71,892632.0,42,29,25,17,0,29.943661971830984,209,61,27.056338028169016,14
Category_Wikipedia_sockpuppets_of_Jim_2_Michael.csv,4909,56687154.0,2072,2837,500,1572,0,42.5265838256264,500,61,21.03687105316765,3
Category_Wikipedia_sockpuppets_of_Nwankwochi.csv,245,99433277.0,91,154,74,17,0,42.80816326530612,245,46,19.03265306122449,11
Category_Wikipedia_sockpuppets_of_Agencyblink.csv,99,1931720.0,40,59,22,18,0,41.36363636363637,255,47,15.222222222222221,4
Category_Wikipedia_sockpuppets_of_Joshuaharrisoneast.csv,100,1373589.0,42,58,35,7,0,42.36,176,34,21.64,13
Category_Wikipedia_sockpuppets_of_ChrisGayle79.csv,37,162884.0,11,26,7,4,0,51.13513513513514,249,41,24.0,14
Category_Wikipedia_sockpuppets_of_Skashifakram.csv,1570,134282987.0,525,1045,500,25,0,50.28662420382165,255,79,26.402547770700636,6
Category_Wikipedia_sockpuppets_of_Samadhan_Gawand.csv,265,4995749.0,84,181,5,79,0,75.3811320754717,238,22,12.641509433962264,6
Category_Wikipedia_sockpuppets_of_Tylernjoten.csv,1,0.0,1,0,1,0,34,34.0,34,11,11.0,11
Category_Wikipedia_sockpuppets_of_Maverick_3000.csv,5,31728.0,2,3,1,1,0,53.0,138,11,11.0,11
Category_Wikipedia_sockpuppets_of_Hardcore4646.csv,14,3024862.0,3,11,1,2,0,49.357142857142854,142,18,12.071428571428571,8
Category_Wikipedia_sockpuppets_of_Dzurdzuketi.csv,2699,112390319.0,952,1747,460,492,0,49.237495368655054,498,61,18.515746572804744,4
Category_Wikipedia_sockpuppets_of_Giblinsurance.csv,9,133071171.0,3,6,2,1,0,15.666666666666666,72,38,27.333333333333332,13
Category_Wikipedia_sockpuppets_of_Brianbrian365.csv,64,460364.0,15,49,7,8,0,64.296875,276,44,22.5625,13
Category_Wikipedia_sockpuppets_of_Bertman2.csv,58,609493.0,15,43,13,2,0,58.10344827586207,199,38,15.551724137931034,4
Category_Wikipedia_sockpuppets_of_Skylord495.csv,52,12561969.0,34,18,28,6,0,37.40384615384615,237,24,11.673076923076923,6
Category_Wikipedia_sockpuppets_of_Schlossdoepken.csv,10,174814.0,5,5,2,3,2,56.4,171,27,24.2,19
Category_Wikipedia_sockpuppets_of_GraftonGirly.csv,35,359233.0,18,17,17,1,0,62.42857142857143,221,37,20.571428571428573,8
Category_Wikipedia_sockpuppets_of_Iexeru.csv,1104,192313453.0,384,720,365,19,0,41.86050724637681,327,53,19.901268115942027,3
Category_Wikipedia_sockpuppets_of_DarkNebula7.csv,36,3773241.0,26,10,11,15,0,20.916666666666668,161,35,34.27777777777778,22
Category_Wikipedia_sockpuppets_of_Pbvasoya.csv,101,99960004.0,36,65,33,3,0,44.40594059405941,221,29,22.207920792079207,15
Category_Wikipedia_sockpuppets_of_–°–ø–∞—Å–∏–æ—Ü–∏.csv,7,13685119.0,4,3,2,2,0,69.28571428571429,199,34,20.428571428571427,13
Category_Wikipedia_sockpuppets_of_Til_Eulenspiegel.csv,8596,484988579.0,2071,6525,500,1571,0,60.48883201489065,450,67,15.991275011633318,1
Category_Wikipedia_sockpuppets_of_Bruce_hughes.csv,496,9748203.0,315,181,110,205,0,37.38508064516129,232,39,22.8125,6
Category_Wikipedia_sockpuppets_of_Bookswik.csv,1,0.0,1,0,1,0,213,213.0,213,40,40.0,40
Category_Wikipedia_sockpuppets_of_Afaq41.csv,95,2605400.0,39,56,29,10,0,49.76842105263158,257,44,23.073684210526316,13
Category_Wikipedia_sockpuppets_of_Samreeveparl.csv,21,37526211.0,14,7,12,2,0,88.47619047619048,462,37,26.333333333333332,23
Category_Wikipedia_sockpuppets_of_03SadOnions.csv,336,12078427.0,152,184,54,98,0,38.526785714285715,196,83,28.80654761904762,7
Category_Wikipedia_sockpuppets_of_Hiranyabaahu.csv,318,6714491.0,122,196,40,82,0,55.69496855345912,500,51,17.0188679245283,6
"Category_Wikipedia_sockpuppets_of_Inferno,_Lord_of_Penguins.csv",2081,125267445.0,708,1373,500,208,0,47.97693416626622,255,96,25.09851033157136,4
Category_Wikipedia_sockpuppets_of_Judgegeoffrey.csv,513,116612073.0,348,165,237,111,0,28.600389863547758,235,44,12.091617933723198,4
Category_Wikipedia_sockpuppets_of_Fixndbdbxtiehabafjfj.csv,1342,1301514.0,400,942,234,166,0,39.52757078986587,512,54,19.0096870342772,4
Category_Wikipedia_sockpuppets_of_Giant_Sumatra_Rat.csv,278,1842382.0,96,182,92,4,0,39.07913669064748,255,21,16.16187050359712,12
Category_Wikipedia_sockpuppets_of_RachelLawTech.csv,8,1920716.0,7,1,4,3,0,39.625,181,35,25.0,23
Category_Wikipedia_sockpuppets_of_LittleDipper.csv,5323,60652835.0,1445,3878,500,945,0,61.988916024798044,523,56,15.109336840127748,3
Category_Wikipedia_sockpuppets_of_Andrewsuraj1.csv,213,33168670.0,75,138,35,40,0,61.140845070422536,504,53,16.380281690140844,5
Category_Wikipedia_sockpuppets_of_69Dracula69.csv,9,778.0,7,2,4,3,0,62.333333333333336,192,10,10.0,10
Category_Wikipedia_sockpuppets_of_Fatima.Innovative.csv,565,165869252.0,182,383,64,118,0,45.9646017699115,255,83,22.74867256637168,6
Category_Wikipedia_sockpuppets_of_Eoghan85.csv,67,64704893.0,53,14,33,20,0,21.791044776119403,141,28,20.223880597014926,5
Category_Wikipedia_sockpuppets_of_Blackmagic1756.csv,489,28577848.0,166,323,47,119,0,41.95501022494888,304,64,29.425357873210633,6
Category_Wikipedia_sockpuppets_of_Pre10da.csv,9,73833773.0,6,3,6,0,0,46.44444444444444,141,17,17.0,17
Category_Wikipedia_sockpuppets_of_Renuka_Kalidin.csv,19,37058433.0,5,14,3,2,0,82.94736842105263,256,44,28.31578947368421,18
Category_Wikipedia_sockpuppets_of_John.jackson123.csv,1,0.0,1,0,1,0,0,0.0,0,12,12.0,12
Category_Wikipedia_sockpuppets_of_MaiJodi_Mk_1.csv,135,602898.0,39,96,37,2,0,48.65185185185185,227,51,24.125925925925927,7
Category_Wikipedia_sockpuppets_of_Hatherington.csv,1418,8466477.0,423,995,55,368,0,45.64174894217207,255,67,17.208039492242595,3
Category_Wikipedia_sockpuppets_of_FusionZenFlame.csv,83,2668061.0,51,32,50,1,0,70.6144578313253,470,38,31.36144578313253,12
Category_Wikipedia_sockpuppets_of_Koitot.csv,399,11292402.0,192,207,116,76,0,37.51629072681704,276,72,21.44611528822055,9
Category_Wikipedia_sockpuppets_of_Savage_8000.csv,34,4917.0,20,14,19,1,0,37.029411764705884,188,12,12.0,12
Category_Wikipedia_sockpuppets_of_Dunkmack9.csv,1901,100543755.0,554,1347,192,362,0,55.950026301946345,255,66,19.802735402419778,5
Category_Wikipedia_sockpuppets_of_Bonkers189.csv,251,59456201.0,71,180,49,22,0,47.57768924302789,199,41,26.382470119521912,8
Category_Wikipedia_sockpuppets_of_Keithg2002.csv,222,7520002.0,75,147,42,33,0,45.23873873873874,254,51,33.53603603603604,11
Category_Wikipedia_sockpuppets_of_879_5Af_w.csv,8,1704.0,4,4,3,1,0,11.0,32,27,16.5,13
Category_Wikipedia_sockpuppets_of_Bloody_Knight_Rider.csv,1013,148441094.0,275,738,249,26,0,44.01085883514314,348,58,21.329713721618955,5
Category_Wikipedia_sockpuppets_of_Rudra_Narain_Singh.csv,185,9005718.0,86,99,49,37,0,45.30810810810811,214,43,15.016216216216216,4
Category_Wikipedia_sockpuppets_of_ZodiacBlogger2.csv,25,58715512.0,7,18,4,3,0,36.68,190,27,18.04,13
Category_Wikipedia_sockpuppets_of_Ewater.csv,1,0.0,1,0,1,0,0,0.0,0,21,21.0,21
Category_Wikipedia_sockpuppets_of_Notsosoros.csv,1601,13399087.0,469,1132,30,439,0,49.93504059962523,255,46,16.131792629606498,4
Category_Wikipedia_sockpuppets_of_Garry14.csv,21,1095974.0,8,13,4,4,0,59.285714285714285,173,8,7.571428571428571,5
Category_Wikipedia_sockpuppets_of_Some_dude_person_guy.csv,14,6305438.0,4,10,2,2,0,88.14285714285714,361,31,13.928571428571429,2
Category_Wikipedia_sockpuppets_of_NisrinSanad.csv,1,0.0,1,0,1,0,61,61.0,61,16,16.0,16
Category_Wikipedia_sockpuppets_of_Swapnil.pathre.csv,107,125076442.0,33,74,12,21,0,56.63551401869159,253,53,28.570093457943926,4
Category_Wikipedia_sockpuppets_of_Francisco-gonzalez-2019.csv,9,2353372.0,8,1,8,0,12,92.11111111111111,254,36,35.666666666666664,33
Category_Wikipedia_sockpuppets_of_Syahmi_syafiq.csv,972,198490609.0,250,722,202,48,0,36.474279835390945,506,72,19.73971193415638,7
Category_Wikipedia_sockpuppets_of_Ockenbock.csv,1327,47707012.0,472,855,261,211,0,35.46721929163527,214,52,17.465712132629992,4
Category_Wikipedia_sockpuppets_of_Doc_Quintana.csv,2577,17019024.0,747,1830,500,247,0,37.78928987194412,255,77,23.56849049282111,4
Category_Wikipedia_sockpuppets_of_WikiBalandina.csv,197,69811171.0,82,115,72,10,0,58.868020304568525,255,42,23.578680203045685,18
Category_Wikipedia_sockpuppets_of_Davidzunigaga.csv,50,8017403.0,22,28,11,11,0,37.6,247,27,19.14,7
Category_Wikipedia_sockpuppets_of_Richardverzosa.csv,617,28576199.0,184,433,131,53,0,43.356564019448946,255,29,12.92544570502431,5
Category_Wikipedia_sockpuppets_of_MovieMakeIn.csv,304,5929224.0,98,206,41,57,0,41.45065789473684,305,38,18.12828947368421,5
Category_Wikipedia_sockpuppets_of_Peteerh.csv,615,8670738.0,346,269,324,22,0,18.60487804878049,237,33,14.04390243902439,9
Category_Wikipedia_sockpuppets_of_Horror99fan.csv,54,312486.0,21,33,14,7,0,44.22222222222222,187,21,17.85185185185185,13
Category_Wikipedia_sockpuppets_of_Maelbros.csv,3945,49719586.0,876,3069,61,815,0,39.0212927756654,255,81,22.531305449936628,2
Category_Wikipedia_sockpuppets_of_Dioxinfreak.csv,959,362532629.0,249,710,245,4,0,49.198123044838376,375,51,18.140771637122,4
Category_Wikipedia_sockpuppets_of_Bhanwar_singh_vaish.csv,3623,49316715.0,1334,2289,500,834,0,35.12255037261938,511,72,22.18354954457632,3
Category_Wikipedia_sockpuppets_of_Weeedd.csv,907,19180544.0,300,607,61,239,0,61.64057331863285,334,59,17.487320837927232,4
Category_Wikipedia_sockpuppets_of_Pantherskin.csv,1761,63883342.0,503,1258,500,3,0,48.889267461669505,246,88,31.49801249290176,5
Category_Wikipedia_sockpuppets_of_Bilal_Ajaj.csv,361,7416387.0,128,233,73,55,0,40.50969529085872,496,64,27.177285318559555,10
Category_Wikipedia_sockpuppets_of_Li_shook.csv,64,21165740.0,30,34,14,16,0,37.09375,199,21,14.078125,12
Category_Wikipedia_sockpuppets_of_Vyblushy077.csv,47,44539.0,25,22,18,7,0,34.276595744680854,190,34,21.638297872340427,14
Category_Wikipedia_sockpuppets_of_Masonjcole.csv,3731,12062989.0,1259,2472,500,759,0,19.461002412221923,345,44,19.366389707853124,8
Category_Wikipedia_sockpuppets_of_Screwyafeelings.csv,117,7689707.0,42,75,19,23,0,35.743589743589745,224,28,17.683760683760685,4
Category_Wikipedia_sockpuppets_of_Shaun_Robsart.csv,88,696033.0,73,15,57,16,0,30.863636363636363,188,24,20.829545454545453,17
Category_Wikipedia_sockpuppets_of_PaigeeWhite.csv,20,6389664.0,4,16,2,2,0,45.7,186,53,33.4,21
Category_Wikipedia_sockpuppets_of_ÿ≥ÿπŸäÿØÿ≥.csv,111,16001656.0,40,71,26,14,0,59.711711711711715,255,60,19.64864864864865,4
Category_Wikipedia_sockpuppets_of_Pallavidevpriya.csv,149,283457282.0,39,110,28,11,0,51.87248322147651,254,60,36.61744966442953,19
Category_Wikipedia_sockpuppets_of_Mr_Andy_Peterson.csv,1326,219260491.0,336,990,179,157,0,44.43665158371041,415,49,19.790346907993968,4
Category_Wikipedia_sockpuppets_of_Sherni.csv,80,7004866.0,29,51,29,0,0,50.6875,237,35,14.4125,8
Category_Wikipedia_sockpuppets_of_Peter_Bille-Lassen.csv,6,78363.0,5,1,3,2,31,37.333333333333336,50,16,16.0,16
Category_Wikipedia_sockpuppets_of_Coconut1002.csv,1427,52883206.0,427,1000,409,18,0,45.26489138051857,255,66,22.925718290119132,5
Category_Wikipedia_sockpuppets_of_Benico.csv,23,210558.0,12,11,9,3,0,54.65217391304348,199,41,33.0,11
Category_Wikipedia_sockpuppets_of_Stonecracker.csv,234,1487224.0,174,60,169,5,0,30.38888888888889,185,40,25.957264957264957,18
Category_Wikipedia_sockpuppets_of_MrCrozMC.csv,17,76291.0,8,9,5,3,0,68.3529411764706,208,21,15.058823529411764,11
Category_Wikipedia_sockpuppets_of_NovaSkola.csv,4553,30156538.0,1747,2806,500,1247,0,41.82604875905996,255,81,19.193498792005272,4
Category_Wikipedia_sockpuppets_of_Delotrooladoo.csv,12013,112946413.0,3771,8242,500,3271,0,51.6582868559061,255,69,18.640472821110464,3
Category_Wikipedia_sockpuppets_of_Officialtonnie.csv,7,836.0,4,3,2,2,20,35.714285714285715,82,46,46.0,46
Category_Wikipedia_sockpuppets_of_LBHS_Cheerleader.csv,196,293848399.0,54,142,41,13,0,54.33673469387755,249,76,30.051020408163264,12
Category_Wikipedia_sockpuppets_of_USGOP.csv,27,9123522.0,9,18,4,5,0,74.92592592592592,199,27,17.22222222222222,11
Category_Wikipedia_sockpuppets_of_Locallion.csv,232,142817351.0,82,150,22,60,0,42.1551724137931,316,53,19.387931034482758,7
Category_Wikipedia_sockpuppets_of_Lutheress.csv,1410,45971074.0,328,1082,80,248,0,52.729078014184395,499,45,15.694326241134751,3
Category_Wikipedia_sockpuppets_of_Tabuhart.csv,1083,23720563.0,483,600,405,78,0,44.151431209602954,259,61,19.889196675900276,4
Category_Wikipedia_sockpuppets_of_Malintharanga.csv,112,96752831.0,37,75,19,18,0,48.982142857142854,196,24,18.625,12
Category_Wikipedia_sockpuppets_of_MTwomey123.csv,162,202554230.0,52,110,42,10,0,38.48148148148148,252,38,14.296296296296296,9
Category_Wikipedia_sockpuppets_of_Srijon_Munshi.csv,274,22318588.0,118,156,87,31,0,38.416058394160586,368,47,24.521897810218977,12
Category_Wikipedia_sockpuppets_of_Saif_baidya.csv,78,250779.0,47,31,47,0,0,20.935897435897434,195,29,17.256410256410255,9
Category_Wikipedia_sockpuppets_of_MALIK_STAR.csv,100,3088813.0,54,46,40,14,0,40.44,255,25,17.03,11
Category_Wikipedia_sockpuppets_of_Drik001.csv,481,222964652.0,180,301,165,15,0,40.83575883575884,250,45,18.006237006237008,9
Category_Wikipedia_sockpuppets_of_Hunter_b1107.csv,177,2230810.0,62,115,47,15,0,52.68361581920904,251,34,20.689265536723163,9
Category_Wikipedia_sockpuppets_of_Sharmavijay123.csv,124,9378311.0,36,88,7,29,0,55.75806451612903,248,35,19.31451612903226,6
Category_Wikipedia_sockpuppets_of_The_battle_bandito.csv,20,5192991.0,13,7,11,2,0,49.1,188,32,26.3,21
Category_Wikipedia_sockpuppets_of_Dominic_Pringle.csv,289,21595702.0,95,194,49,46,0,63.91349480968858,273,47,19.24567474048443,5
Category_Wikipedia_sockpuppets_of_Mk_akash.csv,29,1096680.0,18,11,11,7,0,24.413793103448278,96,38,28.896551724137932,13
Category_Wikipedia_sockpuppets_of_Adil_m104.csv,381,34950519.0,128,253,91,37,0,41.23622047244095,259,47,18.77690288713911,3
Category_Wikipedia_sockpuppets_of_Njirlu.csv,671,22373479.0,248,423,238,10,0,32.81371087928465,227,47,18.637853949329358,6
Category_Wikipedia_sockpuppets_of_Shivamevolution.csv,815,94662649.0,318,497,134,184,0,38.958282208588955,255,64,20.547239263803682,5
Category_Wikipedia_sockpuppets_of_Air-tractor_sledge.csv,283,76475337.0,79,204,27,52,0,59.21201413427562,261,28,13.554770318021202,5
Category_Wikipedia_sockpuppets_of_TheViber1.csv,186,29387742.0,103,83,74,29,0,43.854838709677416,255,27,15.43010752688172,9
Category_Wikipedia_sockpuppets_of_DarkWariior.csv,74,5652679.0,26,48,16,10,0,60.54054054054054,496,50,38.25675675675676,15
Category_Wikipedia_sockpuppets_of_Rodriguezrandy.csv,54,623051.0,22,32,15,7,0,32.96296296296296,221,37,29.962962962962962,5
Category_Wikipedia_sockpuppets_of_Kurigo.csv,155,37831871.0,52,103,44,8,0,53.651612903225804,292,53,21.393548387096775,11
Category_Wikipedia_sockpuppets_of_DragutBarbarossa.csv,365,444699.0,153,212,136,17,0,35.11780821917808,199,38,17.81095890410959,4
Category_Wikipedia_sockpuppets_of_FG789.csv,472,6829144.0,157,315,61,96,0,37.0,233,43,28.739406779661017,8
Category_Wikipedia_sockpuppets_of_Pwt898.csv,6687,160672577.0,1500,5187,500,1000,0,47.297143711679375,476,70,17.935097951248693,3
Category_Wikipedia_sockpuppets_of_Tushar_Chaudharyy.csv,252,36634845.0,94,158,82,12,0,42.67857142857143,230,33,14.05952380952381,5
Category_Wikipedia_sockpuppets_of_Crevaner.csv,10959,81117519.0,2722,8237,500,2222,0,30.990692581439912,219,89,17.71174377224199,2
Category_Wikipedia_sockpuppets_of_Frankie_De_Pyae.csv,167,5530651.0,72,95,29,43,0,37.06586826347306,184,47,21.730538922155688,7
Category_Wikipedia_sockpuppets_of_BigDickMike.csv,3,358.0,3,0,3,0,0,10.0,20,13,13.0,13
Category_Wikipedia_sockpuppets_of_Billywhite86.csv,691,55590416.0,363,328,283,80,0,43.9479015918958,498,53,25.367583212735166,16
Category_Wikipedia_sockpuppets_of_Fone4My.csv,2145,6230373.0,892,1253,500,392,0,37.395337995338,215,57,21.252680652680652,5
Category_Wikipedia_sockpuppets_of_Rayesworied.csv,4653,117739914.0,1310,3343,500,810,0,43.647109391790245,255,62,20.88179669030733,3
Category_Wikipedia_sockpuppets_of_Giulio_Gallazzi.csv,8,277262.0,5,3,4,1,0,33.25,194,15,15.0,15
Category_Wikipedia_sockpuppets_of_Murdernova98.csv,971,42948873.0,545,426,500,45,0,36.13491246138002,253,57,36.838311019567456,15
Category_Wikipedia_sockpuppets_of_Rossrocker09.csv,188,2843436.0,50,138,14,36,0,52.16489361702128,230,38,21.643617021276597,4
Category_Wikipedia_sockpuppets_of_Pfrd.csv,1234,15745998.0,511,723,500,11,0,33.15721231766613,235,56,21.39222042139384,6
Category_Wikipedia_sockpuppets_of_FeatherPluma.csv,1706,70059613.0,616,1090,500,116,0,56.61488862837046,281,70,21.495896834701057,6
Category_Wikipedia_sockpuppets_of_Gandhibandea.csv,418,12183036.0,150,268,118,32,0,28.10047846889952,226,43,20.167464114832537,8
Category_Wikipedia_sockpuppets_of_Timelash.csv,857,49054045.0,268,589,78,190,0,53.593932322053675,494,40,16.617269544924152,3
Category_Wikipedia_sockpuppets_of_Carringtonb.csv,86,73532962.0,40,46,15,25,0,47.04651162790697,249,25,15.116279069767442,13
Category_Wikipedia_sockpuppets_of_MasterOfAllBulls.csv,99,18608727.0,35,64,15,20,0,25.02020202020202,145,25,15.93939393939394,6
Category_Wikipedia_sockpuppets_of_HJBV6.csv,2432,24207973.0,751,1681,171,580,0,38.870065789473685,443,47,15.058388157894736,3
Category_Wikipedia_sockpuppets_of_Abhijeet041.csv,90,2072760.0,66,24,36,30,0,51.82222222222222,269,41,23.68888888888889,17
Category_Wikipedia_sockpuppets_of_Devilidm.csv,17,561664.0,11,6,8,3,0,29.352941176470587,105,44,26.0,17
Category_Wikipedia_sockpuppets_of_Zonbla.csv,19,733593.0,5,14,5,0,0,23.789473684210527,82,17,16.36842105263158,11
Category_Wikipedia_sockpuppets_of_Odd_Master.csv,294,329249453.0,65,229,41,24,0,52.574829931972786,247,47,25.653061224489797,12
Category_Wikipedia_sockpuppets_of_Angel2001.csv,1988,10075634.0,552,1436,500,52,0,35.143863179074444,201,48,18.872736418511067,3
Category_Wikipedia_sockpuppets_of_Dev_Kumar_The_Rubish_Guitar_Player.csv,29,69771148.0,12,17,3,9,0,53.6551724137931,176,44,18.06896551724138,10
Category_Wikipedia_sockpuppets_of_Color_By_Number.csv,9,173309.0,5,4,4,1,0,64.77777777777777,189,25,19.444444444444443,15
Category_Wikipedia_sockpuppets_of_Jackjit.csv,1473,27331632.0,359,1114,91,268,0,51.058384249830276,250,59,17.00135777325187,4
Category_Wikipedia_sockpuppets_of_Kevinschaffer.csv,1821,182631054.0,457,1364,106,351,0,45.658978583196046,314,64,14.892366831411312,5
Category_Wikipedia_sockpuppets_of_The_Epic_Kidd.csv,9,25150.0,5,4,3,2,0,51.111111111111114,154,31,15.444444444444445,11
Category_Wikipedia_sockpuppets_of_Bubblebath_Man.csv,4,189.0,2,2,2,0,71,101.75,146,21,21.0,21
Category_Wikipedia_sockpuppets_of_Nildo_ouriques.csv,604,43969503.0,172,432,51,121,0,60.812913907284766,490,64,38.312913907284766,9
Category_Wikipedia_sockpuppets_of_WWorringer.csv,1145,247810515.0,384,761,228,156,0,47.260262008733626,500,46,16.938864628820962,4
Category_Wikipedia_sockpuppets_of_Atimeman444.csv,61,682022.0,35,26,35,0,0,50.50819672131148,163,38,20.131147540983605,10
Category_Wikipedia_sockpuppets_of_NewZealand_Cricket.csv,26,25681577.0,16,10,10,6,0,55.19230769230769,240,33,16.0,10
Category_Wikipedia_sockpuppets_of_DharakJoo.csv,1160,66373548.0,316,844,268,48,0,33.21465517241379,231,65,24.70344827586207,6
Category_Wikipedia_sockpuppets_of_UvaldeCopsKilledChildren.csv,7,3975.0,5,2,3,2,0,30.714285714285715,88,13,13.0,13
Category_Wikipedia_sockpuppets_of_GreenEarth_Cleaning.csv,10,4904.0,4,6,2,2,22,57.7,108,23,19.6,15
Category_Wikipedia_sockpuppets_of_Rpche.csv,230,298616941.0,46,184,43,3,0,52.97826086956522,255,33,14.721739130434782,8
Category_Wikipedia_sockpuppets_of_KenziD5.csv,206,3803239.0,69,137,69,0,0,47.44174757281554,273,33,12.907766990291263,3
Category_Wikipedia_sockpuppets_of_Gujaratiworld24.csv,318,204775995.0,114,204,46,68,0,51.54716981132076,341,59,20.839622641509433,6
Category_Wikipedia_sockpuppets_of_Honest_Yusuf_Cricket.csv,3979,139827626.0,1410,2569,452,958,0,46.04347826086956,500,52,17.613219401859762,4
Category_Wikipedia_sockpuppets_of_Shawn_Worthington_Laser_Plasma.csv,1524,15812684.0,508,1016,500,8,0,56.1253280839895,250,70,20.928477690288712,4
Category_Wikipedia_sockpuppets_of_Ravindra_Jain_Bengali.csv,159,960130.0,78,81,58,20,0,34.138364779874216,243,41,14.540880503144654,8
Category_Wikipedia_sockpuppets_of_Thetruthexposed879.csv,490,12197229.0,160,330,86,74,0,52.4,255,54,16.079591836734693,4
Category_Wikipedia_sockpuppets_of_Nash8686.csv,169,27029648.0,83,86,73,10,0,47.30769230769231,264,36,18.06508875739645,7
Category_Wikipedia_sockpuppets_of_Lootbrewed.csv,3276,15908196.0,1103,2173,500,603,0,54.78144078144078,255,75,23.552503052503052,5
Category_Wikipedia_sockpuppets_of_WCVB98swell.csv,3232,83338830.0,768,2464,500,268,0,42.13830445544554,255,65,21.650680693069308,3
Category_Wikipedia_sockpuppets_of_Gravitoweak.csv,885,17479010.0,254,631,242,12,0,46.66779661016949,248,74,17.18870056497175,3
Category_Wikipedia_sockpuppets_of_Mark_Yung_Chukwuebuka.csv,1255,239724421.0,409,846,220,189,0,46.766533864541834,410,94,16.305179282868526,3
Category_Wikipedia_sockpuppets_of_Alihamzamehboobbloch.csv,7,586042.0,4,3,3,1,0,53.0,136,30,27.0,23
Category_Wikipedia_sockpuppets_of_Shnitzled.csv,429,25294074.0,126,303,105,21,0,46.64102564102564,250,62,25.986013986013987,3
Category_Wikipedia_sockpuppets_of_IamBill903.csv,29,332416.0,15,14,14,1,0,45.37931034482759,169,25,15.172413793103448,9
Category_Wikipedia_sockpuppets_of_Hscheel.csv,213,153566214.0,65,148,44,21,0,46.36619718309859,250,23,17.953051643192488,10
Category_Wikipedia_sockpuppets_of_Shikab.csv,347,58129436.0,84,263,68,16,0,34.55619596541787,200,44,15.645533141210375,4
Category_Wikipedia_sockpuppets_of_PWfellow.csv,317,49440984.0,196,121,108,88,0,28.22712933753943,214,60,18.242902208201894,13
Category_Wikipedia_sockpuppets_of_Pamela_linkletter.csv,69,3398602.0,26,43,22,4,0,20.10144927536232,172,44,22.391304347826086,9
Category_Wikipedia_sockpuppets_of_Zeroxziggles.csv,25,783633.0,6,19,6,0,0,37.32,80,23,19.92,19
Category_Wikipedia_sockpuppets_of_KoreanResearchCenter.csv,182,37673877.0,50,132,17,33,0,40.86813186813187,251,27,11.115384615384615,7
Category_Wikipedia_sockpuppets_of_Rachel_Oreos.csv,1,0.0,1,0,1,0,0,0.0,0,16,16.0,16
Category_Wikipedia_sockpuppets_of_Sveuciliste1669.csv,42,946312.0,16,26,11,5,0,74.57142857142857,255,50,35.69047619047619,19
Category_Wikipedia_sockpuppets_of_Kolapoimam.csv,791,97628170.0,285,506,192,93,0,45.21618204804046,255,59,17.993678887484197,3
Category_Wikipedia_sockpuppets_of_IronKnuckle.csv,1875,8718962.0,663,1212,500,163,0,41.59146666666667,253,96,22.6992,5
Category_Wikipedia_sockpuppets_of_Matrix_2.csv,21,655742.0,11,10,11,0,0,53.95238095238095,196,18,17.285714285714285,13
Category_Wikipedia_sockpuppets_of_Gerriet42.csv,1459,57318400.0,509,950,500,9,0,50.85058259081563,250,43,14.270047978067169,3
Category_Wikipedia_sockpuppets_of_AkankshaG.csv,1308,18740204.0,530,778,500,30,0,35.06422018348624,255,122,21.058103975535168,6
Category_Wikipedia_sockpuppets_of_Frogsprog.csv,2607,48047663.0,670,1937,295,375,0,39.552742616033754,250,87,20.67855772919064,3
Category_Wikipedia_sockpuppets_of_Innerupon.csv,63,25027.0,24,39,12,12,0,60.888888888888886,191,30,15.571428571428571,4
Category_Wikipedia_sockpuppets_of_Westwired.csv,32,58923761.0,11,21,11,0,0,39.5,122,45,18.5625,13
Category_Wikipedia_sockpuppets_of_MissAsean2022.csv,285,9428760.0,134,151,48,86,0,30.905263157894737,496,37,16.628070175438598,10
Category_Wikipedia_sockpuppets_of_INeverCry.csv,5225,30016290.0,1643,3582,500,1143,0,80.60057416267942,255,80,19.138181818181817,4
Category_Wikipedia_sockpuppets_of_Iamcapogeezy.csv,202,97000219.0,63,139,21,42,0,50.18811881188119,284,42,20.207920792079207,4
Category_Wikipedia_sockpuppets_of_HolyDelly6996.csv,68,30947982.0,21,47,10,11,0,57.61764705882353,289,26,8.882352941176471,3
Category_Wikipedia_sockpuppets_of_IPhonetoby2018.csv,4,2019.0,2,2,2,0,0,52.0,132,24,22.0,20
Category_Wikipedia_sockpuppets_of_Welovevenkys.csv,288,25746922.0,94,194,93,1,0,57.16319444444444,255,30,14.774305555555555,7
Category_Wikipedia_sockpuppets_of_Sven_nestle.csv,582,172262534.0,161,421,82,79,0,49.223367697594504,236,47,21.443298969072163,10
Category_Wikipedia_sockpuppets_of_MrEpsilon.csv,2146,35505624.0,694,1452,262,432,0,55.69664492078285,255,60,19.473438956197576,6
Category_Wikipedia_sockpuppets_of_Simulanissoutions.csv,63,1994195.0,29,34,16,13,0,35.65079365079365,191,40,19.650793650793652,11
Category_Wikipedia_sockpuppets_of_VVillaPower.csv,54,36196.0,20,34,20,0,0,17.444444444444443,125,32,20.40740740740741,5
Category_Wikipedia_sockpuppets_of_Abhishek48.csv,23,11870.0,19,4,13,6,0,6.434782608695652,148,12,12.0,12
Category_Wikipedia_sockpuppets_of_Summerlee44.csv,353,130029746.0,121,232,110,11,0,45.10198300283286,318,62,17.872521246458923,10
Category_Wikipedia_sockpuppets_of_Tariqulislamshabbir.csv,64,1981154.0,30,34,16,14,0,39.609375,221,34,22.984375,8
Category_Wikipedia_sockpuppets_of_Broomhildatook.csv,16,88913009.0,11,5,8,3,0,32.875,141,24,20.9375,17
Category_Wikipedia_sockpuppets_of_Axtramedium.csv,246,44751185.0,119,127,83,36,0,44.65853658536585,254,30,22.88617886178862,6
Category_Wikipedia_sockpuppets_of_PenguinsElite.csv,2064,30154889.0,624,1440,500,124,0,42.47868217054263,260,65,18.410368217054263,7
Category_Wikipedia_sockpuppets_of_Numberblock_20.csv,212,14935066.0,82,130,15,67,0,56.91981132075472,274,50,22.07547169811321,2
Category_Wikipedia_sockpuppets_of_TerrryTerrr.csv,365,153579979.0,94,271,73,21,0,53.868493150684934,253,48,21.46849315068493,2
Category_Wikipedia_sockpuppets_of_User_Team.csv,3506,17787734.0,1135,2371,500,635,0,39.59298345693097,263,64,24.117227609811753,2
Category_Wikipedia_sockpuppets_of_');_DROP_TABLE_en_user.csv,39,318.0,13,26,13,0,0,53.43589743589744,209,27,18.256410256410255,9
Category_Wikipedia_sockpuppets_of_DHawker.csv,552,55814106.0,200,352,183,17,0,52.77717391304348,255,61,27.159420289855074,6
Category_Wikipedia_sockpuppets_of_Astrologer_Rajyogi.csv,2,0.0,1,1,1,0,196,196.0,196,28,28.0,28
Category_Wikipedia_sockpuppets_of_Jbradleyca.csv,98,27022091.0,31,67,21,10,0,33.44897959183673,278,49,47.63265306122449,14
Category_Wikipedia_sockpuppets_of_Pedro_Henrique_Coelho.csv,36,441588.0,19,17,19,0,0,37.97222222222222,199,35,25.02777777777778,16
Category_Wikipedia_sockpuppets_of_Anonymouscarrot1.csv,30,20295.0,15,15,10,5,0,58.0,235,17,11.9,5
Category_Wikipedia_sockpuppets_of_Pinkladypirate.csv,2,101.0,2,0,2,0,28,112.0,196,27,27.0,27
Category_Wikipedia_sockpuppets_of_Scsu76.csv,345,41781527.0,154,191,151,3,0,44.84057971014493,255,44,26.62608695652174,15
Category_Wikipedia_sockpuppets_of_HPFanSF.csv,7,1884526.0,6,1,3,3,0,94.42857142857143,269,12,9.857142857142858,7
Category_Wikipedia_sockpuppets_of_Neglektedfew.csv,1800,416478952.0,564,1236,500,64,0,35.25055555555556,239,52,16.623333333333335,3
Category_Wikipedia_sockpuppets_of_Royroydeb.csv,1375,347266592.0,505,870,500,5,0,47.665454545454544,495,69,21.873454545454546,5
Category_Wikipedia_sockpuppets_of_AVavst.csv,1,0.0,1,0,1,0,17,17.0,17,16,16.0,16
Category_Wikipedia_sockpuppets_of_Kspellskarthik.csv,1473,177412653.0,567,906,500,67,0,52.25661914460285,245,62,19.054310930074678,3
Category_Wikipedia_sockpuppets_of_Gavelascob.csv,10,2243.0,8,2,6,2,0,57.9,196,11,8.5,6
Category_Wikipedia_sockpuppets_of_Seneed_acharya.csv,31,16281298.0,13,18,4,9,0,103.03225806451613,223,27,18.903225806451612,13
Category_Wikipedia_sockpuppets_of_Editor.Eqbal.csv,181,16376600.0,53,128,33,20,0,54.12154696132597,363,47,25.939226519337016,11
Category_Wikipedia_sockpuppets_of_Natantiuk.csv,36,3650618.0,12,24,8,4,0,57.94444444444444,191,26,19.194444444444443,6
Category_Wikipedia_sockpuppets_of_Rai_Mehtab_Dhudhi.csv,91,16422645.0,33,58,13,20,0,37.46153846153846,227,27,17.153846153846153,6
Category_Wikipedia_sockpuppets_of_Ashokkumar44951.csv,17,1789.0,9,8,5,4,0,28.823529411764707,196,27,26.58823529411765,20
Category_Wikipedia_sockpuppets_of_IDriveAStickShift.csv,732,9306306.0,246,486,158,88,0,50.93306010928962,255,53,19.84426229508197,4
Category_Wikipedia_sockpuppets_of_Vimalraj_Selvakumar.csv,443,38627377.0,148,295,119,29,0,29.119638826185103,245,44,20.948081264108353,8
Category_Wikipedia_sockpuppets_of_Professional_Music_Blogger.csv,470,316990.0,191,279,72,119,0,54.81063829787234,255,45,24.68936170212766,5
Category_Wikipedia_sockpuppets_of_Grmgrm.csv,10,53469443.0,5,5,5,0,0,38.3,199,27,27.0,27
Category_Wikipedia_sockpuppets_of_TDC.csv,3983,68356338.0,1142,2841,500,642,0,48.684659804167715,250,115,26.2237007280944,6
Category_Wikipedia_sockpuppets_of_Ogg_Uploads.csv,475,83246637.0,97,378,89,8,0,48.025263157894734,499,54,18.12421052631579,4
Category_Wikipedia_sockpuppets_of_360nosc.csv,99,44607332.0,36,63,19,17,0,58.292929292929294,366,49,19.32323232323232,7
Category_Wikipedia_sockpuppets_of_Ryanbolden.csv,541,12379048.0,171,370,151,20,0,47.47134935304991,255,19,13.905730129390019,9
Category_Wikipedia_sockpuppets_of_Sokollu.csv,39,43397976.0,24,15,10,14,0,24.53846153846154,212,17,16.923076923076923,16
Category_Wikipedia_sockpuppets_of_WCGSOldBoy.csv,226,57879670.0,57,169,7,50,0,43.58849557522124,229,32,18.97345132743363,7
Category_Wikipedia_sockpuppets_of_DataDrivenOne.csv,76,191861.0,27,49,21,6,0,52.171052631578945,196,25,16.763157894736842,8
Category_Wikipedia_sockpuppets_of_Closetrapdoorshut.csv,42,1506.0,10,32,6,4,0,35.26190476190476,232,31,21.38095238095238,9
Category_Wikipedia_sockpuppets_of_Tigeroo.csv,1542,48489563.0,539,1003,500,39,0,53.95330739299611,238,69,18.540856031128406,3
Category_Wikipedia_sockpuppets_of_Roboticmadness233.csv,9,9292.0,8,1,7,1,10,25.77777777777778,136,19,19.0,19
Category_Wikipedia_sockpuppets_of_Rayofwisom.csv,19,765351.0,9,10,6,3,0,34.73684210526316,199,56,50.94736842105263,38
Category_Wikipedia_sockpuppets_of_Pranay_Chopde.csv,824,11707791.0,269,555,92,177,0,52.01456310679612,496,45,13.889563106796116,4
Category_Wikipedia_sockpuppets_of_Srinesh.saravanan.csv,3259,115007102.0,1317,1942,303,1014,0,39.43080699601104,496,54,23.762810678122122,4
Category_Wikipedia_sockpuppets_of_Dingdong12.csv,36,4871.0,13,23,13,0,0,62.30555555555556,180,51,33.47222222222222,7
Category_Wikipedia_sockpuppets_of_Omarinho.csv,2,22.0,2,0,2,0,20,20.0,20,12,12.0,12
Category_Wikipedia_sockpuppets_of_Bigc908.csv,244,157448541.0,59,185,58,1,0,51.532786885245905,242,51,12.39344262295082,8
Category_Wikipedia_sockpuppets_of_Mahdyar_Sabooni.csv,222,83774248.0,70,152,20,50,0,56.585585585585584,496,55,18.90990990990991,5
Category_Wikipedia_sockpuppets_of_Jinnwani1900.csv,25,198885.0,17,8,10,7,0,37.2,162,20,18.36,14
Category_Wikipedia_sockpuppets_of_Susan1621.csv,1717,18417009.0,540,1177,500,40,0,39.615608619685496,424,57,16.74839836924869,3
Category_Wikipedia_sockpuppets_of_Peteski132.csv,1729,352175219.0,640,1089,462,178,0,62.12434933487565,500,59,13.863504916136495,5
Category_Wikipedia_sockpuppets_of_Rivirian_King_of_the_Rails.csv,4050,212197733.0,810,3240,500,310,0,47.06493827160494,500,62,19.29283950617284,4
Category_Wikipedia_sockpuppets_of_Belenardo.csv,73,1552370.0,24,49,15,9,0,50.84931506849315,189,41,28.438356164383563,9
Category_Wikipedia_sockpuppets_of_Ppudate.csv,595,318423135.0,150,445,112,38,0,39.94957983193277,255,48,16.73949579831933,3
Category_Wikipedia_sockpuppets_of_Awanama.csv,2315,7503929.0,887,1428,500,387,0,48.6755939524838,457,52,15.191360691144709,4
Category_Wikipedia_sockpuppets_of_XBlaesBukki.csv,110,8804543.0,33,77,33,0,0,26.8,199,34,19.7,7
Category_Wikipedia_sockpuppets_of_Amateurdesbeauxarts.csv,48,1375380.0,15,33,8,7,0,78.77083333333333,235,31,19.916666666666668,11
Category_Wikipedia_sockpuppets_of_Ballygrand.csv,28,28839092.0,9,19,7,2,0,37.642857142857146,199,46,22.714285714285715,8
Category_Wikipedia_sockpuppets_of_Dhaanunjaya.csv,69,51900207.0,22,47,13,9,0,32.81159420289855,205,30,20.956521739130434,10
Category_Wikipedia_sockpuppets_of_Spacemen2050.csv,772,15017545.0,244,528,130,114,0,43.810880829015545,250,52,23.58937823834197,6
Category_Wikipedia_sockpuppets_of_Sudokuhani.csv,159,326673456.0,40,119,34,6,0,63.35849056603774,240,23,14.28930817610063,7
Category_Wikipedia_sockpuppets_of_Alon_Segev_Gallery_2023.csv,12,88104.0,6,6,4,2,14,66.16666666666667,195,18,17.75,17
Category_Wikipedia_sockpuppets_of_Paul_Ahyi.csv,328,1373818.0,95,233,37,58,0,56.31707317073171,298,62,24.38109756097561,3
Category_Wikipedia_sockpuppets_of_Shaundekment.csv,2,363.0,2,0,2,0,0,11.5,23,10,10.0,10
Category_Wikipedia_sockpuppets_of_Magpie1892.csv,989,117944284.0,203,786,197,6,0,38.93933265925177,221,46,15.953488372093023,5
Category_Wikipedia_sockpuppets_of_Danratedrko.csv,2510,129761724.0,596,1914,500,96,0,41.19003984063745,255,55,21.409561752988047,3
Category_Wikipedia_sockpuppets_of_Marketing5.csv,36,165004357.0,20,16,18,2,0,42.388888888888886,206,20,12.0,11
Category_Wikipedia_sockpuppets_of_Eddymania7.csv,179,14675711.0,60,119,60,0,0,30.078212290502794,199,38,24.843575418994412,6
Category_Wikipedia_sockpuppets_of_Vegan_Witch.csv,1740,157521218.0,509,1231,331,178,0,49.66724137931035,250,42,15.439655172413794,3
Category_Wikipedia_sockpuppets_of_FatherOf5.csv,80,50368243.0,37,43,27,10,0,65.8875,408,24,14.3,6
Category_Wikipedia_sockpuppets_of_Et43.csv,69,340818.0,45,24,42,3,0,36.89855072463768,300,25,17.884057971014492,11
Category_Wikipedia_sockpuppets_of_Keenan202.csv,2143,16421812.0,643,1500,500,143,0,42.77321511899207,255,105,31.764349043397107,4
Category_Wikipedia_sockpuppets_of_P4uk80.csv,140,71518304.0,35,105,21,14,0,41.91428571428571,232,64,21.142857142857142,5
Category_Wikipedia_sockpuppets_of_L_Doungel.csv,4,1475.0,2,2,1,1,19,85.5,202,27,27.0,27
Category_Wikipedia_sockpuppets_of_Nate8234k.csv,117,62704903.0,37,80,8,29,0,52.93162393162393,266,25,19.923076923076923,17
Category_Wikipedia_sockpuppets_of_MrDDBOI.csv,86,106064478.0,22,64,18,4,0,75.05813953488372,500,55,24.27906976744186,12
Category_Wikipedia_sockpuppets_of_MICHAELA_Philippines.csv,2,0.0,1,1,1,0,63,63.0,63,14,14.0,14
Category_Wikipedia_sockpuppets_of_Nad.ooo90.csv,26,1895499.0,12,14,8,4,0,56.69230769230769,160,23,19.653846153846153,19
Category_Wikipedia_sockpuppets_of_Roseviolet952.csv,37,46195.0,10,27,8,2,0,63.567567567567565,273,16,8.27027027027027,4
Category_Wikipedia_sockpuppets_of_Fundudeman.csv,3,7921.0,3,0,2,1,20,20.0,20,32,32.0,32
Category_Wikipedia_sockpuppets_of_Drew_poos_on_chairs_lol.csv,13,16450.0,7,6,4,3,0,81.6923076923077,168,33,17.46153846153846,11
Category_Wikipedia_sockpuppets_of_Sophiaella736.csv,114,1144300.0,28,86,14,14,0,49.675438596491226,238,47,17.105263157894736,6
Category_Wikipedia_sockpuppets_of_Sonyshaan.csv,103,1232287.0,43,60,16,27,0,46.699029126213595,236,30,22.485436893203882,12
Category_Wikipedia_sockpuppets_of_Nyiminsan.csv,215,47691797.0,72,143,46,26,0,45.674418604651166,199,60,22.144186046511628,8
Category_Wikipedia_sockpuppets_of_Mobyvonrobot.csv,6,2421944.0,2,4,2,0,28,51.166666666666664,69,28,24.0,20
Category_Wikipedia_sockpuppets_of_AndresAyDeja.csv,66,4743785.0,39,27,23,16,0,22.87878787878788,169,23,15.090909090909092,13
Category_Wikipedia_sockpuppets_of_HopeAfrique.csv,148,8588003.0,86,62,78,8,0,38.722972972972975,222,71,27.533783783783782,16
Category_Wikipedia_sockpuppets_of_Thewikiuser1999.csv,1622,28038805.0,633,989,281,352,0,56.41615289765721,494,54,20.21763255240444,4
Category_Wikipedia_sockpuppets_of_Marisolurtu.csv,12,702656.0,7,5,6,1,15,54.583333333333336,149,23,18.333333333333332,15
Category_Wikipedia_sockpuppets_of_Crim√©e_Russe.csv,20,1282435.0,10,10,5,5,0,52.3,252,34,18.0,14
Category_Wikipedia_sockpuppets_of_LisaTierney.csv,673,14432568.0,210,463,65,145,0,36.178306092124814,250,54,18.87369985141159,4
Category_Wikipedia_sockpuppets_of_Sebiku.csv,222,3458167.0,90,132,90,0,0,32.14414414414414,209,38,18.324324324324323,12
Category_Wikipedia_sockpuppets_of_Yzd.exe.csv,241,17920387.0,110,131,63,47,0,58.78423236514523,478,31,15.883817427385893,3
Category_Wikipedia_sockpuppets_of_Jaredgk2008.csv,7644,319852389.0,2211,5433,158,2053,0,48.17412349555207,255,81,19.09105180533752,3
Category_Wikipedia_sockpuppets_of_Pptweddie.csv,24,358553.0,12,12,5,7,11,64.33333333333333,210,24,14.541666666666666,11
Category_Wikipedia_sockpuppets_of_Nevandc98.csv,344,4683948.0,128,216,87,41,0,43.502906976744185,245,44,24.49127906976744,10
Category_Wikipedia_sockpuppets_of_Jsao.csv,9,337100.0,6,3,2,4,0,30.333333333333332,81,11,11.0,11
Category_Wikipedia_sockpuppets_of_Ijzerstop.csv,555,90757950.0,165,390,123,42,0,55.01081081081081,496,66,22.83063063063063,3
Category_Wikipedia_sockpuppets_of_Phillipharton.csv,16,42876.0,6,10,6,0,0,50.5625,153,23,18.625,7
Category_Wikipedia_sockpuppets_of_Gee11228.csv,230,2382496.0,94,136,68,26,0,50.68260869565217,420,22,12.326086956521738,4
Category_Wikipedia_sockpuppets_of_ShantanuSingh198.csv,969,67729647.0,379,590,110,269,0,42.75025799793602,250,70,21.306501547987615,5
Category_Wikipedia_sockpuppets_of_Vpsinghp.csv,209,217354909.0,85,124,44,41,0,32.856459330143544,236,33,9.631578947368421,5
Category_Wikipedia_sockpuppets_of_Gameposo.csv,2001,48984790.0,447,1554,205,242,0,48.06896551724138,500,101,18.823088455772115,4
Category_Wikipedia_sockpuppets_of_Isepstudyabroad.csv,3,202.0,2,1,2,0,19,24.333333333333332,29,25,21.666666666666668,20
Category_Wikipedia_sockpuppets_of_Hammadsaeed.csv,576,23496092.0,231,345,61,170,0,40.015625,261,47,21.552083333333332,4
Category_Wikipedia_sockpuppets_of_MikePlant1.csv,352,250914924.0,147,205,102,45,0,40.20454545454545,286,91,26.210227272727273,8
Category_Wikipedia_sockpuppets_of_Fastwaylie.csv,141,11586021.0,115,26,18,97,0,28.368794326241133,246,21,16.24822695035461,16
Category_Wikipedia_sockpuppets_of_Angelspride.csv,5,182545.0,4,1,2,2,20,20.4,22,14,14.0,14
Category_Wikipedia_sockpuppets_of_BrainBalanceMusic.csv,24,1041089.0,15,9,8,7,0,41.458333333333336,189,27,16.791666666666668,13
Category_Wikipedia_sockpuppets_of_ProfessionalScholar.csv,550,10864181.0,162,388,118,44,0,56.801818181818184,255,54,15.921818181818182,3
Category_Wikipedia_sockpuppets_of_Emnx.csv,386,9549749.0,139,247,64,75,0,31.507772020725387,242,50,23.0440414507772,9
Category_Wikipedia_sockpuppets_of_VHSVideos2006.csv,496,39480677.0,108,388,32,76,0,67.58064516129032,255,38,14.540322580645162,3
Category_Wikipedia_sockpuppets_of_Ajaykumar465.csv,7,346198.0,4,3,4,0,0,33.42857142857143,127,39,25.142857142857142,16
Category_Wikipedia_sockpuppets_of_Gavin_the_Otter.csv,843,155183546.0,186,657,116,70,0,52.568208778173194,496,67,21.480427046263344,6
Category_Wikipedia_sockpuppets_of_Promyyyy.csv,85,1899374.0,30,55,27,3,0,62.10588235294118,245,24,14.094117647058823,9
Category_Wikipedia_sockpuppets_of_‡¶Ü‡¶∂‡¶∞‡¶æ‡¶´‡ßÅ‡¶≤_‡¶á‡¶∏‡¶≤‡¶æ‡¶Æ_‡¶Æ‡ßÅ‡¶®‡ßç‡¶®‡¶æ.csv,115,118605032.0,27,88,18,9,0,44.417391304347824,240,41,22.765217391304347,8
Category_Wikipedia_sockpuppets_of_Shakinglord.csv,3693,72988902.0,1200,2493,500,700,0,48.161927971838615,255,81,28.173030056864338,4
Category_Wikipedia_sockpuppets_of_Garran20.csv,925,32125768.0,214,711,200,14,0,39.80972972972973,249,55,21.232432432432432,4
Category_Wikipedia_sockpuppets_of_Nigervibe.csv,24,1382690.0,8,16,8,0,0,79.20833333333333,279,33,17.666666666666668,6
Category_Wikipedia_sockpuppets_of_Qablama.csv,35,3023628.0,10,25,6,4,0,50.02857142857143,168,29,17.485714285714284,11
Category_Wikipedia_sockpuppets_of_Jesse96.csv,991,251478446.0,370,621,364,6,0,50.694248234106965,249,57,23.853683148335016,6
Category_Wikipedia_sockpuppets_of_Deplasco.csv,132,253853328.0,49,83,35,14,0,47.86363636363637,235,42,16.272727272727273,9
Category_Wikipedia_sockpuppets_of_Msemeb.csv,207,3186551.0,125,82,87,38,0,29.48792270531401,247,48,22.685990338164252,11
Category_Wikipedia_sockpuppets_of_Miislamabad.csv,9,487631.0,2,7,2,0,0,50.666666666666664,102,38,34.22222222222222,21
Category_Wikipedia_sockpuppets_of_Haloguy1815.csv,105,16810843.0,45,60,25,20,0,36.542857142857144,242,23,12.780952380952382,8
Category_Wikipedia_sockpuppets_of_YASHU2004.csv,152,3368476.0,72,80,61,11,0,45.13815789473684,379,70,48.2171052631579,13
Category_Wikipedia_sockpuppets_of_Rachelksilber.csv,14,437624.0,7,7,6,1,0,26.857142857142858,92,49,38.142857142857146,11
Category_Wikipedia_sockpuppets_of_Polyefcomike.csv,1,0.0,1,0,1,0,199,199.0,199,20,20.0,20
Category_Wikipedia_sockpuppets_of_Improve2009.csv,1504,10769932.0,354,1150,167,187,0,46.59308510638298,250,45,15.642287234042554,4
Category_Wikipedia_sockpuppets_of_Meysameddie.csv,34,60867792.0,11,23,7,4,0,51.970588235294116,346,31,17.352941176470587,8
Category_Wikipedia_sockpuppets_of_Bigsidfan.csv,157,5275640.0,61,96,61,0,0,51.29936305732484,184,22,11.789808917197453,7
Category_Wikipedia_sockpuppets_of_Anthony_Winward.csv,2279,207878223.0,500,1779,500,0,0,50.06318560772269,255,63,14.957437472575691,8
Category_Wikipedia_sockpuppets_of_HiFromIcelandWeRecoveredByJailingBankers.csv,9,7278601.0,4,5,3,1,0,71.0,208,50,35.55555555555556,30
Category_Wikipedia_sockpuppets_of_Reporter104.csv,777,16738351.0,234,543,81,153,0,52.52895752895753,323,40,17.154440154440156,5
Category_Wikipedia_sockpuppets_of_Neemaz.csv,117,14602210.0,32,85,20,12,0,45.76068376068376,198,28,10.435897435897436,4
Category_Wikipedia_sockpuppets_of_Sam_sonu1.csv,43,267202959.0,9,34,6,3,0,18.3953488372093,107,19,17.372093023255815,17
Category_Wikipedia_sockpuppets_of_Umhafs072.csv,132,8032496.0,97,35,81,16,0,47.56818181818182,264,31,16.681818181818183,13
Category_Wikipedia_sockpuppets_of_Dovale.csv,219,71641557.0,100,119,78,22,0,27.41552511415525,195,19,12.872146118721462,7
Category_Wikipedia_sockpuppets_of_Simonriley1994.csv,289,7160671.0,95,194,60,35,0,53.84083044982699,286,79,20.290657439446367,5
Category_Wikipedia_sockpuppets_of_Shafiqabu.csv,1118,21621300.0,545,573,500,45,0,21.359570661896242,254,41,17.891771019677996,8
Category_Wikipedia_sockpuppets_of_AnnaAndElsa1998.csv,4659,65985981.0,1188,3471,500,688,0,39.75724404378622,492,57,21.161622665808114,4
Category_Wikipedia_sockpuppets_of_Beevenom.csv,9,20102.0,5,4,3,2,0,79.77777777777777,163,21,20.0,18
Category_Wikipedia_sockpuppets_of_Arpis123.csv,63,168972.0,21,42,15,6,0,9.0,75,26,17.603174603174605,8
Category_Wikipedia_sockpuppets_of_Walterlipolyu.csv,74,81180486.0,20,54,10,10,0,46.189189189189186,255,44,21.89189189189189,2
Category_Wikipedia_sockpuppets_of_Md_Ferdous_Tanvir.csv,67,12223109.0,18,49,5,13,0,63.28358208955224,231,46,14.0,6
Category_Wikipedia_sockpuppets_of_Thunderballisthebestjamesbondfilmofalltime.csv,4,484.0,3,1,2,1,13,43.75,134,4,4.0,4
Category_Wikipedia_sockpuppets_of_Evpac.csv,4316,42068576.0,1402,2914,500,902,0,40.739573679332715,496,56,19.781510658016682,4
Category_Wikipedia_sockpuppets_of_Fountainsofwoodvillewake.csv,17,50109.0,6,11,6,0,0,36.1764705882353,166,34,19.647058823529413,4
Category_Wikipedia_sockpuppets_of_Antidote.csv,4055,28120164.0,1437,2618,500,937,0,26.955117139334156,261,120,21.332182490752157,5
Category_Wikipedia_sockpuppets_of_Mercurius1.csv,2011,19014407.0,598,1413,500,98,0,49.072103431128795,483,75,16.9801093983093,3
Category_Wikipedia_sockpuppets_of_Veneficusbvb.csv,111,18803096.0,25,86,21,4,0,62.351351351351354,235,43,16.882882882882882,8
Category_Wikipedia_sockpuppets_of_Deepdish7.csv,1451,4119896.0,509,942,500,9,0,52.94624396967608,250,54,35.89455547898002,10
Category_Wikipedia_sockpuppets_of_Okip.csv,8072,352350199.0,2912,5160,500,2412,0,49.59873637264619,500,113,26.065906838453916,2
Category_Wikipedia_sockpuppets_of_Kumar_Trishul_Deo.csv,14,3046.0,6,8,5,1,0,81.14285714285714,192,27,18.357142857142858,15
Category_Wikipedia_sockpuppets_of_Blake_Shawl.csv,278,808158.0,96,182,28,68,0,55.856115107913666,388,68,18.586330935251798,5
Category_Wikipedia_sockpuppets_of_Norman_the_Tank_Engine.csv,94,41649365.0,31,63,19,12,0,57.702127659574465,211,45,19.414893617021278,3
Category_Wikipedia_sockpuppets_of_Bearguardian.csv,145,108361245.0,55,90,46,9,0,67.6,211,54,28.510344827586206,14
Category_Wikipedia_sockpuppets_of_The_Voice_(UK_TV_series).csv,46,706996.0,43,3,40,3,0,11.065217391304348,192,25,25.0,25
Category_Wikipedia_sockpuppets_of_Blobbery_sitspidoodle.csv,178,14769765.0,60,118,33,27,0,43.2247191011236,272,47,16.219101123595507,2
Category_Wikipedia_sockpuppets_of_NYartreview.csv,30,5338920.0,14,16,5,9,0,59.63333333333333,230,42,24.1,10
Category_Wikipedia_sockpuppets_of_Wonderpet.csv,1367,25044961.0,492,875,367,125,0,46.590343818580834,213,72,15.779809802487199,4
Category_Wikipedia_sockpuppets_of_Argyle2006.csv,1180,155422430.0,329,851,25,304,0,44.159322033898306,237,59,18.241525423728813,5
Category_Wikipedia_sockpuppets_of_Grant_Chuggle.csv,845,198576366.0,222,623,221,1,0,25.08165680473373,222,38,18.362130177514793,9
Category_Wikipedia_sockpuppets_of_ChristiaandeWet.csv,2532,149392935.0,871,1661,500,371,0,46.0240916271722,255,78,26.516192733017377,7
Category_Wikipedia_sockpuppets_of_Drstones.csv,353,9417584.0,154,199,81,73,0,46.141643059490086,200,50,22.407932011331443,10
Category_Wikipedia_sockpuppets_of_Homo_erectus3000.csv,60,18601057.0,12,48,7,5,0,47.516666666666666,157,35,21.916666666666668,11
Category_Wikipedia_sockpuppets_of_Kutu_Debbarma(Joshooul).csv,2,0.0,1,1,1,0,0,0.0,0,18,18.0,18
Category_Wikipedia_sockpuppets_of_Zach_Benjamin.csv,4353,14371947.0,1324,3029,500,824,0,32.362278888123136,250,55,16.59797840569722,3
Category_Wikipedia_sockpuppets_of_Rakesh_biswas01.csv,44,33516868.0,12,32,11,1,0,58.15909090909091,196,36,20.545454545454547,6
Category_Wikipedia_sockpuppets_of_Mohit235.csv,372,120925692.0,125,247,89,36,0,46.344086021505376,428,53,18.93548387096774,10
Category_Wikipedia_sockpuppets_of_Fanaticdragon.csv,4,3159.0,2,2,2,0,13,53.5,92,30,21.0,18
Category_Wikipedia_sockpuppets_of_Ascvlvfkd.csv,293,7718771.0,85,208,14,71,0,52.648464163822524,243,45,14.027303754266212,4
Category_Wikipedia_sockpuppets_of_The_Social_Duchess.csv,237,7984976.0,90,147,33,57,0,40.666666666666664,236,53,25.746835443037973,13
Category_Wikipedia_sockpuppets_of_Ali_Ahamed_Thowfeek.csv,11,169829.0,5,6,2,3,0,74.36363636363636,195,46,34.27272727272727,16
Category_Wikipedia_sockpuppets_of_Mgoodman1.csv,14,6882308.0,6,8,4,2,0,26.071428571428573,155,13,13.0,13
Category_Wikipedia_sockpuppets_of_MsSophiaBlack.csv,55,165431922.0,11,44,6,5,0,57.61818181818182,208,23,14.836363636363636,12
Category_Wikipedia_sockpuppets_of_Koohiar.csv,6,393726.0,2,4,2,0,26,42.333333333333336,69,18,17.5,17
Category_Wikipedia_sockpuppets_of_Jeffrey_Victorino.csv,42,4599166.0,17,25,9,8,0,78.42857142857143,380,77,26.19047619047619,7
Category_Wikipedia_sockpuppets_of_Nirkabessa.csv,340,169343272.0,114,226,70,44,0,46.023529411764706,353,46,16.71764705882353,4
Category_Wikipedia_sockpuppets_of_Ayush_kumar_0.csv,88,604472.0,28,60,27,1,0,59.11363636363637,467,24,9.806818181818182,3
Category_Wikipedia_sockpuppets_of_Karrar-commando.csv,1149,190967448.0,235,914,141,94,0,41.94342906875544,255,43,16.04264577893821,4
Category_Wikipedia_sockpuppets_of_Pantsaklan.csv,1361,49867295.0,385,976,256,129,0,31.278471711976486,251,51,23.52387950036738,6
Category_Wikipedia_sockpuppets_of_Acctry.csv,48,233.0,12,36,12,0,0,52.375,204,40,19.104166666666668,8
Category_Wikipedia_sockpuppets_of_Nittin_Das.csv,19356,165381706.0,4719,14637,500,4219,0,47.314682785699524,500,78,16.766015705724325,3
Category_Wikipedia_sockpuppets_of_TweetiePie1947.csv,1048,40117916.0,455,593,180,275,0,29.942748091603054,253,61,27.443702290076335,9
Category_Wikipedia_sockpuppets_of_SurferSquall.csv,4841,15828757.0,1658,3183,500,1158,0,42.510018591200165,499,73,24.16009089031192,3
Category_Wikipedia_sockpuppets_of_AdityaBuzzinga.csv,114,152136015.0,32,82,31,1,0,39.26315789473684,253,42,16.964912280701753,7
Category_Wikipedia_sockpuppets_of_Timiu.csv,56,3166089.0,21,35,6,15,0,43.107142857142854,196,22,16.446428571428573,10
Category_Wikipedia_sockpuppets_of_Who_ordered_137_.csv,2058,379207405.0,500,1558,500,0,0,61.339650145772595,337,54,19.806608357628765,2
Category_Wikipedia_sockpuppets_of_Thedec.csv,581,45699596.0,136,445,100,36,0,34.79173838209983,205,41,18.074010327022375,3
Category_Wikipedia_sockpuppets_of_Nirmalaraman200.csv,227,7331172.0,93,134,91,2,0,27.215859030837006,238,49,16.123348017621144,6
Category_Wikipedia_sockpuppets_of_Nesterovici.csv,28,728259.0,18,10,11,7,0,18.928571428571427,96,45,40.285714285714285,14
Category_Wikipedia_sockpuppets_of_Pfomma.csv,993,21063765.0,541,452,500,41,0,40.522658610271904,357,59,17.15508559919436,5
Category_Wikipedia_sockpuppets_of_Amosflash.csv,1361,71129973.0,579,782,500,79,0,43.85451873622336,368,58,16.103600293901543,4
Category_Wikipedia_sockpuppets_of_Laura_Dormer.csv,276,81493537.0,148,128,146,2,0,49.57608695652174,255,60,28.644927536231883,11
Category_Wikipedia_sockpuppets_of_Unicorn123SL.csv,1023,19868761.0,358,665,243,115,0,54.763440860215056,496,51,22.941348973607038,6
Category_Wikipedia_sockpuppets_of_Powerkoteshwararao.csv,25,2004937.0,7,18,5,2,0,55.76,138,28,19.44,16
Category_Wikipedia_sockpuppets_of_Space_Cadet.csv,3670,439621924.0,956,2714,500,456,0,43.35231607629428,500,50,17.35776566757493,3
Category_Wikipedia_sockpuppets_of_Yayan550.csv,2831,9208036.0,1023,1808,500,523,0,41.99964676792653,433,77,23.459201695513954,3
Category_Wikipedia_sockpuppets_of_Lollipop-3.csv,729,27773851.0,262,467,218,44,0,31.45679012345679,262,60,24.311385459533607,11
Category_Wikipedia_sockpuppets_of_SurvivorCharmSchool.csv,382,129956884.0,159,223,93,66,0,17.513089005235603,221,29,20.29581151832461,14
Category_Wikipedia_sockpuppets_of_Bengalurumaga.csv,1218,210281655.0,327,891,246,81,0,57.56732348111658,393,53,17.96633825944171,3
Category_Wikipedia_sockpuppets_of_Reddragonawakens.csv,427,5787093.0,168,259,129,39,0,44.8384074941452,255,27,15.637002341920375,7
Category_Wikipedia_sockpuppets_of_WellIAmOk.csv,1494,15942692.0,479,1015,407,72,0,39.137215528781795,255,59,26.862115127175368,4
Category_Wikipedia_sockpuppets_of_Suman_Kumar_Mallick.csv,176,23996774.0,66,110,40,26,0,50.24431818181818,255,56,20.59090909090909,11
Category_Wikipedia_sockpuppets_of_Jdanieloh.csv,257,409764111.0,85,172,82,3,0,52.1284046692607,275,46,19.44747081712062,15
Category_Wikipedia_sockpuppets_of_Rafsanmuqtadir.csv,28,17954522.0,8,20,4,4,0,65.46428571428571,226,24,20.178571428571427,15
Category_Wikipedia_sockpuppets_of_William_Mauco.csv,2608,8138971.0,1064,1544,500,564,0,38.90414110429448,260,85,19.46127300613497,5
Category_Wikipedia_sockpuppets_of_RoyalPains11.csv,1575,22901634.0,559,1016,500,59,0,32.05460317460317,247,61,24.17015873015873,6
Category_Wikipedia_sockpuppets_of_Humtvdramaedit.csv,179,8195103.0,46,133,18,28,0,26.29608938547486,255,36,28.88268156424581,10
Category_Wikipedia_sockpuppets_of_ChelseyTao.csv,41,20788.0,23,18,12,11,0,40.58536585365854,226,7,6.2926829268292686,5
Category_Wikipedia_sockpuppets_of_Im2sweaty.csv,278,8119831.0,72,206,24,48,0,31.597122302158272,255,29,18.845323741007196,12
Category_Wikipedia_sockpuppets_of_Markus_W._Karner.csv,58,9825197.0,18,40,17,1,0,62.258620689655174,245,50,23.448275862068964,10
Category_Wikipedia_sockpuppets_of_MIAJudges.csv,1313,18604633.0,556,757,500,56,0,44.08073115003808,412,68,24.084539223153083,7
Category_Wikipedia_sockpuppets_of_Sheangle.csv,185,1791421.0,57,128,28,29,0,52.76216216216216,239,62,28.0,9
Category_Wikipedia_sockpuppets_of_Slurpy121.csv,1472,15051993.0,387,1085,374,13,0,51.57472826086956,253,47,16.778532608695652,4
Category_Wikipedia_sockpuppets_of_Justa_Punk.csv,4886,125034495.0,1827,3059,500,1327,0,43.351616864510845,250,119,30.94146541137945,3
Category_Wikipedia_sockpuppets_of_BGCTwinsEdit.csv,758,12342737.0,336,422,306,30,0,33.58179419525066,255,48,17.984168865435358,6
Category_Wikipedia_sockpuppets_of_Infeby.csv,12,26440850.0,4,8,4,0,0,63.083333333333336,227,38,30.75,11
Category_Wikipedia_sockpuppets_of_Sjonessimon.csv,10,4493.0,5,5,5,0,0,27.3,110,17,17.0,17
Category_Wikipedia_sockpuppets_of_Theresaolojo.csv,83,1542522.0,54,29,45,9,0,37.8433734939759,173,57,19.46987951807229,7
Category_Wikipedia_sockpuppets_of_HessoMediaHQ.csv,85,2495465.0,36,49,30,6,0,36.129411764705885,190,22,15.08235294117647,11
Category_Wikipedia_sockpuppets_of_Theserialcomma.csv,1928,44757902.0,595,1333,500,95,0,53.52697095435685,250,90,25.240663900414937,5
Category_Wikipedia_sockpuppets_of_NikonovNikolai.csv,273,13632440.0,80,193,44,36,0,56.13553113553114,496,44,16.45054945054945,6
Category_Wikipedia_sockpuppets_of_Freddie_Cas.csv,1509,11212008.0,776,733,490,286,0,41.100066269052355,492,67,15.290258449304176,4
Category_Wikipedia_sockpuppets_of_Sreenu_S.csv,613,471332.0,203,410,199,4,0,32.13703099510604,253,58,20.3442088091354,6
Category_Wikipedia_sockpuppets_of_DebtMan.csv,667,11161904.0,223,444,217,6,0,34.06446776611694,231,53,22.143928035982007,5
Category_Wikipedia_sockpuppets_of_E6nvikas.csv,285,2356696.0,148,137,63,85,0,27.940350877192984,197,51,17.03157894736842,4
Category_Wikipedia_sockpuppets_of_Corbridge.csv,3191,40680509.0,1105,2086,500,605,0,48.76433719837042,250,69,19.49232215606393,3
Category_Wikipedia_sockpuppets_of_TheZeitergeist.csv,449,2261873.0,116,333,91,25,0,42.089086859688194,249,41,21.3630289532294,15
Category_Wikipedia_sockpuppets_of_Jack_Bauer_2016.csv,505,6914099.0,166,339,143,23,0,40.906930693069306,253,46,15.885148514851485,6
Category_Wikipedia_sockpuppets_of_Rheeffrv_moa.csv,161,515952.0,47,114,18,29,0,65.01242236024845,236,45,21.5527950310559,3
Category_Wikipedia_sockpuppets_of_JabrinUttu.csv,115,2847133.0,48,67,30,18,0,52.721739130434784,231,42,17.57391304347826,8
Category_Wikipedia_sockpuppets_of_GhostlyOperative.csv,1810,95976217.0,534,1276,381,153,0,60.07348066298343,500,47,16.54198895027624,4
Category_Wikipedia_sockpuppets_of_Garminder13.csv,308,6655746.0,111,197,95,16,0,42.62987012987013,244,47,16.545454545454547,5
Category_Wikipedia_sockpuppets_of_Devakshrai.csv,112,51637098.0,36,76,23,13,0,47.63392857142857,237,53,26.169642857142858,16
Category_Wikipedia_sockpuppets_of_Aminpalangi.csv,16,18611044.0,13,3,9,4,0,40.625,244,21,14.25,12
Category_Wikipedia_sockpuppets_of_Jonardondishant.csv,2285,12692187.0,898,1387,500,398,0,47.74879649890591,500,43,14.189496717724289,5
Category_Wikipedia_sockpuppets_of_AshTFrankFurter2.csv,6996,32784363.0,1678,5318,500,1178,0,30.36206403659234,255,58,20.371069182389938,4
Category_Wikipedia_sockpuppets_of_Raaj_Tilak.csv,2047,39922665.0,693,1354,396,297,0,55.333170493404985,406,63,19.106985832926235,4
Category_Wikipedia_sockpuppets_of_Sergomen1.csv,127,182263866.0,43,84,42,1,0,46.031496062992126,226,66,20.299212598425196,11
Category_Wikipedia_sockpuppets_of_HaTikwa.csv,2338,80903363.0,704,1634,500,204,0,38.32207014542344,250,48,15.821214713430281,4
Category_Wikipedia_sockpuppets_of_MyrtaBeautyQueen.csv,81,5713321.0,25,56,16,9,0,47.72839506172839,419,37,15.790123456790123,10
Category_Wikipedia_sockpuppets_of_Hardvice.csv,867,32233258.0,278,589,278,0,0,34.06343713956171,199,81,28.44636678200692,5
Category_Wikipedia_sockpuppets_of_Danh90.csv,346,56788567.0,75,271,68,7,0,39.13583815028902,206,39,14.297687861271676,8
Category_Wikipedia_sockpuppets_of_Officer_Boscorelli.csv,1397,8155211.0,440,957,387,53,0,34.68002863278454,243,62,19.72154617036507,4
Category_Wikipedia_sockpuppets_of_Fatwhales.csv,87,3195003.0,32,55,25,7,0,41.14942528735632,199,37,14.551724137931034,5
Category_Wikipedia_sockpuppets_of_Bjoergenbestever.csv,2250,89654979.0,818,1432,135,683,0,44.15111111111111,255,59,17.29511111111111,8
Category_Wikipedia_sockpuppets_of_UnderArmourKid.csv,4372,308916022.0,1184,3188,91,1093,0,50.59629460201281,500,64,18.045059469350413,3
Category_Wikipedia_sockpuppets_of_William_the_enderman6713.csv,948,21818089.0,342,606,147,195,0,43.2542194092827,333,65,32.63818565400844,3
Category_Wikipedia_sockpuppets_of_Mukulu10.csv,48,7900422.0,18,30,18,0,0,49.520833333333336,200,55,21.416666666666668,13
Category_Wikipedia_sockpuppets_of_Smith_Liams.csv,306,2833061.0,82,224,13,69,0,40.76797385620915,356,46,19.31699346405229,5
Category_Wikipedia_sockpuppets_of_Recoome.csv,1161,30907108.0,436,725,413,23,0,30.339362618432386,211,55,20.343669250645995,3
Category_Wikipedia_sockpuppets_of_FreedomBoy77.csv,13,1022382.0,8,5,6,2,0,48.30769230769231,207,22,13.0,9
Category_Wikipedia_sockpuppets_of_TornadoFan45.csv,425,20218939.0,169,256,33,136,0,40.501176470588234,367,55,29.738823529411764,12
Category_Wikipedia_sockpuppets_of_KelseyWill.csv,286,105820611.0,84,202,41,43,0,52.07692307692308,333,78,20.706293706293707,5
Category_Wikipedia_sockpuppets_of_Bzeek1.csv,15,225726.0,5,10,4,1,0,53.333333333333336,225,20,14.466666666666667,11
Category_Wikipedia_sockpuppets_of_Categorica.csv,8504,171938653.0,3008,5496,500,2508,0,43.91498118532456,260,84,24.074553151458137,2
Category_Wikipedia_sockpuppets_of_Callump90.csv,1471,325938716.0,393,1078,53,340,0,48.09653297076819,481,54,23.588035350101972,3
Category_Wikipedia_sockpuppets_of_Here2HelpWiki.csv,1953,6592417.0,847,1106,310,537,0,38.17613927291347,242,69,24.837173579109063,8
Category_Wikipedia_sockpuppets_of_Itsboy1.csv,1,0.0,1,0,1,0,21,21.0,21,17,17.0,17
Category_Wikipedia_sockpuppets_of_Ravindu_Navin.csv,1113,12452705.0,543,570,376,167,0,24.758310871518418,251,41,18.397124887690925,7
Category_Wikipedia_sockpuppets_of_Dianaruttman1.csv,628,9535995.0,193,435,47,146,0,50.36305732484077,243,71,18.160828025477706,6
Category_Wikipedia_sockpuppets_of_Rabidpotato88.csv,20,96037094.0,9,11,8,1,0,68.9,250,26,20.25,14
Category_Wikipedia_sockpuppets_of_KJanderson3092.csv,10,1619460.0,3,7,2,1,0,53.8,137,23,20.0,13
Category_Wikipedia_sockpuppets_of_MRTGM_007.csv,36,1406495.0,10,26,8,2,0,29.52777777777778,156,32,20.166666666666668,10
Category_Wikipedia_sockpuppets_of_The_Watchlist_Editor.csv,1669,33595690.0,397,1272,351,46,0,69.97363690832834,499,50,17.478729778310367,5
Category_Wikipedia_sockpuppets_of_Maleidys_Perez.csv,482,24886796.0,124,358,65,59,0,49.66597510373444,250,56,20.047717842323653,5
Category_Wikipedia_sockpuppets_of_Alexson_97.csv,359,12568335.0,143,216,118,25,0,46.799442896935936,382,47,34.02785515320334,14
Category_Wikipedia_sockpuppets_of_Lgbt.history.ig.csv,72,17367396.0,33,39,32,1,0,65.80555555555556,255,25,16.444444444444443,14
Category_Wikipedia_sockpuppets_of_Stern_review~enwiki.csv,517,242694293.0,179,338,61,118,0,55.77176015473888,255,55,18.218568665377177,5
Category_Wikipedia_sockpuppets_of_Tomlui007.csv,2472,24881953.0,921,1551,500,421,0,25.785598705501616,322,65,26.37985436893204,7
Category_Wikipedia_sockpuppets_of_Vaader.csv,18,3414.0,11,7,11,0,0,36.22222222222222,156,18,12.0,8
Category_Wikipedia_sockpuppets_of_Vijayclicker93.csv,416,102910726.0,174,242,130,44,0,28.560096153846153,218,53,20.795673076923077,13
Category_Wikipedia_sockpuppets_of_Notmaggieplum.csv,37,3115913.0,15,22,14,1,0,56.32432432432432,220,20,11.27027027027027,9
Category_Wikipedia_sockpuppets_of_Prin.csv,4164,10859687.0,1982,2182,500,1482,0,17.680355427473582,248,51,15.311239193083573,3
Category_Wikipedia_sockpuppets_of_Kkkikki.csv,501,38176798.0,195,306,131,64,0,44.61477045908184,495,51,14.165668662674651,3
Category_Wikipedia_sockpuppets_of_HeartlessMind.csv,266,36344722.0,83,183,70,13,0,46.87218045112782,330,60,17.150375939849624,3
Category_Wikipedia_sockpuppets_of_JimmyNutari.csv,56,3332011.0,34,22,22,12,0,68.42857142857143,255,26,17.642857142857142,12
Category_Wikipedia_sockpuppets_of_Smartdivyansh2013.csv,78,12147543.0,27,51,18,9,0,29.846153846153847,255,26,18.82051282051282,10
Category_Wikipedia_sockpuppets_of_Nasz.csv,1621,3204640.0,554,1067,500,54,0,34.99814929056138,237,61,15.102405922270204,3
Category_Wikipedia_sockpuppets_of_Aranui.ventures.csv,1,0.0,1,0,1,0,76,76.0,76,14,14.0,14
Category_Wikipedia_sockpuppets_of_UnstoppableUkrainianUltraNationalist.csv,70,2387.0,31,39,14,17,0,70.85714285714286,210,23,8.82857142857143,4
Category_Wikipedia_sockpuppets_of_Johny5000.csv,385,112331324.0,130,255,107,23,0,45.298701298701296,273,50,18.78181818181818,4
Category_Wikipedia_sockpuppets_of_Hail_the_Dark_Lord_Satan.csv,110,349367.0,39,71,31,8,0,48.17272727272727,233,47,35.92727272727273,13
Category_Wikipedia_sockpuppets_of_Franciscus14.csv,1537,20737563.0,401,1136,134,267,0,30.597267404033833,254,40,15.432661027976577,6
Category_Wikipedia_sockpuppets_of_Mrskorea.csv,1137,46696095.0,598,539,364,234,0,24.716798592788038,250,71,22.862796833773086,8
Category_Wikipedia_sockpuppets_of_Freshazimiz439.csv,106,17180396.0,39,67,26,13,0,31.141509433962263,216,51,16.528301886792452,10
Category_Wikipedia_sockpuppets_of_Ivan_Clarin.csv,316,16392381.0,124,192,87,37,0,29.531645569620252,247,53,20.29746835443038,7
Category_Wikipedia_sockpuppets_of_Qst.csv,1485,115190322.0,534,951,500,34,0,34.47542087542087,221,70,25.1973063973064,5
Category_Wikipedia_sockpuppets_of_Cowcat10.csv,4,83.0,3,1,3,0,10,60.25,180,13,13.0,13
Category_Wikipedia_sockpuppets_of_Gemma_at_Yorkshire_Sculpture_Park.csv,13,408462.0,7,6,5,2,6,73.46153846153847,234,24,24.0,24
Category_Wikipedia_sockpuppets_of_Mikethomas8585.csv,470,16537216.0,167,303,66,101,0,53.9531914893617,254,52,19.319148936170212,3
Category_Wikipedia_sockpuppets_of_Alasto_Light.csv,668,25052358.0,191,477,163,28,0,44.23353293413174,222,50,18.0,6
Category_Wikipedia_sockpuppets_of_AndGate1.csv,44,133002511.0,44,0,24,20,0,8.227272727272727,85,21,20.363636363636363,13
Category_Wikipedia_sockpuppets_of_Ravindrahzhz.csv,38,327062.0,15,23,5,10,0,52.5,200,17,9.921052631578947,6
Category_Wikipedia_sockpuppets_of_Dbdhrvtfxyxgs.csv,19,77978.0,15,4,14,1,0,11.736842105263158,154,15,15.0,15
Category_Wikipedia_sockpuppets_of_G√∂ktuƒü538538.csv,277,15291203.0,105,172,105,0,0,78.47653429602889,504,33,21.6101083032491,13
Category_Wikipedia_sockpuppets_of_Rastamouse-ting.csv,273,4369278.0,116,157,83,33,0,51.86813186813187,248,47,18.39194139194139,8
Category_Wikipedia_sockpuppets_of_1234momdad.csv,122,614634.0,84,38,45,39,0,21.25409836065574,199,32,16.71311475409836,10
Category_Wikipedia_sockpuppets_of_New786678.csv,1326,7460729.0,417,909,400,17,0,44.042232277526395,255,47,16.059577677224738,4
Category_Wikipedia_sockpuppets_of_Pooyarad.csv,140,9419753.0,49,91,47,2,0,31.178571428571427,144,30,17.928571428571427,3
Category_Wikipedia_sockpuppets_of_Mizan_biplob.csv,2735,246363920.0,1131,1604,500,631,0,30.652650822669106,253,62,18.080073126142597,3
Category_Wikipedia_sockpuppets_of_Asimrasool1998.csv,10,5708159.0,8,2,3,5,0,45.0,128,44,26.3,14
Category_Wikipedia_sockpuppets_of_George512.csv,799,27299737.0,460,339,364,96,0,27.295369211514394,216,21,12.996245306633291,6
Category_Wikipedia_sockpuppets_of_Saolisok.csv,2,0.0,1,1,1,0,13,13.0,13,13,13.0,13
Category_Wikipedia_sockpuppets_of_Sprimgman090.csv,60,116114.0,23,37,15,8,0,41.333333333333336,240,23,12.266666666666667,2
Category_Wikipedia_sockpuppets_of_Farah.moonfairy.csv,1858,102446140.0,659,1199,474,185,0,50.977933261571586,500,35,16.358449946178688,3
Category_Wikipedia_sockpuppets_of_Jamal.lasri.csv,22,2840524.0,9,13,9,0,0,69.0909090909091,219,64,24.818181818181817,5
Category_Wikipedia_sockpuppets_of_Kabootar1182.csv,293,1769433.0,118,175,64,54,0,57.0716723549488,416,33,18.139931740614333,10
Category_Wikipedia_sockpuppets_of_Logitech95.csv,1304,43991400.0,422,882,245,177,0,42.34815950920245,250,81,19.992331288343557,5
Category_Wikipedia_sockpuppets_of_Milad_Falahati.csv,1811,5370718.0,862,949,500,362,0,14.156267255659856,250,50,17.609055770292656,9
Category_Wikipedia_sockpuppets_of_Jkrdsr.csv,1778,263050774.0,418,1360,301,117,0,43.095050618672666,253,58,16.687289088863892,3
Category_Wikipedia_sockpuppets_of_Thebigs2update.csv,1479,359204076.0,453,1026,163,290,0,37.960108181203516,255,87,13.720757268424611,3
Category_Wikipedia_sockpuppets_of_Socialdem555.csv,156,4314623.0,75,81,63,12,0,34.66025641025641,214,26,18.724358974358974,7
Category_Wikipedia_sockpuppets_of_Jocer_Blandino.csv,1504,191196457.0,421,1083,78,343,0,44.33311170212766,496,52,21.491356382978722,5
Category_Wikipedia_sockpuppets_of_Ghso_ehwj.csv,428,82412918.0,137,291,42,95,0,39.91588785046729,394,52,19.75467289719626,4
Category_Wikipedia_sockpuppets_of_Human_like_you.csv,806,13621052.0,243,563,144,99,0,65.19354838709677,255,54,20.884615384615383,3
Category_Wikipedia_sockpuppets_of_SheldonBlake.csv,1005,2411896.0,939,66,272,667,0,5.9860696517412935,199,24,16.98308457711443,13
Category_Wikipedia_sockpuppets_of_WikiCreators20.csv,79,17549717.0,43,36,29,14,0,43.89873417721519,500,36,26.240506329113924,12
Category_Wikipedia_sockpuppets_of_Koshervigilante.csv,256,4662990.0,87,169,16,71,0,45.10546875,224,66,25.23828125,10
Category_Wikipedia_sockpuppets_of_Lucretius.csv,9379,474182571.0,3708,5671,500,3208,0,46.040942531186694,496,65,15.307282226250134,3
Category_Wikipedia_sockpuppets_of_TuscanMeadow.csv,64,28062413.0,28,36,18,10,0,56.140625,222,22,14.484375,4
Category_Wikipedia_sockpuppets_of_Septo2002.csv,90,35210293.0,28,62,13,15,0,49.84444444444444,301,24,13.422222222222222,6
Category_Wikipedia_sockpuppets_of_Devman2023.csv,121,23230912.0,28,93,27,1,0,83.34710743801652,469,37,18.94214876033058,4
Category_Wikipedia_sockpuppets_of_Nasir_07.csv,208,255097.0,110,98,35,75,0,35.61057692307692,229,34,15.336538461538462,5
Category_Wikipedia_sockpuppets_of_Mr.Univers99.csv,6,59467394.0,5,1,3,2,0,31.666666666666668,114,17,15.5,14
Category_Wikipedia_sockpuppets_of_BlowingSmoke.csv,98,3049749.0,46,52,34,12,0,43.38775510204081,169,27,17.612244897959183,11
Category_Wikipedia_sockpuppets_of_NitrovitNootropic.csv,35,231778764.0,7,28,2,5,0,61.2,214,23,19.8,8
Category_Wikipedia_sockpuppets_of_TracyWat123.csv,1,0.0,1,0,1,0,0,0.0,0,43,43.0,43
Category_Wikipedia_sockpuppets_of_OldMonk25.csv,10,1380549.0,8,2,7,1,0,50.6,196,37,23.5,22
Category_Wikipedia_sockpuppets_of_Francescarye.csv,178,5704326.0,60,118,55,5,0,66.21348314606742,323,45,20.078651685393258,6
Category_Wikipedia_sockpuppets_of_Berkman_Agency.csv,48,1037996.0,33,15,30,3,0,45.770833333333336,499,25,14.895833333333334,13
Category_Wikipedia_sockpuppets_of_Mikegooderson.csv,457,75426781.0,223,234,156,67,0,30.396061269146607,263,56,17.820568927789935,9
Category_Wikipedia_sockpuppets_of_Foxhound03.csv,2313,154939929.0,501,1812,500,1,0,60.97146562905318,486,47,16.07738867271941,4
Category_Wikipedia_sockpuppets_of_Mmbabies.csv,335,10671701.0,79,256,77,2,0,34.94328358208955,245,56,11.322388059701492,1
Category_Wikipedia_sockpuppets_of_Rishushant7878.csv,21,239718.0,11,10,6,5,0,70.61904761904762,201,26,17.952380952380953,13
Category_Wikipedia_sockpuppets_of_Renan_Luis_Moraes.csv,67,12894206.0,41,26,31,10,0,61.417910447761194,313,15,12.194029850746269,11
Category_Wikipedia_sockpuppets_of_Dane97.csv,745,20763561.0,239,506,84,155,0,32.506040268456374,236,49,19.401342281879195,9
Category_Wikipedia_sockpuppets_of_Orca_Vision_Inc..csv,22,4040.0,12,10,12,0,0,88.5,494,47,29.954545454545453,17
Category_Wikipedia_sockpuppets_of_Bobbybillyquit.csv,14,2570866.0,7,7,2,5,0,29.357142857142858,110,30,17.428571428571427,14
Category_Wikipedia_sockpuppets_of_PaeDae_Entertainment.csv,2,0.0,1,1,1,0,43,43.0,43,20,20.0,20
Category_Wikipedia_sockpuppets_of_AymanJomaa.csv,1,0.0,1,0,1,0,30,30.0,30,11,11.0,11
Category_Wikipedia_sockpuppets_of_PennsilfaanischTatar.csv,1073,141636894.0,340,733,303,37,0,50.00559179869525,452,56,17.094128611369992,6
Category_Wikipedia_sockpuppets_of_Jahidulislamratulx.csv,33,479492.0,10,23,10,0,0,34.63636363636363,143,28,16.818181818181817,11
Category_Wikipedia_sockpuppets_of_Gego_geo.csv,611,16797782.0,190,421,82,108,0,53.250409165302784,242,41,15.60392798690671,3
Category_Wikipedia_sockpuppets_of_SleepyHollowGuy1999.csv,5577,62976533.0,1432,4145,500,932,0,46.544558006096466,500,94,16.758830912677066,3
Category_Wikipedia_sockpuppets_of_DeFacto.csv,6732,396503698.0,2220,4512,500,1720,0,60.169786096256686,486,74,22.831105169340464,4
Category_Wikipedia_sockpuppets_of_Dodona.csv,1287,55299967.0,563,724,500,63,0,38.09168609168609,214,49,17.545454545454547,5
Category_Wikipedia_sockpuppets_of_08aviee.csv,369,26065390.0,121,248,64,57,0,48.956639566395665,246,65,29.14363143631436,10
Category_Wikipedia_sockpuppets_of_Justpassinby.csv,386,104209245.0,161,225,149,12,0,39.968911917098445,212,56,24.417098445595855,12
Category_Wikipedia_sockpuppets_of_TipPt.csv,3718,164766898.0,1224,2494,500,724,0,49.184507799892415,250,66,16.556481979558903,3
Category_Wikipedia_sockpuppets_of_SalemHanna.csv,448,5789011.0,177,271,63,114,0,39.535714285714285,253,50,23.212053571428573,6
Category_Wikipedia_sockpuppets_of_Seth_Gonzalez.csv,497,10223415.0,121,376,110,11,0,46.27766599597585,251,35,14.18712273641851,4
Category_Wikipedia_sockpuppets_of_Charrevel.csv,6,1086.0,5,1,3,2,0,7.0,25,23,21.666666666666668,21
Category_Wikipedia_sockpuppets_of_Robbieranger.csv,571,23893775.0,167,404,62,105,0,43.80210157618214,255,47,18.103327495621716,6
Category_Wikipedia_sockpuppets_of_Dhirendra_Chandra_Das.csv,59,8747840.0,16,43,11,5,0,65.94915254237289,241,56,21.338983050847457,8
Category_Wikipedia_sockpuppets_of_AHLM13.csv,1626,4489392.0,517,1109,500,17,0,46.66912669126691,255,63,19.933579335793358,4
Category_Wikipedia_sockpuppets_of_GlobeClimber.csv,685,85991630.0,226,459,123,103,0,57.17810218978102,356,58,19.27007299270073,3
Category_Wikipedia_sockpuppets_of_JatpackMC.csv,437,18963353.0,125,312,38,87,0,44.54004576659039,496,53,19.151029748283754,3
Category_Wikipedia_sockpuppets_of_Ujjwal_20.csv,466,3751944.0,166,300,165,1,0,43.64377682403433,306,61,17.673819742489272,4
Category_Wikipedia_sockpuppets_of_OddibeKerfeld.csv,2994,61926338.0,1025,1969,500,525,0,35.86573146292585,260,91,19.358383433533735,3
Category_Wikipedia_sockpuppets_of_Halcyon_Gallery.csv,8,3175716.0,7,1,6,1,0,13.375,41,13,13.0,13
Category_Wikipedia_sockpuppets_of_Agnistus.csv,1329,417953081.0,502,827,500,2,0,62.45899172310008,359,54,15.398043641835967,4
Category_Wikipedia_sockpuppets_of_Shann_editor.csv,55,2853751.0,22,33,15,7,0,45.90909090909091,250,34,21.90909090909091,17
Category_Wikipedia_sockpuppets_of_Aa372798.csv,3971,125489519.0,1500,2471,500,1000,0,38.75018886930244,500,87,24.689750692520775,6
Category_Wikipedia_sockpuppets_of_Randy_Jaiyan.csv,3182,48358085.0,1272,1910,434,838,0,34.399748585795095,262,63,17.389692017598993,3
Category_Wikipedia_sockpuppets_of_PredatorAssassin.csv,163,1402919.0,69,94,68,1,0,48.92638036809816,255,29,20.67484662576687,15
Category_Wikipedia_sockpuppets_of_AppleMacReporter.csv,3618,31562764.0,1060,2558,500,560,0,51.744333886124934,233,62,18.944444444444443,3
Category_Wikipedia_sockpuppets_of_Prateek_singhal22.csv,114,495915.0,63,51,63,0,0,30.57894736842105,202,52,26.605263157894736,8
Category_Wikipedia_sockpuppets_of_Gitau_George.csv,3,391.0,2,1,2,0,0,0.0,0,14,14.0,14
Category_Wikipedia_sockpuppets_of_Rayooni.csv,1309,28010508.0,490,819,199,291,0,35.26967150496562,397,78,16.925897631779986,5
Category_Wikipedia_sockpuppets_of_Miss_Littlefoot.csv,2,0.0,1,1,1,0,26,26.0,26,22,22.0,22
Category_Wikipedia_sockpuppets_of_AnneFan1.csv,334,26652663.0,147,187,98,49,0,50.02994011976048,243,54,17.335329341317365,11
Category_Wikipedia_sockpuppets_of_Pranshu25.csv,36,26946087.0,15,21,10,5,0,48.5,148,33,20.833333333333332,9
Category_Wikipedia_sockpuppets_of_Tease_Pillar.csv,3005,130090560.0,1121,1884,500,621,0,45.462229617304494,496,54,19.868885191347754,4
Category_Wikipedia_sockpuppets_of_Turok_1.csv,6,548.0,3,3,3,0,0,22.5,92,38,29.0,11
Category_Wikipedia_sockpuppets_of_Dr._Egalitarian.csv,40,11303106.0,10,30,10,0,0,28.025,101,88,28.675,9
Category_Wikipedia_sockpuppets_of_Sharonc.csv,32,290244.0,25,7,22,3,0,27.25,110,18,18.0,18
Category_Wikipedia_sockpuppets_of_ILovePixarCars2028.csv,333,5630863.0,96,237,80,16,0,38.98198198198198,215,35,21.147147147147148,6
Category_Wikipedia_sockpuppets_of_Eastenderseditor2015.csv,1460,3646511.0,516,944,500,16,0,31.78150684931507,255,43,21.966438356164385,7
Category_Wikipedia_sockpuppets_of_Zagora9.csv,16,50803.0,10,6,9,1,0,79.0625,210,20,16.125,15
Category_Wikipedia_sockpuppets_of_M0r4lity.csv,18,42263.0,9,9,6,3,0,29.333333333333332,112,47,18.88888888888889,7
Category_Wikipedia_sockpuppets_of_Escapement.csv,494,283818700.0,202,292,161,41,0,35.44331983805668,255,58,16.139676113360323,7
Category_Wikipedia_sockpuppets_of_PirateSmackK.csv,3433,25054322.0,1001,2432,500,501,0,61.389746577337604,254,97,19.054762598310514,2
Category_Wikipedia_sockpuppets_of_Inspiralens.csv,13,1682599.0,5,8,4,1,0,57.0,198,33,21.153846153846153,13
Category_Wikipedia_sockpuppets_of_Shawnwelling.csv,13,77998678.0,5,8,3,2,0,75.76923076923077,250,22,19.23076923076923,16
Category_Wikipedia_sockpuppets_of_Walteranubus.csv,4,1026.0,3,1,2,1,13,16.75,28,29,29.0,29
Category_Wikipedia_sockpuppets_of_Hornetman16.csv,2541,21742878.0,780,1761,500,280,0,37.77489177489178,210,88,24.663518299881936,3
Category_Wikipedia_sockpuppets_of_Bkay123.csv,30,276669.0,11,19,7,4,0,43.666666666666664,173,21,17.6,16
Category_Wikipedia_sockpuppets_of_LibertyDash.csv,132,845270.0,47,85,43,4,0,50.871212121212125,239,24,15.143939393939394,6
Category_Wikipedia_sockpuppets_of_Aairenuka956.csv,419,49918354.0,129,290,99,30,0,52.57756563245823,496,42,14.073985680190932,6
Category_Wikipedia_sockpuppets_of_Laneinc.csv,21,27598.0,17,4,13,4,0,38.285714285714285,199,16,10.761904761904763,10
Category_Wikipedia_sockpuppets_of_Ningen2006.csv,1247,22425354.0,332,915,165,167,0,53.991178829190055,496,61,20.63432237369687,4
Category_Wikipedia_sockpuppets_of_Prettymae.102002.csv,125,101573.0,42,83,10,32,0,90.152,500,39,17.72,6
Category_Wikipedia_sockpuppets_of_AniksDutta.csv,289,36474208.0,98,191,78,20,0,45.61937716262976,352,47,18.422145328719722,9
Category_Wikipedia_sockpuppets_of_71.202.169.78.csv,61,2670785.0,20,41,20,0,0,28.114754098360656,215,26,12.78688524590164,9
Category_Wikipedia_sockpuppets_of_Rsduaustralia.csv,34,641556.0,27,7,20,7,0,23.852941176470587,139,37,37.0,37
Category_Wikipedia_sockpuppets_of_Dyorkerman.csv,98,7792230.0,32,66,29,3,0,58.06122448979592,233,41,22.163265306122447,13
Category_Wikipedia_sockpuppets_of_Eyrian.csv,3151,23423342.0,936,2215,500,436,0,44.34306569343066,260,110,21.391621707394478,2
Category_Wikipedia_sockpuppets_of_Duchyii.csv,225,7362124.0,78,147,29,49,0,41.635555555555555,224,45,19.133333333333333,7
Category_Wikipedia_sockpuppets_of_Jallah_jeem.csv,352,8854442.0,224,128,100,124,0,30.775568181818183,485,26,11.272727272727273,6
Category_Wikipedia_sockpuppets_of_Arshad_Roshan.a.a.csv,5147,150106406.0,1778,3369,500,1278,0,35.6770934524966,376,68,21.380610064115018,1
Category_Wikipedia_sockpuppets_of_GoaInsomnia.csv,17,105474.0,11,6,10,1,0,19.88235294117647,196,45,35.11764705882353,14
Category_Wikipedia_sockpuppets_of_MichaelFootage.csv,43,152588.0,21,22,18,3,0,54.27906976744186,212,29,21.953488372093023,14
Category_Wikipedia_sockpuppets_of_InternetExplorer3000.csv,10,1130.0,6,4,5,1,0,135.6,199,36,28.4,10
Category_Wikipedia_sockpuppets_of_Zacknoor123.csv,229,8024540.0,64,165,31,33,0,47.29257641921397,220,46,14.314410480349345,3
Category_Wikipedia_sockpuppets_of_Zahra_1369.csv,893,57252319.0,246,647,122,124,0,40.067189249720045,255,62,15.154535274356103,3
Category_Wikipedia_sockpuppets_of_R26431.csv,6,74622.0,2,4,1,1,8,40.0,56,73,62.333333333333336,41
Category_Wikipedia_sockpuppets_of_Goolman21.csv,6,597.0,4,2,3,1,0,34.5,142,34,28.333333333333332,17
Category_Wikipedia_sockpuppets_of_Sukhbir_singh_ji.csv,38,174469.0,30,8,28,2,0,34.921052631578945,184,29,21.57894736842105,15
Category_Wikipedia_sockpuppets_of_Nepallivetoday.csv,54,3062291.0,19,35,15,4,0,51.2037037037037,142,53,25.333333333333332,18
Category_Wikipedia_sockpuppets_of_VeenM64.csv,1728,142494496.0,428,1300,290,138,0,56.895833333333336,360,86,20.38599537037037,3
Category_Wikipedia_sockpuppets_of_Archhow.csv,86,40434856.0,30,56,30,0,0,42.593023255813954,214,35,14.30232558139535,11
Category_Wikipedia_sockpuppets_of_Sairg.csv,8498,164455753.0,3299,5199,500,2799,0,51.16203812661803,500,54,16.808896210873147,3
Category_Wikipedia_sockpuppets_of_Aftabbanoori.csv,1883,166835478.0,514,1369,500,14,0,53.437599575146045,255,43,15.216144450345194,4
Category_Wikipedia_sockpuppets_of_CookieRaider121.csv,170,51902431.0,59,111,40,19,0,55.13529411764706,255,59,21.21764705882353,8
Category_Wikipedia_sockpuppets_of_Scales1987.csv,1,0.0,1,0,1,0,196,196.0,196,22,22.0,22
Category_Wikipedia_sockpuppets_of_SuperStraightLivesMatter.csv,18,67406.0,6,12,6,0,0,84.88888888888889,318,22,18.833333333333332,18
Category_Wikipedia_sockpuppets_of_Taylorswiftfan22.csv,21,6855551.0,7,14,3,4,0,42.857142857142854,147,13,11.523809523809524,11
Category_Wikipedia_sockpuppets_of_Baljot_singh_lyrics.csv,7,4320.0,5,2,3,2,0,54.142857142857146,170,31,28.857142857142858,26
Category_Wikipedia_sockpuppets_of_Yumibflippin1.csv,1307,37603938.0,393,914,293,100,0,41.9433817903596,250,63,22.100994644223412,3
Category_Wikipedia_sockpuppets_of_Freshworth72688.csv,1572,96352049.0,442,1130,61,381,0,47.36513994910941,470,47,20.6940203562341,5
Category_Wikipedia_sockpuppets_of_SirIsaacBrock.csv,11446,418617619.0,3891,7555,500,3391,0,47.92626244976411,500,85,20.276952647213,3
Category_Wikipedia_sockpuppets_of_Numptyisfat.csv,9,1071.0,3,6,2,1,0,101.44444444444444,208,16,16.0,16
Category_Wikipedia_sockpuppets_of_JustTheFacts77.csv,21,19065.0,5,16,3,2,0,62.61904761904762,227,38,26.714285714285715,10
Category_Wikipedia_sockpuppets_of_Kemstarmem.csv,12,975.0,7,5,5,2,19,69.08333333333333,180,23,23.0,23
Category_Wikipedia_sockpuppets_of_Kirbytime.csv,5728,61781970.0,1553,4175,500,1053,0,41.39664804469274,247,104,26.642807262569832,1
Category_Wikipedia_sockpuppets_of_Williamgregory213.csv,2360,42449503.0,566,1794,500,66,0,49.69661016949153,500,53,15.080508474576272,4
Category_Wikipedia_sockpuppets_of_Hadysylmy.csv,866,85460732.0,186,680,120,66,0,52.07274826789838,491,38,10.600461893764434,3
Category_Wikipedia_sockpuppets_of_Abhisheksuvarna17.csv,204,54537537.0,96,108,46,50,0,50.67156862745098,225,53,27.107843137254903,8
Category_Wikipedia_sockpuppets_of_Lolterrybethdenberg.csv,42,2032057.0,26,16,17,9,0,26.80952380952381,196,39,16.785714285714285,12
Category_Wikipedia_sockpuppets_of_LucaCacciolatti.csv,63,43926045.0,21,42,20,1,0,81.38095238095238,269,50,20.80952380952381,15
Category_Wikipedia_sockpuppets_of_Yeeticus14.csv,654,34291944.0,218,436,130,88,0,42.5611620795107,314,33,13.931192660550458,3
Category_Wikipedia_sockpuppets_of_Vishal0soni.csv,1776,103353870.0,647,1129,500,147,0,45.075450450450454,358,149,21.6981981981982,4
Category_Wikipedia_sockpuppets_of_Tarysky.csv,1424,4807283.0,500,924,500,0,0,36.04073033707865,267,54,20.396067415730336,4
Category_Wikipedia_sockpuppets_of_Jawaddmp.csv,31,11644846.0,11,20,5,6,0,38.74193548387097,181,44,23.870967741935484,7
Category_Wikipedia_sockpuppets_of_TheRealAzza.csv,160,5447451.0,64,96,39,25,0,49.2375,240,30,19.35,7
Category_Wikipedia_sockpuppets_of_Biliuyzoz.csv,55,1184418.0,18,37,3,15,0,45.527272727272724,193,28,19.836363636363636,8
Category_Wikipedia_sockpuppets_of_Kumargargavinash.csv,201,151568417.0,68,133,53,15,0,46.472636815920396,244,32,17.388059701492537,8
Category_Wikipedia_sockpuppets_of_Erfan_Abolghasemi.csv,31,934390.0,21,10,12,9,0,64.03225806451613,484,62,56.03225806451613,22
Category_Wikipedia_sockpuppets_of_Lboa2822.csv,80,11750721.0,25,55,12,13,0,55.625,254,63,18.1625,4
Category_Wikipedia_sockpuppets_of_Chukwu12345.csv,84,63697960.0,21,63,15,6,0,51.904761904761905,208,62,34.785714285714285,7
Category_Wikipedia_sockpuppets_of_LordRockall.csv,252,8366771.0,98,154,75,23,0,63.37301587301587,494,52,19.003968253968253,7
Category_Wikipedia_sockpuppets_of_Natly_88.csv,4737,179814518.0,1730,3007,500,1230,0,29.396875659700232,294,69,16.538104285412707,4
Category_Wikipedia_sockpuppets_of_UnbridledBC.csv,132,1901377.0,62,70,24,38,0,44.21212121212121,247,41,21.666666666666668,7
Category_Wikipedia_sockpuppets_of_NewDigitalVideo.csv,12,1039263.0,4,8,4,0,10,45.416666666666664,78,20,20.0,20
Category_Wikipedia_sockpuppets_of_Mythologia.csv,2820,16592627.0,564,2256,500,64,0,34.65780141843972,199,71,14.52836879432624,5
Category_Wikipedia_sockpuppets_of_Sajithj.csv,43,1271877.0,13,30,13,0,0,62.2093023255814,253,36,20.767441860465116,5
Category_Wikipedia_sockpuppets_of_Truetimekeeper.csv,92,3305557.0,31,61,6,25,0,59.81521739130435,225,26,13.58695652173913,6
Category_Wikipedia_sockpuppets_of_GrecoArm.csv,836,4517908.0,240,596,159,81,0,44.57655502392345,321,61,18.07535885167464,5
Category_Wikipedia_sockpuppets_of_Hopiakuta.csv,1459,154331620.0,505,954,500,5,0,72.05414667580534,255,69,19.09184372858122,1
Category_Wikipedia_sockpuppets_of_ƒ∞smail_Kendir.csv,2659,62666788.0,804,1855,383,421,0,57.21812711545694,497,71,15.65814215870628,2
Category_Wikipedia_sockpuppets_of_Obliquenature.csv,227,9638870.0,78,149,42,36,0,57.22466960352423,500,54,7.0176211453744495,3
Category_Wikipedia_sockpuppets_of_Basis_his_4.csv,1746,43993127.0,405,1341,145,260,0,48.81156930126002,217,64,24.873424971363114,4
Category_Wikipedia_sockpuppets_of_Adversegecko.csv,117,403551387.0,39,78,34,5,0,38.1965811965812,224,45,16.17094017094017,3
Category_Wikipedia_sockpuppets_of_Á†¥Â£ûÁ∂≠Âü∫.csv,136,1255820.0,41,95,15,26,0,64.05147058823529,204,37,17.25,7
Category_Wikipedia_sockpuppets_of_Justinwiki75.csv,43,10291038.0,23,20,16,7,0,59.16279069767442,179,13,12.44186046511628,12
Category_Wikipedia_sockpuppets_of_JCKitKat.csv,198,21959526.0,71,127,60,11,0,70.01010101010101,496,47,26.025252525252526,12
Category_Wikipedia_sockpuppets_of_Dadaastra.csv,152,1368731.0,45,107,33,12,0,48.026315789473685,256,44,19.68421052631579,9
Category_Wikipedia_sockpuppets_of_EspinosaLuisJr1791.csv,629,67003229.0,330,299,330,0,0,61.69634340222576,303,74,44.82034976152623,7
Category_Wikipedia_sockpuppets_of_Guns'nroseslover.csv,225,1448875.0,95,130,69,26,0,25.217777777777776,199,27,15.826666666666666,4
Category_Wikipedia_sockpuppets_of_HDHBapji.csv,75,7086791.0,31,44,18,13,0,55.13333333333333,211,33,25.04,13
Category_Wikipedia_sockpuppets_of_Afsoshy.csv,3,347.0,2,1,1,1,0,54.333333333333336,143,37,25.0,19
Category_Wikipedia_sockpuppets_of_Sorufx1.csv,622,2811498.0,183,439,99,84,0,51.59003215434084,496,73,20.622186495176848,4
Category_Wikipedia_sockpuppets_of_HenryFriedberg.csv,2461,51658083.0,684,1777,115,569,0,48.827712312068265,322,55,15.75619666802113,5
Category_Wikipedia_sockpuppets_of_Alextiffin88.csv,567,162087300.0,192,375,168,24,0,48.329805996472665,266,53,22.483245149911816,6
Category_Wikipedia_sockpuppets_of_Sko1221.csv,1246,22259710.0,440,806,426,14,0,47.924558587479936,249,67,20.29454253611557,3
Category_Wikipedia_sockpuppets_of_RUSTINGTON.csv,59,169684893.0,32,27,12,20,0,38.52542372881356,265,32,31.864406779661017,24
Category_Wikipedia_sockpuppets_of_Tgdrebtyrtytyty.csv,27,1267336.0,14,13,8,6,10,77.96296296296296,232,20,8.666666666666666,1
Category_Wikipedia_sockpuppets_of_Naramaru.csv,1026,10480573.0,297,729,260,37,0,54.31384015594542,498,71,17.49317738791423,3
Category_Wikipedia_sockpuppets_of_Laughingdevil.csv,73,33274317.0,30,43,19,11,0,69.8082191780822,361,36,24.876712328767123,16
Category_Wikipedia_sockpuppets_of_Moneyshear123.csv,31,1205.0,9,22,6,3,0,51.516129032258064,230,40,23.516129032258064,4
Category_Wikipedia_sockpuppets_of_Geoffw1948.csv,405,296423913.0,81,324,54,27,0,52.54814814814815,238,41,15.33827160493827,6
Category_Wikipedia_sockpuppets_of_Utpalbaruah.csv,5,4695.0,3,2,3,0,16,118.6,490,31,29.2,28
Category_Wikipedia_sockpuppets_of_Jasmine_Carmelle.csv,12,21037.0,7,5,7,0,31,42.083333333333336,86,15,15.0,15
Category_Wikipedia_sockpuppets_of_Sagethebeast.csv,610,40269371.0,140,470,116,24,0,40.70327868852459,255,52,22.995081967213114,7
Category_Wikipedia_sockpuppets_of_Benniejets.csv,6566,104177626.0,2338,4228,500,1838,0,51.27855619859884,500,82,22.57691136155955,2
Category_Wikipedia_sockpuppets_of_Vicky4197.csv,371,13442756.0,152,219,101,51,0,61.23719676549865,488,29,14.331536388140162,6
Category_Wikipedia_sockpuppets_of_StevenJoarenson.csv,367,254214717.0,103,264,14,89,0,45.10354223433242,245,54,17.73024523160763,8
Category_Wikipedia_sockpuppets_of_George1954US.csv,757,18137589.0,320,437,230,90,0,53.760898282694846,496,53,21.809775429326287,4
Category_Wikipedia_sockpuppets_of_Geofq.csv,850,232383659.0,270,580,227,43,0,49.33529411764706,325,32,13.814117647058824,2
Category_Wikipedia_sockpuppets_of_SoftHusky.csv,167,34994203.0,57,110,21,36,0,48.790419161676645,239,46,20.143712574850298,6
Category_Wikipedia_sockpuppets_of_Bart_Versieck.csv,1800,488075340.0,517,1283,500,17,0,46.596111111111114,507,140,25.22222222222222,7
Category_Wikipedia_sockpuppets_of_Dooggydyl69420.csv,9,746.0,4,5,3,1,0,73.88888888888889,189,20,20.0,20
Category_Wikipedia_sockpuppets_of_Nsequeira119.csv,282,49062200.0,71,211,27,44,0,43.49645390070922,234,70,29.30851063829787,3
Category_Wikipedia_sockpuppets_of_MatimyasFranciaDisneyFan.csv,468,77389461.0,133,335,75,58,0,56.26068376068376,423,54,18.728632478632477,4
Category_Wikipedia_sockpuppets_of_Chess2021.csv,1044,6581585.0,291,753,204,87,0,42.15996168582375,238,53,15.395593869731801,3
Category_Wikipedia_sockpuppets_of_Piyushbhat.csv,223,22643928.0,94,129,69,25,0,53.228699551569505,437,46,18.45291479820628,6
Category_Wikipedia_sockpuppets_of_Tonytonyb.csv,206,99563939.0,56,150,18,38,0,47.922330097087375,206,51,14.577669902912621,10
Category_Wikipedia_sockpuppets_of_Kitkat2015.csv,8,12868720.0,6,2,4,2,0,43.125,190,38,38.0,38
Category_Wikipedia_sockpuppets_of_Bhaveshkpandey.csv,55,11697067.0,23,32,15,8,0,55.54545454545455,253,48,22.654545454545456,14
Category_Wikipedia_sockpuppets_of_Masudraba7576567.csv,21,2328624.0,9,12,4,5,0,48.76190476190476,493,25,18.142857142857142,17
Category_Wikipedia_sockpuppets_of_Elvisasiedu63.csv,4,44764.0,3,1,3,0,15,15.5,16,12,12.0,12
Category_Wikipedia_sockpuppets_of_LiamBanks93.csv,4,257.0,4,0,4,0,0,52.25,199,16,16.0,16
Category_Wikipedia_sockpuppets_of_Scrubber20.csv,126,3374112.0,48,78,30,18,0,61.87301587301587,252,43,15.293650793650794,9
Category_Wikipedia_sockpuppets_of_Riza1234.csv,5014,14045278.0,1826,3188,500,1326,0,26.787794176306342,255,69,17.28121260470682,4
Category_Wikipedia_sockpuppets_of_Peterjohnbrennan.csv,245,16223668.0,80,165,9,71,0,46.6,188,46,18.76326530612245,10
Category_Wikipedia_sockpuppets_of_VisionHawk.csv,422,8788393.0,192,230,73,119,0,54.90284360189573,255,50,31.44075829383886,14
Category_Wikipedia_sockpuppets_of_ArsA-92.csv,1549,29796739.0,511,1038,362,149,0,38.20981278244028,255,55,18.805035506778566,4
Category_Wikipedia_sockpuppets_of_Hersheychu.csv,99,17723812.0,36,63,13,23,0,56.292929292929294,251,29,12.16161616161616,5
Category_Wikipedia_sockpuppets_of_Cucthanh.csv,231,52906694.0,61,170,61,0,0,50.2034632034632,276,27,16.835497835497836,9
Category_Wikipedia_sockpuppets_of_We_have_time_to_go_now_and_we_should_be_there_right_now_so_we_could_still_go_there_go.csv,121,588374.0,40,81,40,0,0,64.66115702479338,276,95,28.107438016528924,9
Category_Wikipedia_sockpuppets_of_Dj1508.csv,3016,60799285.0,1046,1970,500,546,0,38.426392572944295,500,84,26.14555702917772,3
Category_Wikipedia_sockpuppets_of_Lebronjames65456.csv,16,1162.0,7,9,5,2,0,41.8125,233,23,13.5625,10
Category_Wikipedia_sockpuppets_of_Ali1228.csv,22,35302.0,9,13,7,2,0,68.95454545454545,234,17,7.545454545454546,5
Category_Wikipedia_sockpuppets_of_CaptainAmerica12.csv,40,3461544.0,10,30,5,5,0,62.95,234,19,14.425,12
Category_Wikipedia_sockpuppets_of_MusaIbnYusef.csv,77,44221991.0,29,48,27,2,0,47.311688311688314,214,27,12.03896103896104,5
Category_Wikipedia_sockpuppets_of_Galaxyangelnew.csv,160,776981.0,110,50,110,0,0,27.2625,149,27,22.5,12
Category_Wikipedia_sockpuppets_of_Rockosteve.csv,368,10895893.0,99,269,47,52,0,55.375,240,56,17.70108695652174,5
Category_Wikipedia_sockpuppets_of_Arsen.danga.csv,20,338869.0,7,13,7,0,0,41.1,146,23,19.0,13
Category_Wikipedia_sockpuppets_of_Dseeswe.csv,11,24941411.0,4,7,3,1,0,18.363636363636363,89,35,17.818181818181817,14
Category_Wikipedia_sockpuppets_of_Vote4Freedom.csv,23,39715.0,14,9,13,1,21,39.869565217391305,66,25,17.0,4
Category_Wikipedia_sockpuppets_of_–ú–æ–π_–ø–∞—Ä–æ–ª—å_—è–π—Ü–æ.csv,3,20.0,2,1,2,0,40,44.0,52,20,12.666666666666666,9
Category_Wikipedia_sockpuppets_of_Ernestosanz.csv,18,3609496.0,7,11,6,1,0,82.88888888888889,155,20,14.222222222222221,13
Category_Wikipedia_sockpuppets_of_TamwarThePeabrain.csv,25,119470.0,12,13,8,4,0,57.12,150,36,17.2,11
Category_Wikipedia_sockpuppets_of_PatrickHenryClark.csv,128,82951453.0,47,81,26,21,0,46.96875,332,32,16.0078125,4
Category_Wikipedia_sockpuppets_of_Ankit_verma_123.csv,23,34506123.0,6,17,6,0,0,47.69565217391305,157,42,30.73913043478261,19
Category_Wikipedia_sockpuppets_of_Edgar181.csv,13541,415514168.0,4023,9518,500,3523,0,61.083007163429585,481,115,18.8076212982793,2
Category_Wikipedia_sockpuppets_of_YhwhElohimAdonMoshe.csv,3,48932.0,2,1,1,1,7,96.66666666666667,179,18,18.0,18
Category_Wikipedia_sockpuppets_of_TGI_TUESDAYS.csv,19,1329.0,6,13,3,3,0,69.15789473684211,240,21,15.526315789473685,11
Category_Wikipedia_sockpuppets_of_SHAHEENHUN.csv,1808,13383879.0,858,950,500,358,0,44.38993362831859,427,71,29.331305309734514,7
Category_Wikipedia_sockpuppets_of_Rescue_15_Pakistan.csv,13,10326520.0,7,6,4,3,0,43.07692307692308,199,25,19.384615384615383,12
Category_Wikipedia_sockpuppets_of_Jimbollins.csv,10,749948.0,5,5,4,1,0,20.3,129,47,33.9,14
Category_Wikipedia_sockpuppets_of_Chaubeypu.csv,61,8186469.0,28,33,18,10,0,34.442622950819676,165,34,20.491803278688526,12
Category_Wikipedia_sockpuppets_of_Sam_Zannino.csv,36,214965.0,17,19,8,9,0,26.27777777777778,199,23,15.63888888888889,14
Category_Wikipedia_sockpuppets_of_Bonkers_The_Clown.csv,1373,18146806.0,513,860,500,13,0,52.64166059723234,255,95,25.431900946831757,4
Category_Wikipedia_sockpuppets_of_Foulball.csv,82,691374.0,26,56,15,11,0,50.80487804878049,199,42,23.573170731707318,16
Category_Wikipedia_sockpuppets_of_Daniel_Fatahillah_Abrori.csv,991,43321516.0,303,688,50,253,0,33.17255297679112,422,46,25.471241170534814,7
Category_Wikipedia_sockpuppets_of_Musukundan.csv,3094,69757267.0,1198,1896,500,698,0,31.748868778280542,250,84,27.156755009696187,4
Category_Wikipedia_sockpuppets_of_XcamFly.csv,478,9500115.0,140,338,59,81,0,62.00418410041841,496,52,19.225941422594143,4
Category_Wikipedia_sockpuppets_of_Walkabout21.csv,37,2207177.0,20,17,14,6,0,40.21621621621622,358,23,18.486486486486488,8
Category_Wikipedia_sockpuppets_of_Kells48.csv,3,258.0,2,1,2,0,11,17.333333333333332,21,17,14.333333333333334,9
Category_Wikipedia_sockpuppets_of_Nandha_Gokul_Hero.csv,4,103182434.0,3,1,3,0,16,27.0,36,20,20.0,20
Category_Wikipedia_sockpuppets_of_RadyoUkay819.csv,5313,41501506.0,1952,3361,500,1452,0,31.742706568793526,498,48,18.583662714097496,6
Category_Wikipedia_sockpuppets_of_Jornalista68152.csv,62,35163310.0,30,32,18,12,0,64.91935483870968,492,37,19.20967741935484,4
Category_Wikipedia_sockpuppets_of_Oftenalert2000.csv,81,14063356.0,48,33,31,17,0,44.97530864197531,255,24,10.419753086419753,6
Category_Wikipedia_sockpuppets_of_Aj30003000.csv,287,5455878.0,123,164,93,30,0,56.40418118466899,264,61,21.843205574912893,5
Category_Wikipedia_sockpuppets_of_Kagundu.csv,2462,109525666.0,887,1575,500,387,0,63.56661251015434,314,91,25.68927701056052,3
Category_Wikipedia_sockpuppets_of_Soniadakota.csv,101,2258511.0,43,58,38,5,0,51.94059405940594,255,26,18.861386138613863,9
Category_Wikipedia_sockpuppets_of_Jobayer007.csv,69,376936.0,26,43,26,0,0,30.014492753623188,188,22,13.884057971014492,6
Category_Wikipedia_sockpuppets_of_45abc123.csv,1685,12093624.0,709,976,393,316,0,28.988724035608307,255,41,20.644510385756675,3
Category_Wikipedia_sockpuppets_of_Nikkul.csv,2685,387067908.0,637,2048,500,137,0,53.1608938547486,255,56,11.166852886405959,4
Category_Wikipedia_sockpuppets_of_Dariuspalmer.csv,13,21071.0,5,8,5,0,0,24.076923076923077,132,25,19.153846153846153,12
Category_Wikipedia_sockpuppets_of_Acejet.csv,6689,208163418.0,2135,4554,500,1635,0,43.368066975631635,255,97,23.738376438929585,2
Category_Wikipedia_sockpuppets_of_CommanderReviser.csv,97,766615.0,34,63,22,12,0,54.608247422680414,260,51,21.237113402061855,8
Category_Wikipedia_sockpuppets_of_SamridhTmrk.csv,1857,5590223.0,666,1191,500,166,0,42.788906838987614,364,49,21.03446418955304,5
Category_Wikipedia_sockpuppets_of_AHeistwithEgeSamil.csv,22,11663676.0,7,15,5,2,0,66.4090909090909,230,47,22.681818181818183,10
Category_Wikipedia_sockpuppets_of_RussianFanboy2010.csv,2400,63592081.0,818,1582,500,318,0,43.4725,496,49,19.280416666666667,4
Category_Wikipedia_sockpuppets_of_Kim_Cardassian.csv,24036,144407486.0,8197,15839,500,7697,0,37.41213180229656,271,123,20.7799550673989,1
Category_Wikipedia_sockpuppets_of_Regisfugit.csv,356,5595471.0,137,219,133,4,0,45.89887640449438,195,51,24.640449438202246,11
Category_Wikipedia_sockpuppets_of_Lena_Jp.csv,115,44655418.0,31,84,15,16,0,48.26086956521739,362,39,16.547826086956523,3
Category_Wikipedia_sockpuppets_of_Assaf050.csv,1480,11977267.0,539,941,500,39,0,36.54121621621621,247,48,23.45472972972973,4
Category_Wikipedia_sockpuppets_of_Chris386a.csv,11,8524817.0,6,5,6,0,0,63.45454545454545,199,19,17.09090909090909,14
Category_Wikipedia_sockpuppets_of_Vivekkumar987v.csv,33,40495.0,11,22,7,4,0,65.96969696969697,187,21,12.696969696969697,4
Category_Wikipedia_sockpuppets_of_Mary512.csv,55,1511390.0,16,39,14,2,0,66.63636363636364,200,20,19.818181818181817,18
Category_Wikipedia_sockpuppets_of_Ericbiddle.csv,100,79750257.0,20,80,8,12,0,50.24,250,35,18.59,4
Category_Wikipedia_sockpuppets_of_NORDKAPP.csv,681,36719768.0,259,422,169,90,0,36.286343612334804,200,35,13.37151248164464,5
Category_Wikipedia_sockpuppets_of_Pilyakin.csv,85,3976247.0,32,53,6,26,0,23.141176470588235,179,27,15.129411764705882,11
Category_Wikipedia_sockpuppets_of_Seong_Il_Moon.csv,1339,155751500.0,306,1033,173,133,0,47.28603435399552,485,52,14.48469006721434,1
Category_Wikipedia_sockpuppets_of_Gozelbahadur.csv,190,19485194.0,59,131,19,40,0,53.642105263157895,260,40,17.71578947368421,6
Category_Wikipedia_sockpuppets_of_Isaacarthy.csv,3522,100460866.0,803,2719,412,391,0,38.80891538898353,499,78,21.005394662123795,4
Category_Wikipedia_sockpuppets_of_EChewning.csv,6308,100750983.0,1750,4558,209,1541,0,49.11271401395054,484,80,22.27393785668992,3
Category_Wikipedia_sockpuppets_of_Sir_Francis_Drake_(not_really!).csv,728,54520501.0,287,441,173,114,0,38.63324175824176,218,65,25.103021978021978,9
Category_Wikipedia_sockpuppets_of_M.vladislav26.csv,114,20144223.0,40,74,34,6,0,45.421052631578945,290,49,22.412280701754387,7
Category_Wikipedia_sockpuppets_of_Johnking121.csv,288,58405670.0,123,165,85,38,0,71.63888888888889,396,53,15.315972222222221,9
Category_Wikipedia_sockpuppets_of_Aashu27.csv,77,6809685.0,28,49,18,10,0,40.16883116883117,208,38,16.532467532467532,5
Category_Wikipedia_sockpuppets_of_Bookbinder_01.csv,179,11919030.0,50,129,31,19,0,60.899441340782126,239,63,26.48603351955307,9
Category_Wikipedia_sockpuppets_of_Samuel_Williscroft.csv,1045,169314131.0,344,701,315,29,0,42.20861244019139,332,79,27.475598086124403,3
Category_Wikipedia_sockpuppets_of_WrestlerHelper3.csv,2018,17282542.0,727,1291,500,227,0,44.72001982160555,423,56,20.986620416253718,3
Category_Wikipedia_sockpuppets_of_Rhenyra.csv,222,13261115.0,74,148,67,7,0,49.252252252252255,306,30,19.08108108108108,5
Category_Wikipedia_sockpuppets_of_The_Wookieepedian.csv,2210,47616431.0,597,1613,500,97,0,44.69864253393665,255,71,20.27918552036199,4
Category_Wikipedia_sockpuppets_of_HenryVIIIyes.csv,293,34889789.0,83,210,12,71,0,57.51877133105802,249,47,22.0580204778157,6
Category_Wikipedia_sockpuppets_of_Jt986.csv,50,2002372.0,12,38,8,4,0,82.74,233,46,19.4,9
Category_Wikipedia_sockpuppets_of_Vandman1.csv,2180,53324310.0,599,1581,26,573,0,56.58761467889908,499,70,22.923853211009174,4
Category_Wikipedia_sockpuppets_of_Ayushmaan14.csv,1112,31958934.0,383,729,118,265,0,52.548561151079134,496,86,26.115107913669064,11
Category_Wikipedia_sockpuppets_of_Ragusino.csv,3709,127175486.0,1444,2265,500,944,0,36.22566729576705,250,53,15.294149366406039,4
Category_Wikipedia_sockpuppets_of_HJKPO.csv,9,396.0,7,2,3,4,0,36.111111111111114,125,61,44.666666666666664,12
Category_Wikipedia_sockpuppets_of_Martinakohl.csv,41,25383.0,22,19,19,3,0,35.26829268292683,202,18,12.024390243902438,9
Category_Wikipedia_sockpuppets_of_VishalVithalKamat.csv,113,1485838.0,57,56,39,18,0,51.584070796460175,298,70,24.424778761061948,4
Category_Wikipedia_sockpuppets_of_Fryboy_Editor.csv,2065,2967023.0,579,1486,500,79,0,45.24939467312349,515,47,15.00629539951574,3
Category_Wikipedia_sockpuppets_of_Smsarmad.csv,2119,470430706.0,502,1617,500,2,0,46.46295422369042,498,57,19.43558282208589,2
Category_Wikipedia_sockpuppets_of_Yoodaba.csv,30193,108297438.0,8487,21706,500,7987,0,48.752194217202664,500,78,15.843672374391415,3
Category_Wikipedia_sockpuppets_of_Thegoravsharma.csv,262,4360568.0,98,164,96,2,0,37.80916030534351,276,31,16.33587786259542,7
Category_Wikipedia_sockpuppets_of_Bojnec.csv,4,3113810.0,3,1,2,1,28,84.25,196,23,19.5,16
Category_Wikipedia_sockpuppets_of_GFZLab.csv,54,7633263.0,26,28,20,6,0,50.03703703703704,212,21,12.537037037037036,5
Category_Wikipedia_sockpuppets_of_Phoebe_Snow00.csv,157,11145012.0,62,95,26,36,0,55.78343949044586,494,29,12.738853503184714,7
Category_Wikipedia_sockpuppets_of_FredericoHibertus95.csv,3270,8906820.0,1169,2101,500,669,0,35.26299694189603,255,42,19.444648318042812,9
Category_Wikipedia_sockpuppets_of_Christosebastin.csv,234,45667774.0,61,173,60,1,0,32.67094017094017,229,54,16.97008547008547,6
Category_Wikipedia_sockpuppets_of_Belovedaunt.csv,81,72137429.0,41,40,39,2,0,41.50617283950617,199,28,22.950617283950617,13
Category_Wikipedia_sockpuppets_of_BelDog1964x.csv,21,2686.0,11,10,9,2,0,26.0,270,17,12.19047619047619,10
Category_Wikipedia_sockpuppets_of_Marco747.csv,383,3128977.0,142,241,64,78,0,28.287206266318538,199,50,15.297650130548304,4
Category_Wikipedia_sockpuppets_of_Aalistan.csv,134,6921190.0,52,82,25,27,0,49.62686567164179,298,45,18.402985074626866,5
Category_Wikipedia_sockpuppets_of_TheCaseOfGoliath.csv,1988,43744156.0,725,1263,88,637,0,52.649396378269614,499,63,18.419517102615693,5
Category_Wikipedia_sockpuppets_of_P0rk.csv,57,790307.0,19,38,11,8,0,27.07017543859649,134,34,11.12280701754386,4
Category_Wikipedia_sockpuppets_of_Aashima_Kapoor_Bhatia.csv,135,12623379.0,44,91,41,3,0,45.87407407407407,239,56,25.355555555555554,6
Category_Wikipedia_sockpuppets_of_Sheeryn21.csv,438,4759746.0,149,289,104,45,0,34.75114155251141,269,33,14.132420091324201,6
Category_Wikipedia_sockpuppets_of_Thomas_Keats.csv,35,4065492.0,12,23,6,6,0,62.05714285714286,200,40,27.285714285714285,10
Category_Wikipedia_sockpuppets_of_Maxpayne525.csv,167,318150.0,74,93,67,7,0,28.652694610778443,199,30,19.275449101796408,9
Category_Wikipedia_sockpuppets_of_L2pkpandey.csv,245,95066189.0,55,190,38,17,0,44.85306122448979,358,59,17.848979591836734,5
Category_Wikipedia_sockpuppets_of_Ideogram.csv,3721,180697510.0,1226,2495,500,726,0,41.19645256651438,255,84,24.031711905401774,3
Category_Wikipedia_sockpuppets_of_Myths_of_Christianity.csv,30,1434.0,15,15,7,8,0,62.13333333333333,250,50,17.833333333333332,10
Category_Wikipedia_sockpuppets_of_Mohdasad2006.csv,514,13403633.0,202,312,193,9,0,35.490272373540854,254,42,12.0,5
Category_Wikipedia_sockpuppets_of_Boskit190.csv,1209,293368709.0,404,805,86,318,0,49.30934656741108,286,63,24.33498759305211,3
Category_Wikipedia_sockpuppets_of_Forceian.csv,8,54017.0,3,5,2,1,32,66.25,84,18,17.375,13
Category_Wikipedia_sockpuppets_of_Susan_Alexander_Kane.csv,49,1624472.0,20,29,11,9,0,79.12244897959184,245,40,17.918367346938776,8
Category_Wikipedia_sockpuppets_of_Rfaith09.csv,1408,165713763.0,510,898,493,17,0,46.19673295454545,259,44,20.254261363636363,9
Category_Wikipedia_sockpuppets_of_Frater_FiatLux.csv,2642,38753551.0,1201,1441,500,701,0,37.7664647993944,200,100,33.22482967448902,10
Category_Wikipedia_sockpuppets_of_Promojacksin.csv,1,0.0,1,0,1,0,0,0.0,0,22,22.0,22
Category_Wikipedia_sockpuppets_of_7USpv9^k.csv,34,1386559.0,23,11,13,10,0,106.05882352941177,273,32,21.705882352941178,15
Category_Wikipedia_sockpuppets_of_Armandojimenesaqp.csv,377,10985881.0,104,273,45,59,0,50.289124668435015,313,39,18.453580901856764,5
Category_Wikipedia_sockpuppets_of_Astha211.csv,1,0.0,1,0,1,0,31,31.0,31,18,18.0,18
Category_Wikipedia_sockpuppets_of_Dr_Sachin_Kapur_Fanclub.csv,2639,99691447.0,773,1866,500,273,0,59.666540356195526,501,61,18.30125047366427,4
Category_Wikipedia_sockpuppets_of_Bella1111.csv,190,5515172.0,102,88,32,70,0,25.3,199,48,16.652631578947368,12
Category_Wikipedia_sockpuppets_of_Fccorra.csv,31,447802.0,17,14,10,7,0,51.32258064516129,198,24,9.32258064516129,4
Category_Wikipedia_sockpuppets_of_CareerUpdate.csv,431,85657075.0,152,279,135,17,0,51.25522041763341,238,51,16.79350348027842,9
Category_Wikipedia_sockpuppets_of_EssieErving.csv,47,701896.0,13,34,4,9,0,42.0,199,28,19.53191489361702,12
Category_Wikipedia_sockpuppets_of_ExtendicareCommunications.csv,7,424384.0,6,1,2,4,0,37.857142857142854,158,11,11.0,11
Category_Wikipedia_sockpuppets_of_CompScientist.csv,899,14700651.0,328,571,321,7,0,41.1301446051168,250,61,13.942157953281423,8
Category_Wikipedia_sockpuppets_of_Silly.boiz.csv,29,1867.0,9,20,9,0,0,40.275862068965516,150,24,19.93103448275862,17
Category_Wikipedia_sockpuppets_of_Harry_sinclair.csv,85,3804100.0,24,61,10,14,0,51.34117647058824,218,26,19.223529411764705,12
Category_Wikipedia_sockpuppets_of_Brockhold.csv,6693,120605000.0,1824,4869,500,1324,0,43.336620349619004,505,62,22.916629314208876,4
Category_Wikipedia_sockpuppets_of_MY_KPLY.csv,12,14452.0,8,4,6,2,5,26.0,117,18,13.833333333333334,13
Category_Wikipedia_sockpuppets_of_Wesleyner7.csv,666,162144898.0,242,424,96,146,0,45.28078078078078,295,66,18.91141141141141,5
Category_Wikipedia_sockpuppets_of_Recent_contributors_unless.csv,25,4846909.0,5,20,3,2,0,64.56,265,37,31.16,9
Category_Wikipedia_sockpuppets_of_ILIRIDAproud.csv,260,116909467.0,98,162,50,48,0,48.542307692307695,500,49,13.146153846153846,4
Category_Wikipedia_sockpuppets_of_JohnHarold.csv,1051,255604539.0,500,551,500,0,0,35.22930542340628,252,33,14.414843006660323,9
Category_Wikipedia_sockpuppets_of_Kaasdaraubrrruh.csv,13,172052.0,9,4,9,0,0,63.69230769230769,265,30,24.46153846153846,18
Category_Wikipedia_sockpuppets_of_Coqsportif.csv,3025,2705156.0,944,2081,500,444,0,28.73388429752066,200,84,17.613884297520663,3
Category_Wikipedia_sockpuppets_of_Mowglili.csv,33,8189.0,25,8,22,3,0,15.181818181818182,221,24,24.0,24
Category_Wikipedia_sockpuppets_of_Freedom_is_Possible_Ministry.csv,7,534.0,4,3,4,0,14,56.142857142857146,171,20,20.0,20
Category_Wikipedia_sockpuppets_of_Jagz.csv,4887,65125987.0,1814,3073,500,1314,0,50.44321669736034,255,69,26.494372825864538,6
Category_Wikipedia_sockpuppets_of_Evanthius_Donatus.csv,87,7158139.0,39,48,31,8,0,54.40229885057471,216,51,22.908045977011493,8
Category_Wikipedia_sockpuppets_of_Pablozeta.csv,2666,83425373.0,1017,1649,500,517,0,39.09452363090773,249,69,22.6470367591898,9
Category_Wikipedia_sockpuppets_of_Tempo_temp.csv,32,13218199.0,15,17,14,1,0,42.6875,196,30,17.15625,6
Category_Wikipedia_sockpuppets_of_I_Like_Socks.csv,76,2129.0,21,55,16,5,0,59.026315789473685,255,31,17.855263157894736,9
Category_Wikipedia_sockpuppets_of_SongForOrhan.csv,118,43460826.0,29,89,12,17,0,56.80508474576271,232,50,20.95762711864407,9
Category_Wikipedia_sockpuppets_of_Moe_Zoyari.csv,82,15994025.0,36,46,18,18,0,41.59756097560975,238,44,24.524390243902438,10
Category_Wikipedia_sockpuppets_of_THEPILEFROMTHEHEAVENS.csv,7,3846.0,4,3,2,2,0,44.0,150,46,34.42857142857143,19
Category_Wikipedia_sockpuppets_of_Blazewing16.csv,1588,11496272.0,574,1014,500,74,0,62.7588161209068,395,62,20.879093198992443,4
Category_Wikipedia_sockpuppets_of_Am6212.csv,1899,26918157.0,680,1219,440,240,0,43.38230647709321,217,71,16.516061084781462,4
Category_Wikipedia_sockpuppets_of_Haramisalabakchod.csv,135,2159153.0,43,92,35,8,0,46.03703703703704,234,44,18.288888888888888,5
Category_Wikipedia_sockpuppets_of_Filmgola.csv,708,3560366.0,202,506,23,179,0,36.3545197740113,255,34,15.63135593220339,6
Category_Wikipedia_sockpuppets_of_JINXTENGU.csv,78,39492227.0,25,53,8,17,0,33.43589743589744,147,35,23.0,5
Category_Wikipedia_sockpuppets_of_Realhistorybuff.csv,564,17941071.0,124,440,34,90,0,56.67553191489362,247,47,16.51595744680851,4
Category_Wikipedia_sockpuppets_of_Klitsnerfamily.csv,9,56423.0,6,3,4,2,0,23.22222222222222,55,12,11.666666666666666,9
Category_Wikipedia_sockpuppets_of_DJMASACRE.csv,86,206803.0,42,44,21,21,0,43.02325581395349,176,27,20.511627906976745,18
Category_Wikipedia_sockpuppets_of_INDpedia.csv,173,71320083.0,54,119,30,24,0,37.91329479768786,463,63,47.323699421965316,19
Category_Wikipedia_sockpuppets_of_Kory_clark.csv,34,183926.0,15,19,10,5,0,47.11764705882353,137,31,21.352941176470587,10
Category_Wikipedia_sockpuppets_of_AuthenticSources2546.csv,2085,6698261.0,669,1416,500,169,0,58.84268585131895,384,35,13.597601918465228,3
Category_Wikipedia_sockpuppets_of_Blenard_Azizaj.csv,10,12038.0,7,3,5,2,0,75.4,495,28,25.9,24
Category_Wikipedia_sockpuppets_of_Argumentdebate.csv,124,6986.0,29,95,20,9,0,44.67741935483871,209,50,31.233870967741936,19
Category_Wikipedia_sockpuppets_of_Annavaldez.csv,393,62964114.0,119,274,42,77,0,38.50381679389313,255,53,23.66412213740458,7
Category_Wikipedia_sockpuppets_of_Morphenniel.csv,1740,22860113.0,514,1226,500,14,0,61.974137931034484,340,87,23.285057471264366,4
Category_Wikipedia_sockpuppets_of_Bigbulletfeels.csv,265,80744698.0,84,181,32,52,0,49.60377358490566,302,43,18.381132075471697,10
Category_Wikipedia_sockpuppets_of_Justiceinwiki.csv,314,8464501.0,135,179,91,44,0,32.03503184713376,210,28,17.121019108280255,10
Category_Wikipedia_sockpuppets_of_Suresh_jaggi.csv,16,1032255.0,9,7,9,0,0,18.625,68,12,12.0,12
Category_Wikipedia_sockpuppets_of_Hibrido_Mutante.csv,1312,182175942.0,527,785,500,27,0,51.823170731707314,253,57,19.798780487804876,10
Category_Wikipedia_sockpuppets_of_Nhlrules.csv,524,21263856.0,166,358,80,86,0,38.12404580152672,250,53,18.39503816793893,9
Category_Wikipedia_sockpuppets_of_GabrielCombs.csv,95,37342179.0,28,67,17,11,0,41.68421052631579,224,44,30.105263157894736,20
Category_Wikipedia_sockpuppets_of_Cecelia199.csv,78,54482776.0,36,42,22,14,0,39.14102564102564,193,15,11.038461538461538,10
Category_Wikipedia_sockpuppets_of_ANNMT.csv,29,9316336.0,25,4,13,12,0,17.275862068965516,84,22,16.517241379310345,10
Category_Wikipedia_sockpuppets_of_Jumamuba.csv,1173,6174912.0,448,725,426,22,0,40.18840579710145,229,45,10.252344416027281,3
Category_Wikipedia_sockpuppets_of_Geb2355.csv,1710,11740988.0,712,998,306,406,0,34.27076023391813,496,54,35.21637426900585,9
Category_Wikipedia_sockpuppets_of_Vikash9097.csv,40,1707577.0,13,27,8,5,0,42.95,196,28,18.85,11
Category_Wikipedia_sockpuppets_of_BoopedityBoop1.csv,154,74580414.0,50,104,45,5,0,52.077922077922075,242,57,16.058441558441558,8
Category_Wikipedia_sockpuppets_of_Rd64e.csv,265,26254623.0,93,172,69,24,0,43.716981132075475,273,60,25.252830188679244,3
Category_Wikipedia_sockpuppets_of_Lcxzdf56.csv,1187,52873443.0,437,750,399,38,0,42.393428812131425,255,55,16.91743892165122,3
Category_Wikipedia_sockpuppets_of_Stpetestan.csv,1619,85796754.0,430,1189,210,220,0,51.06114885731933,275,53,22.29647930821495,5
Category_Wikipedia_sockpuppets_of_Baron_D._Z..csv,612,421030524.0,196,416,195,1,0,54.51307189542484,241,43,17.233660130718953,4
Category_Wikipedia_sockpuppets_of_Elanor_Day_Bel.csv,20,10423417.0,10,10,10,0,0,44.4,194,29,20.5,15
Category_Wikipedia_sockpuppets_of_Usblogger27.csv,224,4368394.0,91,133,91,0,0,38.625,255,46,12.25,4
Category_Wikipedia_sockpuppets_of_Kataraisdabest.csv,93,5285898.0,24,69,18,6,0,29.49462365591398,141,29,18.096774193548388,10
Category_Wikipedia_sockpuppets_of_Ghrnnthethnthnthn.csv,4,8036.0,3,1,2,1,0,79.25,143,18,18.0,18
Category_Wikipedia_sockpuppets_of_Gavinc2211.csv,150,19197596.0,43,107,17,26,0,47.82,312,35,16.126666666666665,3
Category_Wikipedia_sockpuppets_of_Shastatree748.csv,18,255212.0,15,3,14,1,0,55.22222222222222,303,28,25.88888888888889,9
Category_Wikipedia_sockpuppets_of_Radicalafrica.csv,330,4971519.0,101,229,39,62,0,54.28787878787879,232,65,14.266666666666667,6
Category_Wikipedia_sockpuppets_of_NekSeOvajVijekGordi.csv,180,3672785.0,147,33,142,5,0,42.983333333333334,496,55,18.31111111111111,12
Category_Wikipedia_sockpuppets_of_Thaizokku.csv,1058,20331661.0,320,738,300,20,0,37.05198487712666,233,51,20.03024574669187,6
Category_Wikipedia_sockpuppets_of_Malakadew.csv,816,35644179.0,369,447,331,38,0,28.827205882352942,215,65,20.426470588235293,9
Category_Wikipedia_sockpuppets_of_Shokioto22.csv,1771,32081026.0,444,1327,339,105,0,50.984189723320156,255,66,25.525127046866178,2
Category_Wikipedia_sockpuppets_of_Clong6496.csv,171,7348376.0,44,127,32,12,0,54.9766081871345,245,93,23.649122807017545,6
Category_Wikipedia_sockpuppets_of_BriceStratford.csv,2449,278975098.0,617,1832,500,117,0,48.6802776643528,255,85,20.35198040016333,4
Category_Wikipedia_sockpuppets_of_Kirbyn4.csv,110,155061.0,48,62,31,17,0,30.78181818181818,192,18,17.636363636363637,14
Category_Wikipedia_sockpuppets_of_Virajmishra.csv,2348,101390868.0,784,1564,217,567,0,38.7133730834753,299,87,20.11839863713799,2
Category_Wikipedia_sockpuppets_of_Whiteproperton97.csv,2581,44954906.0,851,1730,500,351,0,41.61410306082914,500,55,19.048430840759394,4
Category_Wikipedia_sockpuppets_of_Yash_Pal_Rao.csv,108,90267891.0,48,60,40,8,0,33.592592592592595,208,22,8.703703703703704,5
Category_Wikipedia_sockpuppets_of_Pepe_Grillo_2010.csv,159,1796862.0,73,86,67,6,0,38.257861635220124,272,27,17.465408805031448,7
Category_Wikipedia_sockpuppets_of_ThatIPGuy.csv,143,231062.0,70,73,51,19,0,33.11888111888112,191,47,24.965034965034967,14
Category_Wikipedia_sockpuppets_of_Skiyomi.csv,1661,127549485.0,555,1106,65,490,0,52.41420830824804,496,88,25.995183624322696,4
Category_Wikipedia_sockpuppets_of_Atifaven.csv,32,1027795.0,15,17,14,1,0,54.5,520,31,12.71875,11
Category_Wikipedia_sockpuppets_of_MJGR.csv,1919,38011381.0,673,1246,500,173,0,26.878582595101616,198,73,19.009379885356957,5
Category_Wikipedia_sockpuppets_of_Jfell.csv,85,2938973.0,25,60,25,0,0,32.22352941176471,139,25,15.611764705882353,5
Category_Wikipedia_sockpuppets_of_TVC_colwal.csv,62,7096862.0,30,32,15,15,0,42.67741935483871,175,28,13.903225806451612,9
Category_Wikipedia_sockpuppets_of_Asafedi.csv,547,230277171.0,174,373,53,121,0,39.82815356489945,255,51,18.23583180987203,6
Category_Wikipedia_sockpuppets_of_His_excellency.csv,5152,68397452.0,1795,3357,500,1295,0,44.47127329192546,249,104,25.656638198757765,5
Category_Wikipedia_sockpuppets_of_RidinHood25.csv,1462,473262.0,451,1011,451,0,0,40.811217510259915,255,116,19.61833105335157,7
Category_Wikipedia_sockpuppets_of_Libessart100.csv,8019,136803305.0,2706,5313,500,2206,0,50.6687866317496,397,74,24.48148148148148,4
Category_Wikipedia_sockpuppets_of_DnevnaDozaDebilizma.csv,8,10144.0,5,3,4,1,0,27.375,166,29,23.375,20
Category_Wikipedia_sockpuppets_of_KewQuorum.csv,33,5434811.0,12,21,7,5,0,50.96969696969697,236,45,18.757575757575758,11
Category_Wikipedia_sockpuppets_of_Moban222.csv,12,1725365.0,3,9,3,0,0,31.416666666666668,80,27,24.166666666666668,10
Category_Wikipedia_sockpuppets_of_Deucharman.csv,2677,93127568.0,1122,1555,500,622,0,63.444527456107586,255,61,22.806126260739635,6
Category_Wikipedia_sockpuppets_of_Eatdrinkmerry.csv,279,31027868.0,92,187,34,58,0,51.842293906810035,255,40,15.731182795698924,7
Category_Wikipedia_sockpuppets_of_GagsGagsGags.csv,206,33023310.0,57,149,28,29,0,44.49514563106796,255,46,25.233009708737864,7
Category_Wikipedia_sockpuppets_of_Khan_tabrez.csv,936,118808324.0,261,675,61,200,0,50.20405982905983,359,72,19.86111111111111,6
Category_Wikipedia_sockpuppets_of_Luvstay11.csv,2,57.0,2,0,2,0,0,98.0,196,24,24.0,24
Category_Wikipedia_sockpuppets_of_Mauryabhi7715.csv,2517,73803847.0,957,1560,500,457,0,45.60866110448947,498,50,15.580055621771951,3
Category_Wikipedia_sockpuppets_of_Factsonlyplease39.csv,21003,321226726.0,6356,14647,500,5856,0,47.581964481264585,500,89,17.860448507356093,3
Category_Wikipedia_sockpuppets_of_Harirajmohanhrm.csv,2301,74904182.0,631,1670,500,131,0,52.41764450239027,255,56,15.006084311169056,4
Category_Wikipedia_sockpuppets_of_Ryan_Fitzpatrick's_Beard.csv,48,6153621.0,17,31,9,8,0,64.29166666666667,200,75,40.354166666666664,8
Category_Wikipedia_sockpuppets_of_CWii.csv,5134,38725241.0,2026,3108,500,1526,0,51.67062719127386,264,96,21.10966108297624,1
"Category_Wikipedia_sockpuppets_of_Scooby,_Scrappy_and_etc..csv",4,177.0,2,2,2,0,0,56.5,160,32,23.0,20
Category_Wikipedia_sockpuppets_of_La_goutte_de_pluie.csv,1740,15560339.0,541,1199,500,41,0,48.055747126436785,250,64,27.889080459770113,4
Category_Wikipedia_sockpuppets_of_EurigiYO.csv,480,10799724.0,141,339,40,101,0,46.56666666666667,278,54,19.725,6
Category_Wikipedia_sockpuppets_of_Rockzchandan.csv,49,14069551.0,31,18,17,14,0,40.57142857142857,255,82,38.63265306122449,9
Category_Wikipedia_sockpuppets_of_The_Voice_Stars.csv,42,124288231.0,11,31,11,0,0,47.142857142857146,252,36,22.285714285714285,12
Category_Wikipedia_sockpuppets_of_Stronzo89.csv,115,330052.0,29,86,9,20,0,45.55652173913043,229,22,13.165217391304347,6
Category_Wikipedia_sockpuppets_of_Mocha2007.csv,2059,420601211.0,508,1551,500,8,0,50.65080135988344,321,116,19.3317144244779,3
Category_Wikipedia_sockpuppets_of_Newtonslaw40.csv,638,58976134.0,215,423,104,111,0,47.739811912225704,255,58,20.037617554858933,3
Category_Wikipedia_sockpuppets_of_FonnerDalton.csv,130,2213977.0,101,29,89,12,0,23.16923076923077,209,30,19.592307692307692,14
Category_Wikipedia_sockpuppets_of_LCJUNIOR1220.csv,80,19736769.0,36,44,25,11,0,44.4375,206,48,33.875,22
Category_Wikipedia_sockpuppets_of_Opc123.csv,1019,763006.0,367,652,341,26,0,31.852796859666338,248,45,14.909715407262022,3
Category_Wikipedia_sockpuppets_of_IHeardFromBob.csv,1244,204865943.0,270,974,140,130,0,48.714630225080384,255,71,20.510450160771704,5
Category_Wikipedia_sockpuppets_of_RufusTheEditor.csv,65,57563067.0,13,52,8,5,0,104.04615384615384,254,45,18.06153846153846,11
Category_Wikipedia_sockpuppets_of_Phage434.csv,100,39044723.0,40,60,35,5,0,52.96,233,50,28.35,6
Category_Wikipedia_sockpuppets_of_Guswen.csv,1294,83062619.0,501,793,500,1,0,70.07109737248841,500,57,20.341576506955178,2
Category_Wikipedia_sockpuppets_of_BlackTreble.csv,19,4018992.0,5,14,4,1,0,25.36842105263158,158,12,10.526315789473685,6
Category_Wikipedia_sockpuppets_of_Yrdsb.csv,426,43981315.0,144,282,108,36,0,50.44600938967136,490,71,25.610328638497652,6
Category_Wikipedia_sockpuppets_of_GR86.csv,1360,12361563.0,504,856,500,4,0,49.52720588235294,500,90,17.33823529411765,4
Category_Wikipedia_sockpuppets_of_Tylerbrooker1.csv,2,52282.0,2,0,2,0,23,259.5,496,30,24.5,19
Category_Wikipedia_sockpuppets_of_Anuragdixitartist.csv,49,6275185.0,44,5,24,20,0,19.46938775510204,152,27,14.89795918367347,12
Category_Wikipedia_sockpuppets_of_Fred117.csv,10,396.0,8,2,4,4,0,28.9,140,17,17.0,17
Category_Wikipedia_sockpuppets_of_Ireneirenegoncalves.csv,254,6615421.0,89,165,13,76,0,52.326771653543304,455,31,19.551181102362204,5
Category_Wikipedia_sockpuppets_of_Mikhailov_Kusserow.csv,1510,329230518.0,500,1010,500,0,0,38.21456953642384,261,76,27.10927152317881,4
Category_Wikipedia_sockpuppets_of_River1range.csv,2,1655.0,2,0,1,1,86,86.0,86,16,14.0,12
Category_Wikipedia_sockpuppets_of_Ilhamramadhan1996.csv,132,100349.0,61,71,46,15,0,51.15909090909091,207,30,15.280303030303031,9
Category_Wikipedia_sockpuppets_of_Fantasy_Entertainment.csv,2028,15597866.0,625,1403,500,125,0,28.5034516765286,225,68,18.974358974358974,3
Category_Wikipedia_sockpuppets_of_EntmootsOfTrolls.csv,2212,65591296.0,867,1345,444,423,0,24.24367088607595,200,93,21.97965641952984,3
Category_Wikipedia_sockpuppets_of_Shahidislam31.csv,196,165118477.0,66,130,22,44,0,47.025510204081634,230,74,24.474489795918366,11
Category_Wikipedia_sockpuppets_of_Mrlob.csv,6336,139553815.0,2120,4216,500,1620,0,31.083333333333332,237,72,19.666035353535353,4
Category_Wikipedia_sockpuppets_of_IAskWhatIsTrue.csv,263,7254280.0,99,164,73,26,0,50.372623574144484,473,47,29.254752851711025,9
Category_Wikipedia_sockpuppets_of_Chace_Watson.csv,4211,150822434.0,1523,2688,500,1023,0,36.76870102113512,255,57,14.112087390168606,4
Category_Wikipedia_sockpuppets_of_CowboysRDaBest.csv,35,1067959.0,17,18,15,2,0,22.742857142857144,140,26,15.82857142857143,13
Category_Wikipedia_sockpuppets_of_Stickulus.csv,861,48821485.0,316,545,232,84,0,35.40766550522648,250,66,18.5993031358885,4
Category_Wikipedia_sockpuppets_of_LindaBresonik.csv,87,429792.0,55,32,46,9,0,37.275862068965516,361,29,19.0,8
Category_Wikipedia_sockpuppets_of_Jpfuktard.csv,19,450278.0,8,11,3,5,0,56.526315789473685,216,36,26.05263157894737,5
Category_Wikipedia_sockpuppets_of_NazariyKaminski.csv,2930,219733626.0,1000,1930,500,500,0,64.57303754266212,500,67,16.244368600682595,5
Category_Wikipedia_sockpuppets_of_PunjabCinema07.csv,4083,17409500.0,1036,3047,500,536,0,49.56086211119275,497,62,13.732549595885379,5
Category_Wikipedia_sockpuppets_of_Deanarthurl.csv,7256,44330037.0,2915,4341,500,2415,0,34.34922822491731,500,71,21.709619625137815,4
Category_Wikipedia_sockpuppets_of_GingerBreadHarlot.csv,1777,46844974.0,637,1140,500,137,0,51.00956668542487,254,51,18.484524479459765,7
Category_Wikipedia_sockpuppets_of_Syedaadi.csv,383,209496911.0,156,227,102,54,0,45.362924281984334,497,48,19.446475195822455,5
Category_Wikipedia_sockpuppets_of_Ayodejiabdura.csv,55,7259719.0,15,40,9,6,0,44.03636363636364,197,32,13.745454545454546,7
Category_Wikipedia_sockpuppets_of_Shankarees.csv,98,2879174.0,43,55,41,2,0,25.336734693877553,169,20,11.704081632653061,5
Category_Wikipedia_sockpuppets_of_Starofnight2012.csv,62,341475.0,31,31,29,2,0,56.5,192,53,19.629032258064516,9
Category_Wikipedia_sockpuppets_of_Vincent9000.csv,576,9717518.0,211,365,37,174,0,42.640625,255,40,22.241319444444443,7
Category_Wikipedia_sockpuppets_of_WilliamJohnCox.csv,779,297204688.0,253,526,134,119,0,49.397946084724005,279,42,18.517329910141207,3
Category_Wikipedia_sockpuppets_of_Atheist_kerala.csv,1769,70520707.0,548,1221,312,236,0,58.25268513284342,500,59,19.582815149802148,3
Category_Wikipedia_sockpuppets_of_Tweety21.csv,2357,92090867.0,821,1536,477,344,0,30.855748833262624,214,59,20.605854900296986,5
Category_Wikipedia_sockpuppets_of_Bigbadbass.csv,476,267193903.0,205,271,114,91,0,33.34033613445378,241,37,16.964285714285715,8
Category_Wikipedia_sockpuppets_of_Murphywonder789.csv,29,6396002.0,7,22,5,2,0,54.44827586206897,222,22,14.620689655172415,11
Category_Wikipedia_sockpuppets_of_Kkm5848.csv,1101,115769146.0,432,669,409,23,0,45.475022706630334,224,77,21.158038147138964,5
Category_Wikipedia_sockpuppets_of_Ben.Kura.csv,3,263413.0,2,1,2,0,0,2.3333333333333335,7,18,18.0,18
Category_Wikipedia_sockpuppets_of_Wikipatrolwatch.csv,104,24511061.0,42,62,33,9,0,42.66346153846154,234,84,29.41346153846154,10
Category_Wikipedia_sockpuppets_of_WWEFan1926.csv,1232,224511811.0,733,499,500,233,0,40.861201298701296,491,38,25.377435064935064,14
Category_Wikipedia_sockpuppets_of_Rovendley.csv,435,63484142.0,196,239,156,40,0,31.56551724137931,214,54,16.2,4
Category_Wikipedia_sockpuppets_of_Shashwad_Basavaraj_Babalgaon.csv,33,20211799.0,8,25,6,2,0,74.51515151515152,234,38,18.181818181818183,5
Category_Wikipedia_sockpuppets_of_Kinglongbackdaggerdick.csv,1,0.0,1,0,1,0,107,107.0,107,16,16.0,16
Category_Wikipedia_sockpuppets_of_Ickenyon1.csv,1,0.0,1,0,1,0,61,61.0,61,14,14.0,14
Category_Wikipedia_sockpuppets_of_Dessiedolan.csv,72,169706.0,26,46,12,14,0,31.27777777777778,158,17,14.041666666666666,9
Category_Wikipedia_sockpuppets_of_Deadbeat_parent.csv,43,7686696.0,23,20,7,16,0,70.74418604651163,252,28,20.325581395348838,12
Category_Wikipedia_sockpuppets_of_Bhaskarrijal.csv,908,194615935.0,323,585,167,156,0,38.636563876651984,338,41,19.62775330396476,3
Category_Wikipedia_sockpuppets_of_Cars_And_Computers.csv,90,24637528.0,25,65,11,14,0,52.98888888888889,222,46,24.81111111111111,3
Category_Wikipedia_sockpuppets_of_Simon_vod.csv,16,6711745.0,7,9,3,4,0,18.8125,104,27,26.1875,14
Category_Wikipedia_sockpuppets_of_Linder1990.csv,2140,11496953.0,816,1324,467,349,0,33.23177570093458,241,57,25.209345794392522,3
Category_Wikipedia_sockpuppets_of_Treeyoyo.csv,199,37895242.0,82,117,35,47,0,36.82914572864322,229,28,18.64824120603015,6
Category_Wikipedia_sockpuppets_of_◊û◊™◊ü_◊î◊ó◊™◊ô◊ö.csv,231,5525493.0,53,178,51,2,0,37.103896103896105,192,47,14.965367965367966,4
Category_Wikipedia_sockpuppets_of_RT_Rana.csv,52,24044890.0,16,36,16,0,0,38.34615384615385,190,20,17.71153846153846,15
Category_Wikipedia_sockpuppets_of_Kane584.csv,316,13645369.0,70,246,56,14,0,40.35443037974684,219,45,9.155063291139241,3
Category_Wikipedia_sockpuppets_of_ThomasK.csv,2464,152287758.0,558,1906,500,58,0,41.78814935064935,251,56,18.25284090909091,2
Category_Wikipedia_sockpuppets_of_DJ_Lil'_Shock.csv,1502,11368938.0,529,973,500,29,0,28.333555259653796,233,43,18.278295605858855,3
Category_Wikipedia_sockpuppets_of_Musicfan000.csv,19,14579140.0,12,7,9,3,0,53.26315789473684,196,26,16.63157894736842,14
Category_Wikipedia_sockpuppets_of_Tony_Beach_Enthusiast.csv,630,4917666.0,258,372,110,148,0,45.53015873015873,398,80,23.488888888888887,5
Category_Wikipedia_sockpuppets_of_No_Great_Shaker.csv,6076,354038414.0,2165,3911,500,1665,0,52.98782093482554,500,94,25.17577353522054,5
Category_Wikipedia_sockpuppets_of_CapitalSmartCity19.csv,2,1176.0,2,0,1,1,45,45.0,45,28,26.0,24
Category_Wikipedia_sockpuppets_of_Gctyler.csv,126,3062367.0,45,81,23,22,0,52.285714285714285,255,73,20.30952380952381,5
Category_Wikipedia_sockpuppets_of_Zhmailik.csv,762,61080648.0,311,451,229,82,0,43.71391076115486,495,50,19.12204724409449,5
Category_Wikipedia_sockpuppets_of_OwenReeceBaines.csv,32,2569658.0,11,21,7,4,0,41.125,108,42,29.9375,17
Category_Wikipedia_sockpuppets_of_Hydrabolessay.csv,2415,17699489.0,679,1736,259,420,0,54.457556935817806,500,68,17.836024844720498,4
Category_Wikipedia_sockpuppets_of_Michel_Herv√©_Bertaux-Navoiseau.csv,1123,124255342.0,332,791,329,3,0,58.28940338379341,255,50,27.576135351736422,7
Category_Wikipedia_sockpuppets_of_Mr.Cappadocia.csv,151,49675321.0,53,98,20,33,0,51.258278145695364,209,49,18.43046357615894,8
Category_Wikipedia_sockpuppets_of_Baekho0721.csv,231,32584443.0,102,129,52,50,0,48.878787878787875,495,20,13.354978354978355,6
Category_Wikipedia_sockpuppets_of_Peter_perry.csv,13,1251.0,8,5,5,3,0,13.384615384615385,171,41,38.76923076923077,12
Category_Wikipedia_sockpuppets_of_Nongmenz.csv,10,2465.0,7,3,6,1,0,51.8,113,14,14.0,14
Category_Wikipedia_sockpuppets_of_Jabberwock2015.csv,279,12208364.0,67,212,43,24,0,51.229390681003586,254,56,31.27956989247312,9
Category_Wikipedia_sockpuppets_of_Mikethewhistle-original.csv,2935,26155290.0,814,2121,500,314,0,67.37137989778535,500,76,21.455536626916526,3
Category_Wikipedia_sockpuppets_of_Elpresidente360.csv,1999,12705609.0,605,1394,235,370,0,46.729864932466235,500,53,14.125062531265632,3
Category_Wikipedia_sockpuppets_of_MunasheHungwe.csv,23,760112.0,9,14,8,1,0,64.0,219,18,13.304347826086957,12
Category_Wikipedia_sockpuppets_of_IphisOfCrete.csv,6105,44337880.0,2152,3953,500,1652,0,49.96445536445536,471,73,18.818345618345617,3
Category_Wikipedia_sockpuppets_of_Datker32.csv,169,28065998.0,55,114,47,8,0,51.44378698224852,376,45,17.94674556213018,4
Category_Wikipedia_sockpuppets_of_Alex_singersing.csv,572,17108187.0,189,383,23,166,0,41.6486013986014,243,68,25.95104895104895,4
Category_Wikipedia_sockpuppets_of_Sebastian80.csv,1535,4574605.0,500,1035,500,0,0,40.57068403908795,250,56,15.745928338762216,4
Category_Wikipedia_sockpuppets_of_Esdfgh.csv,408,45106299.0,136,272,80,56,0,36.36029411764706,284,43,17.75,8
Category_Wikipedia_sockpuppets_of_Tankosava.csv,353,1997818.0,121,232,4,117,0,71.4929178470255,238,25,13.88385269121813,4
Category_Wikipedia_sockpuppets_of_Anyuse110.csv,1180,148610106.0,282,898,208,74,0,49.34322033898305,225,52,18.051694915254238,5
Category_Wikipedia_sockpuppets_of_LadyGaGaDDDisco.csv,507,9432143.0,187,320,69,118,0,32.18145956607495,255,58,23.499013806706113,8
Category_Wikipedia_sockpuppets_of_FriendlyTamer.csv,1803,21972598.0,488,1315,413,75,0,44.36882972823073,472,52,18.828618968386024,6
Category_Wikipedia_sockpuppets_of_AussieJr.csv,202,6812997.0,82,120,76,6,0,39.12376237623762,224,44,21.02970297029703,6
Category_Wikipedia_sockpuppets_of_BME917.csv,33,66594270.0,8,25,6,2,0,56.96969696969697,202,49,20.12121212121212,14
Category_Wikipedia_sockpuppets_of_VoHRA.csv,136,1676417.0,57,79,19,38,0,47.595588235294116,252,19,13.985294117647058,9
Category_Wikipedia_sockpuppets_of_Ancy025.csv,277,20160749.0,141,136,131,10,0,30.03610108303249,255,39,14.59927797833935,9
Category_Wikipedia_sockpuppets_of_SAS343.csv,470,188255254.0,137,333,77,60,0,60.806382978723406,353,53,14.846808510638297,3
Category_Wikipedia_sockpuppets_of_Felixfollets.csv,156,5809512.0,60,96,32,28,0,69.15384615384616,252,52,20.102564102564102,5
Category_Wikipedia_sockpuppets_of_Geezygee.csv,1031,89889392.0,436,595,256,180,0,45.59068865179437,496,56,17.536372453928227,4
Category_Wikipedia_sockpuppets_of_Porgers.csv,331,1080144.0,88,243,60,28,0,54.48036253776435,248,72,25.018126888217523,6
Category_Wikipedia_sockpuppets_of_Alexsirguy.csv,81,425409.0,23,58,13,10,0,71.5925925925926,305,19,12.975308641975309,7
Category_Wikipedia_sockpuppets_of_Samar_Abbas_Chaudhary.csv,40,3019979.0,15,25,6,9,0,38.35,160,41,19.275,3
Category_Wikipedia_sockpuppets_of_Karala_Suresh.csv,3369,49292647.0,1268,2101,500,768,0,32.468981893737016,461,47,15.674680914217868,4
Category_Wikipedia_sockpuppets_of_TwelverShii.csv,270,3120579.0,98,172,98,0,0,51.544444444444444,488,57,17.822222222222223,5
Category_Wikipedia_sockpuppets_of_APKRader.csv,6,817.0,3,3,3,0,20,69.66666666666667,274,27,21.333333333333332,15
Category_Wikipedia_sockpuppets_of_Top_20_Remedies.csv,11,1633119.0,5,6,5,0,11,38.18181818181818,126,20,10.727272727272727,6
Category_Wikipedia_sockpuppets_of_Demond_Anthony.csv,1350,6212948.0,489,861,475,14,0,33.03407407407408,364,67,28.925185185185185,9
Category_Wikipedia_sockpuppets_of_Wikpedia_boy.csv,25,5336.0,8,17,3,5,0,74.72,157,28,16.76,10
Category_Wikipedia_sockpuppets_of_DreamWorksFan.csv,1445,17619390.0,517,928,500,17,0,34.43598615916955,255,40,25.078200692041523,3
Category_Wikipedia_sockpuppets_of_Avengersarise.csv,6,1309.0,6,0,5,1,0,51.666666666666664,153,25,25.0,25
Category_Wikipedia_sockpuppets_of_Vrrayrescue.csv,82,1119197.0,34,48,21,13,0,46.97560975609756,213,47,17.25609756097561,7
Category_Wikipedia_sockpuppets_of_Moha.Ay.csv,434,19663653.0,190,244,163,27,0,43.596774193548384,255,74,19.163594470046082,6
Category_Wikipedia_sockpuppets_of_TeenTitansBeastBoy.csv,154,462797.0,45,109,23,22,0,32.883116883116884,197,26,12.584415584415584,6
Category_Wikipedia_sockpuppets_of_Kari2MuchFan.csv,2362,19660251.0,701,1661,500,201,0,23.77688399661304,200,45,15.873412362404741,1
Category_Wikipedia_sockpuppets_of_Anon_ducky.csv,34,7637774.0,25,9,17,8,0,73.67647058823529,256,28,17.941176470588236,11
Category_Wikipedia_sockpuppets_of_Rajesh121skr.csv,194,12734383.0,72,122,39,33,0,45.22164948453608,284,52,19.1340206185567,5
Category_Wikipedia_sockpuppets_of_Delzem.csv,204,6144114.0,90,114,60,30,0,39.28431372549019,232,72,23.083333333333332,6
Category_Wikipedia_sockpuppets_of_Sandra.pied.csv,64,6214536.0,24,40,16,8,0,66.859375,212,51,30.390625,14
Category_Wikipedia_sockpuppets_of_Jelloud_Najem.csv,92,7173304.0,31,61,14,17,0,43.81521739130435,446,42,14.793478260869565,10
Category_Wikipedia_sockpuppets_of_Lutrinae.csv,1266,20749916.0,385,881,274,111,0,62.05608214849921,250,56,20.226698262243286,5
Category_Wikipedia_sockpuppets_of_CarlosSinclair.csv,4,13431.0,2,2,1,1,58,101.0,118,18,14.0,10
Category_Wikipedia_sockpuppets_of_Gerald_Gonzalez.csv,9099,66452332.0,3536,5563,500,3036,0,28.950214309264755,262,83,18.61402351906803,3
Category_Wikipedia_sockpuppets_of_Moneag0123.csv,4,67349.0,2,2,2,0,0,66.25,127,13,12.0,11
Category_Wikipedia_sockpuppets_of_Gojolly18.csv,13,3628686.0,7,6,7,0,0,61.61538461538461,203,39,15.307692307692308,4
Category_Wikipedia_sockpuppets_of_Editor_Ignasi.csv,51,74446.0,21,30,15,6,0,76.92156862745098,237,54,26.352941176470587,8
Category_Wikipedia_sockpuppets_of_Jinnifer.csv,2000,101722919.0,573,1427,48,525,0,51.5295,484,66,20.039,4
Category_Wikipedia_sockpuppets_of_SimpsonsFan08.csv,2773,46748187.0,1053,1720,389,664,0,33.80923187883159,268,81,20.87017670393076,3
Category_Wikipedia_sockpuppets_of_PakistanHistorian.csv,14004,54845995.0,3545,10459,500,3045,0,45.51206798057698,500,62,17.26885175664096,3
Category_Wikipedia_sockpuppets_of_Derwulf.csv,9,691.0,4,5,2,2,0,65.66666666666667,146,18,11.0,9
Category_Wikipedia_sockpuppets_of_RabiaAsif7.csv,42,1310972.0,12,30,8,4,0,44.38095238095238,189,21,14.333333333333334,9
Category_Wikipedia_sockpuppets_of_Fahim_Ahmed_CEO.csv,9,161358.0,2,7,2,0,1,66.66666666666667,92,45,41.22222222222222,28
Category_Wikipedia_sockpuppets_of_Wowzers.csv,18,2977527.0,7,11,5,2,0,59.166666666666664,254,20,12.222222222222221,10
Category_Wikipedia_sockpuppets_of_Mecotuningg.csv,19,471175.0,6,13,3,3,0,88.57894736842105,245,23,14.052631578947368,10
Category_Wikipedia_sockpuppets_of_Maltamatters.csv,32,467071.0,24,8,22,2,0,113.9375,310,25,15.96875,15
Category_Wikipedia_sockpuppets_of_SharkEmpress01.csv,250,30756548.0,63,187,55,8,0,38.748,229,43,20.444,4
Category_Wikipedia_sockpuppets_of_Jezyl_Galarpe.csv,1547,8741564.0,521,1026,500,21,0,34.48674854557208,285,61,25.376212023270845,1
Category_Wikipedia_sockpuppets_of_Akash.vg3309.csv,10,9704.0,6,4,6,0,4,22.4,74,47,31.0,14
Category_Wikipedia_sockpuppets_of_Samranghani.csv,6,12632125.0,5,1,3,2,0,30.833333333333332,83,29,23.833333333333332,21
Category_Wikipedia_sockpuppets_of_Crownies.csv,84,214362.0,32,52,16,16,0,42.95238095238095,207,37,15.654761904761905,9
Category_Wikipedia_sockpuppets_of_Virotherapy.csv,28,529623.0,24,4,14,10,0,115.39285714285714,326,6,6.0,6
Category_Wikipedia_sockpuppets_of_Victim_of_Cybercrime.csv,19,7797.0,14,5,14,0,0,43.73684210526316,197,30,24.0,19
Category_Wikipedia_sockpuppets_of_Williammorris69420.csv,5,239.0,3,2,2,1,0,68.0,147,24,12.0,4
Category_Wikipedia_sockpuppets_of_Jayjatyu.csv,18,86848.0,12,6,8,4,0,20.333333333333332,134,14,10.11111111111111,7
Category_Wikipedia_sockpuppets_of_Yorkshirian.csv,12232,87453184.0,4287,7945,500,3787,0,40.151814911707,269,76,18.205689993459778,4
Category_Wikipedia_sockpuppets_of_GlobalTPlaza.csv,67,921141.0,25,42,14,11,0,53.298507462686565,156,31,17.134328358208954,9
Category_Wikipedia_sockpuppets_of_Cyclic_Learning.csv,93,130474624.0,51,42,46,5,0,36.25806451612903,177,52,24.344086021505376,12
Category_Wikipedia_sockpuppets_of_Koconnell13.csv,20,193764.0,12,8,6,6,0,43.2,185,38,37.2,34
Category_Wikipedia_sockpuppets_of_Polopaladin.csv,1182,15714343.0,482,700,352,130,0,38.41962774957699,255,54,17.446700507614214,6
Category_Wikipedia_sockpuppets_of_FAHADChughtai123.csv,67,4248063.0,21,46,8,13,0,50.6865671641791,212,43,18.70149253731343,3
Category_Wikipedia_sockpuppets_of_PabloOsvaldo17.csv,4347,15791633.0,1550,2797,500,1050,0,35.82263630089717,259,50,16.460087416609156,7
Category_Wikipedia_sockpuppets_of_Prodicred.csv,108,59813359.0,43,65,27,16,0,40.43518518518518,240,34,25.22222222222222,6
Category_Wikipedia_sockpuppets_of_Trongphu.csv,1550,129229798.0,445,1105,441,4,0,47.74709677419355,248,87,22.825806451612902,3
Category_Wikipedia_sockpuppets_of_Bushiroad07_official.csv,49,600732.0,36,13,35,1,0,44.69387755102041,500,30,19.163265306122447,18
Category_Wikipedia_sockpuppets_of_Kenziz.csv,50,1858123.0,18,32,9,9,0,58.48,337,42,23.3,7
Category_Wikipedia_sockpuppets_of_TheRexIsRising.csv,123,172352486.0,46,77,40,6,0,59.51219512195122,302,26,16.926829268292682,8
Category_Wikipedia_sockpuppets_of_Xxxfunkychixxx.csv,29,189090.0,27,2,26,1,0,19.137931034482758,199,27,25.413793103448278,16
Category_Wikipedia_sockpuppets_of_Nacho2009Kenarock.csv,5,1738917.0,2,3,2,0,0,49.4,198,30,19.2,12
Category_Wikipedia_sockpuppets_of_Praneetquantumx.csv,1,0.0,1,0,1,0,0,0.0,0,13,13.0,13
Category_Wikipedia_sockpuppets_of_DisneyCSIfan.csv,3701,45337482.0,1060,2641,355,705,0,49.51526614428533,259,71,22.71088894893272,2
Category_Wikipedia_sockpuppets_of_Sselraef1.csv,87,24184695.0,33,54,22,11,0,52.10344827586207,252,43,32.64367816091954,15
Category_Wikipedia_sockpuppets_of_Weina67.csv,8,78290287.0,3,5,2,1,0,44.25,133,47,40.375,20
Category_Wikipedia_sockpuppets_of_Colton2022.csv,546,16584807.0,162,384,83,79,0,48.498168498168496,288,56,15.238095238095237,2
Category_Wikipedia_sockpuppets_of_Cokesakto.csv,6,4227.0,2,4,1,1,0,23.0,84,19,14.333333333333334,12
Category_Wikipedia_sockpuppets_of_Nash16.csv,4875,30848070.0,975,3900,500,475,0,33.747076923076925,262,74,25.737435897435898,4
Category_Wikipedia_sockpuppets_of_Tom_wade.csv,13,97293.0,7,6,5,2,0,42.23076923076923,98,27,18.0,6
Category_Wikipedia_sockpuppets_of_Prodipm.csv,172,3461196.0,65,107,49,16,0,32.883720930232556,309,49,20.598837209302324,7
Category_Wikipedia_sockpuppets_of_Jm33746.csv,592,145627655.0,203,389,190,13,0,43.54391891891892,451,70,34.22466216216216,9
Category_Wikipedia_sockpuppets_of_Pnatt.csv,1952,14913513.0,620,1332,457,163,0,31.09733606557377,200,64,19.30891393442623,5
Category_Wikipedia_sockpuppets_of_PoliticalScientist3.csv,570,3353712.0,145,425,49,96,0,65.56315789473685,305,36,14.766666666666667,8
Category_Wikipedia_sockpuppets_of_N._Narcissus.csv,84,455712.0,18,66,17,1,0,37.51190476190476,174,47,20.726190476190474,4
Category_Wikipedia_sockpuppets_of_Qminh91.csv,98,2592400.0,26,72,15,11,0,53.234693877551024,239,49,23.306122448979593,11
Category_Wikipedia_sockpuppets_of_Tonysinclair13g.csv,60,8728123.0,23,37,19,4,0,42.733333333333334,235,22,11.85,7
Category_Wikipedia_sockpuppets_of_Icsunonove.csv,2950,117255518.0,1076,1874,500,576,0,33.69525423728813,246,63,25.360677966101694,4
Category_Wikipedia_sockpuppets_of_Mysuperradishfinger.csv,225,4569352.0,70,155,55,15,0,56.52444444444444,307,54,36.13777777777778,12
Category_Wikipedia_sockpuppets_of_FryUp32.csv,1477,20745629.0,465,1012,457,8,0,39.97968855788761,261,50,16.777251184834125,3
Category_Wikipedia_sockpuppets_of_Timharper068.csv,75,615653.0,30,45,23,7,0,78.92,234,50,16.093333333333334,10
Category_Wikipedia_sockpuppets_of_Faisal_Imtiyaz_Khan.csv,16,269764.0,6,10,6,0,0,54.8125,191,29,17.5,11
Category_Wikipedia_sockpuppets_of_Satttgns.csv,196,406307691.0,57,139,37,20,0,47.12755102040816,271,34,16.9234693877551,8
Category_Wikipedia_sockpuppets_of_Wise_charly.csv,1779,35218959.0,668,1111,500,168,0,46.26925238898257,496,65,19.201798763350197,5
Category_Wikipedia_sockpuppets_of_MunirUtubi.csv,20,67990.0,14,6,8,6,0,71.25,250,46,38.9,14
Category_Wikipedia_sockpuppets_of_Edson_Makatar_2.csv,18,2035417.0,5,13,4,1,0,89.11111111111111,329,32,23.11111111111111,17
Category_Wikipedia_sockpuppets_of_Dragon_Master_666.csv,8,744.0,3,5,2,1,4,89.875,164,9,6.625,4
Category_Wikipedia_sockpuppets_of_TechGrizzly.csv,7,280589.0,3,4,2,1,0,10.857142857142858,52,38,38.0,38
Category_Wikipedia_sockpuppets_of_Speakermatch.csv,38,4376649.0,32,6,28,4,0,30.763157894736842,197,48,26.157894736842106,11
Category_Wikipedia_sockpuppets_of_Tobias_Conradi.csv,31962,452808431.0,10821,21141,500,10321,0,48.19620173956574,500,92,22.46173581127589,1
Category_Wikipedia_sockpuppets_of_InklingGirl_error.csv,1914,91988561.0,650,1264,199,451,0,54.12957157784744,490,70,20.288923719958202,3
Category_Wikipedia_sockpuppets_of_Georgie_20.csv,2690,246071493.0,635,2055,473,162,0,41.72602230483271,480,52,20.773977695167286,4
Category_Wikipedia_sockpuppets_of_Jaideep_thakur.csv,931,15018019.0,298,633,72,226,0,60.36734693877551,328,50,17.6047261009667,3
Category_Wikipedia_sockpuppets_of_NOFXXX812.csv,42,60022236.0,12,30,3,9,0,55.23809523809524,194,61,28.071428571428573,8
Category_Wikipedia_sockpuppets_of_Mochamoutains.csv,1,0.0,1,0,1,0,46,46.0,46,8,8.0,8
Category_Wikipedia_sockpuppets_of_Cedarash.csv,113,1529577.0,40,73,22,18,0,30.079646017699115,196,41,14.734513274336283,5
Category_Wikipedia_sockpuppets_of_Ahmed_maher_saddam.csv,106,3971731.0,49,57,29,20,0,47.509433962264154,217,54,23.169811320754718,10
Category_Wikipedia_sockpuppets_of_WestHamFC91.csv,1785,25645676.0,725,1060,500,225,0,41.398319327731095,402,60,26.246498599439775,5
Category_Wikipedia_sockpuppets_of_Moniqueduplessis.csv,18,1484857.0,15,3,7,8,0,33.333333333333336,118,39,39.0,39
Category_Wikipedia_sockpuppets_of_Purpleseokjinssi.csv,15,3837.0,10,5,8,2,0,37.0,160,12,12.0,12
Category_Wikipedia_sockpuppets_of_Sam_at_Samsung_Unpacked_Event.csv,46,1818592.0,19,27,15,4,0,40.26086956521739,159,53,30.869565217391305,14
Category_Wikipedia_sockpuppets_of_DjMondo.csv,21,782350.0,9,12,8,1,0,74.33333333333333,247,51,23.238095238095237,18
Category_Wikipedia_sockpuppets_of_Mrclickettycane.csv,141,207964233.0,59,82,39,20,0,37.780141843971634,215,62,23.092198581560282,3
Category_Wikipedia_sockpuppets_of_Bodynerd2021.csv,20,163674.0,11,9,6,5,15,136.35,381,21,10.35,7
Category_Wikipedia_sockpuppets_of_Beaufffffff.csv,473,7882715.0,115,358,31,84,0,38.276955602537,255,83,17.234672304439748,7
Category_Wikipedia_sockpuppets_of_Stunray.csv,18,30699404.0,6,12,6,0,0,36.72222222222222,207,37,12.166666666666666,4
Category_Wikipedia_sockpuppets_of_Arham_Tanveer.csv,173,229990458.0,66,107,34,32,0,50.716763005780344,350,35,15.83815028901734,5
Category_Wikipedia_sockpuppets_of_Lambass.csv,3,31.0,2,1,2,0,14,46.0,86,56,50.0,38
Category_Wikipedia_sockpuppets_of_Bwburke94.csv,745,120943975.0,163,582,127,36,0,41.75167785234899,211,49,21.315436241610737,3
Category_Wikipedia_sockpuppets_of_OLlie_trAver.csv,20,917326.0,8,12,5,3,0,61.45,204,53,24.2,9
Category_Wikipedia_sockpuppets_of_Ravagnan_gallery.csv,6,1063900.0,4,2,2,2,0,71.0,173,17,17.0,17
Category_Wikipedia_sockpuppets_of_Mzajmi.csv,741,2242886.0,262,479,231,31,0,33.45479082321187,255,51,16.750337381916328,8
Category_Wikipedia_sockpuppets_of_Jurriaan.csv,2153,133003715.0,1196,957,500,696,0,37.37807710171853,432,51,25.14073385973061,9
Category_Wikipedia_sockpuppets_of_HornetsMike.csv,1514,65350872.0,479,1035,229,250,0,32.42800528401585,272,57,21.61360634081902,3
Category_Wikipedia_sockpuppets_of_Elmira91.csv,24,1637.0,13,11,6,7,0,45.291666666666664,183,25,11.625,5
Category_Wikipedia_sockpuppets_of_MaxKen.csv,174,485189.0,60,114,58,2,0,51.54597701149425,248,47,28.603448275862068,8
Category_Wikipedia_sockpuppets_of_Jmaxwell10.csv,304,24303405.0,105,199,26,79,0,45.588815789473685,496,53,19.38486842105263,9
Category_Wikipedia_sockpuppets_of_EverybodyHatesChris.csv,10651,55761758.0,3795,6856,500,3295,0,27.836353394047507,249,54,17.26382499295841,3
Category_Wikipedia_sockpuppets_of_Iamandrewrice.csv,7646,80960796.0,2937,4709,500,2437,0,33.071802249542245,250,82,19.804080565001307,2
Category_Wikipedia_sockpuppets_of_Usaeedi.csv,365,132550296.0,138,227,77,61,0,43.42191780821918,255,59,21.0,4
Category_Wikipedia_sockpuppets_of_I_am._furhan..csv,1138,103314033.0,504,634,500,4,0,42.13708260105448,255,48,18.2091388400703,4
Category_Wikipedia_sockpuppets_of_VarunKrishna01.csv,11,86121.0,3,8,1,2,0,19.0,84,45,30.272727272727273,13
Category_Wikipedia_sockpuppets_of_Caucasianium.csv,76,45576092.0,39,37,23,16,0,44.60526315789474,196,29,18.82894736842105,8
Category_Wikipedia_sockpuppets_of_Ieodoiskorean.csv,185,1806827.0,59,126,32,27,0,51.98918918918919,250,39,15.8,6
Category_Wikipedia_sockpuppets_of_Princefancy.csv,64,17733950.0,32,32,24,8,0,27.15625,229,12,12.0,12
Category_Wikipedia_sockpuppets_of_ThomasPark02.csv,4815,41176310.0,1320,3495,500,820,0,40.472897196261684,255,70,20.09927310488058,6
Category_Wikipedia_sockpuppets_of_Tenzingnineoneone.csv,430,14107519.0,211,219,210,1,0,32.372093023255815,266,51,18.025581395348837,9
Category_Wikipedia_sockpuppets_of_Nestorsanpablo25.csv,437,10206708.0,209,228,93,116,0,39.183066361556065,255,38,19.480549199084667,9
Category_Wikipedia_sockpuppets_of_Tsan2008.csv,80,7883276.0,17,63,17,0,0,53.6,182,23,14.9,9
Category_Wikipedia_sockpuppets_of_Ragemanchoo.csv,2960,48884037.0,722,2238,500,222,0,39.54121621621621,246,86,18.708108108108107,3
Category_Wikipedia_sockpuppets_of_Owen_Slatery.csv,22,403616.0,5,17,1,4,0,38.95454545454545,243,30,24.59090909090909,13
Category_Wikipedia_sockpuppets_of_MystifiedCitizen.csv,78,5736610.0,31,47,22,9,0,72.41025641025641,239,71,27.82051282051282,12
Category_Wikipedia_sockpuppets_of_ColumbiaAlumnus.csv,359,8564271.0,129,230,50,79,0,58.022284122562674,248,54,30.448467966573816,12
Category_Wikipedia_sockpuppets_of_LAmediamaven.csv,23,7864934.0,13,10,5,8,0,57.0,279,34,19.782608695652176,13
Category_Wikipedia_sockpuppets_of_Zazamental.csv,147,91429544.0,41,106,36,5,0,31.639455782312925,232,39,16.034013605442176,5
Category_Wikipedia_sockpuppets_of_RiverRubicon.csv,670,22140521.0,186,484,124,62,0,46.41492537313433,254,48,20.661194029850748,4
Category_Wikipedia_sockpuppets_of_Achmednut321.csv,777,40129105.0,311,466,183,128,0,33.78120978120978,240,50,22.82110682110682,8
Category_Wikipedia_sockpuppets_of_Dallidoman22.csv,421,13587985.0,146,275,113,33,0,58.342042755344416,255,37,16.712589073634206,8
Category_Wikipedia_sockpuppets_of_Lewiswizz.csv,22,2525.0,7,15,3,4,0,33.45454545454545,235,31,22.681818181818183,11
Category_Wikipedia_sockpuppets_of_Buddylovely.csv,2103,482075114.0,550,1553,428,122,0,61.44460294816928,500,50,16.57631954350927,7
Category_Wikipedia_sockpuppets_of_Ghughesarch.csv,1916,240135841.0,533,1383,500,33,0,60.21033402922756,305,63,20.25678496868476,4
Category_Wikipedia_sockpuppets_of_Some1234567890.csv,3997,8748892.0,1237,2760,500,737,0,52.7182887165374,497,64,18.12884663497623,3
Category_Wikipedia_sockpuppets_of_AutomatixOfficial.csv,11,62060.0,7,4,4,3,12,56.18181818181818,129,23,16.636363636363637,13
Category_Wikipedia_sockpuppets_of_Khall6.csv,1444,22627023.0,454,990,59,395,0,43.94806094182825,499,85,17.746537396121884,4
Category_Wikipedia_sockpuppets_of_Libermercatus.csv,3230,43038774.0,1050,2180,500,550,0,43.13095975232198,499,64,16.657894736842106,3
Category_Wikipedia_sockpuppets_of_EpicArtLessons.csv,21,2302392.0,8,13,6,2,0,59.19047619047619,157,24,19.428571428571427,9
Category_Wikipedia_sockpuppets_of_Kaebae116.csv,119,9873979.0,45,74,35,10,0,71.32773109243698,235,37,19.19327731092437,9
Category_Wikipedia_sockpuppets_of_Philipraoot.csv,136,160834731.0,48,88,11,37,0,50.080882352941174,228,24,14.852941176470589,11
Category_Wikipedia_sockpuppets_of_Msoamu.csv,3401,183592578.0,1139,2262,500,639,0,48.85063216700971,255,76,20.401058512202294,3
Category_Wikipedia_sockpuppets_of_Vfffffffffdfger.csv,153,6905895.0,35,118,5,30,0,33.568627450980394,215,35,13.908496732026144,3
Category_Wikipedia_sockpuppets_of_ÊªøÂ∞±ÈÄÅÊúâÈôêÂÖ¨Âè∏.csv,1193,32224839.0,333,860,55,278,0,49.42665549036044,442,71,19.55322715842414,3
Category_Wikipedia_sockpuppets_of_Stanovc.csv,1694,48571625.0,751,943,500,251,0,35.6151121605667,252,48,14.152302243211334,4
Category_Wikipedia_sockpuppets_of_Forhadalam29.csv,39,43891444.0,12,27,7,5,0,36.69230769230769,168,51,30.974358974358974,7
Category_Wikipedia_sockpuppets_of_SCIART23.csv,110,6488848.0,68,42,62,6,0,41.872727272727275,269,44,27.509090909090908,15
Category_Wikipedia_sockpuppets_of_JesusLovesUs2019.csv,379,26110835.0,134,245,85,49,0,47.261213720316626,245,31,15.137203166226913,9
Category_Wikipedia_sockpuppets_of_Viktor.vince.csv,3,694.0,2,1,2,0,26,71.0,114,13,10.333333333333334,9
Category_Wikipedia_sockpuppets_of_EMr_KnG.csv,654,158934915.0,156,498,102,54,0,52.13149847094801,255,60,18.357798165137616,4
Category_Wikipedia_sockpuppets_of_Sharma666.csv,859,81003047.0,539,320,500,39,0,30.50174621653085,470,26,15.739231664726425,6
Category_Wikipedia_sockpuppets_of_Kevinbarlow.csv,53,272875.0,26,27,20,6,0,31.754716981132077,250,43,29.18867924528302,18
Category_Wikipedia_sockpuppets_of_REPARADOR.csv,733,98317114.0,169,564,72,97,0,47.60300136425648,255,66,32.88130968622101,6
Category_Wikipedia_sockpuppets_of_Electricbassguy.csv,1770,546904034.0,570,1200,500,70,0,46.23276836158192,496,71,20.852542372881356,2
Category_Wikipedia_sockpuppets_of_Histury613.csv,80,3306130.0,61,19,55,6,0,41.5125,263,15,10.6125,8
Category_Wikipedia_sockpuppets_of_New_York_Patty.csv,67,981629.0,20,47,19,1,0,56.64179104477612,229,81,33.26865671641791,14
Category_Wikipedia_sockpuppets_of_AkashRajputDelhi.csv,323,2337382.0,113,210,37,76,0,52.54489164086687,304,38,15.034055727554179,5
Category_Wikipedia_sockpuppets_of_Sabathia9.csv,34,261325.0,25,9,16,9,0,38.705882352941174,147,20,17.352941176470587,5
Category_Wikipedia_sockpuppets_of_Avoncycles.csv,6,11706.0,5,1,5,0,0,10.833333333333334,14,20,20.0,20
Category_Wikipedia_sockpuppets_of_Eaglewolfspirit.csv,2453,124738601.0,911,1542,500,411,0,48.78516102731349,402,73,23.936404402772116,2
Category_Wikipedia_sockpuppets_of_Javad_Ibrahimov.csv,271,2927318.0,76,195,75,1,0,46.81918819188192,486,47,15.413284132841328,6
Category_Wikipedia_sockpuppets_of_Lysvincent.csv,1655,15636382.0,500,1155,500,0,0,39.32447129909366,255,55,19.328700906344412,2
Category_Wikipedia_sockpuppets_of_Soap_Boy_1.csv,7399,89780311.0,1885,5514,500,1385,0,52.38207865927828,500,80,19.619543181511016,3
Category_Wikipedia_sockpuppets_of_Jarrets.csv,18,187900.0,6,12,6,0,0,48.833333333333336,214,35,14.88888888888889,9
Category_Wikipedia_sockpuppets_of_Nadeemsofi.csv,1,0.0,1,0,1,0,29,29.0,29,20,20.0,20
Category_Wikipedia_sockpuppets_of_Ilecity.csv,90,11355995.0,28,62,13,15,0,44.266666666666666,220,46,20.88888888888889,10
Category_Wikipedia_sockpuppets_of_Codename_Lisa.csv,2718,47956797.0,743,1975,500,243,0,69.14422369389257,513,64,20.36019131714496,3
Category_Wikipedia_sockpuppets_of_98.194.123.23.csv,423,42946348.0,209,214,126,83,0,50.981087470449175,249,44,15.581560283687944,9
Category_Wikipedia_sockpuppets_of_Mqwertyiol.csv,9,3927.0,5,4,4,1,0,40.44444444444444,122,37,24.555555555555557,15
Category_Wikipedia_sockpuppets_of_Potters_house.csv,1412,29544972.0,501,911,500,1,0,35.1600566572238,250,70,24.36827195467422,5
Category_Wikipedia_sockpuppets_of_WhitFruit.csv,21,11468569.0,6,15,5,1,0,31.0,120,28,20.142857142857142,17
Category_Wikipedia_sockpuppets_of_Ph2214.csv,80,51201542.0,44,36,32,12,0,26.025,223,34,17.55,12
Category_Wikipedia_sockpuppets_of_Noveli.csv,29,68411283.0,18,11,11,7,0,55.58620689655172,185,58,26.379310344827587,14
Category_Wikipedia_sockpuppets_of_Th3Shoudy.csv,678,13886843.0,286,392,146,140,0,36.508849557522126,333,52,20.38053097345133,3
Category_Wikipedia_sockpuppets_of_Bcai3887.csv,241,69156056.0,51,190,51,0,0,42.954356846473026,250,35,18.57676348547718,5
Category_Wikipedia_sockpuppets_of_HenryWalken.csv,108,3282413.0,31,77,21,10,0,45.861111111111114,255,42,17.98148148148148,12
Category_Wikipedia_sockpuppets_of_Kavdiaravish.csv,329,3164568.0,170,159,157,13,0,62.495440729483285,229,48,21.34954407294833,6
Category_Wikipedia_sockpuppets_of_WaW.csv,7,581876004.0,2,5,1,1,0,20.142857142857142,32,41,32.42857142857143,21
Category_Wikipedia_sockpuppets_of_EnergyStar45.csv,56,1064534.0,18,38,18,0,0,34.517857142857146,188,33,16.607142857142858,11
Category_Wikipedia_sockpuppets_of_Professor_Profession.csv,173,5371932.0,65,108,57,8,0,47.69364161849711,238,56,21.254335260115607,5
Category_Wikipedia_sockpuppets_of_Intedit226.csv,86,34476799.0,30,56,18,12,0,61.26744186046512,252,69,16.651162790697676,4
Category_Wikipedia_sockpuppets_of_WMGoode.csv,429,279924799.0,121,308,62,59,0,52.64801864801865,413,39,19.38927738927739,9
Category_Wikipedia_sockpuppets_of_Reema_rahman.csv,11,1264.0,4,7,2,2,13,62.72727272727273,163,39,39.0,39
Category_Wikipedia_sockpuppets_of_Emmettvinyarde42.csv,18,426535.0,13,5,10,3,0,40.388888888888886,209,18,11.777777777777779,11
Category_Wikipedia_sockpuppets_of_Calvin_Marquess.csv,8338,50315373.0,2174,6164,500,1674,0,39.353442072439435,253,92,15.029143679539457,1
Category_Wikipedia_sockpuppets_of_Bailrigg.csv,3451,28859788.0,1010,2441,500,510,0,25.408866995073893,243,66,15.501014198782961,4
Category_Wikipedia_sockpuppets_of_Guys1234567890.csv,197,3684181.0,63,134,17,46,0,49.10659898477157,244,40,21.949238578680202,17
Category_Wikipedia_sockpuppets_of_AndreiMoldovanNew.csv,1,0.0,1,0,1,0,110,110.0,110,22,22.0,22
Category_Wikipedia_sockpuppets_of_Jamiechef2.csv,150,1522961.0,64,86,24,40,0,42.45333333333333,218,19,8.333333333333334,6
Category_Wikipedia_sockpuppets_of_Cyberpunk2077JohnnySilverhand.csv,515,36639706.0,169,346,12,157,0,47.21941747572816,319,64,24.485436893203882,10
Category_Wikipedia_sockpuppets_of_Phattcityusa.csv,27,19012.0,10,17,9,1,0,69.11111111111111,199,22,8.703703703703704,7
Category_Wikipedia_sockpuppets_of_Pro_Art_Editer.csv,161,9623465.0,53,108,42,11,0,55.96894409937888,277,43,14.677018633540373,8
Category_Wikipedia_sockpuppets_of_CBG17.csv,6908,40561172.0,2367,4541,500,1867,0,42.722206137811234,462,61,23.531268094962364,4
Category_Wikipedia_sockpuppets_of_Barracuda41.csv,3667,67314048.0,1127,2540,500,627,0,59.30979001908917,458,58,16.55113171529861,2
Category_Wikipedia_sockpuppets_of_Indigenousfreethinker.csv,2,455.0,2,0,2,0,29,40.0,51,35,35.0,35
Category_Wikipedia_sockpuppets_of_Oriory.csv,10,429.0,7,3,7,0,13,62.8,193,5,5.0,5
Category_Wikipedia_sockpuppets_of_Proud_Liberal_6.csv,39,530247.0,13,26,11,2,0,49.41025641025641,174,20,8.461538461538462,3
Category_Wikipedia_sockpuppets_of_Total_drama_king_4.csv,104,25312961.0,37,67,19,18,0,49.61538461538461,255,58,33.32692307692308,12
Category_Wikipedia_sockpuppets_of_Nairunnigs.csv,10,331000899.0,8,2,3,5,0,42.0,107,25,21.7,20
Category_Wikipedia_sockpuppets_of_Caltraser5.csv,1338,29687603.0,524,814,500,24,0,65.24289985052317,507,58,18.361733931240657,4
Category_Wikipedia_sockpuppets_of_Joe_Parkinson.csv,2,490.0,2,0,2,0,23,27.0,31,48,48.0,48
Category_Wikipedia_sockpuppets_of_Pzakgod.csv,23,8737608.0,15,8,14,1,0,36.82608695652174,179,13,12.130434782608695,11
Category_Wikipedia_sockpuppets_of_July6177.csv,21,256622.0,9,12,9,0,0,37.333333333333336,140,15,13.857142857142858,11
Category_Wikipedia_sockpuppets_of_Soupdragon42.csv,394,47460809.0,141,253,132,9,0,42.52030456852792,200,70,26.309644670050762,13
Category_Wikipedia_sockpuppets_of_Ealbayrak.csv,109,15923089.0,58,51,31,27,0,132.85321100917432,1000,27,14.238532110091743,9
Category_Wikipedia_sockpuppets_of_KFA_Private_Limited.csv,15,1032311.0,6,9,6,0,0,18.533333333333335,145,36,23.866666666666667,18
Category_Wikipedia_sockpuppets_of_BOOGERBOYOFOHIO.csv,253,26020385.0,87,166,69,18,0,47.312252964426875,270,30,14.134387351778656,3
Category_Wikipedia_sockpuppets_of_Researchamerica.csv,104,14955735.0,33,71,11,22,0,42.71153846153846,258,33,17.240384615384617,8
Category_Wikipedia_sockpuppets_of_Rachellegeneroso.csv,3011,240726685.0,808,2203,201,607,0,35.24476917967453,376,60,23.22783128528728,6
Category_Wikipedia_sockpuppets_of_Naveen2019.csv,37,51148580.0,13,24,10,3,0,80.8108108108108,237,21,12.027027027027026,6
Category_Wikipedia_sockpuppets_of_Cavalarious.csv,27,702.0,22,5,10,12,0,30.62962962962963,194,71,40.51851851851852,16
Category_Wikipedia_sockpuppets_of_TemplatePeterBaldwin.csv,1885,20427108.0,531,1354,500,31,0,47.271618037135276,453,61,16.80424403183024,3
Category_Wikipedia_sockpuppets_of_M_Rob1119.csv,2056,31260755.0,475,1581,401,74,0,47.581225680933855,255,45,14.329280155642023,5
Category_Wikipedia_sockpuppets_of_Vision_2.csv,47,54960588.0,20,27,15,5,0,44.91489361702128,214,29,16.638297872340427,10
Category_Wikipedia_sockpuppets_of_Vidhi10.csv,1,0.0,1,0,1,0,0,0.0,0,21,21.0,21
Category_Wikipedia_sockpuppets_of_TopGun_madness.csv,49,3537613.0,17,32,15,2,0,44.224489795918366,242,36,20.857142857142858,11
Category_Wikipedia_sockpuppets_of_Jack.Hartford.csv,9623,54356770.0,2169,7454,500,1669,0,47.26841941182583,250,59,15.722124077730438,3
Category_Wikipedia_sockpuppets_of_Black_magic_specialist.csv,1,0.0,1,0,1,0,42,42.0,42,25,25.0,25
Category_Wikipedia_sockpuppets_of_Sutts1111.csv,19,60345.0,16,3,11,5,0,16.36842105263158,118,36,14.526315789473685,12
Category_Wikipedia_sockpuppets_of_Dickonlandia.csv,359,4119954.0,129,230,112,17,0,57.5208913649025,496,47,20.45682451253482,5
Category_Wikipedia_sockpuppets_of_BadgerStateHistorian1967.csv,562,16736424.0,152,410,128,24,0,57.33451957295374,255,32,19.190391459074732,7
Category_Wikipedia_sockpuppets_of_Papa_Smooch.csv,584,48843411.0,205,379,38,167,0,45.0,249,65,22.450342465753426,5
Category_Wikipedia_sockpuppets_of_King_peyton.csv,947,13814769.0,313,634,67,246,0,49.581837381203805,490,54,18.34002111932418,4
Category_Wikipedia_sockpuppets_of_JashonCuyler15.csv,13,4292083.0,7,6,6,1,0,29.384615384615383,138,28,25.307692307692307,17
Category_Wikipedia_sockpuppets_of_Adrienrux.csv,20,6942364.0,7,13,4,3,0,29.1,150,19,9.65,4
Category_Wikipedia_sockpuppets_of_VengadorJusticiero.csv,105,2842399.0,33,72,22,11,0,51.93333333333333,236,28,18.923809523809524,10
Category_Wikipedia_sockpuppets_of_Brahmosaerospace.csv,94,12644909.0,32,62,30,2,0,47.0,216,59,26.03191489361702,16
Category_Wikipedia_sockpuppets_of_Belived7666.csv,285,3676859.0,167,118,167,0,0,35.95789473684211,197,41,17.056140350877193,5
Category_Wikipedia_sockpuppets_of_Djbarnes.csv,62,155343.0,40,22,37,3,0,40.74193548387097,199,56,39.17741935483871,14
Category_Wikipedia_sockpuppets_of_HurricameWilma344224.csv,416,832157.0,222,194,190,32,0,33.82211538461539,201,47,22.11298076923077,14
Category_Wikipedia_sockpuppets_of_LanceShipp.csv,6,1213.0,3,3,2,1,25,78.83333333333333,154,33,20.166666666666668,14
Category_Wikipedia_sockpuppets_of_EPANews.csv,4000,261854205.0,1426,2574,64,1362,0,42.429,255,59,16.038,3
Category_Wikipedia_sockpuppets_of_MultiWorlds.csv,484,81389649.0,182,302,134,48,0,51.11363636363637,250,51,20.669421487603305,9
Category_Wikipedia_sockpuppets_of_Kevin_≈ÅpKrJ.csv,49,250198.0,18,31,15,3,0,53.0,230,47,20.081632653061224,5
Category_Wikipedia_sockpuppets_of_InspectahDeck90.csv,13,11969.0,13,0,8,5,0,17.76923076923077,21,16,16.0,16
Category_Wikipedia_sockpuppets_of_Oxidised_Alpha.csv,796,6521506.0,200,596,134,66,0,48.07788944723618,360,68,24.766331658291456,6
Category_Wikipedia_sockpuppets_of_Dickjameson.csv,596,136445405.0,183,413,70,113,0,46.29194630872483,237,57,18.595637583892618,5
Category_Wikipedia_sockpuppets_of_ILToEdit.csv,2991,104464127.0,1312,1679,500,812,0,39.79070544968238,496,62,20.334670678702775,8
Category_Wikipedia_sockpuppets_of_EliteBrandRealm.csv,48,5920957.0,10,38,9,1,0,53.833333333333336,161,44,19.166666666666668,16
Category_Wikipedia_sockpuppets_of_Avidhomebuilder.csv,172,7007906.0,61,111,14,47,0,46.93604651162791,221,32,15.773255813953488,6
Category_Wikipedia_sockpuppets_of_Herrera3428.csv,73,4601918.0,29,44,18,11,0,32.12328767123287,149,28,18.410958904109588,12
Category_Wikipedia_sockpuppets_of_LosAngeles000!.csv,2858,43457997.0,1080,1778,500,580,0,45.0111966410077,439,56,21.148005598320506,4
Category_Wikipedia_sockpuppets_of_RAJAKC.csv,501,2426559.0,196,305,179,17,0,37.97804391217565,355,54,16.756487025948104,6
Category_Wikipedia_sockpuppets_of_AvantGardeAClue.csv,157,363776.0,61,96,41,20,0,58.5796178343949,250,49,15.840764331210192,7
Category_Wikipedia_sockpuppets_of_Trevorhaag.csv,1101,94523708.0,319,782,297,22,0,38.51771117166213,255,71,20.204359673024523,5
Category_Wikipedia_sockpuppets_of_Verocastro.csv,68,1887843.0,43,25,42,1,0,14.161764705882353,139,36,17.11764705882353,12
Category_Wikipedia_sockpuppets_of_Barkfox.csv,54,59778245.0,17,37,16,1,0,44.2962962962963,255,23,16.09259259259259,6
Category_Wikipedia_sockpuppets_of_Tarun_K_Chowdary.csv,135,20056028.0,45,90,36,9,0,26.555555555555557,196,61,27.511111111111113,14
Category_Wikipedia_sockpuppets_of_Liliana_Verdiana_Levy.csv,375,20929490.0,118,257,107,11,0,39.896,235,52,17.92,8
Category_Wikipedia_sockpuppets_of_Mario96.csv,1428,67088762.0,366,1062,53,313,0,38.529411764705884,250,46,28.061624649859944,6
Category_Wikipedia_sockpuppets_of_Kimi95523.csv,194,21259536.0,61,133,13,48,0,50.623711340206185,270,36,23.056701030927837,7
Category_Wikipedia_sockpuppets_of_Marvell27.csv,105,14703.0,30,75,12,18,0,57.60952380952381,191,31,17.038095238095238,5
Category_Wikipedia_sockpuppets_of_InvincibleBlaze.csv,118,50294977.0,36,82,24,12,0,47.898305084745765,251,33,26.21186440677966,17
Category_Wikipedia_sockpuppets_of_Rec082.csv,22,3699357.0,16,6,14,2,0,46.86363636363637,207,38,25.318181818181817,11
Category_Wikipedia_sockpuppets_of_Jared_Boon.csv,20,3976954.0,17,3,5,12,0,28.4,183,25,15.5,10
Category_Wikipedia_sockpuppets_of_Roje_Vala.csv,2409,50899853.0,627,1782,500,127,0,41.1129099211291,488,63,17.39601494396015,3
Category_Wikipedia_sockpuppets_of_Thegoldensilkmaster.csv,16,2521.0,5,11,4,1,0,19.625,111,22,17.625,17
Category_Wikipedia_sockpuppets_of_Eggd2.csv,930,30592837.0,195,735,19,176,0,46.54086021505376,226,49,14.429032258064517,3
Category_Wikipedia_sockpuppets_of_Romellsimons.csv,1,0.0,1,0,1,0,35,35.0,35,14,14.0,14
Category_Wikipedia_sockpuppets_of_Zala_Dinesh.csv,100,76028697.0,52,48,22,30,0,35.08,189,32,17.52,6
Category_Wikipedia_sockpuppets_of_Colwyn_13@hotmail.com.csv,20,3829.0,7,13,6,1,0,29.8,160,32,24.25,21
Category_Wikipedia_sockpuppets_of_MiltenR.csv,1511,16342045.0,504,1007,500,4,0,57.44473858371939,497,48,17.037723362011914,4
Category_Wikipedia_sockpuppets_of_ZxchSHS.csv,5,615267.0,3,2,2,1,5,64.8,158,14,11.6,8
Category_Wikipedia_sockpuppets_of_AKScott.csv,107,17247493.0,39,68,31,8,0,52.88785046728972,223,41,17.327102803738317,8
Category_Wikipedia_sockpuppets_of_Thagoah.csv,35,3530460.0,20,15,20,0,0,43.371428571428574,179,22,17.6,15
Category_Wikipedia_sockpuppets_of_Cplot.csv,2838,34177647.0,833,2005,500,333,0,46.59654686398873,203,79,23.474982381959126,3
Category_Wikipedia_sockpuppets_of_Atricels0098.csv,30,88415822.0,6,24,5,1,0,42.6,136,33,32.46666666666667,17
Category_Wikipedia_sockpuppets_of_22asmi.csv,56,4897.0,16,40,6,10,0,55.875,197,39,20.625,7
Category_Wikipedia_sockpuppets_of_Crispyducks678.csv,373,10245682.0,152,221,138,14,0,42.820375335120644,246,54,21.297587131367294,7
Category_Wikipedia_sockpuppets_of_Paiew.csv,19,512718.0,9,10,5,4,0,63.1578947368421,161,13,11.210526315789474,10
Category_Wikipedia_sockpuppets_of_Fresh22222.csv,280,41730203.0,96,184,17,79,0,50.125,239,27,14.135714285714286,4
Category_Wikipedia_sockpuppets_of_Geoff2006.csv,84,3042386.0,58,26,53,5,0,101.96428571428571,306,22,8.107142857142858,4
Category_Wikipedia_sockpuppets_of_Dirk0001.csv,4637,23086651.0,1539,3098,500,1039,0,47.11623894759543,496,57,21.599309898641362,4
Category_Wikipedia_sockpuppets_of_Sorudeh.csv,86,2747370.0,40,46,23,17,0,38.74418604651163,255,68,14.209302325581396,13
Category_Wikipedia_sockpuppets_of_Carlmumba.csv,2140,24928737.0,647,1493,500,147,0,42.05,497,61,17.252336448598133,4
Category_Wikipedia_sockpuppets_of_Kpopjpop.csv,50,4575659.0,28,22,19,9,0,28.68,185,13,10.28,5
Category_Wikipedia_sockpuppets_of_Adamsmithjonson.csv,3,54.0,2,1,2,0,14,33.0,69,14,14.0,14
Category_Wikipedia_sockpuppets_of_Nbp777.csv,126,37510349.0,50,76,30,20,0,39.3968253968254,219,43,18.023809523809526,3
Category_Wikipedia_sockpuppets_of_Costrom6.csv,273,12871056.0,84,189,64,20,0,41.824175824175825,254,58,21.846153846153847,6
Category_Wikipedia_sockpuppets_of_AirFrance358.csv,1040,53404671.0,408,632,247,161,0,36.61153846153846,254,54,20.60576923076923,5
Category_Wikipedia_sockpuppets_of_Heba_jad.csv,165,2418610.0,50,115,25,25,0,42.157575757575756,241,28,7.260606060606061,3
Category_Wikipedia_sockpuppets_of_Ryleewilder.csv,3,114336.0,2,1,1,1,0,56.0,124,16,16.0,16
Category_Wikipedia_sockpuppets_of_Cemalbasaran.csv,124,327219265.0,39,85,19,20,0,49.524193548387096,255,56,24.887096774193548,13
Category_Wikipedia_sockpuppets_of_MediaUpdatesWest.csv,274,30854445.0,78,196,78,0,0,46.02919708029197,269,43,17.956204379562045,4
Category_Wikipedia_sockpuppets_of_The_Office.csv,44,357424.0,14,30,12,2,0,31.681818181818183,143,28,13.136363636363637,7
Category_Wikipedia_sockpuppets_of_Nypoetsociety.csv,20,283880.0,12,8,7,5,0,24.1,157,43,40.0,23
Category_Wikipedia_sockpuppets_of_Bobstanley08.csv,11,3887.0,6,5,3,3,0,45.45454545454545,139,25,22.818181818181817,17
Category_Wikipedia_sockpuppets_of_Lparsons67.csv,182,41524772.0,59,123,19,40,0,59.14835164835165,493,39,17.956043956043956,4
Category_Wikipedia_sockpuppets_of_Devrimdpt.csv,78,86993.0,22,56,15,7,0,60.11538461538461,234,36,18.602564102564102,5
Category_Wikipedia_sockpuppets_of_Azerphoenix.csv,71,2743849.0,18,53,14,4,0,56.563380281690144,178,37,18.929577464788732,7
Category_Wikipedia_sockpuppets_of_Bade5825.csv,8,11719531.0,5,3,2,3,8,32.25,60,27,17.125,10
Category_Wikipedia_sockpuppets_of_VikramVS1208.csv,1240,4584190.0,424,816,416,8,0,48.18306451612903,500,75,20.170967741935485,5
Category_Wikipedia_sockpuppets_of_SugeRight.csv,1565,14652886.0,512,1053,500,12,0,50.48434504792332,496,91,18.47731629392971,3
Category_Wikipedia_sockpuppets_of_Sophiedookh.csv,205,64980794.0,69,136,63,6,0,44.74146341463415,217,51,22.414634146341463,9
Category_Wikipedia_sockpuppets_of_EnPassant.csv,3230,121128746.0,1000,2230,500,500,0,55.87801857585139,496,85,21.321981424148607,3
Category_Wikipedia_sockpuppets_of_1995rms.csv,347,14188413.0,229,118,225,4,0,22.138328530259365,322,20,16.59077809798271,9
Category_Wikipedia_sockpuppets_of_Willow7575.csv,22,7644.0,12,10,7,5,0,42.77272727272727,196,47,14.045454545454545,6
Category_Wikipedia_sockpuppets_of_‡Æµ‡Æø‡Æï‡Øç‡Æ©‡Øá‡Æ∑‡Øç‡Æµ‡Æ∞‡Øç_‡Æ™‡Ææ_‡ÆÆ‡Ææ‡Æ≥‡ØÅ‡Æö‡ØÅ‡Æ§‡Øç‡Æ§‡Æø‡ÆØ‡Ææ‡Æ∞‡Øç.csv,430,177648454.0,145,285,82,63,0,58.395348837209305,347,39,15.669767441860465,6
Category_Wikipedia_sockpuppets_of_Raja_Atizaz_Ahmed_Kiyani.csv,433,169983699.0,198,235,164,34,0,48.60277136258661,402,48,18.265588914549653,9
Category_Wikipedia_sockpuppets_of_Hugo.tran08.csv,1274,16503638.0,389,885,360,29,0,42.923861852433284,364,46,12.085557299843014,4
Category_Wikipedia_sockpuppets_of_Planetofjelly.csv,1336,37337957.0,517,819,500,17,0,39.73877245508982,253,53,21.8375748502994,4
Category_Wikipedia_sockpuppets_of_Ax4asdetv.csv,80,5728954.0,24,56,11,13,0,62.025,237,41,19.3625,4
Category_Wikipedia_sockpuppets_of_NonResidentFellow.csv,293,102891465.0,121,172,60,61,0,51.93174061433447,246,41,13.279863481228668,5
Category_Wikipedia_sockpuppets_of_Bikrampuri.csv,841,22527091.0,290,551,246,44,0,45.794292508917955,362,39,11.984542211652794,3
Category_Wikipedia_sockpuppets_of_77.83.176.157.csv,30,253868.0,10,20,5,5,0,48.7,200,34,19.566666666666666,6
Category_Wikipedia_sockpuppets_of_Zlgiancarlo.csv,2403,25582406.0,902,1501,500,402,0,35.593008739076154,255,65,20.895963379109446,3
Category_Wikipedia_sockpuppets_of_Former_user_20140220.csv,1380,121245436.0,494,886,221,273,0,39.43188405797101,255,56,18.08768115942029,4
Category_Wikipedia_sockpuppets_of_The_Blizzard_King.csv,1195,34371426.0,291,904,222,69,0,34.589121338912136,219,65,19.07531380753138,4
Category_Wikipedia_sockpuppets_of_Yoshialonso.csv,132,7793376.0,51,81,26,25,0,43.20454545454545,255,50,17.833333333333332,6
Category_Wikipedia_sockpuppets_of_EdmondDantesOfMonteCristo.csv,248,1496424.0,90,158,42,48,0,45.33467741935484,236,40,21.25,4
Category_Wikipedia_sockpuppets_of_8i347g8gl.csv,784,7700676.0,481,303,355,126,0,32.213010204081634,241,37,24.674744897959183,4
Category_Wikipedia_sockpuppets_of_Jeff_barnett.csv,381,5745580.0,141,240,119,22,0,36.979002624671914,255,82,30.25984251968504,7
Category_Wikipedia_sockpuppets_of_Pali_Upadhyay.csv,1230,7937098.0,565,665,500,65,0,36.169918699186994,444,52,35.06585365853658,12
Category_Wikipedia_sockpuppets_of_The_La_Chapla.csv,12,944845.0,8,4,8,0,10,16.75,26,23,23.0,23
Category_Wikipedia_sockpuppets_of_Arcanus121.csv,61,238761.0,47,14,39,8,0,30.934426229508198,196,46,27.40983606557377,20
Category_Wikipedia_sockpuppets_of_Kumarila.csv,950,96615134.0,227,723,205,22,0,56.90842105263158,255,42,14.291578947368421,3
Category_Wikipedia_sockpuppets_of_Happy_Geographer.csv,1048,856223.0,287,761,178,109,0,40.778625954198475,249,27,11.341603053435115,4
Category_Wikipedia_sockpuppets_of_Lucifernam.csv,786,23084689.0,311,475,255,56,0,45.3587786259542,482,65,29.220101781170484,6
Category_Wikipedia_sockpuppets_of_Nepanoin.csv,83,2632104.0,39,44,21,18,0,42.6144578313253,173,43,23.6144578313253,5
Category_Wikipedia_sockpuppets_of_Toomanywordstoolittletime.csv,413,761495.0,166,247,163,3,0,47.87409200968523,260,46,16.17675544794189,6
Category_Wikipedia_sockpuppets_of_Shamsuddin_Patel.csv,23,7722683.0,11,12,8,3,0,24.0,148,29,19.0,17
Category_Wikipedia_sockpuppets_of_AkibanTech.csv,17,344909.0,5,12,4,1,14,75.52941176470588,189,42,28.58823529411765,15
Category_Wikipedia_sockpuppets_of_Parkings2.csv,40,1014673.0,37,3,27,10,0,23.85,196,22,17.1,12
Category_Wikipedia_sockpuppets_of_Sophisol.csv,275,4571726.0,81,194,68,13,0,28.563636363636363,223,39,24.723636363636363,11
Category_Wikipedia_sockpuppets_of_Bothiman.csv,8686,286698428.0,3383,5303,500,2883,0,42.310269399032926,384,69,16.932189730600967,4
Category_Wikipedia_sockpuppets_of_Acid420.csv,178,533228.0,48,130,37,11,0,56.7752808988764,228,35,13.089887640449438,2
Category_Wikipedia_sockpuppets_of_Bryson_85.csv,3050,127010251.0,926,2124,378,548,0,38.1144262295082,496,87,24.471475409836067,5
Category_Wikipedia_sockpuppets_of_Bullshimoot.csv,7,248206.0,4,3,2,2,0,41.142857142857146,127,39,20.142857142857142,9
Category_Wikipedia_sockpuppets_of_Dilipjrajpurohit.csv,35,17083816.0,14,21,14,0,0,56.05714285714286,201,29,18.857142857142858,9
Category_Wikipedia_sockpuppets_of_Harsr002.317.csv,262,218420081.0,96,166,78,18,0,61.50763358778626,271,46,22.88167938931298,15
Category_Wikipedia_sockpuppets_of_Ram_Charitra_Dwivedi.csv,352,99193524.0,83,269,65,18,0,57.64488636363637,255,148,16.639204545454547,6
Category_Wikipedia_sockpuppets_of_Insightzz10.csv,172,2833864.0,56,116,28,28,0,62.52906976744186,351,53,21.598837209302324,4
Category_Wikipedia_sockpuppets_of_Jeff_dean.csv,4108,115876180.0,1449,2659,500,949,0,45.47784810126582,246,71,18.395813047711783,3
Category_Wikipedia_sockpuppets_of_LeonidJoJoSchneider.csv,12,59828.0,5,7,3,2,21,61.416666666666664,261,51,51.0,51
Category_Wikipedia_sockpuppets_of_Ben_pig_rowe.csv,26,3106.0,15,11,14,1,0,10.346153846153847,153,5,5.0,5
Category_Wikipedia_sockpuppets_of_Sweetestchandran.csv,23,33513675.0,11,12,11,0,0,26.91304347826087,196,29,21.434782608695652,10
Category_Wikipedia_sockpuppets_of_Alisabriofficiel.csv,116,34330665.0,42,74,18,24,0,38.5,214,41,30.310344827586206,9
Category_Wikipedia_sockpuppets_of_Blotted_Ink.csv,15,14078871.0,9,6,6,3,0,31.333333333333332,118,38,26.2,15
Category_Wikipedia_sockpuppets_of_Unbuttered_Parsnip.csv,3592,69173696.0,861,2731,500,361,0,48.72550111358574,255,71,16.306514476614698,3
Category_Wikipedia_sockpuppets_of_GoravSharma0245.csv,387,26395845.0,127,260,96,31,0,46.423772609819125,275,36,16.44702842377261,7
Category_Wikipedia_sockpuppets_of_AnYoNe!.csv,1806,105736056.0,442,1364,292,150,0,34.50221483942414,253,77,16.659468438538205,2
Category_Wikipedia_sockpuppets_of_Aussiebrisguy.csv,1179,25483036.0,301,878,301,0,0,32.438507209499576,212,62,22.714164546225614,6
Category_Wikipedia_sockpuppets_of_OnyxModsLLC.csv,15,9086586.0,5,10,4,1,0,41.4,119,53,23.0,15
Category_Wikipedia_sockpuppets_of_UnnamedWasTaken.csv,317,1680631.0,103,214,84,19,0,58.88643533123028,309,54,21.41955835962145,3
Category_Wikipedia_sockpuppets_of_JBurger2018.csv,1151,3983154.0,577,574,500,77,0,19.32406602953953,413,61,26.783666377063422,4
Category_Wikipedia_sockpuppets_of_Android_1123581321.csv,358,25727602.0,118,240,33,85,0,57.91340782122905,322,53,18.650837988826815,8
Category_Wikipedia_sockpuppets_of_AnooseMuncher.csv,24,10029.0,8,16,6,2,0,55.958333333333336,250,29,21.5,15
Category_Wikipedia_sockpuppets_of_HenryJMajik.csv,15,5038088.0,5,10,2,3,0,50.733333333333334,174,55,46.0,10
Category_Wikipedia_sockpuppets_of_Orangesodakid.csv,1304,74886173.0,502,802,500,2,0,43.357361963190186,250,74,23.75230061349693,6
Category_Wikipedia_sockpuppets_of_Pelie43.csv,541,15634411.0,135,406,95,40,0,31.841035120147875,250,41,25.373382624768947,8
Category_Wikipedia_sockpuppets_of_Artistseries.csv,232,886251.0,93,139,54,39,0,36.0301724137931,196,53,31.67241379310345,11
Category_Wikipedia_sockpuppets_of_Kang_Hyun_Min.csv,781,31978098.0,273,508,92,181,0,43.15236875800256,228,40,17.454545454545453,4
Category_Wikipedia_sockpuppets_of_Leonardocognoscenti.csv,2128,118828662.0,799,1329,500,299,0,51.32612781954887,361,57,23.396616541353385,3
Category_Wikipedia_sockpuppets_of_Pow0017.csv,2241,76962156.0,833,1408,431,402,0,44.99152164212405,496,81,18.92280232039268,3
Category_Wikipedia_sockpuppets_of_Na_Nach_Nachmu_Nachmun.csv,172,36544860.0,85,87,78,7,0,56.58139534883721,211,44,20.901162790697676,7
Category_Wikipedia_sockpuppets_of_Mdhashim24.csv,1516,193712122.0,552,964,153,399,0,49.98416886543536,328,80,20.75065963060686,4
Category_Wikipedia_sockpuppets_of_FredyCruz94.csv,1105,7755464.0,357,748,102,255,0,35.87963800904977,332,64,33.25248868778281,5
Category_Wikipedia_sockpuppets_of_Pcirpack.csv,71,6426974.0,47,24,15,32,0,57.15492957746479,250,25,12.267605633802816,7
Category_Wikipedia_sockpuppets_of_LOLSPORKSLOL.csv,7,1642.0,4,3,3,1,0,41.57142857142857,135,17,16.428571428571427,13
Category_Wikipedia_sockpuppets_of_76.216.187.182.csv,65,50263318.0,14,51,11,3,0,59.276923076923076,235,55,20.892307692307693,8
Category_Wikipedia_sockpuppets_of_Kaifijap.csv,6,72.0,2,4,2,0,0,44.666666666666664,178,27,17.0,12
Category_Wikipedia_sockpuppets_of_Medysy.csv,16,83065.0,7,9,6,1,0,63.0625,175,29,19.5625,16
Category_Wikipedia_sockpuppets_of_Honkshreader.csv,28,2238.0,9,19,1,8,25,45.535714285714285,96,38,34.464285714285715,32
Category_Wikipedia_sockpuppets_of_10shedana.csv,1,0.0,1,0,1,0,20,20.0,20,12,12.0,12
Category_Wikipedia_sockpuppets_of_Stress_theorist.csv,548,42720741.0,205,343,129,76,0,53.058394160583944,500,57,22.447080291970803,7
Category_Wikipedia_sockpuppets_of_Gordon_Bleu.csv,43,439708.0,16,27,11,5,0,59.883720930232556,173,25,17.13953488372093,16
Category_Wikipedia_sockpuppets_of_JournalmanManila.csv,5966,52066853.0,2142,3824,500,1642,0,44.9896077774053,500,71,21.446362722091855,4
Category_Wikipedia_sockpuppets_of_Spartanmastah.csv,346,5102595.0,115,231,33,82,0,43.99132947976879,203,27,19.07514450867052,6
Category_Wikipedia_sockpuppets_of_Harrison_Luce_21.csv,77,11209202.0,31,46,31,0,0,34.58441558441559,187,26,13.974025974025974,8
Category_Wikipedia_sockpuppets_of_Salim567.csv,1721,9710036.0,482,1239,409,73,0,55.151074956420686,481,43,15.005810575246949,3
Category_Wikipedia_sockpuppets_of_Jcarleo.csv,190,10193096.0,81,109,29,52,0,51.13157894736842,223,51,18.805263157894736,12
Category_Wikipedia_sockpuppets_of_Desert_jasmine.csv,71,6738885.0,28,43,26,2,0,40.95774647887324,222,30,12.774647887323944,4
Category_Wikipedia_sockpuppets_of_STARSsocialclub.csv,124,21327091.0,53,71,44,9,0,49.13709677419355,208,51,21.032258064516128,7
Category_Wikipedia_sockpuppets_of_Philadlam.csv,97,230110436.0,32,65,18,14,0,41.7319587628866,224,33,23.412371134020617,8
Category_Wikipedia_sockpuppets_of_ProudIndian007.csv,907,122247490.0,318,589,94,224,0,45.219404630650494,254,53,21.851157662624036,5
Category_Wikipedia_sockpuppets_of_Jjjjess.csv,79,12778498.0,43,36,32,11,0,64.89873417721519,196,36,29.354430379746834,21
Category_Wikipedia_sockpuppets_of_IvanOS.csv,1764,21327815.0,805,959,500,305,0,60.50283446712018,255,97,14.77437641723356,3
Category_Wikipedia_sockpuppets_of_Eshwar.om.csv,1865,73256314.0,513,1352,500,13,0,46.806970509383376,255,51,14.734048257372654,4
Category_Wikipedia_sockpuppets_of_Kheetah.csv,25,925067.0,15,10,13,2,0,37.52,181,26,19.44,17
Category_Wikipedia_sockpuppets_of_GuffasBorgz.csv,85,13158285.0,17,68,12,5,0,36.63529411764706,202,22,12.976470588235294,8
Category_Wikipedia_sockpuppets_of_Namerst.csv,391,77411766.0,147,244,127,20,0,49.869565217391305,237,47,19.823529411764707,3
Category_Wikipedia_sockpuppets_of_Debramartinchase.csv,223,844628.0,80,143,60,20,0,51.90582959641256,249,52,15.802690582959642,4
Category_Wikipedia_sockpuppets_of_Anogenyoganathan.csv,807,37583705.0,230,577,51,179,0,51.012391573729865,496,55,17.297397769516728,3
Category_Wikipedia_sockpuppets_of_SebastainTorres.csv,645,64440104.0,265,380,99,166,0,39.713178294573645,231,51,22.6046511627907,8
Category_Wikipedia_sockpuppets_of_Ryujg.csv,8,448360.0,7,1,7,0,0,13.75,63,15,15.0,15
Category_Wikipedia_sockpuppets_of_Escoperloit.csv,8613,413615636.0,3104,5509,236,2868,0,41.74259839777081,500,47,13.664925113200976,4
Category_Wikipedia_sockpuppets_of_WGroup.csv,982,6902718.0,365,617,285,80,0,30.88900203665988,249,45,20.9989816700611,7
Category_Wikipedia_sockpuppets_of_TylerCarlosa.csv,192,357487.0,61,131,17,44,0,74.27604166666667,299,35,14.963541666666666,5
Category_Wikipedia_sockpuppets_of_TRockferd.csv,355,11567508.0,101,254,100,1,0,36.84788732394366,222,46,17.65070422535211,7
Category_Wikipedia_sockpuppets_of_Karunyan.csv,1913,390711613.0,480,1433,192,288,0,54.01045478306325,255,74,23.417668583376894,2
Category_Wikipedia_sockpuppets_of_FixerFixerFixer.csv,147,196879939.0,59,88,58,1,0,78.53061224489795,394,51,18.095238095238095,9
Category_Wikipedia_sockpuppets_of_Steve1984stallone.csv,234,111323237.0,54,180,17,37,0,47.18376068376068,320,62,17.773504273504273,10
Category_Wikipedia_sockpuppets_of_Tlaconete11.csv,2626,44485911.0,919,1707,500,419,0,34.15536938309216,248,73,20.076161462300075,3
Category_Wikipedia_sockpuppets_of_Chanc20190325.csv,2607,18186041.0,783,1824,500,283,0,60.83084004602992,499,58,19.065592635212887,2
Category_Wikipedia_sockpuppets_of_ScientificEthics.csv,49,1314567.0,23,26,14,9,0,49.775510204081634,248,21,17.632653061224488,12
Category_Wikipedia_sockpuppets_of_Longjohnlong.csv,204,29016089.0,96,108,41,55,0,41.181372549019606,196,84,29.91176470588235,14
Category_Wikipedia_sockpuppets_of_Account_created_to_post_on_Reference_Desk.csv,518,2519057.0,145,373,125,20,0,40.43050193050193,215,59,32.91891891891892,5
Category_Wikipedia_sockpuppets_of_MarceloLanda6.csv,127,17875852.0,53,74,14,39,0,60.173228346456696,263,38,18.133858267716537,12
Category_Wikipedia_sockpuppets_of_Mostestargue.csv,235,247535448.0,52,183,45,7,0,53.96170212765958,264,36,16.527659574468085,8
Category_Wikipedia_sockpuppets_of_Thank_you_very_much_wiki.csv,199,5878205.0,89,110,46,43,0,46.51256281407035,255,56,30.266331658291456,10
Category_Wikipedia_sockpuppets_of_Lamrongpeng5.csv,231,13479371.0,80,151,48,32,0,50.96969696969697,228,32,22.471861471861473,9
Category_Wikipedia_sockpuppets_of_Itsisaacs.csv,1663,11053783.0,543,1120,500,43,0,36.774503908598916,496,54,27.570054119061936,7
Category_Wikipedia_sockpuppets_of_AndrewCrogonklol.csv,174,18513070.0,44,130,40,4,0,42.5632183908046,213,53,19.310344827586206,5
Category_Wikipedia_sockpuppets_of_DWGT_Radio.csv,15,1552.0,6,9,6,0,0,25.066666666666666,125,42,15.866666666666667,4
Category_Wikipedia_sockpuppets_of_Topbookclub.csv,1759,79267758.0,569,1190,500,69,0,47.513928368391134,255,70,20.575326890278568,4
Category_Wikipedia_sockpuppets_of_Jellywings19.csv,16882,100200611.0,5189,11693,500,4689,0,37.164435493424946,496,69,23.20743987679185,3
Category_Wikipedia_sockpuppets_of_EdwinKibs.csv,131,13409239.0,50,81,32,18,0,45.02290076335878,252,53,28.65648854961832,13
Category_Wikipedia_sockpuppets_of_Imash_Dinmukhamed.csv,37,2461377.0,13,24,7,6,0,35.13513513513514,259,24,17.37837837837838,15
Category_Wikipedia_sockpuppets_of_Bhushan_Kumar.csv,47,44740562.0,17,30,15,2,0,39.51063829787234,196,33,23.78723404255319,12
Category_Wikipedia_sockpuppets_of_Superpilot123456.csv,244,4493020.0,82,162,64,18,0,41.131147540983605,250,43,23.151639344262296,10
Category_Wikipedia_sockpuppets_of_Hostsewa.csv,84,115355449.0,34,50,29,5,0,48.523809523809526,227,45,20.44047619047619,11
Category_Wikipedia_sockpuppets_of_Taqabul.csv,16,2673756.0,5,11,4,1,0,44.6875,160,37,30.75,21
Category_Wikipedia_sockpuppets_of_Larryisreal123456789.csv,3,1934309.0,2,1,1,1,17,33.0,64,18,18.0,18
Category_Wikipedia_sockpuppets_of_Alexcalitri4.csv,895,177498626.0,271,624,138,133,0,49.34301675977654,458,51,20.798882681564248,4
Category_Wikipedia_sockpuppets_of_Advocata.csv,2696,358298795.0,953,1743,500,453,0,45.484050445103854,496,73,18.593842729970326,4
Category_Wikipedia_sockpuppets_of_Holdman_Studios.csv,18,3360208.0,13,5,8,5,0,31.166666666666668,101,22,13.444444444444445,11
Category_Wikipedia_sockpuppets_of_VoldemortRams.csv,7,3024559.0,6,1,6,0,0,6.571428571428571,46,23,23.0,23
Category_Wikipedia_sockpuppets_of_ClaudioSantos.csv,2207,391590602.0,824,1383,500,324,0,53.8142274580879,419,50,21.681468056184865,3
Category_Wikipedia_sockpuppets_of_Jamiebijania.csv,1423,251445296.0,511,912,500,11,0,40.40969782150386,243,71,18.520028109627546,5
Category_Wikipedia_sockpuppets_of_Akashmunsaram.csv,89,1886671.0,29,60,25,4,0,39.73033707865169,252,23,14.0561797752809,11
Category_Wikipedia_sockpuppets_of_Namexre.csv,108,12343146.0,51,57,49,2,0,43.25925925925926,252,49,27.046296296296298,12
Category_Wikipedia_sockpuppets_of_Pavlosvos.csv,8,3752.0,8,0,8,0,0,36.25,83,13,13.0,13
Category_Wikipedia_sockpuppets_of_Flagrantedelicto.csv,907,5344177.0,509,398,500,9,0,46.79051819184124,227,47,23.636163175303196,3
Category_Wikipedia_sockpuppets_of_someone65.csv,2961,10742408.0,751,2210,500,251,0,45.78081729145559,253,89,26.178993583248904,3
Category_Wikipedia_sockpuppets_of_Fuu5tgsrygr.csv,816,8943609.0,202,614,33,169,0,39.7328431372549,255,51,23.607843137254903,5
Category_Wikipedia_sockpuppets_of_JonniVegaz.csv,46,26593768.0,12,34,11,1,0,52.23913043478261,226,26,19.17391304347826,15
Category_Wikipedia_sockpuppets_of_Wikoaq.csv,15,145546.0,12,3,6,6,11,74.0,184,16,14.133333333333333,14
Category_Wikipedia_sockpuppets_of_Ogowatertechnologies.csv,27,171864.0,20,7,8,12,0,41.74074074074074,179,25,21.296296296296298,21
Category_Wikipedia_sockpuppets_of_Bakir123.csv,2746,169274871.0,1017,1729,500,517,0,33.2680262199563,500,77,18.672978878368536,5
Category_Wikipedia_sockpuppets_of_Helpalot.csv,678,57791715.0,147,531,147,0,0,43.21828908554572,268,49,24.660766961651916,4
Category_Wikipedia_sockpuppets_of_Boxman88.csv,2267,100704875.0,575,1692,475,100,0,50.31892368769299,255,52,17.90251433612704,4
Category_Wikipedia_sockpuppets_of_Kayvon2008.csv,766,94641553.0,232,534,179,53,0,49.85770234986945,339,54,22.48302872062663,5
Category_Wikipedia_sockpuppets_of_Baburakbar.csv,155,1921350.0,64,91,58,6,0,42.76129032258064,298,26,13.96774193548387,5
Category_Wikipedia_sockpuppets_of_Iam.spark55.csv,548,11361345.0,133,415,62,71,0,30.62043795620438,227,47,13.956204379562044,6
Category_Wikipedia_sockpuppets_of_Veritas2021.csv,11,42482.0,4,7,3,1,2,71.0909090909091,187,33,26.0,20
Category_Wikipedia_sockpuppets_of_Vhvenkatesh.csv,265,30084247.0,223,42,200,23,0,25.581132075471697,255,29,23.362264150943396,11
Category_Wikipedia_sockpuppets_of_Studentwowdeals.csv,2,11244.0,2,0,2,0,18,18.0,18,22,22.0,22
Category_Wikipedia_sockpuppets_of_Thatoneguylol101.csv,385,89327679.0,135,250,120,15,0,55.6987012987013,448,54,22.862337662337662,8
Category_Wikipedia_sockpuppets_of_StarFish2022.csv,43,37358225.0,25,18,22,3,0,69.81395348837209,499,22,14.44186046511628,13
Category_Wikipedia_sockpuppets_of_Ali_Akbar_son_of_Muhammad_Iftikhar.csv,18,431209.0,10,8,3,7,0,59.22222222222222,172,35,12.0,8
Category_Wikipedia_sockpuppets_of_Peas345.csv,420,5422111.0,142,278,90,52,0,45.13809523809524,231,48,16.061904761904763,5
Category_Wikipedia_sockpuppets_of_Maahmudul_Islam.csv,11,36769191.0,7,4,6,1,0,68.36363636363636,185,14,14.0,14
Category_Wikipedia_sockpuppets_of_Gulliver419.csv,11,831948.0,7,4,6,1,0,51.72727272727273,173,15,11.181818181818182,8
Category_Wikipedia_sockpuppets_of_Anon360.csv,45,148865466.0,19,26,16,3,0,47.733333333333334,212,53,27.533333333333335,17
Category_Wikipedia_sockpuppets_of_JessikaRita.csv,153,51338271.0,49,104,28,21,0,53.509803921568626,255,49,19.241830065359476,6
Category_Wikipedia_sockpuppets_of_Jirgen666.csv,5541,7562718.0,1489,4052,424,1065,0,46.19473019310594,516,81,16.01425735426818,2
Category_Wikipedia_sockpuppets_of_DevMor.csv,99,31966.0,30,69,19,11,0,52.42424242424242,232,33,16.252525252525253,5
Category_Wikipedia_sockpuppets_of_AwStarz.csv,232,70390606.0,65,167,58,7,0,59.51724137931034,253,45,16.99137931034483,6
Category_Wikipedia_sockpuppets_of_Lionel4power.csv,570,141473318.0,136,434,48,88,0,46.71052631578947,255,42,16.782456140350877,3
Category_Wikipedia_sockpuppets_of_Hconingsby.csv,5,39639.0,3,2,3,0,0,25.6,98,46,32.2,23
Category_Wikipedia_sockpuppets_of_Theeditorr.csv,6,1585640.0,5,1,4,1,0,14.333333333333334,49,39,20.5,12
Category_Wikipedia_sockpuppets_of_Mark753.csv,949,22725428.0,287,662,86,201,0,36.15595363540569,216,43,19.00421496311907,1
Category_Wikipedia_sockpuppets_of_Rsgupta.in.csv,19,340892.0,14,5,11,3,20,41.21052631578947,125,23,22.36842105263158,21
Category_Wikipedia_sockpuppets_of_Phelpsaictor.csv,1,0.0,1,0,1,0,161,161.0,161,16,16.0,16
Category_Wikipedia_sockpuppets_of_Dicksg.csv,30,1723208.0,22,8,21,1,0,30.8,140,30,29.066666666666666,29
Category_Wikipedia_sockpuppets_of_Hunterwetzel123.csv,3,495.0,3,0,2,1,15,15.0,15,16,16.0,16
Category_Wikipedia_sockpuppets_of_Jhonh3360.csv,2858,202721704.0,797,2061,183,614,0,45.75717284814556,494,57,22.199440167949614,7
Category_Wikipedia_sockpuppets_of_Patchouli.csv,1861,5641036.0,625,1236,500,125,0,43.76786673831273,203,76,19.29231595916174,4
Category_Wikipedia_sockpuppets_of_Counselor's_justice.csv,47,31701156.0,13,34,6,7,0,68.8936170212766,253,10,8.382978723404255,7
Category_Wikipedia_sockpuppets_of_Jo√£o_Victor_Bissiato.csv,359,19055488.0,94,265,47,47,0,41.949860724233986,376,49,18.350974930362117,5
Category_Wikipedia_sockpuppets_of_Dr.Jhingaadey.csv,1106,67093564.0,421,685,199,222,0,43.397830018083184,255,57,21.303797468354432,10
Category_Wikipedia_sockpuppets_of_I_Love_Bananas.csv,9,169427.0,4,5,3,1,13,81.44444444444444,141,17,12.666666666666666,4
Category_Wikipedia_sockpuppets_of_Sykess.csv,953,284318758.0,271,682,269,2,0,47.51206715634837,481,59,15.646379853095487,3
Category_Wikipedia_sockpuppets_of_Johan_Archiles.csv,54,587949.0,27,27,27,0,0,33.94444444444444,180,54,25.5,13
Category_Wikipedia_sockpuppets_of_SammySmith8765.csv,1141,150417967.0,315,826,249,66,0,55.01489921121823,394,61,18.623137598597722,4
Category_Wikipedia_sockpuppets_of_Linkschwartz.csv,2,913.0,2,0,2,0,196,196.0,196,17,17.0,17
Category_Wikipedia_sockpuppets_of_Kurmaa.csv,1272,235777037.0,508,764,495,13,0,33.533018867924525,250,79,16.358490566037737,4
Category_Wikipedia_sockpuppets_of_WilliamDevault.csv,267,2527720.0,74,193,11,63,0,37.53932584269663,280,21,13.632958801498127,7
Category_Wikipedia_sockpuppets_of_SirAlexOreo.csv,1314,49170748.0,359,955,224,135,0,52.082191780821915,255,71,16.21461187214612,6
Category_Wikipedia_sockpuppets_of_Whatthedog.csv,279,19525835.0,111,168,107,4,0,46.62724014336918,230,5,5.0,5
Category_Wikipedia_sockpuppets_of_Jennagleespen.csv,6,9957.0,3,3,2,1,0,33.833333333333336,172,25,23.666666666666668,23
Category_Wikipedia_sockpuppets_of_Khani100.csv,3180,246211487.0,1004,2176,500,504,0,46.1814465408805,334,76,18.13867924528302,5
Category_Wikipedia_sockpuppets_of_Mcallister2412.csv,14,1328316.0,6,8,5,1,0,69.78571428571429,236,19,14.428571428571429,11
Category_Wikipedia_sockpuppets_of_Imranmehroz.csv,56,54887699.0,19,37,19,0,0,66.44642857142857,255,23,15.446428571428571,7
Category_Wikipedia_sockpuppets_of_Olsen24.csv,1375,38354794.0,698,677,500,198,0,41.16218181818182,479,47,29.82618181818182,8
Category_Wikipedia_sockpuppets_of_Askmeforquestions.csv,10,15106.0,9,1,8,1,0,35.9,196,27,25.8,19
Category_Wikipedia_sockpuppets_of_Unkownzero.csv,2126,34017266.0,822,1304,500,322,0,56.79868297271872,255,53,19.233301975540922,4
Category_Wikipedia_sockpuppets_of_Metalmasta5.csv,196,2297222.0,52,144,18,34,0,39.58673469387755,209,25,11.60204081632653,3
Category_Wikipedia_sockpuppets_of_Mopertcasocp.csv,5,1745659.0,2,3,1,1,7,123.2,398,49,46.6,46
Category_Wikipedia_sockpuppets_of_Shit233333334.csv,2386,25065165.0,879,1507,231,648,0,47.027661357921204,500,50,17.25146689019279,5
Category_Wikipedia_sockpuppets_of_Isaiasad.csv,2195,24201045.0,728,1467,500,228,0,33.4123006833713,255,80,26.927107061503417,9
Category_Wikipedia_sockpuppets_of_Reutrolantri.csv,217,3031635.0,109,108,18,91,0,41.617511520737324,233,34,15.599078341013826,6
Category_Wikipedia_sockpuppets_of_Lethanhphong1992.csv,1144,46846368.0,316,828,58,258,0,39.95979020979021,443,69,19.092657342657343,4
Category_Wikipedia_sockpuppets_of_Bengalred.csv,1,0.0,1,0,1,0,30,30.0,30,26,26.0,26
Category_Wikipedia_sockpuppets_of_Alex9777777.csv,367,143676243.0,164,203,11,153,0,48.41144414168937,440,61,18.583106267029972,2
Category_Wikipedia_sockpuppets_of_Laksh_talreja.csv,86,16501105.0,25,61,23,2,0,45.7906976744186,205,19,10.209302325581396,5
Category_Wikipedia_sockpuppets_of_Samssara_Capital.csv,4,307.0,2,2,2,0,15,108.75,192,26,26.0,26
Category_Wikipedia_sockpuppets_of_CAtruthwatcher.csv,143,3638108.0,65,78,55,10,0,71.14685314685315,199,42,25.95104895104895,12
Category_Wikipedia_sockpuppets_of_RighterTurn.csv,10,24261.0,7,3,7,0,18,72.1,120,20,10.6,6
Category_Wikipedia_sockpuppets_of_Bruno_Sequito.csv,549,23743992.0,180,369,106,74,0,43.650273224043715,309,37,16.99271402550091,4
Category_Wikipedia_sockpuppets_of_TrueParf.csv,457,21421659.0,123,334,67,56,0,69.93654266958424,500,43,15.708971553610503,4
Category_Wikipedia_sockpuppets_of_Chrisfairbank888.csv,40,57367051.0,16,24,14,2,0,48.575,231,26,18.5,16
Category_Wikipedia_sockpuppets_of_Car4tea.csv,107,804725.0,72,35,52,20,0,27.35514018691589,209,62,36.91588785046729,13
Category_Wikipedia_sockpuppets_of_Hussein_Sonic.csv,265,7526132.0,85,180,33,52,0,60.26792452830189,255,29,16.328301886792453,5
Category_Wikipedia_sockpuppets_of_LadyLashes.csv,2879,32102077.0,1000,1879,500,500,0,39.56200069468566,261,55,20.39701285168461,5
Category_Wikipedia_sockpuppets_of_Festive_Fig.csv,11,2654.0,4,7,2,2,0,63.27272727272727,199,18,15.818181818181818,14
Category_Wikipedia_sockpuppets_of_Heyoboyo.csv,545,49515760.0,133,412,57,76,0,60.95963302752293,404,40,15.732110091743118,5
Category_Wikipedia_sockpuppets_of_Agaal.csv,45,257013.0,21,24,11,10,0,58.37777777777778,195,29,21.822222222222223,9
Category_Wikipedia_sockpuppets_of_ItzRicoHenry.csv,209,2654132.0,96,113,62,34,0,43.55502392344498,296,47,27.267942583732058,15
Category_Wikipedia_sockpuppets_of_Ansar908716281.csv,116,394670.0,54,62,29,25,0,71.23275862068965,341,17,10.336206896551724,5
Category_Wikipedia_sockpuppets_of_Chandu_Kumar_Potter.csv,1325,6654808.0,500,825,374,126,0,27.219622641509435,324,67,22.62566037735849,5
Category_Wikipedia_sockpuppets_of_Hoho24.csv,1946,12555082.0,520,1426,500,20,0,40.73741007194245,254,70,15.5344295991778,1
Category_Wikipedia_sockpuppets_of_0Juan234.csv,406,4928576.0,133,273,99,34,0,45.20443349753695,255,51,19.539408866995075,4
Category_Wikipedia_sockpuppets_of_Nuklear.csv,7585,439735097.0,2338,5247,500,1838,0,52.297165458141066,486,58,14.466446934739619,2
Category_Wikipedia_sockpuppets_of_JaySiers.csv,31,7346551.0,10,21,9,1,0,47.774193548387096,244,20,15.935483870967742,7
Category_Wikipedia_sockpuppets_of_Correction_With_Evidence.csv,105,1656378.0,59,46,43,16,0,36.55238095238095,500,36,21.885714285714286,4
Category_Wikipedia_sockpuppets_of_Korea4one.csv,283,68216222.0,83,200,37,46,0,40.71024734982332,195,51,20.141342756183747,7
Category_Wikipedia_sockpuppets_of_Boulayp.csv,407,323047270.0,151,256,43,108,0,47.06633906633907,428,71,15.88943488943489,7
Category_Wikipedia_sockpuppets_of_Account2900.csv,7,97040.0,4,3,3,1,7,60.857142857142854,111,56,46.42857142857143,21
Category_Wikipedia_sockpuppets_of_Mithila_Madawa.csv,1600,14895050.0,566,1034,500,66,0,40.33625,448,77,21.055625,5
Category_Wikipedia_sockpuppets_of_MichaelKRBE.csv,454,67724781.0,139,315,132,7,0,39.57929515418502,324,51,15.341409691629956,4
Category_Wikipedia_sockpuppets_of_Mindraker.csv,1285,6840839.0,503,782,500,3,0,35.134630350194556,217,117,27.687937743190663,5
Category_Wikipedia_sockpuppets_of_Yungbrook.csv,1,0.0,1,0,1,0,48,48.0,48,20,20.0,20
Category_Wikipedia_sockpuppets_of_Khabboos.csv,2144,11314715.0,632,1512,500,132,0,49.048507462686565,255,55,19.73554104477612,5
Category_Wikipedia_sockpuppets_of_ManojKumar2012.csv,126,3894231.0,43,83,16,27,0,49.682539682539684,228,43,21.38888888888889,8
Category_Wikipedia_sockpuppets_of_Jason_foren_daniel.csv,997,2609122.0,326,671,257,69,0,46.246740220661984,255,46,16.37713139418255,3
Category_Wikipedia_sockpuppets_of_Quintinense.csv,525,408835199.0,124,401,113,11,0,50.10285714285714,251,68,24.464761904761904,4
Category_Wikipedia_sockpuppets_of_Fergasonanton.csv,67,98377229.0,18,49,12,6,0,35.44776119402985,151,46,20.01492537313433,7
Category_Wikipedia_sockpuppets_of_ALittleCuriousFanatic2020.csv,857,8246946.0,259,598,144,115,0,38.35355892648775,388,39,17.13418903150525,4
Category_Wikipedia_sockpuppets_of_Asaaaasa.csv,234,8439033.0,79,155,27,52,0,66.52991452991454,255,43,13.901709401709402,6
Category_Wikipedia_sockpuppets_of_LED_BodyBuilding.csv,734,10059039.0,286,448,201,85,0,57.94686648501362,490,79,17.960490463215258,4
Category_Wikipedia_sockpuppets_of_Suneel5789.csv,26,980804.0,16,10,9,7,0,49.0,222,26,20.384615384615383,18
Category_Wikipedia_sockpuppets_of_Japandroids.csv,243,12956452.0,121,122,103,18,0,50.358024691358025,226,30,19.08230452674897,9
Category_Wikipedia_sockpuppets_of_Lokesh_Siddha.csv,214,23834962.0,60,154,24,36,0,64.10747663551402,264,25,11.369158878504672,3
Category_Wikipedia_sockpuppets_of_Raveonpragha.csv,1,0.0,1,0,1,0,33,33.0,33,19,19.0,19
Category_Wikipedia_sockpuppets_of_RRRR8888.csv,310,8907066.0,108,202,48,60,0,51.58709677419355,230,50,24.467741935483872,7
Category_Wikipedia_sockpuppets_of_Simodabir0.csv,578,6242287.0,193,385,50,143,0,48.67128027681661,496,61,22.878892733564015,4
Category_Wikipedia_sockpuppets_of_Telanian.csv,760,87176306.0,215,545,90,125,0,68.42631578947369,249,57,21.188157894736843,6
Category_Wikipedia_sockpuppets_of_Chrome1k.csv,232,2027068.0,93,139,57,36,0,42.12931034482759,313,37,18.594827586206897,4
Category_Wikipedia_sockpuppets_of_Qled.csv,16,1301074.0,12,4,10,2,0,37.25,172,9,4.3125,4
Category_Wikipedia_sockpuppets_of_BLPDegreaser.csv,425,7786707.0,211,214,188,23,0,39.03294117647059,244,97,43.37882352941176,3
Category_Wikipedia_sockpuppets_of_Vipulsshah.csv,301,21464394.0,102,199,85,17,0,54.97674418604651,264,57,20.07308970099668,6
Category_Wikipedia_sockpuppets_of_Rai_sandeep700.csv,42,58759830.0,13,29,10,3,0,63.285714285714285,414,24,16.571428571428573,10
Category_Wikipedia_sockpuppets_of_QuirkyAndSuch.csv,1285,104652321.0,442,843,397,45,0,30.68171206225681,188,84,22.40077821011673,5
Category_Wikipedia_sockpuppets_of_Ïù¥ÌïúÏ≤†_(Ïã±Ïñ¥ÏÜ°ÎùºÏù¥ÌÑ∞).csv,2105,339452879.0,528,1577,483,45,0,48.5790973871734,329,41,11.785748218527315,3
Category_Wikipedia_sockpuppets_of_JamariWiki.csv,214,66404487.0,79,135,78,1,0,63.54205607476636,496,49,23.345794392523363,6
Category_Wikipedia_sockpuppets_of_Yandurb.csv,123,1758591.0,107,16,76,31,0,24.951219512195124,215,30,23.11382113821138,9
Category_Wikipedia_sockpuppets_of_Jb09012.csv,1321,50544290.0,597,724,500,97,0,42.79182437547313,337,67,18.639666919000756,5
Category_Wikipedia_sockpuppets_of_NewPak2.csv,232,27737683.0,77,155,20,57,0,56.41379310344828,251,31,12.793103448275861,3
Category_Wikipedia_sockpuppets_of_MilesTrap.csv,10,2163.0,4,6,2,2,0,78.3,184,12,11.0,10
Category_Wikipedia_sockpuppets_of_Themediatalk.csv,125,135199671.0,30,95,15,15,0,36.752,190,51,19.328,9
Category_Wikipedia_sockpuppets_of_Reed77.csv,2331,21611927.0,509,1822,246,263,0,45.81467181467181,255,58,16.00772200772201,5
Category_Wikipedia_sockpuppets_of_Charlieparr123456.csv,17,8210912.0,5,12,5,0,0,38.470588235294116,166,27,15.117647058823529,4
Category_Wikipedia_sockpuppets_of_Akshay_Aswani.csv,49,45280352.0,20,29,20,0,0,49.06122448979592,248,63,15.938775510204081,11
Category_Wikipedia_sockpuppets_of_Sajjad4300.csv,44,369701.0,19,25,7,12,0,46.84090909090909,196,24,18.34090909090909,13
Category_Wikipedia_sockpuppets_of_Hyung-jun_park.csv,34,686623.0,8,26,5,3,0,62.14705882352941,194,37,12.235294117647058,5
Category_Wikipedia_sockpuppets_of_NovaPlaycer.csv,613,48082063.0,195,418,137,58,0,43.184339314845026,496,53,17.486133768352364,8
Category_Wikipedia_sockpuppets_of_Ndokl4.csv,7,3541352.0,3,4,2,1,0,54.0,126,16,14.857142857142858,14
Category_Wikipedia_sockpuppets_of_Craffael.csv,157,39012721.0,48,109,45,3,0,55.044585987261144,369,64,25.414012738853504,10
Category_Wikipedia_sockpuppets_of_Renzo_1_Entertainment.csv,34,464108.0,28,6,22,6,1,40.88235294117647,195,18,7.0588235294117645,6
Category_Wikipedia_sockpuppets_of_RFAVED2022.csv,73,257151.0,48,25,33,15,0,30.013698630136986,183,32,18.589041095890412,12
Category_Wikipedia_sockpuppets_of_Spinwatch.csv,76,1558123.0,30,46,19,11,0,67.42105263157895,278,22,16.36842105263158,11
Category_Wikipedia_sockpuppets_of_Untileverycageisempty.csv,1783,9384897.0,779,1004,500,279,0,34.77958496915311,222,56,23.05888951205833,3
Category_Wikipedia_sockpuppets_of_I_B_Wright.csv,10564,197961399.0,2952,7612,500,2452,0,58.05802726240061,487,69,24.748674744414995,2
Category_Wikipedia_sockpuppets_of_CountingStars500.csv,1756,16449343.0,694,1062,500,194,0,44.33542141230068,418,57,15.639521640091116,4
Category_Wikipedia_sockpuppets_of_Parintar.csv,500,23779963.0,152,348,113,39,0,37.162,255,47,20.758,3
Category_Wikipedia_sockpuppets_of_…äim≈•e√∞√°_ƒç√´hoƒµ≈ì≈ïi.csv,193,33246211.0,72,121,39,33,0,43.295336787564764,253,45,22.854922279792746,11
Category_Wikipedia_sockpuppets_of_Gavinsblog.csv,456,7456331.0,179,277,162,17,0,38.56798245614035,221,40,18.13157894736842,9
Category_Wikipedia_sockpuppets_of_Ugbedeg.csv,7986,120697268.0,3474,4512,500,2974,0,54.12471825694966,496,82,20.85023791635362,3
Category_Wikipedia_sockpuppets_of_Surwane1.csv,47,5383141.0,31,16,23,8,0,45.46808510638298,255,31,10.617021276595745,7
Category_Wikipedia_sockpuppets_of_Boman12.csv,113,521570.0,86,27,15,71,0,39.150442477876105,495,42,29.38053097345133,13
Category_Wikipedia_sockpuppets_of_NYScholar.csv,1561,180340473.0,661,900,500,161,0,46.55861627162076,246,60,23.130044843049326,3
Category_Wikipedia_sockpuppets_of_Darkmatters1.csv,1917,17703938.0,480,1437,419,61,0,50.61554512258738,454,66,15.96452790818988,3
Category_Wikipedia_sockpuppets_of_Yukileoo.csv,643,210316585.0,198,445,47,151,0,54.27527216174183,255,43,14.241057542768274,4
Category_Wikipedia_sockpuppets_of_Antiracistzwei.csv,172,520736.0,63,109,42,21,0,65.34302325581395,500,47,22.75,14
Category_Wikipedia_sockpuppets_of_Hencoder.csv,25,1455817.0,10,15,3,7,0,68.44,231,24,17.4,8
Category_Wikipedia_sockpuppets_of_StealthForce.csv,430,216033421.0,115,315,83,32,0,57.27906976744186,337,55,29.1046511627907,8
Category_Wikipedia_sockpuppets_of_Greg1425.csv,20,12101.0,14,6,12,2,0,40.95,141,31,18.25,16
Category_Wikipedia_sockpuppets_of_Nocturnalnow.csv,2039,107906809.0,607,1432,500,107,0,57.6233447768514,493,113,25.543403629230014,5
Category_Wikipedia_sockpuppets_of_Dannybriggs93.csv,1587,41365425.0,429,1158,422,7,0,25.502835538752365,233,54,26.567737870195337,3
Category_Wikipedia_sockpuppets_of_Arohan19.csv,2375,47211226.0,573,1802,500,73,0,56.41768421052632,500,50,16.94484210526316,4
Category_Wikipedia_sockpuppets_of_Jsucooldude1.csv,250,215068421.0,61,189,40,21,0,65.748,252,53,25.192,6
Category_Wikipedia_sockpuppets_of_Kelly_Pelaou.csv,211,9336572.0,113,98,83,30,0,42.39810426540284,233,48,27.327014218009477,14
Category_Wikipedia_sockpuppets_of_Johnken21.csv,2,1301509.0,2,0,1,1,0,15.5,31,28,27.0,26
Category_Wikipedia_sockpuppets_of_Fiona_Forde.csv,76,2124354.0,57,19,53,4,0,19.039473684210527,106,11,11.0,11
Category_Wikipedia_sockpuppets_of_Stacey196.csv,68,48444332.0,22,46,12,10,0,53.338235294117645,118,44,22.323529411764707,16
Category_Wikipedia_sockpuppets_of_Puttyschool.csv,1461,5563632.0,519,942,500,19,0,47.502395619438744,255,48,26.00479123887748,4
Category_Wikipedia_sockpuppets_of_Julia.Gillard.The.Ranga.csv,19,515486.0,11,8,4,7,0,34.63157894736842,163,41,32.78947368421053,28
Category_Wikipedia_sockpuppets_of_Skanter.csv,2162,51985881.0,641,1521,500,141,0,35.8686401480111,268,55,15.10268270120259,4
Category_Wikipedia_sockpuppets_of_BessieLoo.csv,71,40905083.0,39,32,36,3,0,21.338028169014084,161,13,13.0,13
Category_Wikipedia_sockpuppets_of_TheRealLilSae.csv,3,192.0,2,1,2,0,0,47.0,130,11,11.0,11
Category_Wikipedia_sockpuppets_of_Mymusictrip.csv,21,141671.0,17,4,13,4,15,45.42857142857143,199,46,29.333333333333332,21
Category_Wikipedia_sockpuppets_of_Rodre1.csv,795,150271669.0,170,625,166,4,0,36.49811320754717,250,51,22.862893081761005,7
Category_Wikipedia_sockpuppets_of_College_Watch.csv,1926,458383793.0,444,1482,442,2,0,51.09605399792316,380,59,22.922118380062305,4
Category_Wikipedia_sockpuppets_of_Raguseo.csv,528,28772467.0,195,333,195,0,0,33.797348484848484,255,34,18.488636363636363,5
Category_Wikipedia_sockpuppets_of_Your_Personal_Rooster.csv,75,524341.0,24,51,13,11,0,44.38666666666666,303,26,13.586666666666666,7
Category_Wikipedia_sockpuppets_of_Acbraughlerauthor.csv,184,69116126.0,46,138,40,6,0,56.141304347826086,249,27,14.33695652173913,4
Category_Wikipedia_sockpuppets_of_Karanshrivastva.csv,2889,148572758.0,1255,1634,500,755,0,57.81619937694704,520,59,14.239529248875042,2
Category_Wikipedia_sockpuppets_of_Edwincruz96.csv,610,128016812.0,122,488,115,7,0,38.8672131147541,233,37,17.067213114754097,4
Category_Wikipedia_sockpuppets_of_Nyantiaz.csv,2166,65175734.0,558,1608,366,192,0,59.947830101569714,500,60,14.223453370267775,4
Category_Wikipedia_sockpuppets_of_Sangha357.csv,1435,11182253.0,545,890,500,45,0,37.038327526132406,255,68,20.648780487804878,6
Category_Wikipedia_sockpuppets_of_Abhi97973.csv,1915,27014609.0,561,1354,99,462,0,33.391644908616186,371,47,16.08720626631854,3
Category_Wikipedia_sockpuppets_of_Pitambarlama.csv,513,5110525.0,122,391,46,76,0,44.16764132553606,252,24,13.52046783625731,5
Category_Wikipedia_sockpuppets_of_Mcgu8943.csv,72,21200611.0,34,38,19,15,0,45.72222222222222,239,47,30.65277777777778,18
Category_Wikipedia_sockpuppets_of_Chaitanya.gayke.csv,31,185625.0,15,16,13,2,0,36.225806451612904,207,26,22.096774193548388,19
Category_Wikipedia_sockpuppets_of_Steve_Sap.csv,13,111689.0,8,5,2,6,15,60.0,199,41,36.23076923076923,14
Category_Wikipedia_sockpuppets_of_JAP2024.csv,25,584131.0,17,8,6,11,0,41.44,251,24,18.92,14
Category_Wikipedia_sockpuppets_of_MarcZumoffBooking.csv,10,1558374.0,8,2,4,4,0,42.5,148,23,13.4,11
Category_Wikipedia_sockpuppets_of_Wettendass2008.csv,39,564220.0,15,24,15,0,0,57.82051282051282,212,21,16.82051282051282,13
Category_Wikipedia_sockpuppets_of_Masahiro007.csv,348,153188443.0,104,244,37,67,0,52.770114942528735,496,45,15.508620689655173,4
Category_Wikipedia_sockpuppets_of_Gills322.csv,6,693.0,3,3,3,0,0,17.0,31,38,26.0,14
Category_Wikipedia_sockpuppets_of_EverettMcGill.csv,1932,17454659.0,580,1352,136,444,0,38.633022774327124,244,69,20.78985507246377,4
Category_Wikipedia_sockpuppets_of_Tarunq.csv,2829,3910768.0,1000,1829,500,500,0,33.672675857193354,404,63,17.895015906680808,3
Category_Wikipedia_sockpuppets_of_SConner252.csv,71,143268283.0,25,46,24,1,0,61.61971830985915,297,62,35.12676056338028,18
Category_Wikipedia_sockpuppets_of_Cutiehoney12.csv,207,4343024.0,117,90,89,28,0,35.97584541062802,235,36,28.154589371980677,7
Category_Wikipedia_sockpuppets_of_Samithaathula.csv,1337,15472970.0,503,834,166,337,0,43.58863126402393,255,102,22.084517576664172,5
Category_Wikipedia_sockpuppets_of_Gosego_Nkwadzile.csv,263,31307852.0,98,165,58,40,0,50.49429657794677,395,49,20.269961977186313,7
Category_Wikipedia_sockpuppets_of_Venkatasubramaniyaiyer.csv,3310,6603851.0,1030,2280,472,558,0,42.909667673716015,496,79,19.02084592145015,4
Category_Wikipedia_sockpuppets_of_Zyker.csv,227,39056175.0,69,158,66,3,0,66.12334801762114,247,36,15.590308370044053,6
Category_Wikipedia_sockpuppets_of_Kookie_Cookie_Knows_What's_Best.csv,1013,15723173.0,340,673,187,153,0,39.00592300098717,248,42,20.519249753208292,4
Category_Wikipedia_sockpuppets_of_Giovanni_Giove.csv,1471,273174182.0,529,942,500,29,0,44.85384092454113,250,53,18.794017675050984,8
Category_Wikipedia_sockpuppets_of_Pi-gimjiRu.csv,1062,10735056.0,413,649,276,137,0,66.66007532956685,255,34,18.03578154425612,7
Category_Wikipedia_sockpuppets_of_Aniket_Gupta_USA.csv,71,44696.0,24,47,9,15,0,83.80281690140845,499,54,28.47887323943662,16
Category_Wikipedia_sockpuppets_of_OtelCana.csv,2,115.0,2,0,2,0,52,71.0,90,13,13.0,13
Category_Wikipedia_sockpuppets_of_ArsenalAtletico2017.csv,9312,59349064.0,3332,5980,500,2832,0,44.69093642611684,499,121,24.09289089347079,3
Category_Wikipedia_sockpuppets_of_Turkfromturkey.csv,263,1049582.0,124,139,99,25,0,47.3574144486692,253,50,23.9467680608365,9
Category_Wikipedia_sockpuppets_of_MANOZ_GYAASI.csv,441,88740339.0,150,291,55,95,0,43.9750566893424,255,35,12.841269841269842,3
Category_Wikipedia_sockpuppets_of_Yanelazulu_.s.csv,24,152916.0,14,10,10,4,0,31.625,133,24,20.125,11
Category_Wikipedia_sockpuppets_of_DaddySaurus.csv,112,80954188.0,41,71,20,21,0,47.330357142857146,192,52,32.080357142857146,19
Category_Wikipedia_sockpuppets_of_EstebanJals.csv,3408,61330995.0,1036,2372,310,726,0,34.39172535211268,255,78,21.821596244131456,3
Category_Wikipedia_sockpuppets_of_Nik50382.csv,94,3826667.0,49,45,38,11,0,61.04255319148936,227,44,29.5531914893617,18
Category_Wikipedia_sockpuppets_of_–≠–ª—å–±—Ä—É—Å_–ö–∞–∑–±–µ–∫–æ–≤–∏—á.csv,590,39413739.0,249,341,184,65,0,47.686440677966104,305,42,16.086440677966102,7
Category_Wikipedia_sockpuppets_of_Anhajiofkandahar.csv,376,9689178.0,117,259,53,64,0,52.3031914893617,255,54,21.18351063829787,5
Category_Wikipedia_sockpuppets_of_Nokhaiz_Kaunpal.csv,601,12135332.0,211,390,208,3,0,49.098169717138106,244,72,17.891846921797004,3
Category_Wikipedia_sockpuppets_of_Justice_Forever.csv,1484,166668448.0,516,968,146,370,0,81.05188679245283,255,64,19.83153638814016,5
Category_Wikipedia_sockpuppets_of_19Francis65.csv,27,3905105.0,13,14,12,1,0,86.29629629629629,238,46,42.2962962962963,21
Category_Wikipedia_sockpuppets_of_Sandyminek1.csv,68,158052.0,19,49,5,14,0,56.6764705882353,316,42,18.205882352941178,5
Category_Wikipedia_sockpuppets_of_Snakehead123.csv,5,179.0,2,3,2,0,16,81.0,194,16,16.0,16
Category_Wikipedia_sockpuppets_of_Codemastersnake.csv,24,1119809.0,6,18,3,3,2,37.5,140,26,13.833333333333334,8
Category_Wikipedia_sockpuppets_of_Bhind45.csv,313,47285069.0,105,208,96,9,0,45.89776357827476,232,63,22.79552715654952,5
Category_Wikipedia_sockpuppets_of_Halosine.csv,501,21855521.0,197,304,66,131,0,38.6746506986028,261,47,17.880239520958085,4
Category_Wikipedia_sockpuppets_of_Carindem.csv,4,648.0,4,0,2,2,0,20.0,80,59,48.0,15
Category_Wikipedia_sockpuppets_of_LittleMemories.csv,374,1819461.0,162,212,94,68,0,41.473262032085564,312,50,20.82085561497326,7
Category_Wikipedia_sockpuppets_of_Belteshazzar.csv,1643,102432239.0,538,1105,500,38,0,61.28971393791844,499,56,25.382836275106513,4
Category_Wikipedia_sockpuppets_of_WikiGuy_Steev.csv,76,2715574.0,25,51,12,13,0,59.86842105263158,255,26,14.618421052631579,7
Category_Wikipedia_sockpuppets_of_Mindcap.csv,625,17035639.0,293,332,280,13,0,56.792,232,83,22.3088,5
Category_Wikipedia_sockpuppets_of_Generic_Character.csv,1492,8474240.0,566,926,402,164,0,31.010053619302948,218,92,18.595844504021446,2
Category_Wikipedia_sockpuppets_of_ShirazQ.csv,339,98751483.0,154,185,124,30,0,35.49557522123894,334,47,18.28023598820059,5
Category_Wikipedia_sockpuppets_of_Bianbum.csv,491,110473510.0,181,310,170,11,0,56.36456211812627,255,53,22.751527494908352,4
Category_Wikipedia_sockpuppets_of_Dhirenmb.csv,373,66706939.0,154,219,44,110,0,34.88739946380697,255,54,23.096514745308312,6
Category_Wikipedia_sockpuppets_of_Account10000.csv,706,60475106.0,243,463,72,171,0,55.81161473087819,494,54,19.10198300283286,4
Category_Wikipedia_sockpuppets_of_Renatolaranja.csv,61,319399.0,22,39,22,0,0,55.90163934426229,198,47,37.19672131147541,19
Category_Wikipedia_sockpuppets_of_Gummybearswillruletheworld.csv,33,1811804.0,7,26,6,1,0,55.93939393939394,197,28,18.060606060606062,14
Category_Wikipedia_sockpuppets_of_Hk12hk.csv,72,80381.0,28,44,22,6,0,62.583333333333336,461,54,25.38888888888889,5
Category_Wikipedia_sockpuppets_of_Shane.Kelly.csv,7,568755.0,6,1,4,2,0,86.0,196,28,26.0,24
Category_Wikipedia_sockpuppets_of_Semmy1960.csv,4328,63890515.0,1500,2828,500,1000,0,49.159658040665434,494,96,18.826709796672827,3
Category_Wikipedia_sockpuppets_of_FMBlogger.csv,3725,253054959.0,1553,2172,500,1053,0,33.23355704697987,250,70,24.391409395973156,3
Category_Wikipedia_sockpuppets_of_AdirondackMan.csv,699,26797951.0,219,480,211,8,0,41.97854077253219,250,48,22.709585121602288,4
Category_Wikipedia_sockpuppets_of_Cybershinde.csv,40,222577708.0,8,32,7,1,0,52.725,234,19,11.1,7
Category_Wikipedia_sockpuppets_of_LAz17.csv,1431,42422776.0,507,924,500,7,0,39.958071278826,255,93,27.69601677148847,6
Category_Wikipedia_sockpuppets_of_Dino245.csv,5178,96612872.0,1391,3787,500,891,0,67.53611432985709,500,85,20.909231363460794,3
Category_Wikipedia_sockpuppets_of_Wiki.Apt.csv,15449,7117015.0,5000,10449,500,4500,0,40.58858178522882,496,85,18.504239756618553,4
Category_Wikipedia_sockpuppets_of_Guddu_Banerjee.csv,1926,17774726.0,862,1064,500,362,0,35.09761163032191,255,76,18.45379023883697,5
Category_Wikipedia_sockpuppets_of_HaruhiSuzumiyaIsAGod.csv,2169,15009036.0,651,1518,332,319,0,44.97372060857538,499,70,17.106500691562932,4
Category_Wikipedia_sockpuppets_of_Kenny139.csv,84,1773907.0,47,37,34,13,0,56.523809523809526,267,29,22.047619047619047,8
Category_Wikipedia_sockpuppets_of_Silverlakecamusic.csv,14,6473991.0,14,0,10,4,13,37.42857142857143,131,18,18.0,18
Category_Wikipedia_sockpuppets_of_Name-100000.csv,12,621038.0,4,8,2,2,0,44.666666666666664,247,42,42.0,42
Category_Wikipedia_sockpuppets_of_JacksonPB5.csv,180,7983062.0,136,44,118,18,0,44.044444444444444,494,29,17.866666666666667,15
Category_Wikipedia_sockpuppets_of_Ian.bjorn.csv,1289,13924569.0,465,824,434,31,0,41.25523661753297,250,77,20.595034910783554,3
Category_Wikipedia_sockpuppets_of_Bernardusaji.csv,36,3540365.0,15,21,14,1,0,39.75,191,26,17.5,10
Category_Wikipedia_sockpuppets_of_Zenasprime.csv,465,7626894.0,146,319,104,42,0,47.22795698924731,247,68,24.64516129032258,3
Category_Wikipedia_sockpuppets_of_NormalguyfromUK.csv,2250,38248509.0,822,1428,500,322,0,52.16844444444445,496,76,22.280444444444445,4
Category_Wikipedia_sockpuppets_of_Jack_DeMattos.csv,1002,9395981.0,508,494,500,8,0,64.65868263473054,254,59,14.401197604790418,10
Category_Wikipedia_sockpuppets_of_Alex_Meechan.csv,120,196007.0,45,75,25,20,0,39.15833333333333,204,41,19.658333333333335,5
Category_Wikipedia_sockpuppets_of_Walkwounded.csv,74,27211221.0,40,34,34,6,0,58.7972972972973,227,29,20.08108108108108,17
Category_Wikipedia_sockpuppets_of_G2gg-8g40.csv,45,24253.0,25,20,12,13,0,27.511111111111113,190,53,22.955555555555556,18
Category_Wikipedia_sockpuppets_of_SkagitRiverQueen.csv,4807,66700796.0,1440,3367,500,940,0,55.768046598710214,250,65,21.006032868733097,4
Category_Wikipedia_sockpuppets_of_Azad.Ghilji.csv,18,262710.0,10,8,9,1,0,65.61111111111111,222,16,13.11111111111111,12
Category_Wikipedia_sockpuppets_of_Telanian7790.csv,478,61339017.0,160,318,140,20,0,75.08995815899581,473,69,25.49581589958159,6
Category_Wikipedia_sockpuppets_of_Nkeerthana29.csv,381,145568975.0,157,224,71,86,0,37.60629921259842,260,41,18.965879265091864,10
Category_Wikipedia_sockpuppets_of_Mainudin_Sumro.csv,23,17718.0,12,11,12,0,0,22.956521739130434,196,14,13.043478260869565,11
Category_Wikipedia_sockpuppets_of_Applus2021.csv,6223,87808119.0,1644,4579,496,1148,0,59.01783705608228,500,85,19.21838341635867,3
Category_Wikipedia_sockpuppets_of_Bekir_Brunƒçeviƒá.csv,41,7882520.0,23,18,8,15,0,34.829268292682926,191,47,19.048780487804876,12
Category_Wikipedia_sockpuppets_of_Nathancookie1.csv,31,2332303.0,10,21,5,5,0,53.67741935483871,185,18,11.935483870967742,10
Category_Wikipedia_sockpuppets_of_StanG1992.csv,86,46290509.0,25,61,15,10,0,51.7093023255814,232,43,22.941860465116278,8
Category_Wikipedia_sockpuppets_of_Decepticon_Shockwave.csv,460,15099636.0,165,295,164,1,0,52.380434782608695,224,90,28.57391304347826,10
Category_Wikipedia_sockpuppets_of_EstellaAdora.csv,61,1024030.0,30,31,26,4,0,40.77049180327869,248,47,20.688524590163933,9
Category_Wikipedia_sockpuppets_of_Labsalah_Duhul_Hassan.csv,118,1060621.0,53,65,38,15,0,55.66949152542373,173,44,27.279661016949152,8
Category_Wikipedia_sockpuppets_of_LogoSubcheck.csv,1016,62907958.0,309,707,281,28,0,38.56200787401575,255,47,23.353346456692915,3
Category_Wikipedia_sockpuppets_of_Zeeshan313b.csv,231,252392926.0,85,146,68,17,0,49.056277056277054,255,32,23.73160173160173,6
Category_Wikipedia_sockpuppets_of_Laugedefrent.csv,3,266.0,2,1,1,1,0,62.0,186,19,19.0,19
Category_Wikipedia_sockpuppets_of_Rolleygiacalone.csv,2522,48188835.0,602,1920,367,235,0,45.84734337827121,386,55,16.29817605075337,3
Category_Wikipedia_sockpuppets_of_Sarenne.csv,2437,31749321.0,679,1758,500,179,0,48.08945424702503,212,59,17.33606893721789,2
Category_Wikipedia_sockpuppets_of_Urgal.csv,5834,16761828.0,1746,4088,500,1246,0,44.00891326705519,491,65,16.80442235173123,3
Category_Wikipedia_sockpuppets_of_Fretmaswter.csv,13,376329.0,3,10,2,1,23,41.69230769230769,68,33,26.0,17
Category_Wikipedia_sockpuppets_of_Cookie_hijacker.csv,31,1222.0,11,20,6,5,0,71.6774193548387,191,32,19.161290322580644,17
Category_Wikipedia_sockpuppets_of_Imadiceman.csv,82,125539254.0,32,50,25,7,0,47.52439024390244,236,47,24.865853658536587,14
Category_Wikipedia_sockpuppets_of_Neonstar1868.csv,33,107397.0,28,5,23,5,0,112.33333333333333,144,48,27.939393939393938,7
Category_Wikipedia_sockpuppets_of_Mustafa_Kemal_Atat√ºrk.csv,124,154596.0,56,68,56,0,0,42.95161290322581,250,50,32.03225806451613,7
Category_Wikipedia_sockpuppets_of_Loleris02.csv,239,3667729.0,90,149,86,4,0,52.26359832635983,291,26,19.06276150627615,8
Category_Wikipedia_sockpuppets_of_Roushil_Thoi_Singla.csv,49,8394794.0,20,29,8,12,0,24.387755102040817,218,30,13.673469387755102,9
Category_Wikipedia_sockpuppets_of_Zorro544.csv,141,4646185.0,47,94,21,26,0,43.56028368794326,313,42,16.73049645390071,5
Category_Wikipedia_sockpuppets_of_Dr_ahmed_akl.csv,265,47911711.0,107,158,67,40,0,56.1811320754717,237,25,15.483018867924528,6
Category_Wikipedia_sockpuppets_of_BabyEinsteinFan238.csv,159,29695872.0,64,95,39,25,0,43.276729559748425,211,45,23.60377358490566,12
Category_Wikipedia_sockpuppets_of_AnnGresveel.csv,47,786172.0,19,28,6,13,0,66.42553191489361,231,33,17.51063829787234,7
Category_Wikipedia_sockpuppets_of_344766480A.csv,346,8867611.0,107,239,103,4,0,46.23988439306358,475,54,22.789017341040463,3
Category_Wikipedia_sockpuppets_of_Zipmagic.csv,119,33946941.0,32,87,13,19,0,49.26890756302521,249,24,11.142857142857142,4
Category_Wikipedia_sockpuppets_of_Creative_Software_Consultancy_Services.csv,4,1964183.0,3,1,2,1,15,58.75,87,27,26.0,23
Category_Wikipedia_sockpuppets_of_Feinoa.csv,1547,5724905.0,510,1037,500,10,0,48.57013574660633,489,59,23.06076276664512,3
Category_Wikipedia_sockpuppets_of_Snoopy012.csv,1294,37639744.0,537,757,500,37,0,34.24884080370943,254,57,25.082689335394125,7
Category_Wikipedia_sockpuppets_of_Huresihn.csv,1,0.0,1,0,1,0,0,0.0,0,8,8.0,8
Category_Wikipedia_sockpuppets_of_ThatOneGuyLol.csv,13,916.0,8,5,7,1,0,74.23076923076923,192,24,24.0,24
Category_Wikipedia_sockpuppets_of_JeraldPlathottam.csv,9,2986200.0,7,2,7,0,0,30.333333333333332,151,26,22.22222222222222,9
Category_Wikipedia_sockpuppets_of_Alekborodina.csv,151,50200275.0,51,100,51,0,0,50.22516556291391,255,49,25.7682119205298,15
Category_Wikipedia_sockpuppets_of_Oliviaharley24.csv,5,59698463.0,4,1,2,2,20,39.2,63,26,20.8,14
Category_Wikipedia_sockpuppets_of_Rejedef.csv,4898,410305395.0,1146,3752,500,646,0,58.97488770926909,399,80,20.748264597795018,4
Category_Wikipedia_sockpuppets_of_Jtaylor7309.csv,121,141937278.0,43,78,37,6,0,42.93388429752066,255,55,35.19834710743802,13
Category_Wikipedia_sockpuppets_of_BobRosencrantz.csv,435,8137224.0,127,308,62,65,0,45.59310344827586,233,62,20.324137931034482,6
Category_Wikipedia_sockpuppets_of_LennY1000.csv,13,459970.0,6,7,5,1,16,75.53846153846153,217,13,11.846153846153847,10
Category_Wikipedia_sockpuppets_of_Bandarudanaiahkavi.csv,53,264911652.0,20,33,20,0,0,22.169811320754718,156,52,26.62264150943396,10
Category_Wikipedia_sockpuppets_of_Interesting_Soup.csv,2918,43026521.0,764,2154,49,715,0,43.75805346127485,459,52,20.26113776559287,4
Category_Wikipedia_sockpuppets_of_Labyrinth13.csv,1600,194677532.0,508,1092,500,8,0,52.5575,250,54,22.248125,5
Category_Wikipedia_sockpuppets_of_R213P.csv,69,2740571.0,30,39,20,10,0,50.88405797101449,202,57,16.884057971014492,9
Category_Wikipedia_sockpuppets_of_CensoredScribe.csv,32515,310614266.0,8397,24118,500,7897,0,41.35685068429955,500,79,19.614700907273566,3
Category_Wikipedia_sockpuppets_of_Lakshani85.csv,331,312794903.0,107,224,96,11,0,32.65558912386707,327,56,16.6404833836858,12
Category_Wikipedia_sockpuppets_of_Edychiva94.csv,60,26393460.0,14,46,8,6,0,51.733333333333334,223,32,18.083333333333332,11
Category_Wikipedia_sockpuppets_of_HurricaneCenterControl.csv,183,13399918.0,66,117,66,0,0,46.224043715846996,484,37,24.30054644808743,12
Category_Wikipedia_sockpuppets_of_JoKing.csv,2403,176517990.0,612,1791,500,112,0,46.79816895547233,250,56,15.454431960049938,3
Category_Wikipedia_sockpuppets_of_Bhmyashwanth00.csv,18,448560.0,8,10,5,3,0,64.66666666666667,223,23,16.5,10
Category_Wikipedia_sockpuppets_of_Ravi_mavi.csv,346,3394211.0,126,220,102,24,0,63.335260115606935,434,37,17.208092485549134,6
Category_Wikipedia_sockpuppets_of_USMC_Padre.csv,116,93621759.0,43,73,43,0,0,52.18103448275862,199,59,24.836206896551722,8
Category_Wikipedia_sockpuppets_of_PAKHIGHWAY.csv,2789,21581463.0,1018,1771,500,518,0,42.27859447830764,382,97,22.31803513804231,4
Category_Wikipedia_sockpuppets_of_Joestieg.csv,389,7357600.0,135,254,95,40,0,30.362467866323907,142,52,11.311053984575835,3
Category_Wikipedia_sockpuppets_of_ZomRe.csv,419,60106526.0,151,268,75,76,0,52.56801909307876,253,47,19.498806682577566,3
Category_Wikipedia_sockpuppets_of_Pelaisse.csv,1526,27751518.0,509,1017,300,209,0,39.54521625163827,234,51,19.256225425950195,6
Category_Wikipedia_sockpuppets_of_AreYouARightPerson.csv,193,99873.0,103,90,53,50,0,53.97409326424871,500,28,18.202072538860104,7
Category_Wikipedia_sockpuppets_of_Wwikix.csv,8749,181259857.0,3439,5310,500,2939,0,38.17213395816665,501,78,24.00708652417419,4
Category_Wikipedia_sockpuppets_of_DylanPuma20.csv,430,5699582.0,178,252,58,120,0,46.0046511627907,279,59,29.76279069767442,12
Category_Wikipedia_sockpuppets_of_Ruderow.csv,698,342323310.0,239,459,182,57,0,45.77507163323782,304,46,13.98567335243553,5
Category_Wikipedia_sockpuppets_of_CarlosJalisco.csv,863,107573551.0,199,664,138,61,0,49.261877172653534,496,74,17.12862108922364,4
Category_Wikipedia_sockpuppets_of_BelAirRuse.csv,3205,26289155.0,1142,2063,500,642,0,52.01716068642746,255,71,22.66021840873635,5
Category_Wikipedia_sockpuppets_of_WikiWooToo.csv,6,252182.0,4,2,2,2,0,35.333333333333336,101,16,13.333333333333334,12
Category_Wikipedia_sockpuppets_of_Testmailmejoe.csv,24,274177.0,10,14,10,0,0,36.75,168,34,17.916666666666668,5
Category_Wikipedia_sockpuppets_of_DaDeadzombie.csv,3492,32529772.0,1197,2295,500,697,0,39.237972508591064,500,70,18.90549828178694,6
Category_Wikipedia_sockpuppets_of_Tomforward.csv,4,356.0,3,1,3,0,0,59.0,188,12,12.0,12
Category_Wikipedia_sockpuppets_of_Ruhrob.csv,448,9689078.0,155,293,107,48,0,60.799107142857146,489,53,24.566964285714285,11
Category_Wikipedia_sockpuppets_of_Kaltsef.csv,77,10588669.0,28,49,23,5,0,38.22077922077922,199,28,18.532467532467532,6
Category_Wikipedia_sockpuppets_of_Clockworkgirl21.csv,185,20301414.0,68,117,57,11,0,35.61081081081081,199,47,35.32972972972973,11
Category_Wikipedia_sockpuppets_of_Jan_Shane.csv,13,3412.0,8,5,4,4,0,41.69230769230769,174,11,11.0,11
Category_Wikipedia_sockpuppets_of_Inapproprichu.csv,114,7514716.0,59,55,28,31,0,43.06140350877193,238,45,20.42982456140351,5
Category_Wikipedia_sockpuppets_of_Factual_items.csv,407,22728978.0,196,211,142,54,0,41.41277641277641,199,37,23.847665847665848,11
Category_Wikipedia_sockpuppets_of_Lsdhami17.csv,13,765366.0,7,6,7,0,0,49.61538461538461,293,25,18.23076923076923,12
Category_Wikipedia_sockpuppets_of_The_Recycling_Troll.csv,1662,59100229.0,416,1246,414,2,0,27.343561973525873,200,93,25.584235860409144,3
Category_Wikipedia_sockpuppets_of_Hamdirfan987.csv,921,69235605.0,351,570,191,160,0,40.666666666666664,255,40,16.25515743756786,7
Category_Wikipedia_sockpuppets_of_Vivekanand_Selvaraj.csv,51,25305170.0,17,34,12,5,0,40.568627450980394,196,29,18.11764705882353,11
Category_Wikipedia_sockpuppets_of_Archetypex07.csv,312,71128839.0,84,228,70,14,0,57.32051282051282,237,51,16.53205128205128,3
Category_Wikipedia_sockpuppets_of_Jenny2393.csv,50,270437.0,14,36,9,5,0,55.82,243,35,24.16,9
Category_Wikipedia_sockpuppets_of_Collegesoccer.news.csv,87,345594.0,32,55,28,4,0,41.195402298850574,203,44,31.436781609195403,12
Category_Wikipedia_sockpuppets_of_ScottishNationalJazzOrchestra.csv,35,83767.0,22,13,18,4,0,30.17142857142857,146,28,22.428571428571427,13
Category_Wikipedia_sockpuppets_of_Eggdipie3.csv,1867,130703969.0,719,1148,427,292,0,40.31655061596143,499,82,20.671665773968932,3
Category_Wikipedia_sockpuppets_of_Scrublord69.csv,21,599196.0,9,12,5,4,0,65.0952380952381,231,25,15.619047619047619,5
Category_Wikipedia_sockpuppets_of_Win7777.csv,61,75750.0,59,2,57,2,0,2.0655737704918034,84,17,17.0,17
Category_Wikipedia_sockpuppets_of_Somies568.csv,75,133305.0,27,48,26,1,0,53.653333333333336,270,42,16.866666666666667,4
Category_Wikipedia_sockpuppets_of_Irvine22.csv,4198,207274709.0,1270,2928,500,770,0,47.15269175797999,255,57,20.34468794664126,4
Category_Wikipedia_sockpuppets_of_Chikumusale.csv,66,1294206.0,23,43,16,7,0,60.95454545454545,287,28,17.03030303030303,7
Category_Wikipedia_sockpuppets_of_Ylevy.csv,348,300456512.0,111,237,95,16,0,43.229885057471265,236,53,19.948275862068964,5
Category_Wikipedia_sockpuppets_of_Dontcancelfruitsnacks.csv,156,73590111.0,51,105,28,23,0,45.59615384615385,289,31,12.987179487179487,4
Category_Wikipedia_sockpuppets_of_Metroponce.csv,96,599869.0,26,70,21,5,0,26.84375,189,39,18.447916666666668,4
Category_Wikipedia_sockpuppets_of_Harry59b.csv,126,782561.0,28,98,19,9,0,46.698412698412696,146,47,36.62698412698413,15
Category_Wikipedia_sockpuppets_of_OwainAFC.csv,1329,13886182.0,565,764,500,65,0,35.43641835966893,317,46,22.696764484574867,6
Category_Wikipedia_sockpuppets_of_Hayley308.csv,230,272494109.0,50,180,32,18,0,47.14782608695652,254,26,15.156521739130435,4
Category_Wikipedia_sockpuppets_of_Guidales.csv,849,24849594.0,253,596,74,179,0,37.928150765606595,211,40,17.111896348645466,3
Category_Wikipedia_sockpuppets_of_BurhanHyder.csv,582,88692675.0,223,359,135,88,0,46.517182130584196,249,53,23.915807560137456,14
Category_Wikipedia_sockpuppets_of_Bardeep.csv,307,58644393.0,75,232,22,53,0,36.36807817589577,200,39,18.81758957654723,4
Category_Wikipedia_sockpuppets_of_Wikid77.csv,2039,282787791.0,508,1531,500,8,0,51.590975968612064,337,99,19.072584600294263,3
Category_Wikipedia_sockpuppets_of_Woodsend.csv,11,19467.0,9,2,3,6,0,21.545454545454547,56,46,33.54545454545455,14
Category_Wikipedia_sockpuppets_of_Arsh_L.csv,12,98542.0,8,4,5,3,0,51.833333333333336,205,14,10.333333333333334,10
Category_Wikipedia_sockpuppets_of_Reliapump.csv,10,777834.0,5,5,3,2,26,57.3,165,16,13.0,11
Category_Wikipedia_sockpuppets_of_Exploreandwrite.csv,5170,76707940.0,2280,2890,500,1780,0,42.561121856866535,484,79,19.851063829787233,5
Category_Wikipedia_sockpuppets_of_Sajed_Mahmud.csv,1204,11587678.0,401,803,266,135,0,43.475083056478404,255,61,22.238372093023255,6
Category_Wikipedia_sockpuppets_of_Bayu_Fuller.csv,4834,41380690.0,1561,3273,500,1061,0,63.73893256102607,504,73,24.45386843194042,4
Category_Wikipedia_sockpuppets_of_Dj_S_UNIVERSE_'Q'.csv,591,35898993.0,221,370,33,188,0,44.83925549915398,279,51,15.861252115059221,3
Category_Wikipedia_sockpuppets_of_XavierDodo.csv,1881,37425440.0,701,1180,500,201,0,59.94417862838915,387,64,17.556618819776716,4
Category_Wikipedia_sockpuppets_of_Pettickal.csv,105,62462976.0,37,68,35,2,0,37.58095238095238,196,78,26.39047619047619,6
Category_Wikipedia_sockpuppets_of_Quisp65.csv,446,396500527.0,120,326,62,58,0,50.49551569506726,260,41,20.056053811659194,8
Category_Wikipedia_sockpuppets_of_Designer_Liz_Taylor.csv,117,10960214.0,65,52,36,29,0,54.623931623931625,228,25,23.17948717948718,13
Category_Wikipedia_sockpuppets_of_Yohowithrum.csv,1598,165111147.0,567,1031,500,67,0,38.62953692115144,255,57,22.029411764705884,4
Category_Wikipedia_sockpuppets_of_Dan23tss.csv,97,2304101.0,34,63,20,14,0,51.77319587628866,175,23,15.391752577319588,8
Category_Wikipedia_sockpuppets_of_Kcosip.csv,1725,81080713.0,876,849,500,376,0,51.6,488,67,21.490434782608695,5
Category_Wikipedia_sockpuppets_of_EastBelfastBoy.csv,1323,107569726.0,482,841,387,95,0,42.71806500377929,255,90,21.808767951625093,5
Category_Wikipedia_sockpuppets_of_TheTaskman.csv,29,18768152.0,20,9,9,11,10,50.86206896551724,262,44,16.137931034482758,12
Category_Wikipedia_sockpuppets_of_Sol-lol.csv,92,11917884.0,24,68,9,15,0,53.42391304347826,222,24,14.228260869565217,7
Category_Wikipedia_sockpuppets_of_Mnaqvii.csv,901,51744039.0,301,600,83,218,0,45.872364039955606,255,74,19.901220865704772,5
Category_Wikipedia_sockpuppets_of_UrantiaRI.csv,18,417656.0,12,6,10,2,0,27.833333333333332,140,25,21.22222222222222,21
Category_Wikipedia_sockpuppets_of_MostTeachersSuck.csv,20,1724.0,11,9,8,3,0,79.4,151,26,16.1,14
Category_Wikipedia_sockpuppets_of_Wikedit-34.csv,333,96265417.0,95,238,31,64,0,40.54354354354354,222,90,24.087087087087088,5
Category_Wikipedia_sockpuppets_of_Anuj_Parikh.csv,15,437516.0,6,9,4,2,0,50.86666666666667,196,24,20.8,16
Category_Wikipedia_sockpuppets_of_Roman_Hural.csv,31,6847715.0,23,8,12,11,0,29.64516129032258,194,26,12.129032258064516,11
Category_Wikipedia_sockpuppets_of_Vodu3000.csv,901,456300328.0,362,539,210,152,0,41.634850166481684,266,61,24.35405105438402,5
Category_Wikipedia_sockpuppets_of_KYNY.csv,100,374012.0,36,64,18,18,0,56.3,229,49,18.7,10
Category_Wikipedia_sockpuppets_of_A.JulianEditor.csv,1559,119103314.0,519,1040,500,19,0,46.18152661962797,492,80,25.14432328415651,5
Category_Wikipedia_sockpuppets_of_Imrutu.csv,111,39617329.0,42,69,8,34,0,46.027027027027025,254,53,22.7027027027027,10
Category_Wikipedia_sockpuppets_of_Roadcreature.csv,1790,216962505.0,515,1275,500,15,0,51.59608938547486,233,89,33.61564245810056,2
Category_Wikipedia_sockpuppets_of_Gca.345.csv,521,2716225.0,212,309,202,10,0,39.838771593090215,346,34,17.63147792706334,7
Category_Wikipedia_sockpuppets_of_Gen._von_Klinkerhoffen.csv,1203,54270482.0,324,879,234,90,0,56.428927680798004,250,77,21.250207813798838,4
Category_Wikipedia_sockpuppets_of_The_Oak_Ridge_Boys.csv,5,6038.0,3,2,3,0,0,5.2,26,31,25.8,18
Category_Wikipedia_sockpuppets_of_HareKrishnaPortal.csv,769,3277532.0,282,487,154,128,0,43.15084525357607,250,64,16.407022106631988,2
Category_Wikipedia_sockpuppets_of_QueenXi.csv,2,723.0,2,0,1,1,0,2.0,4,52,52.0,52
Category_Wikipedia_sockpuppets_of_Universe_Daily.csv,1755,170934241.0,583,1172,79,504,0,51.36923076923077,249,63,17.745299145299146,3
Category_Wikipedia_sockpuppets_of_TB115.csv,865,11225111.0,323,542,323,0,0,29.247398843930636,199,41,16.3364161849711,4
Category_Wikipedia_sockpuppets_of_Villaged.csv,589,570609844.0,137,452,131,6,0,72.16808149405773,499,73,21.171477079796265,3
Category_Wikipedia_sockpuppets_of_UnbiasedVictory.csv,4409,74935683.0,1519,2890,500,1019,0,58.6527557269222,255,67,22.636879110909504,6
Category_Wikipedia_sockpuppets_of_Wictoriamalawi.csv,1824,15836016.0,815,1009,500,315,0,39.01315789473684,496,71,20.52357456140351,8
Category_Wikipedia_sockpuppets_of_Beleiutz.csv,735,110844940.0,283,452,252,31,0,39.25034013605442,250,47,18.941496598639457,4
"Category_Wikipedia_sockpuppets_of_Perseus,_Son_of_Zeus.csv",7919,92178997.0,2934,4985,500,2434,0,47.30710948352065,250,81,26.312413183482764,3
Category_Wikipedia_sockpuppets_of_Rdactyl.csv,153,252563020.0,38,115,21,17,0,46.411764705882355,233,45,17.61437908496732,5
Category_Wikipedia_sockpuppets_of_Pkvashisht.csv,15,2141018.0,3,12,2,1,0,43.0,230,22,18.0,17
Category_Wikipedia_sockpuppets_of_Fikeithomas.csv,233,599208.0,85,148,19,66,0,40.84978540772532,268,49,17.836909871244636,5
Category_Wikipedia_sockpuppets_of_LichfieldCC.csv,87,2478315.0,59,28,39,20,0,58.42528735632184,196,31,21.448275862068964,16
Category_Wikipedia_sockpuppets_of_TristanMoens.csv,6633,12045608.0,2403,4230,500,1903,0,88.80943766018393,473,66,14.778531584501733,5
Category_Wikipedia_sockpuppets_of_Sanjana67.csv,15,5189747.0,10,5,7,3,0,26.866666666666667,203,53,31.866666666666667,4
Category_Wikipedia_sockpuppets_of_Ju_English.csv,58,5170948.0,42,16,14,28,0,29.75862068965517,118,23,18.810344827586206,12
Category_Wikipedia_sockpuppets_of_TRothschild.csv,5,986682.0,2,3,2,0,24,66.0,121,50,39.2,32
Category_Wikipedia_sockpuppets_of_Jonasorg.csv,234,10219406.0,98,136,61,37,0,49.41025641025641,250,44,22.572649572649574,6
Category_Wikipedia_sockpuppets_of_MovieMan13.csv,56,1824917.0,25,31,25,0,0,50.375,218,49,19.267857142857142,12
Category_Wikipedia_sockpuppets_of_Smokefan2007.csv,2070,40423893.0,433,1637,379,54,0,41.16328502415459,223,51,14.732367149758455,4
Category_Wikipedia_sockpuppets_of_MianAbdulHaseeb.csv,37,2067866.0,16,21,8,8,0,51.486486486486484,256,26,17.216216216216218,12
Category_Wikipedia_sockpuppets_of_Corneldidit.csv,71,895159.0,26,45,26,0,0,36.774647887323944,176,37,28.450704225352112,17
Category_Wikipedia_sockpuppets_of_Malhomsi.csv,100,263565051.0,36,64,6,30,0,44.55,203,23,13.33,7
Category_Wikipedia_sockpuppets_of_Wombatfooty.csv,61,950070.0,30,31,12,18,0,50.91803278688525,223,28,19.557377049180328,9
Category_Wikipedia_sockpuppets_of_Arcarius.csv,1835,19125116.0,641,1194,500,141,0,41.716076294277926,255,66,21.25286103542234,3
Category_Wikipedia_sockpuppets_of_Mukundmahamuni.csv,7,182033635.0,2,5,2,0,0,39.857142857142854,126,27,19.285714285714285,18
Category_Wikipedia_sockpuppets_of_Gololur.csv,2254,27495317.0,1006,1248,487,519,0,26.055900621118013,255,31,12.877551020408163,5
Category_Wikipedia_sockpuppets_of_Wendystarland.csv,41,441331496.0,13,28,5,8,0,54.0,268,63,22.4390243902439,16
Category_Wikipedia_sockpuppets_of_JellyfishFilms.csv,268,66224888.0,74,194,54,20,0,48.38805970149254,255,50,16.5,10
Category_Wikipedia_sockpuppets_of_Atharvnannu2.csv,232,1484407.0,69,163,18,51,0,48.5,282,57,19.655172413793103,5
Category_Wikipedia_sockpuppets_of_Wanderer_kanishk.csv,410,22307739.0,189,221,186,3,0,45.892682926829266,496,52,24.046341463414635,12
Category_Wikipedia_sockpuppets_of_Enivak.csv,1852,10132312.0,553,1299,500,53,0,75.51079913606911,333,83,21.420626349892007,4
Category_Wikipedia_sockpuppets_of_Abdulla_Sahil.csv,547,4902079.0,258,289,248,10,0,30.416819012797074,250,52,17.356489945155392,6
Category_Wikipedia_sockpuppets_of_Fanofblackened.csv,2044,60317568.0,619,1425,500,119,0,47.62769080234834,496,104,19.961839530332682,5
Category_Wikipedia_sockpuppets_of_√ûj√≥√∞√≥lfr.csv,3848,20652201.0,1253,2595,500,753,0,39.862006237006234,253,73,20.2752079002079,1
Category_Wikipedia_sockpuppets_of_Kdie84.csv,50,64931.0,27,23,17,10,0,84.34,253,42,15.78,10
Category_Wikipedia_sockpuppets_of_AJ_DA_YOUNGAN.csv,658,58354278.0,233,425,103,130,0,37.77051671732523,500,31,16.928571428571427,12
Category_Wikipedia_sockpuppets_of_BrockHoliox.csv,25,1030181.0,6,19,4,2,0,52.52,163,27,23.56,11
Category_Wikipedia_sockpuppets_of_.caiify3623..csv,208,8295929.0,97,111,79,18,0,62.28365384615385,495,56,25.557692307692307,5
Category_Wikipedia_sockpuppets_of_Mr.Robertson88.csv,50,5425837.0,25,25,10,15,0,51.68,190,14,14.0,14
Category_Wikipedia_sockpuppets_of_Omoyeglow.csv,83,3588425.0,31,52,19,12,0,44.69879518072289,193,33,14.674698795180722,8
Category_Wikipedia_sockpuppets_of_Parabellus.csv,1584,48451348.0,374,1210,334,40,0,46.53409090909091,500,93,20.858585858585858,4
Category_Wikipedia_sockpuppets_of_State_Diane.csv,263,30607760.0,63,200,20,43,0,55.638783269961976,255,53,21.47148288973384,6
Category_Wikipedia_sockpuppets_of_TelosCricket.csv,1542,113081342.0,534,1008,500,34,0,54.090142671854736,382,63,21.73865110246433,5
Category_Wikipedia_sockpuppets_of_Zarvonov.csv,1267,4068134.0,520,747,500,20,0,51.06314127861089,499,49,17.400947119179165,10
Category_Wikipedia_sockpuppets_of_Luka_Djordjevic55.csv,833,10729489.0,311,522,245,66,0,50.362545018007204,450,62,22.03841536614646,4
Category_Wikipedia_sockpuppets_of_Therainbowsend.csv,1668,12100268.0,586,1082,500,86,0,29.298561151079138,251,62,16.8794964028777,4
Category_Wikipedia_sockpuppets_of_Hilspress.csv,750,82094013.0,323,427,251,72,0,45.550666666666665,311,54,14.965333333333334,5
Category_Wikipedia_sockpuppets_of_Tdk20063.csv,77,35006447.0,35,42,26,9,0,38.97402597402598,240,26,16.77922077922078,11
Category_Wikipedia_sockpuppets_of_ParkShinHyeFanatics2015.csv,117,8937753.0,85,32,16,69,0,46.63247863247863,195,15,12.222222222222221,10
Category_Wikipedia_sockpuppets_of_Bobert42069.csv,194,69011.0,63,131,37,26,0,74.9020618556701,245,27,8.922680412371134,1
Category_Wikipedia_sockpuppets_of_Vjardin2.csv,63,3828545.0,33,30,14,19,0,45.333333333333336,342,50,24.22222222222222,17
Category_Wikipedia_sockpuppets_of_Yenkangjushi.csv,18,10058093.0,14,4,11,3,0,36.888888888888886,159,7,7.0,7
Category_Wikipedia_sockpuppets_of_LokiiT.csv,3370,272209710.0,1046,2324,500,546,0,53.41839762611276,255,107,22.470029673590503,3
Category_Wikipedia_sockpuppets_of_Shrinivaskulkarni1388.csv,1377,52313292.0,546,831,500,46,0,39.286855482933916,269,64,16.67102396514161,5
Category_Wikipedia_sockpuppets_of_Savagebladez.csv,260,40325854.0,96,164,58,38,0,38.81923076923077,214,31,19.165384615384614,6
Category_Wikipedia_sockpuppets_of_ArmyBrat64.csv,137,9603304.0,60,77,43,17,0,70.06569343065694,259,50,23.291970802919707,12
Category_Wikipedia_sockpuppets_of_Richzog_Tri.csv,468,21315954.0,161,307,112,49,0,51.33119658119658,255,37,18.47222222222222,6
Category_Wikipedia_sockpuppets_of_Mohamad_Aliff_Shafiq_Azizan.csv,1258,17549483.0,419,839,181,238,0,33.11526232114468,255,57,20.93243243243243,3
Category_Wikipedia_sockpuppets_of_Arvintakshan.csv,2,0.0,1,1,1,0,0,0.0,0,14,14.0,14
Category_Wikipedia_sockpuppets_of_Ivan_Disouza.csv,1562,364703997.0,490,1072,249,241,0,39.74519846350832,243,64,18.346350832266324,3
Category_Wikipedia_sockpuppets_of_OxfordGeo.csv,299,109751261.0,122,177,81,41,0,42.020066889632105,245,55,18.49163879598662,6
Category_Wikipedia_sockpuppets_of_Thetroublewithmyname.csv,93,2934578.0,31,62,25,6,0,59.043010752688176,340,49,15.56989247311828,7
Category_Wikipedia_sockpuppets_of_Rajput334.csv,1007,155103409.0,323,684,323,0,0,56.15988083416087,255,39,14.265143992055611,5
Category_Wikipedia_sockpuppets_of_John_Mactsvish_838.csv,2046,32972663.0,565,1481,387,178,0,43.32453567937439,351,77,19.39345063538612,5
Category_Wikipedia_sockpuppets_of_Samat_lib.csv,924,207809987.0,521,403,500,21,0,40.01190476190476,500,96,39.01190476190476,5
Category_Wikipedia_sockpuppets_of_Sundaram7.csv,1237,113025930.0,472,765,296,176,0,41.69927243330638,234,76,23.316895715440584,3
Category_Wikipedia_sockpuppets_of_Memegoduno.csv,12,100564.0,9,3,6,3,0,26.25,167,9,9.0,9
Category_Wikipedia_sockpuppets_of_Quickelink123.csv,22,87800.0,15,7,9,6,11,69.72727272727273,194,26,17.59090909090909,13
Category_Wikipedia_sockpuppets_of_God's_Godzilla.csv,2297,36643762.0,541,1756,500,41,0,45.34784501523727,258,52,19.0387461906835,4
Category_Wikipedia_sockpuppets_of_CFredkin.csv,3415,102830704.0,1045,2370,500,545,0,56.15636896046852,255,101,18.483748169838947,6
Category_Wikipedia_sockpuppets_of_Bluegold.csv,1214,52676943.0,435,779,241,194,0,22.056836902800658,174,52,18.588962108731465,2
Category_Wikipedia_sockpuppets_of_SCPSLBFCPCFB.csv,1932,32474763.0,603,1329,341,262,0,51.90734989648033,494,80,27.935300207039337,6
Category_Wikipedia_sockpuppets_of_Amitbhb12.csv,1731,102993772.0,718,1013,500,218,0,31.362796071634893,265,41,16.32062391681109,4
Category_Wikipedia_sockpuppets_of_Guofenghao22.csv,365,75426986.0,106,259,78,28,0,50.824657534246576,363,50,24.71232876712329,5
Category_Wikipedia_sockpuppets_of_LehCatsTrebron.csv,82,5038618.0,30,52,29,1,0,38.353658536585364,170,68,26.79268292682927,9
Category_Wikipedia_sockpuppets_of_CAWRI-CISD`.csv,77,13549.0,37,40,26,11,0,42.76623376623377,240,78,31.428571428571427,4
Category_Wikipedia_sockpuppets_of_Daniel_vic.csv,374,15166879.0,134,240,76,58,0,41.90909090909091,295,41,15.334224598930481,4
Category_Wikipedia_sockpuppets_of_Ceredigion.csv,29,65950.0,9,20,7,2,0,43.241379310344826,154,33,23.413793103448278,15
Category_Wikipedia_sockpuppets_of_Visitor876.csv,73,13499.0,31,42,24,7,0,41.93150684931507,115,40,24.876712328767123,13
Category_Wikipedia_sockpuppets_of_Putinstalin.csv,400,4035661.0,136,264,113,23,0,33.645,288,47,16.575,4
Category_Wikipedia_sockpuppets_of_Catrgud.csv,8,3371.0,4,4,4,0,0,76.875,203,18,16.0,10
Category_Wikipedia_sockpuppets_of_Nivoc_Alley.csv,3121,20034960.0,846,2275,304,542,0,42.2495994873438,493,95,18.508170458186477,3
Category_Wikipedia_sockpuppets_of_Yashodhan_Ganu.csv,1758,19039092.0,555,1203,500,55,0,25.973833902161548,300,44,25.445961319681455,5
Category_Wikipedia_sockpuppets_of_Sharmavo.csv,9,340895.0,4,5,4,0,28,84.77777777777777,205,17,10.333333333333334,5
Category_Wikipedia_sockpuppets_of_PMK2000.csv,428,255711931.0,150,278,134,16,0,56.66588785046729,366,74,22.71728971962617,7
Category_Wikipedia_sockpuppets_of_AkoAyMayLobo.csv,1741,2643936.0,589,1152,500,89,0,34.32797242963814,255,62,15.934520390580126,3
Category_Wikipedia_sockpuppets_of_Mohamedabdell.csv,1,0.0,1,0,1,0,0,0.0,0,26,26.0,26
Category_Wikipedia_sockpuppets_of_Alwaysrightman.csv,313,27602736.0,103,210,62,41,0,48.30670926517572,324,47,16.15335463258786,3
Category_Wikipedia_sockpuppets_of_Arjunkrishna90.csv,1997,43946736.0,671,1326,500,171,0,59.42113169754632,255,38,10.751126690035052,4
Category_Wikipedia_sockpuppets_of_Monopolydealfan.csv,27,6219246.0,20,7,8,12,0,80.77777777777777,241,13,13.0,13
Category_Wikipedia_sockpuppets_of_Samrat_Singh_Jaunpur.csv,431,92147686.0,146,285,133,13,0,38.08120649651972,249,38,19.56844547563805,9
Category_Wikipedia_sockpuppets_of_Fayssaloss.csv,117,3365913.0,31,86,15,16,0,52.52991452991453,203,30,18.965811965811966,9
Category_Wikipedia_sockpuppets_of_LaMoustacho98.csv,34,91834.0,10,24,6,4,0,62.794117647058826,240,24,15.852941176470589,10
Category_Wikipedia_sockpuppets_of_Saqiboberoi.csv,545,6541752.0,155,390,152,3,0,56.987155963302754,255,40,17.196330275229357,6
Category_Wikipedia_sockpuppets_of_Yongbyong38.csv,1014,416518269.0,238,776,209,29,0,57.61341222879685,335,70,24.26923076923077,4
Category_Wikipedia_sockpuppets_of_Heyday_to_you.csv,1384,6433677.0,429,955,403,26,0,40.75722543352601,500,57,19.577312138728324,4
Category_Wikipedia_sockpuppets_of_AdamCHarlow.csv,1330,1395515.0,397,933,79,318,0,50.266917293233085,255,65,15.661654135338345,4
Category_Wikipedia_sockpuppets_of_Memento2149.csv,33,13880223.0,9,24,7,2,0,62.84848484848485,255,30,20.424242424242426,18
Category_Wikipedia_sockpuppets_of_Adbob.csv,24,3016207.0,22,2,8,14,0,15.666666666666666,157,15,15.0,15
Category_Wikipedia_sockpuppets_of_Shrian.csv,258,8499096.0,89,169,84,5,0,48.348837209302324,255,75,22.585271317829456,2
Category_Wikipedia_sockpuppets_of_JTDG2005.csv,2101,17722857.0,593,1508,500,93,0,40.62684435982865,469,55,19.334602570204666,4
Category_Wikipedia_sockpuppets_of_Digital_NEEBank.csv,6,485.0,3,3,3,0,0,68.5,135,22,21.333333333333332,21
Category_Wikipedia_sockpuppets_of_Amongusches.csv,54,17428361.0,22,32,5,17,0,58.592592592592595,495,21,17.22222222222222,10
Category_Wikipedia_sockpuppets_of_A_young_communist.csv,1121,35721448.0,331,790,256,75,0,46.250669045495094,249,65,21.229259589652095,4
Category_Wikipedia_sockpuppets_of_Freedom5000.csv,805,8507100.0,349,456,74,275,0,59.61490683229814,248,45,20.86335403726708,3
Category_Wikipedia_sockpuppets_of_Yossimgim.csv,3212,56554131.0,846,2366,500,346,0,51.64103362391034,255,50,18.13667496886675,3
Category_Wikipedia_sockpuppets_of_Ch.AhmedRaza23.csv,387,15171136.0,116,271,105,11,0,55.62532299741602,483,60,17.242894056847547,4
Category_Wikipedia_sockpuppets_of_Rajaduraiviamla.csv,28,3254619.0,9,19,5,4,0,55.0,196,51,29.142857142857142,13
Category_Wikipedia_sockpuppets_of_Mikequfv.csv,558,8457749.0,180,378,157,23,0,44.77956989247312,254,38,12.768817204301076,4
Category_Wikipedia_sockpuppets_of_Tony_Senatore.csv,827,30756965.0,500,327,500,0,0,25.305925030229748,179,45,24.544135429262393,9
Category_Wikipedia_sockpuppets_of_Witzeman.csv,8,1399.0,6,2,6,0,0,9.875,76,18,18.0,18
Category_Wikipedia_sockpuppets_of_MLSSoccerPlayer13.csv,128,19008765.0,42,86,22,20,0,51.359375,494,29,17.796875,10
Category_Wikipedia_sockpuppets_of_Evangp.csv,1851,429343957.0,633,1218,500,133,0,44.22312263641275,495,70,21.04159913560238,4
Category_Wikipedia_sockpuppets_of_Frozenfool.csv,197,43273670.0,55,142,44,11,0,51.934010152284266,219,34,13.741116751269036,5
Category_Wikipedia_sockpuppets_of_Polar123bin.csv,34,535159.0,10,24,6,4,0,69.20588235294117,203,50,35.26470588235294,27
Category_Wikipedia_sockpuppets_of_SPIKE_SPIKE_BAD.csv,2680,6841192.0,852,1828,500,352,0,63.35597014925373,255,57,23.73992537313433,3
Category_Wikipedia_sockpuppets_of_Hellosmarty.csv,93,6188699.0,28,65,17,11,0,46.935483870967744,236,53,21.021505376344088,7
Category_Wikipedia_sockpuppets_of_Pinakinvaghela.csv,72,38175992.0,23,49,18,5,0,58.90277777777778,231,26,14.38888888888889,3
Category_Wikipedia_sockpuppets_of_Giteshs78.csv,314,61058556.0,85,229,67,18,0,41.9140127388535,237,53,22.130573248407643,8
Category_Wikipedia_sockpuppets_of_Amack17.csv,118,9405436.0,33,85,27,6,0,57.38135593220339,226,24,16.576271186440678,9
Category_Wikipedia_sockpuppets_of_Nedgreiner.csv,2067,22446305.0,838,1229,500,338,0,42.79196903725206,246,59,18.57861635220126,3
Category_Wikipedia_sockpuppets_of_Roxtiger.csv,9,276739.0,7,2,2,5,23,125.88888888888889,196,29,15.777777777777779,11
Category_Wikipedia_sockpuppets_of_BonTheFox13.csv,276,240035977.0,74,202,31,43,0,48.46376811594203,255,40,18.884057971014492,9
Category_Wikipedia_sockpuppets_of_Slotmachiner.csv,209,27367492.0,64,145,55,9,0,52.239234449760765,238,59,21.559808612440193,10
Category_Wikipedia_sockpuppets_of_Fornevermore.csv,365,57199418.0,76,289,49,27,0,46.52054794520548,227,54,18.046575342465754,4
Category_Wikipedia_sockpuppets_of_Iamwikiwiki2023.csv,22,1898254.0,10,12,5,5,0,33.95454545454545,155,32,19.045454545454547,6
Category_Wikipedia_sockpuppets_of_Tip_Ipp_Ipp.csv,137,53415283.0,28,109,15,13,0,55.81021897810219,205,29,15.474452554744525,1
Category_Wikipedia_sockpuppets_of_Encyclopediast.csv,60,30434.0,29,31,18,11,0,50.95,172,39,37.38333333333333,24
Category_Wikipedia_sockpuppets_of_NCarbo.csv,122,10221566.0,109,13,105,4,0,22.434426229508198,132,22,20.901639344262296,10
Category_Wikipedia_sockpuppets_of_shahine.csv,32,416688.0,17,15,17,0,11,46.6875,174,33,23.0,7
Category_Wikipedia_sockpuppets_of_Canadian_Cup.csv,99,1072442.0,37,62,24,13,0,27.747474747474747,208,29,16.09090909090909,4
Category_Wikipedia_sockpuppets_of_Jchyon.csv,15,87738.0,10,5,5,5,0,29.733333333333334,196,37,29.0,13
Category_Wikipedia_sockpuppets_of_Consort-Plus.csv,362,16390599.0,131,231,121,10,0,49.447513812154696,335,49,20.248618784530386,8
Category_Wikipedia_sockpuppets_of_Dromaeosaur_Dude.csv,4572,33380411.0,1695,2877,500,1195,0,39.70866141732284,255,76,18.69685039370079,3
Category_Wikipedia_sockpuppets_of_RedHughs.csv,80,97768951.0,16,64,15,1,0,37.65,200,32,21.7,4
Category_Wikipedia_sockpuppets_of_John574.csv,1207,321473678.0,351,856,37,314,0,49.50041425020712,234,52,15.67522783761392,4
Category_Wikipedia_sockpuppets_of_Stralia_Mate.csv,105,604001.0,35,70,17,18,0,50.838095238095235,233,40,24.142857142857142,12
Category_Wikipedia_sockpuppets_of_Amin_mehraien.csv,261,10797396.0,118,143,36,82,0,36.24521072796935,499,49,20.038314176245212,10
Category_Wikipedia_sockpuppets_of_Jack90s15.csv,10848,112664844.0,3006,7842,500,2506,0,67.84365781710915,500,180,22.72603244837758,3
Category_Wikipedia_sockpuppets_of_Leemeister3.csv,3,911.0,3,0,3,0,17,35.666666666666664,45,6,6.0,6
Category_Wikipedia_sockpuppets_of_Naseeb2468.csv,1576,78343702.0,474,1102,147,327,0,60.23540609137056,500,47,13.938451776649746,2
Category_Wikipedia_sockpuppets_of_Dingdongdingdong123.csv,16,2250185.0,15,1,9,6,0,24.6875,46,46,32.625,23
Category_Wikipedia_sockpuppets_of_BoogaLouie.csv,41,79492.0,13,28,13,0,0,42.21951219512195,192,39,15.878048780487806,9
Category_Wikipedia_sockpuppets_of_Peterwoodwilson.csv,150,1401272.0,41,109,34,7,0,55.2,255,51,19.42,4
Category_Wikipedia_sockpuppets_of_Zarbon.csv,3756,417180741.0,1126,2630,500,626,0,40.23695420660277,325,57,19.787539936102238,3
Category_Wikipedia_sockpuppets_of_Commedian_news.csv,100,4056976.0,49,51,14,35,0,30.66,207,55,33.99,15
Category_Wikipedia_sockpuppets_of_Chatarpatar2020.csv,2675,38848095.0,1140,1535,500,640,0,40.038878504672894,475,72,21.896448598130842,6
Category_Wikipedia_sockpuppets_of_Alexdoherty2.csv,60,1100749.0,47,13,47,0,0,26.616666666666667,292,22,21.25,11
Category_Wikipedia_sockpuppets_of_Salebot12.csv,550,10595884.0,166,384,54,112,0,80.00545454545454,500,40,16.616363636363637,5
Category_Wikipedia_sockpuppets_of_CharlySimps.csv,12097,33601236.0,3074,9023,218,2856,0,51.80350500123998,496,74,16.578077209225427,3
Category_Wikipedia_sockpuppets_of_Leibnizcreation.csv,22,543058.0,5,17,4,1,0,49.36363636363637,185,53,31.318181818181817,20
Category_Wikipedia_sockpuppets_of_YDNW_Dive.csv,14,14535335.0,4,10,4,0,0,45.5,146,19,10.571428571428571,5
Category_Wikipedia_sockpuppets_of_Chinmay_Patel_SPCE.csv,18,3620158.0,8,10,2,6,0,87.77777777777777,196,30,28.27777777777778,19
Category_Wikipedia_sockpuppets_of_Gecoprakla.csv,427,99622639.0,179,248,90,89,0,47.1615925058548,218,26,15.721311475409836,11
Category_Wikipedia_sockpuppets_of_Noel_Jarloc.csv,380,28912565.0,181,199,179,2,0,41.59473684210526,282,31,23.46315789473684,16
Category_Wikipedia_sockpuppets_of_Abdullahsheikh03.csv,114,19988727.0,38,76,24,14,0,25.80701754385965,218,26,14.973684210526315,5
Category_Wikipedia_sockpuppets_of_Wpoel.csv,80,24877374.0,24,56,12,12,0,47.575,227,24,12.175,3
Category_Wikipedia_sockpuppets_of_Harinder0923.csv,44,403637.0,20,24,18,2,0,35.84090909090909,221,20,13.409090909090908,8
Category_Wikipedia_sockpuppets_of_Ryanjay1996.csv,4986,153267156.0,1466,3520,241,1225,0,37.591255515443244,258,56,13.195146409947855,3
Category_Wikipedia_sockpuppets_of_RazorThick.csv,724,26295808.0,252,472,119,133,0,48.488950276243095,496,47,22.535911602209946,9
Category_Wikipedia_sockpuppets_of_Chongkina.csv,143,50348533.0,46,97,42,4,0,27.797202797202797,204,11,10.538461538461538,8
Category_Wikipedia_sockpuppets_of_Raju_Adhikari.csv,10,10070792.0,2,8,2,0,0,67.1,192,39,27.4,10
Category_Wikipedia_sockpuppets_of_Marcobadotti.csv,1614,113734557.0,608,1006,500,108,0,48.092317224287484,250,58,12.968401486988848,5
Category_Wikipedia_sockpuppets_of_YouCanDoBetter.csv,3744,50545298.0,1000,2744,500,500,0,52.602029914529915,482,148,19.805555555555557,5
Category_Wikipedia_sockpuppets_of_Gericochea.csv,29,222490032.0,7,22,4,3,0,56.6551724137931,195,61,21.275862068965516,13
Category_Wikipedia_sockpuppets_of_DanielLerish.csv,1061,103018967.0,272,789,247,25,0,63.0,500,55,17.575871819038642,5
Category_Wikipedia_sockpuppets_of_Mactabbed.csv,6962,77250892.0,1420,5542,500,920,0,35.710140764148235,248,79,19.41424877908647,3
Category_Wikipedia_sockpuppets_of_Voice_Of_Myself.csv,8,116.0,3,5,3,0,0,31.625,110,48,26.375,11
Category_Wikipedia_sockpuppets_of_DanaTodd.csv,190,44027267.0,61,129,15,46,0,55.49473684210526,250,41,18.094736842105263,8
Category_Wikipedia_sockpuppets_of_Sweetleafjackcaitlyn.csv,57,2748834.0,24,33,18,6,0,40.96491228070175,255,56,22.36842105263158,7
Category_Wikipedia_sockpuppets_of_KevinThomas71293.csv,892,34134539.0,330,562,268,62,0,40.11883408071749,500,50,17.02578475336323,4
Category_Wikipedia_sockpuppets_of_Kevt2002.csv,2026,278630341.0,561,1465,483,78,0,50.13030602171767,500,54,17.438302073050345,4
Category_Wikipedia_sockpuppets_of_Yunongdog.csv,322,669035.0,102,220,6,96,0,47.5527950310559,395,72,19.925465838509318,4
Category_Wikipedia_sockpuppets_of_LiberalViews.csv,774,31642478.0,175,599,175,0,0,47.83204134366925,199,46,15.581395348837209,4
Category_Wikipedia_sockpuppets_of_Catsmeow8989.csv,667,17851892.0,278,389,264,14,0,47.7856071964018,255,47,27.503748125937033,12
Category_Wikipedia_sockpuppets_of_POSTED.csv,26,4370.0,14,12,6,8,0,58.84615384615385,248,33,30.923076923076923,6
Category_Wikipedia_sockpuppets_of_Ren_Yifan.csv,732,12431053.0,188,544,73,115,0,34.69945355191257,251,61,34.9603825136612,4
Category_Wikipedia_sockpuppets_of_SensualIntracourse.csv,60,4679550.0,27,33,12,15,0,54.15,227,62,18.15,9
Category_Wikipedia_sockpuppets_of_ReptonSchoolDubai.csv,18,3035400.0,15,3,9,6,0,24.444444444444443,140,19,19.0,19
Category_Wikipedia_sockpuppets_of_Kyeongju09.csv,139,7594358.0,61,78,41,20,0,44.597122302158276,376,37,16.345323741007196,8
Category_Wikipedia_sockpuppets_of_Jasminedavis6.csv,1,0.0,1,0,1,0,66,66.0,66,19,19.0,19
Category_Wikipedia_sockpuppets_of_Houcks_Balloon.csv,8,9135.0,4,4,2,2,10,43.625,116,29,16.5,13
Category_Wikipedia_sockpuppets_of_Asdaa.csv,27,977092.0,19,8,19,0,0,36.22222222222222,192,28,18.037037037037038,12
Category_Wikipedia_sockpuppets_of_Slbc143.csv,164,35645313.0,53,111,45,8,0,44.18292682926829,232,64,20.713414634146343,7
Category_Wikipedia_sockpuppets_of_KVDP.csv,575,20765433.0,164,411,115,49,0,52.61739130434783,254,81,20.038260869565217,3
Category_Wikipedia_sockpuppets_of_Le_Grand_Roi_des_Citrouilles.csv,331,48373144.0,102,229,70,32,0,45.67371601208459,214,94,22.882175226586103,5
Category_Wikipedia_sockpuppets_of_UraBigot.csv,6,763508.0,3,3,2,1,24,111.0,216,15,14.0,13
Category_Wikipedia_sockpuppets_of_Powerprowess.csv,333,740841.0,126,207,105,21,0,36.408408408408405,220,27,9.162162162162161,4
Category_Wikipedia_sockpuppets_of_RealMadridCF2012.csv,331,126297307.0,97,234,28,69,0,38.30211480362538,235,54,24.76737160120846,7
Category_Wikipedia_sockpuppets_of_Sriramachandran_V..csv,126,14012158.0,38,88,21,17,0,63.65079365079365,226,58,18.515873015873016,7
Category_Wikipedia_sockpuppets_of_Colton997.csv,53,82072.0,23,30,7,16,0,54.905660377358494,161,23,14.433962264150944,7
Category_Wikipedia_sockpuppets_of_Terma_wiki_searcher.csv,4,244.0,3,1,3,0,18,18.0,18,27,27.0,27
Category_Wikipedia_sockpuppets_of_Chunghaukim.csv,29,195118.0,21,8,20,1,0,45.3448275862069,196,21,11.379310344827585,8
Category_Wikipedia_sockpuppets_of_Ronron101010.csv,6012,71561331.0,2328,3684,500,1828,0,31.629075182967398,250,65,19.067198935462407,3
Category_Wikipedia_sockpuppets_of_Wp_projectq.csv,16,1742024.0,6,10,4,2,7,61.4375,204,53,25.625,2
Category_Wikipedia_sockpuppets_of_Keshave.csv,8,8172.0,6,2,6,0,0,22.125,99,9,9.0,9
Category_Wikipedia_sockpuppets_of_Alex_Neman.csv,3103,172325587.0,857,2246,500,357,0,43.51724137931034,476,51,14.753786658072833,3
Category_Wikipedia_sockpuppets_of_Zvfibkoj.csv,113,925867.0,40,73,29,11,0,39.97345132743363,188,28,23.849557522123895,12
Category_Wikipedia_sockpuppets_of_Ane_wiki.csv,2520,137849726.0,665,1855,321,344,0,47.06825396825397,260,57,18.779761904761905,4
Category_Wikipedia_sockpuppets_of_Pchl2334.csv,29,346541.0,15,14,15,0,0,33.206896551724135,150,42,24.586206896551722,9
Category_Wikipedia_sockpuppets_of_Jonahmusiclover.csv,7,25244.0,5,2,3,2,0,76.42857142857143,196,26,17.428571428571427,14
Category_Wikipedia_sockpuppets_of_Lt._Col._Cole.csv,1351,8035249.0,467,884,431,36,0,27.055514433752776,266,40,13.827535159141377,3
Category_Wikipedia_sockpuppets_of_Adanna72.csv,58,34290858.0,28,30,26,2,0,29.120689655172413,111,42,33.01724137931034,17
Category_Wikipedia_sockpuppets_of_Kaushals_Kross.csv,27,166520.0,12,15,9,3,0,34.96296296296296,196,41,29.74074074074074,19
Category_Wikipedia_sockpuppets_of_Deezcutsnut.csv,99,432469.0,33,66,9,24,0,70.9090909090909,184,41,16.646464646464647,6
Category_Wikipedia_sockpuppets_of_Rohanmalode21.csv,19,13749619.0,15,4,15,0,0,41.421052631578945,196,18,14.210526315789474,14
Category_Wikipedia_sockpuppets_of_Adnankhan1738.csv,93,28852642.0,34,59,30,4,0,34.043010752688176,221,26,15.096774193548388,2
Category_Wikipedia_sockpuppets_of_Eihtesham.csv,89,989827.0,44,45,41,3,0,57.51685393258427,327,29,17.84269662921348,13
Category_Wikipedia_sockpuppets_of_Notanotheridiot.csv,231,441292642.0,49,182,38,11,0,48.67099567099567,322,54,16.4025974025974,3
Category_Wikipedia_sockpuppets_of_Tayo_the_little_bus.csv,48,17446953.0,14,34,9,5,0,49.958333333333336,218,19,15.541666666666666,6
Category_Wikipedia_sockpuppets_of_Ortho-One.csv,3,1057.0,2,1,2,0,30,140.0,195,28,24.666666666666668,23
Category_Wikipedia_sockpuppets_of_Rukn950.csv,1599,449726722.0,525,1074,500,25,0,52.68042526579112,495,63,24.516572858036273,4
Category_Wikipedia_sockpuppets_of_LenaZet.csv,7,666088.0,3,4,3,0,2,32.42857142857143,71,51,46.42857142857143,43
Category_Wikipedia_sockpuppets_of_Hamitdmr.csv,130,3445041.0,48,82,25,23,0,54.42307692307692,245,28,16.607692307692307,6
Category_Wikipedia_sockpuppets_of_Csukys7.csv,12,37828.0,8,4,5,3,0,41.416666666666664,221,32,28.0,24
Category_Wikipedia_sockpuppets_of_O-TOWN'S_AT.csv,674,25749271.0,251,423,185,66,0,28.764094955489615,199,56,22.5919881305638,9
Category_Wikipedia_sockpuppets_of_Light_current.csv,7270,143052643.0,2025,5245,500,1525,0,42.83466299862448,250,68,24.004814305364512,3
Category_Wikipedia_sockpuppets_of_Rinda_Fergiawan.csv,3818,94294587.0,1438,2380,500,938,0,32.460450497642746,496,68,20.05893137768465,5
Category_Wikipedia_sockpuppets_of_AsianEuro_Cungball.csv,647,113876253.0,214,433,178,36,0,31.74497681607419,496,70,26.612055641421946,10
Category_Wikipedia_sockpuppets_of_Every875.csv,2103,204866294.0,505,1598,500,5,0,53.823585354255826,497,62,17.92677127912506,3
Category_Wikipedia_sockpuppets_of_LawrenceGavin.csv,5,850514.0,4,1,1,3,63,169.2,196,24,21.4,20
Category_Wikipedia_sockpuppets_of_Adhithya_Kiran_Chekavar.csv,1424,161199191.0,439,985,252,187,0,52.06039325842696,500,46,14.768960674157304,4
Category_Wikipedia_sockpuppets_of_Sbsashar.csv,39,17234279.0,12,27,9,3,0,45.69230769230769,193,38,17.82051282051282,9
Category_Wikipedia_sockpuppets_of_Italianlover07.csv,8251,326111787.0,1935,6316,500,1435,0,45.00969579444916,259,50,14.573991031390134,4
Category_Wikipedia_sockpuppets_of_Ambili123.csv,1796,109105696.0,762,1034,500,262,0,62.57628062360802,288,80,23.001670378619153,5
Category_Wikipedia_sockpuppets_of_Wawi_khanaqin.csv,90,109136070.0,31,59,10,21,0,49.4,306,50,22.822222222222223,7
Category_Wikipedia_sockpuppets_of_Gol_Misra_Elementalist.csv,969,3507022.0,502,467,500,2,0,33.92156862745098,241,61,25.79669762641899,7
Category_Wikipedia_sockpuppets_of_Hatharchoudhary.csv,291,3566182.0,86,205,54,32,0,57.553264604811,406,24,14.683848797250858,6
Category_Wikipedia_sockpuppets_of_2019AlwaysLit.csv,5545,91618277.0,1528,4017,500,1028,0,44.68999098286745,496,54,17.4297565374211,4
Category_Wikipedia_sockpuppets_of_Aircrafts_and_motorboats.csv,49,3680905.0,22,27,17,5,0,63.775510204081634,240,36,21.489795918367346,8
Category_Wikipedia_sockpuppets_of_Mushroomexpertboy.csv,150,5871865.0,56,94,43,13,0,45.64,240,27,15.6,7
Category_Wikipedia_sockpuppets_of_Drabsi_Jimmy.csv,29,8095406.0,18,11,12,6,0,41.827586206896555,124,25,18.82758620689655,14
Category_Wikipedia_sockpuppets_of_Mollymaybach.csv,24,71185852.0,7,17,6,1,0,59.0,177,44,14.708333333333334,7
Category_Wikipedia_sockpuppets_of_Noggyjoggy.csv,239,20054131.0,62,177,38,24,0,48.94142259414226,259,41,21.16317991631799,7
Category_Wikipedia_sockpuppets_of_Pszczolka_Maja1.csv,894,41889062.0,359,535,103,256,0,42.3903803131991,255,51,18.589485458612977,2
Category_Wikipedia_sockpuppets_of_Lincesspreia.csv,140,4888200.0,36,104,20,16,0,44.75714285714286,198,47,18.885714285714286,9
Category_Wikipedia_sockpuppets_of_Thompsonmark907.csv,45,2412385.0,40,5,26,14,0,54.48888888888889,245,33,33.0,33
Category_Wikipedia_sockpuppets_of_V√©rit√©_certifi√©.csv,52,9321431.0,23,29,21,2,0,49.09615384615385,200,25,17.46153846153846,14
Category_Wikipedia_sockpuppets_of_Suburb_77.csv,1794,459548212.0,488,1306,352,136,0,48.948160535117054,460,47,16.334448160535118,4
Category_Wikipedia_sockpuppets_of_DannyEffy.csv,668,28496814.0,191,477,160,31,0,57.85778443113772,255,73,24.273952095808383,9
Category_Wikipedia_sockpuppets_of_Toppeloppe.csv,7,1133.0,5,2,4,1,14,59.857142857142854,191,16,16.0,16
Category_Wikipedia_sockpuppets_of_Jetwave_Dave.csv,5765,38508221.0,2170,3595,500,1670,0,30.038334778837815,217,109,16.199826539462272,2
Category_Wikipedia_sockpuppets_of_ChoonkaOrg.csv,1,0.0,1,0,1,0,56,56.0,56,21,21.0,21
Category_Wikipedia_sockpuppets_of_Beanieshark05.csv,341,16234703.0,106,235,39,67,0,41.71554252199414,269,50,20.472140762463344,6
Category_Wikipedia_sockpuppets_of_Idowbiggin.csv,4,1652931.0,2,2,2,0,0,75.75,169,13,13.0,13
Category_Wikipedia_sockpuppets_of_Hemeda83.csv,51,85024943.0,36,15,35,1,0,27.529411764705884,131,12,12.0,12
Category_Wikipedia_sockpuppets_of_Bhuvanhungund.csv,1033,41104414.0,418,615,85,333,0,48.502420135527586,496,60,17.95353339787028,5
Category_Wikipedia_sockpuppets_of_Aanand_mehta.csv,1700,28363316.0,565,1135,500,65,0,43.805882352941175,460,59,19.442941176470587,4
Category_Wikipedia_sockpuppets_of_Adshead123.csv,3185,97169616.0,733,2452,136,597,0,51.73814756671899,500,47,14.733437990580848,3
Category_Wikipedia_sockpuppets_of_WBJB03.csv,2047,40130550.0,740,1307,465,275,0,38.72349780166097,253,60,19.953102100635075,4
Category_Wikipedia_sockpuppets_of_Bischof-Ralph.csv,367,2285838.0,162,205,103,59,0,29.095367847411445,199,53,25.997275204359674,12
Category_Wikipedia_sockpuppets_of_Battlaxe.csv,3,2611.0,2,1,2,0,28,71.0,101,27,21.0,18
Category_Wikipedia_sockpuppets_of_IvanDC14.csv,61,5773587.0,23,38,19,4,0,36.9344262295082,236,16,12.311475409836065,5
Category_Wikipedia_sockpuppets_of_Rawtunejr.csv,6,170761.0,2,4,2,0,0,11.0,22,16,15.0,14
Category_Wikipedia_sockpuppets_of_Bennydadawg.csv,23,150435.0,12,11,6,6,0,45.26086956521739,148,19,12.956521739130435,10
Category_Wikipedia_sockpuppets_of_Chanels4ever.csv,1056,32746162.0,431,625,428,3,0,32.1875,242,50,33.28030303030303,14
Category_Wikipedia_sockpuppets_of_CSTFTW.csv,200,45959914.0,61,139,31,30,0,56.975,251,27,15.625,5
Category_Wikipedia_sockpuppets_of_Djheckes.csv,21,49310.0,20,1,20,0,0,13.857142857142858,50,11,11.0,11
Category_Wikipedia_sockpuppets_of_robertjkoenig.csv,665,247404507.0,197,468,101,96,0,44.123308270676695,255,37,13.70375939849624,4
Category_Wikipedia_sockpuppets_of_Dr_-_YASER_J._K._ALSAIDI.csv,19,97178.0,9,10,5,4,0,61.94736842105263,246,34,23.105263157894736,13
Category_Wikipedia_sockpuppets_of_Bringbackthetylers.csv,491,33079511.0,109,382,70,39,0,43.22199592668024,222,42,19.024439918533606,8
Category_Wikipedia_sockpuppets_of_Liuben.csv,167,54340701.0,58,109,43,15,0,55.191616766467064,212,51,14.251497005988025,4
Category_Wikipedia_sockpuppets_of_Shevakumaran.csv,156,6118154.0,46,110,42,4,0,61.1474358974359,243,22,12.916666666666666,6
Category_Wikipedia_sockpuppets_of_Mar400r.csv,5653,33828060.0,1878,3775,307,1571,0,46.41960021227667,426,68,18.90235273306209,3
Category_Wikipedia_sockpuppets_of_Shovansundar_Bosu.csv,3,613.0,2,1,2,0,28,140.0,196,22,22.0,22
Category_Wikipedia_sockpuppets_of_Theharrywang.csv,7,282.0,4,3,4,0,0,42.285714285714285,145,30,30.0,30
Category_Wikipedia_sockpuppets_of_Yungkash3x.csv,59,1523009.0,40,19,21,19,0,34.101694915254235,234,27,18.54237288135593,9
Category_Wikipedia_sockpuppets_of_KeithTheKing.csv,38,86071609.0,17,21,15,2,0,48.76315789473684,247,37,25.86842105263158,14
Category_Wikipedia_sockpuppets_of_NerdyGenius1.csv,1362,175242162.0,518,844,500,18,0,64.02129221732746,496,54,21.759911894273127,5
Category_Wikipedia_sockpuppets_of_Scidiagnose.csv,33,213931.0,14,19,7,7,0,109.54545454545455,500,38,16.09090909090909,3
Category_Wikipedia_sockpuppets_of_Manu3693.csv,105,78205495.0,28,77,18,10,0,38.82857142857143,183,27,13.209523809523809,6
Category_Wikipedia_sockpuppets_of_Crovata.csv,2010,14018640.0,732,1278,500,232,0,50.017910447761196,259,50,18.86417910447761,3
Category_Wikipedia_sockpuppets_of_Belginusanl.csv,1570,60231988.0,314,1256,233,81,0,36.68343949044586,214,65,14.363057324840764,3
Category_Wikipedia_sockpuppets_of_Storyrates1987.csv,503,4662153.0,198,305,43,155,0,47.013916500994036,211,84,32.49304174950298,7
Category_Wikipedia_sockpuppets_of_Hotndead.csv,851,15053837.0,227,624,189,38,0,45.68037602820211,258,71,19.17038777908343,3
Category_Wikipedia_sockpuppets_of_CAYA.csv,587,15578114.0,159,428,152,7,0,23.574105621805792,171,29,13.09710391822828,4
Category_Wikipedia_sockpuppets_of_R.C.Velu.csv,4,17.0,2,2,2,0,0,7.0,14,32,32.0,32
Category_Wikipedia_sockpuppets_of_EIC.csv,185,26424821.0,95,90,80,15,0,33.2972972972973,199,81,27.2972972972973,12
Category_Wikipedia_sockpuppets_of_RolandSupreme.csv,583,9941873.0,159,424,116,43,0,43.56260720411664,255,50,26.46483704974271,9
Category_Wikipedia_sockpuppets_of_Bryan4562013.csv,2705,67635886.0,1000,1705,500,500,0,29.75083179297597,438,51,16.486506469500924,6
Category_Wikipedia_sockpuppets_of_YungSilver.csv,2272,25330077.0,687,1585,500,187,0,29.073063380281692,242,45,17.279049295774648,4
Category_Wikipedia_sockpuppets_of_USAthegreatest.csv,199,450411.0,86,113,51,35,0,49.90954773869347,255,47,22.718592964824122,3
Category_Wikipedia_sockpuppets_of_Itsagreatviewfromlevel42.csv,8,1563873.0,4,4,3,1,0,79.875,466,23,23.0,23
Category_Wikipedia_sockpuppets_of_Ikristin.csv,132,6622689.0,31,101,9,22,0,44.196969696969695,230,29,15.56060606060606,10
Category_Wikipedia_sockpuppets_of_123Aristotle.csv,6051,159583592.0,2510,3541,500,2010,0,36.07668154024128,500,66,19.31829449677739,2
Category_Wikipedia_sockpuppets_of_TheEmeraldMiner1.csv,377,70933313.0,95,282,67,28,0,51.10875331564987,311,46,18.045092838196286,4
Category_Wikipedia_sockpuppets_of_MMFan.csv,58,3485275.0,22,36,14,8,0,30.017241379310345,140,19,11.137931034482758,11
Category_Wikipedia_sockpuppets_of_Thelittlegreenfrog.csv,355,235889391.0,120,235,118,2,0,52.36056338028169,346,83,25.107042253521126,6
Category_Wikipedia_sockpuppets_of_Theginaledonne.csv,1,0.0,1,0,1,0,0,0.0,0,18,18.0,18
Category_Wikipedia_sockpuppets_of_Miriammuros.csv,1,0.0,1,0,1,0,40,40.0,40,25,25.0,25
Category_Wikipedia_sockpuppets_of_Tautologist.csv,1264,33886191.0,573,691,500,73,0,39.48180379746835,250,79,20.363132911392405,7
Category_Wikipedia_sockpuppets_of_Poladmoscow.csv,199,5173107.0,103,96,23,80,0,42.41206030150754,249,44,17.201005025125628,6
Category_Wikipedia_sockpuppets_of_Wikie_Cat54.csv,524,15982035.0,148,376,83,65,0,42.9942748091603,343,41,16.62786259541985,5
Category_Wikipedia_sockpuppets_of_Sorginak.csv,200,13748570.0,83,117,49,34,0,45.94,333,63,30.095,13
Category_Wikipedia_sockpuppets_of_BrillLyle.csv,641,1592969.0,500,141,500,0,0,41.07488299531981,463,47,15.29641185647426,10
Category_Wikipedia_sockpuppets_of_Sandystraus.csv,182,3381468.0,59,123,33,26,0,33.7967032967033,198,78,32.27472527472528,4
Category_Wikipedia_sockpuppets_of_TomWatkins1970.csv,1428,161679418.0,518,910,74,444,0,66.33403361344538,637,50,18.72689075630252,3
Category_Wikipedia_sockpuppets_of_Willywill3x.csv,86,608641.0,27,59,27,0,0,32.03488372093023,194,65,23.976744186046513,16
Category_Wikipedia_sockpuppets_of_AXXXXK.csv,205,12980053.0,41,164,41,0,0,57.34146341463415,244,50,20.673170731707316,9
Category_Wikipedia_sockpuppets_of_Bingnewsquiz.csv,18,9081.0,8,10,3,5,0,71.33333333333333,160,41,16.833333333333332,9
Category_Wikipedia_sockpuppets_of_Rickquiroz.csv,12,108185.0,7,5,5,2,0,36.916666666666664,153,16,15.583333333333334,15
Category_Wikipedia_sockpuppets_of_Iloveartrock.csv,35,1570916.0,15,20,11,4,0,45.31428571428572,180,41,19.97142857142857,12
Category_Wikipedia_sockpuppets_of_Pooh_the_hat.csv,101,898194.0,36,65,36,0,0,34.62376237623762,153,54,21.792079207920793,12
Category_Wikipedia_sockpuppets_of_Arthur_Brum.csv,8581,160254497.0,2445,6136,500,1945,0,43.68255448082974,498,69,19.298566600629297,4
Category_Wikipedia_sockpuppets_of_Protot.csv,532,245526933.0,195,337,187,8,0,35.090225563909776,245,50,15.808270676691729,5
Category_Wikipedia_sockpuppets_of_Yadavjeetpal.csv,135,49232240.0,33,102,21,12,0,48.75555555555555,203,31,21.94814814814815,11
Category_Wikipedia_sockpuppets_of_LigonJudd.csv,3,409.0,3,0,3,0,0,174.66666666666666,496,22,22.0,22
Category_Wikipedia_sockpuppets_of_Ubman.csv,146,4221326.0,69,77,27,42,0,66.34931506849315,255,63,26.78767123287671,8
Category_Wikipedia_sockpuppets_of_Thyrien.csv,29,171231.0,20,9,13,7,0,40.275862068965516,124,32,17.896551724137932,12
Category_Wikipedia_sockpuppets_of_Daxriver920.csv,27,266741.0,9,18,5,4,0,62.7037037037037,217,30,22.51851851851852,15
Category_Wikipedia_sockpuppets_of_Jericho_Walls.csv,53,996262.0,27,26,7,20,0,45.339622641509436,254,49,11.81132075471698,4
Category_Wikipedia_sockpuppets_of_Ichek.csv,937,77184867.0,409,528,191,218,0,39.924226254002136,255,56,33.828175026680896,13
Category_Wikipedia_sockpuppets_of_Beyonceringthealarm.csv,2849,16849222.0,940,1909,401,539,0,19.823797823797825,199,55,22.664794664794666,5
Category_Wikipedia_sockpuppets_of_Ric275.csv,390,295960373.0,93,297,89,4,0,54.04871794871795,289,59,17.78974358974359,7
Category_Wikipedia_sockpuppets_of_Royalbankuk.csv,10,181307.0,8,2,4,4,26,69.1,142,35,35.0,35
Category_Wikipedia_sockpuppets_of_PixtonRran.csv,2590,25938833.0,1000,1590,500,500,0,35.65907335907336,495,61,24.16988416988417,5
Category_Wikipedia_sockpuppets_of_TheogThotPatrol.csv,11,331121.0,6,5,3,3,0,22.727272727272727,61,25,23.181818181818183,20
Category_Wikipedia_sockpuppets_of_Pristine_Light.csv,71,1597992.0,41,30,29,12,0,31.464788732394368,196,32,13.95774647887324,7
Category_Wikipedia_sockpuppets_of_Godzilla719701.csv,55,97764.0,19,36,19,0,0,47.56363636363636,178,35,12.654545454545454,3
Category_Wikipedia_sockpuppets_of_LudoVicar.csv,1373,149809088.0,381,992,111,270,0,45.60160233066278,254,51,14.778587035688274,4
Category_Wikipedia_sockpuppets_of_LeoRussoLeo.csv,63,7671894.0,26,37,23,3,0,80.57142857142857,267,47,20.682539682539684,8
Category_Wikipedia_sockpuppets_of_Western_Sushi.csv,290,2868357.0,60,230,14,46,0,56.220689655172414,495,31,15.303448275862069,3
Category_Wikipedia_sockpuppets_of_Samlaptop85213.csv,2458,426706866.0,772,1686,276,496,0,53.20992676973149,342,67,16.07160292921074,2
Category_Wikipedia_sockpuppets_of_Shaquezedrayton.csv,808,6090619.0,282,526,209,73,0,37.78712871287129,478,39,17.48267326732673,3
Category_Wikipedia_sockpuppets_of_Zanhigirl.csv,659,23648255.0,385,274,385,0,0,27.82701062215478,475,39,15.54628224582701,5
Category_Wikipedia_sockpuppets_of_Laura210.csv,14,467265.0,9,5,8,1,0,23.642857142857142,134,17,14.5,14
Category_Wikipedia_sockpuppets_of_Paknur.csv,3498,40072521.0,1003,2495,500,503,0,30.019725557461406,250,62,15.044025157232705,3
Category_Wikipedia_sockpuppets_of_Abhikhurana.csv,784,42668038.0,570,214,277,293,0,26.286989795918366,255,59,18.404336734693878,9
Category_Wikipedia_sockpuppets_of_PhilCoulson20.csv,2801,6914366.0,946,1855,500,446,0,62.10674759014638,500,62,24.208139950017852,4
Category_Wikipedia_sockpuppets_of_Chobber_Sidhu0.csv,12,12340855.0,4,8,2,2,0,63.583333333333336,251,24,22.75,19
Category_Wikipedia_sockpuppets_of_Victor_Pluta»ôu.csv,50,10147499.0,18,32,12,6,0,68.22,230,24,16.1,12
Category_Wikipedia_sockpuppets_of_ExtraBart.csv,2960,278540441.0,916,2044,500,416,0,54.4597972972973,488,68,20.32364864864865,1
Category_Wikipedia_sockpuppets_of_DevianDevian.csv,648,11508041.0,247,401,174,73,0,36.273148148148145,291,53,15.125,6
Category_Wikipedia_sockpuppets_of_AidenBoss.csv,8,52958.0,5,3,3,2,0,37.375,142,10,9.25,8
Category_Wikipedia_sockpuppets_of_Tintle.csv,994,112661137.0,417,577,413,4,0,42.52917505030181,224,54,18.438631790744466,7
Category_Wikipedia_sockpuppets_of_Dyhp612.csv,4338,136524202.0,1638,2700,321,1317,0,28.45781466113416,496,71,18.49815583218073,5
Category_Wikipedia_sockpuppets_of_Vokaicra.csv,180,39469988.0,69,111,20,49,0,52.00555555555555,490,50,18.094444444444445,6
Category_Wikipedia_sockpuppets_of_Frank.diaz1994.csv,126,6405501.0,40,86,30,10,0,46.37301587301587,209,36,18.103174603174605,7
Category_Wikipedia_sockpuppets_of_Sarojupreti.csv,4010,25393851.0,1595,2415,500,1095,0,37.78952618453865,255,92,18.941645885286782,4
Category_Wikipedia_sockpuppets_of_Yimingllewyn.csv,1463,19284848.0,506,957,354,152,0,44.358168147641834,371,69,20.398496240601503,6
Category_Wikipedia_sockpuppets_of_Distributor108.csv,1800,47518741.0,670,1130,500,170,0,45.63166666666667,255,73,25.984444444444446,5
Category_Wikipedia_sockpuppets_of_Patronus78.csv,99,207968334.0,23,76,16,7,0,55.323232323232325,213,18,16.04040404040404,9
Category_Wikipedia_sockpuppets_of_Oatsandcream.csv,1889,101530903.0,521,1368,170,351,0,53.390682901005825,390,89,22.091053467443093,4
Category_Wikipedia_sockpuppets_of_Satyaharimondal.csv,62,1548649.0,22,40,11,11,0,46.91935483870968,201,49,24.79032258064516,12
Category_Wikipedia_sockpuppets_of_Radovicdarko538.csv,4016,17989169.0,1072,2944,463,609,0,55.0089641434263,493,72,22.118027888446214,3
Category_Wikipedia_sockpuppets_of_Leonardox2002.csv,351,97100250.0,75,276,64,11,0,57.29059829059829,287,29,13.267806267806268,4
Category_Wikipedia_sockpuppets_of_Andrevan.csv,1615,561482758.0,538,1077,500,38,0,54.426006191950464,496,73,25.25139318885449,5
Category_Wikipedia_sockpuppets_of_RBDRBDRBD.csv,8,3584952.0,3,5,2,1,0,34.75,179,29,27.125,26
Category_Wikipedia_sockpuppets_of_Sean_Hussainen.csv,163,3638652.0,47,116,4,43,0,27.69325153374233,241,38,23.466257668711656,11
Category_Wikipedia_sockpuppets_of_Earl_of_Frokem.csv,85,7420211.0,27,58,26,1,0,68.72941176470589,255,54,20.28235294117647,7
Category_Wikipedia_sockpuppets_of_Jeanpuetz.csv,119,9740399.0,25,94,15,10,0,48.20168067226891,190,33,18.84873949579832,9
Category_Wikipedia_sockpuppets_of_Saketsnehil.csv,16,6278.0,11,5,9,2,0,43.5625,91,53,28.0,12
Category_Wikipedia_sockpuppets_of_The_Twenty_Thousand_Tonne_Bomb.csv,1772,4198759.0,503,1269,500,3,0,49.5186230248307,271,54,18.649548532731377,3
Category_Wikipedia_sockpuppets_of_Littleteddy.csv,1744,1985717.0,515,1229,500,15,0,40.2454128440367,210,111,27.727064220183486,4
Category_Wikipedia_sockpuppets_of_Abdulaziz999982.csv,5042,110895104.0,2717,2325,500,2217,0,28.482546608488693,496,60,17.990479968266563,6
Category_Wikipedia_sockpuppets_of_Bialongo.csv,128,14426691.0,59,69,43,16,0,32.6953125,176,23,9.09375,8
Category_Wikipedia_sockpuppets_of_GDayton85.csv,574,51924501.0,123,451,32,91,0,55.19512195121951,445,47,17.770034843205575,4
Category_Wikipedia_sockpuppets_of_Xp54321.csv,1719,101167300.0,514,1205,500,14,0,51.38394415357766,233,96,21.738801628853984,3
Category_Wikipedia_sockpuppets_of_GJFBR.csv,1088,142914038.0,502,586,500,2,0,50.184742647058826,395,62,19.58639705882353,6
Category_Wikipedia_sockpuppets_of_Charles_Rapeneau.csv,1,0.0,1,0,1,0,11,11.0,11,25,25.0,25
Category_Wikipedia_sockpuppets_of_Raag_online.csv,102,3735115.0,32,70,15,17,0,37.029411764705884,223,69,20.254901960784313,3
Category_Wikipedia_sockpuppets_of_Dusrapehelu.csv,3634,34608892.0,1079,2555,185,894,0,50.38414969730325,500,63,26.39708310401761,3
Category_Wikipedia_sockpuppets_of_TPCFanFor_Facts.csv,15,6366869.0,5,10,3,2,0,22.666666666666668,75,27,25.0,22
Category_Wikipedia_sockpuppets_of_Amy_wamey.csv,205,23725089.0,68,137,65,3,0,52.05365853658537,375,59,22.73658536585366,4
Category_Wikipedia_sockpuppets_of_Hairy_brush.csv,41,888.0,14,27,13,1,0,64.97560975609755,208,21,11.048780487804878,5
Category_Wikipedia_sockpuppets_of_LiquidLuke91.csv,110,23846.0,42,68,26,16,0,31.381818181818183,190,21,12.472727272727273,8
Category_Wikipedia_sockpuppets_of_Wefffrrr.csv,2776,47461068.0,1000,1776,500,500,0,32.45100864553314,494,56,17.73451008645533,5
Category_Wikipedia_sockpuppets_of_JwayneRabago.csv,33,383633.0,28,5,12,16,0,30.818181818181817,206,22,16.515151515151516,5
Category_Wikipedia_sockpuppets_of_AliCharlie898.csv,2345,28243237.0,1292,1053,500,792,0,25.525799573560768,300,54,23.851172707889127,7
Category_Wikipedia_sockpuppets_of_LewisChu.csv,306,14087477.0,133,173,67,66,0,51.251633986928105,255,98,24.898692810457515,3
Category_Wikipedia_sockpuppets_of_Neno8403.csv,218,39418870.0,82,136,82,0,0,29.087155963302752,239,48,34.9954128440367,9
Category_Wikipedia_sockpuppets_of_Nova1Nova1.csv,43,946263.0,23,20,15,8,0,72.27906976744185,430,21,11.86046511627907,8
Category_Wikipedia_sockpuppets_of_Forwiki321.csv,41,12016104.0,12,29,12,0,0,51.5609756097561,185,29,17.414634146341463,6
Category_Wikipedia_sockpuppets_of_Leijurv.csv,1829,208147992.0,515,1314,500,15,0,68.18808091853472,455,61,23.552214324767633,4
Category_Wikipedia_sockpuppets_of_Max.coke.csv,350,2849906.0,115,235,100,15,0,31.594285714285714,201,40,15.354285714285714,3
Category_Wikipedia_sockpuppets_of_Kostas181.csv,1116,35038718.0,315,801,171,144,0,46.727598566308245,434,58,22.14426523297491,4
Category_Wikipedia_sockpuppets_of_Amalbahi1.csv,23,43749.0,17,6,11,6,0,29.695652173913043,142,20,12.347826086956522,8
Category_Wikipedia_sockpuppets_of_LouiseTsun.csv,75,1087101.0,15,60,4,11,0,51.50666666666667,224,38,32.72,19
Category_Wikipedia_sockpuppets_of_Don_song25.csv,47,6840654.0,16,31,6,10,0,58.234042553191486,227,17,11.76595744680851,6
Category_Wikipedia_sockpuppets_of_Degmarshall.csv,168,121760591.0,58,110,36,22,0,37.232142857142854,211,29,17.172619047619047,7
Category_Wikipedia_sockpuppets_of_Gurunatha.csv,481,201674638.0,133,348,115,18,0,54.25571725571726,273,51,19.9002079002079,6
Category_Wikipedia_sockpuppets_of_Leftyfb.csv,32,99063649.0,8,24,8,0,0,36.125,128,30,20.53125,16
Category_Wikipedia_sockpuppets_of_Constitutionalism.csv,3193,272905540.0,1033,2160,154,879,0,54.601941747572816,255,62,22.88192922016912,2
Category_Wikipedia_sockpuppets_of_720vikas.csv,121,72847020.0,27,94,14,13,0,64.76859504132231,290,51,22.41322314049587,4
Category_Wikipedia_sockpuppets_of_00091a0203.csv,34,38535.0,14,20,9,5,0,55.911764705882355,154,20,18.441176470588236,17
Category_Wikipedia_sockpuppets_of_Fsilvers.csv,413,317279259.0,118,295,89,29,0,57.634382566585955,263,45,19.031476997578693,3
Category_Wikipedia_sockpuppets_of_Kevalchacha.csv,28,373713.0,13,15,11,2,0,27.571428571428573,228,59,16.785714285714285,4
Category_Wikipedia_sockpuppets_of_MrNigerian.csv,137,6585494.0,53,84,41,12,0,66.03649635036497,499,46,14.781021897810218,6
Category_Wikipedia_sockpuppets_of_PlikoraT.csv,1291,45361551.0,433,858,28,405,0,45.17893106119288,253,53,18.478698683191325,3
Category_Wikipedia_sockpuppets_of_Kamra456.csv,65,5538498.0,25,40,24,1,0,33.738461538461536,230,31,15.661538461538461,7
Category_Wikipedia_sockpuppets_of_Sammy.joseph.csv,1329,269035027.0,534,795,500,34,0,40.38374717832957,395,55,14.565838976674192,6
Category_Wikipedia_sockpuppets_of_DJ15Nario.csv,115,119743677.0,27,88,27,0,0,41.44347826086957,215,48,20.26086956521739,8
Category_Wikipedia_sockpuppets_of_Skylandtourim.csv,27,97637.0,15,12,15,0,0,12.518518518518519,190,13,13.0,13
Category_Wikipedia_sockpuppets_of_You've_been_REJECTED!.csv,2,0.0,1,1,1,0,12,12.0,12,34,34.0,34
Category_Wikipedia_sockpuppets_of_Hellishscrubber.csv,712,14606418.0,240,472,89,151,0,55.883426966292134,407,53,22.31179775280899,6
Category_Wikipedia_sockpuppets_of_Wienliebe.csv,202,99019031.0,63,139,51,12,0,47.76237623762376,494,46,24.5,9
Category_Wikipedia_sockpuppets_of_Buzzards-Watch_Me_Work.csv,15374,142167333.0,5127,10247,500,4627,0,48.103876674905685,498,81,18.910693378431116,3
Category_Wikipedia_sockpuppets_of_CRAustralia.csv,91,2693924.0,52,39,41,11,0,67.51648351648352,192,27,18.857142857142858,14
Category_Wikipedia_sockpuppets_of_Ajschon.csv,33,141481.0,16,17,10,6,0,67.24242424242425,151,23,17.060606060606062,8
Category_Wikipedia_sockpuppets_of_Akibwiki.csv,62,31376136.0,25,37,17,8,0,50.38709677419355,245,22,18.870967741935484,8
Category_Wikipedia_sockpuppets_of_PROPHET_MUPAMIGWA.csv,9,3282.0,3,6,2,1,0,103.0,255,27,16.555555555555557,8
Category_Wikipedia_sockpuppets_of_Science3456.csv,1004,20091728.0,382,622,381,1,0,22.286852589641434,195,61,15.913346613545817,3
Category_Wikipedia_sockpuppets_of_Artgeller.csv,90,13642890.0,33,57,14,19,0,60.74444444444445,255,47,18.288888888888888,8
Category_Wikipedia_sockpuppets_of_Alisher_Novarro_82.csv,266,10786665.0,94,172,90,4,0,42.7593984962406,255,48,20.0,7
Category_Wikipedia_sockpuppets_of_Gbgfbgfbgfb.csv,4204,70577793.0,1348,2856,150,1198,0,50.61964795432921,255,75,22.837059942911512,3
Category_Wikipedia_sockpuppets_of_KHAYAL_ABBAS_AKHTAR.csv,33,49270089.0,13,20,10,3,0,49.484848484848484,225,29,17.666666666666668,11
Category_Wikipedia_sockpuppets_of_Mhdsuhail111.csv,496,268374442.0,161,335,70,91,0,45.61693548387097,292,56,27.443548387096776,5
Category_Wikipedia_sockpuppets_of_TylerDurden1963.csv,2191,96506820.0,505,1686,346,159,0,36.77133728890917,250,60,16.30442720219078,4
Category_Wikipedia_sockpuppets_of_Simhaprasad9.csv,10,1811653.0,3,7,2,1,16,60.5,131,22,19.6,19
Category_Wikipedia_sockpuppets_of_Heatfan9876.csv,16,1992.0,5,11,3,2,0,82.875,224,15,10.5,6
Category_Wikipedia_sockpuppets_of_Naradasupreme.csv,510,82683327.0,142,368,92,50,0,39.89607843137255,199,58,18.63137254901961,8
Category_Wikipedia_sockpuppets_of_Joaquin_or_Chestnut.csv,470,9599994.0,152,318,90,62,0,30.23617021276596,491,55,20.99148936170213,10
Category_Wikipedia_sockpuppets_of_Dr._M_Ravi_Kanth.csv,47,4055815.0,22,25,10,12,0,54.851063829787236,200,33,20.638297872340427,8
Category_Wikipedia_sockpuppets_of_RayAlt.csv,1164,124832257.0,305,859,207,98,0,46.59879725085911,375,71,21.516323024054984,6
Category_Wikipedia_sockpuppets_of_Cheylesmore.csv,76,306262074.0,26,50,14,12,0,40.38157894736842,250,34,17.56578947368421,11
Category_Wikipedia_sockpuppets_of_Chok_Bahadur.csv,38,4013995.0,9,29,4,5,0,53.86842105263158,158,53,34.94736842105263,17
Category_Wikipedia_sockpuppets_of_Fisherman6996.csv,8,773.0,7,1,7,0,0,0.0,0,13,13.0,13
Category_Wikipedia_sockpuppets_of_Omnipum.csv,286,15218062.0,140,146,126,14,0,65.57342657342657,255,19,12.26923076923077,9
Category_Wikipedia_sockpuppets_of_Redbowcreative.csv,28,10264.0,13,15,13,0,0,41.5,196,51,29.357142857142858,18
Category_Wikipedia_sockpuppets_of_Rockdolly.csv,1389,31634021.0,332,1057,332,0,0,23.17278617710583,251,42,14.713462922966162,9
Category_Wikipedia_sockpuppets_of_Lille_wexford.csv,3,430835.0,2,1,1,1,0,45.0,130,26,26.0,26
Category_Wikipedia_sockpuppets_of_TheBoiZurkelman.csv,2687,13299127.0,936,1751,293,643,0,51.4812058057313,450,64,18.96538890956457,2
Category_Wikipedia_sockpuppets_of_Hazim_saeed786.csv,820,2498526.0,268,552,194,74,0,45.58170731707317,359,50,19.423170731707316,4
Category_Wikipedia_sockpuppets_of_Murad_Shair.csv,146,236623947.0,38,108,18,20,0,47.8013698630137,496,38,12.931506849315069,8
Category_Wikipedia_sockpuppets_of_MushuNeak.csv,769,99263699.0,254,515,176,78,0,60.60338101430429,255,63,17.734720416124837,4
Category_Wikipedia_sockpuppets_of_Cleter.csv,1923,4237658.0,542,1381,500,42,0,64.87311492459699,500,70,15.546541861674466,4
Category_Wikipedia_sockpuppets_of_Ninatehran2011.csv,39,1255.0,23,16,23,0,0,71.97435897435898,150,48,16.71794871794872,11
Category_Wikipedia_sockpuppets_of_Elyelm.csv,10,111096.0,5,5,5,0,0,81.6,137,16,15.0,11
Category_Wikipedia_sockpuppets_of_WIKIPEDIARUS.csv,17,359318.0,7,10,3,4,0,23.647058823529413,88,48,32.8235294117647,24
Category_Wikipedia_sockpuppets_of_Neeraj_Puruvanshi_saini.csv,202,9123243.0,58,144,57,1,0,50.65841584158416,225,43,13.222772277227723,4
Category_Wikipedia_sockpuppets_of_Cookied00750.csv,13,69467.0,6,7,5,1,0,22.0,191,17,16.53846153846154,16
Category_Wikipedia_sockpuppets_of_Sjhaines.csv,137,84431657.0,31,106,31,0,0,44.31386861313869,203,41,25.686131386861312,14
Category_Wikipedia_sockpuppets_of_CIWed92.csv,9,7349725.0,9,0,2,7,12,31.555555555555557,58,13,11.333333333333334,10
Category_Wikipedia_sockpuppets_of_Coolman882.csv,9,1369450.0,4,5,4,0,6,75.66666666666667,157,20,14.666666666666666,14
Category_Wikipedia_sockpuppets_of_Thomasstrudwick.csv,48,3433145.0,42,6,20,22,0,21.625,249,45,20.416666666666668,16
Category_Wikipedia_sockpuppets_of_Anatta.nergui.csv,20,1485548.0,17,3,10,7,0,8.9,90,23,15.8,14
Category_Wikipedia_sockpuppets_of_Mnur.csv,11,226649.0,10,1,8,2,0,30.90909090909091,199,18,10.636363636363637,9
Category_Wikipedia_sockpuppets_of_Kykyred2.csv,1330,44530046.0,375,955,54,321,0,49.43383458646616,491,66,28.585714285714285,5
Category_Wikipedia_sockpuppets_of_Battalion_of_allah.csv,1760,15412026.0,560,1200,500,60,0,40.325,500,48,16.739772727272726,4
Category_Wikipedia_sockpuppets_of_The_Namaste_Guild.csv,27,87569.0,15,12,13,2,0,39.0,199,50,40.51851851851852,22
Category_Wikipedia_sockpuppets_of_Apnagm.csv,769,293289255.0,238,531,234,4,0,39.568270481144346,318,48,18.512353706111835,8
Category_Wikipedia_sockpuppets_of_A_Mal.csv,37,355884.0,26,11,15,11,0,30.513513513513512,156,15,10.45945945945946,10
Category_Wikipedia_sockpuppets_of_Cheetomalik4.csv,939,50342206.0,325,614,300,25,0,50.10223642172524,496,46,17.275825346112885,4
Category_Wikipedia_sockpuppets_of_Endi_cufi.csv,6,12695906.0,2,4,2,0,3,29.5,114,27,23.0,19
Category_Wikipedia_sockpuppets_of_BrianZhukov.csv,1230,271625604.0,683,547,500,183,0,35.86991869918699,259,47,19.40650406504065,6
Category_Wikipedia_sockpuppets_of_Mataan_cabdule.csv,6,2889056.0,2,4,1,1,0,44.166666666666664,135,19,18.0,17
Category_Wikipedia_sockpuppets_of_Frau_Holle.csv,4735,627509462.0,1203,3532,500,703,0,49.44941921858501,500,65,17.914889123548047,3
Category_Wikipedia_sockpuppets_of_Arizonaabbebe.csv,8,52432.0,7,1,5,2,0,25.875,130,18,16.625,15
Category_Wikipedia_sockpuppets_of_AwardPunjabi.csv,114,19176392.0,56,58,33,23,0,40.43859649122807,241,32,13.105263157894736,6
Category_Wikipedia_sockpuppets_of_Hemmeband17.csv,1738,51100737.0,528,1210,500,28,0,32.87686996547756,251,48,14.295166858457998,6
Category_Wikipedia_sockpuppets_of_KHLrookie.csv,3509,19148481.0,1047,2462,500,547,0,40.062125961812484,255,64,22.190652607580507,6
Category_Wikipedia_sockpuppets_of_Soltumia123.csv,81,4364573.0,22,59,12,10,0,48.30864197530864,251,51,14.839506172839506,7
Category_Wikipedia_sockpuppets_of_Aa1232011.csv,838,12970764.0,283,555,227,56,0,45.63245823389021,250,51,25.24582338902148,6
Category_Wikipedia_sockpuppets_of_The_fashionable_baby.csv,1598,265542262.0,492,1106,172,320,0,42.34230287859825,288,45,24.398623279098874,5
Category_Wikipedia_sockpuppets_of_Donaldleegraham.csv,69,67093535.0,30,39,16,14,0,39.04347826086956,199,39,18.3768115942029,9
Category_Wikipedia_sockpuppets_of_Ahmad7610365.csv,29,347109.0,15,14,7,8,0,49.89655172413793,182,21,12.172413793103448,5
Category_Wikipedia_sockpuppets_of_UGETH.csv,12,45500.0,5,7,4,1,0,40.416666666666664,177,30,12.5,7
Category_Wikipedia_sockpuppets_of_BasedAtlas.csv,3716,8036350.0,1500,2216,500,1000,0,27.607642626480086,257,67,17.124058127018298,3
Category_Wikipedia_sockpuppets_of_Ani4ani.csv,5,494076.0,5,0,3,2,63,91.8,125,29,23.8,17
Category_Wikipedia_sockpuppets_of_The_contentor.csv,765,131378974.0,386,379,224,162,0,48.68627450980392,515,56,23.516339869281047,5
Category_Wikipedia_sockpuppets_of_Seanosull2841.csv,217,31012652.0,80,137,68,12,0,38.225806451612904,293,36,20.391705069124423,5
Category_Wikipedia_sockpuppets_of_Billnye123456.csv,111,1554002.0,33,78,15,18,0,34.414414414414416,178,27,13.531531531531531,4
Category_Wikipedia_sockpuppets_of_WikiMann123.csv,316,196682237.0,67,249,36,31,0,58.642405063291136,380,48,20.86392405063291,5
Category_Wikipedia_sockpuppets_of_Jsmith_51389.csv,710,165733942.0,199,511,65,134,0,40.65633802816902,249,58,22.83239436619718,6
Category_Wikipedia_sockpuppets_of_Cats21.csv,125,1493577.0,66,59,66,0,0,33.776,203,39,32.976,16
Category_Wikipedia_sockpuppets_of_FortUser.csv,4139,64889645.0,1334,2805,500,834,0,45.97245711524523,484,76,25.71877265039865,3
Category_Wikipedia_sockpuppets_of_Thesatyam.csv,292,14556966.0,99,193,21,78,0,47.91438356164384,231,48,20.698630136986303,4
Category_Wikipedia_sockpuppets_of_Confused_guy_152.csv,325,6299456.0,104,221,100,4,0,55.07692307692308,500,48,18.932307692307692,5
Category_Wikipedia_sockpuppets_of_Futbase.csv,3011,6764754.0,1001,2010,500,501,0,31.653935569578213,255,60,23.270674194619726,4
Category_Wikipedia_sockpuppets_of_Lawsonf_Flear.csv,63,3170.0,34,29,22,12,0,42.98412698412698,215,30,18.873015873015873,7
Category_Wikipedia_sockpuppets_of_Grammophone.csv,391,72871451.0,171,220,158,13,0,55.994884910485936,255,47,17.63682864450128,10
Category_Wikipedia_sockpuppets_of_Chorndavid.csv,433,276779326.0,143,290,129,14,0,53.85912240184758,255,44,23.140877598152425,4
Category_Wikipedia_sockpuppets_of_Seokochin.csv,291,122238617.0,91,200,72,19,0,34.175257731958766,243,49,12.8659793814433,5
Category_Wikipedia_sockpuppets_of_Lpkids2006.csv,876,121460721.0,201,675,67,134,0,32.9486301369863,243,55,18.8824200913242,3
Category_Wikipedia_sockpuppets_of_Treylander.csv,559,420626.0,236,323,236,0,0,53.89982110912344,246,58,31.962432915921287,4
Category_Wikipedia_sockpuppets_of_Thecutehero.csv,2837,7363142.0,1000,1837,500,500,0,43.98202326401128,255,69,19.890377158970743,5
Category_Wikipedia_sockpuppets_of_Dudeskin8.csv,425,94736728.0,117,308,69,48,0,55.091764705882355,254,37,16.91764705882353,5
Category_Wikipedia_sockpuppets_of_Concerned_cynic.csv,3052,167558465.0,743,2309,500,243,0,43.01376146788991,227,54,19.28473132372215,3
Category_Wikipedia_sockpuppets_of_DrZoidberg.csv,1481,10193001.0,513,968,500,13,0,13.920324105334233,200,51,25.563808237677247,14
Category_Wikipedia_sockpuppets_of_Obamafan70.csv,2383,14859258.0,816,1567,500,316,0,46.605958875367186,239,56,19.75996642887117,3
Category_Wikipedia_sockpuppets_of_Sadiecollective.csv,16,4114329.0,11,5,7,4,0,45.125,299,25,17.625,12
Category_Wikipedia_sockpuppets_of_Wikigabriel11.csv,284,53500251.0,95,189,95,0,0,48.397887323943664,206,40,22.260563380281692,9
Category_Wikipedia_sockpuppets_of_Girls_eating_poop_on_YouTube.csv,75,525912.0,26,49,18,8,0,66.94666666666667,204,38,20.493333333333332,6
Category_Wikipedia_sockpuppets_of_Doglicker9912.csv,24,15694.0,15,9,14,1,0,80.0,242,17,16.625,16
Category_Wikipedia_sockpuppets_of_Alex_at_FCPEuro.csv,112,83048798.0,36,76,21,15,0,51.1875,255,65,27.348214285714285,7
Category_Wikipedia_sockpuppets_of_Sacoca.csv,322,79529392.0,114,208,57,57,0,49.56211180124224,233,45,15.900621118012422,6
Category_Wikipedia_sockpuppets_of_Bmatthewsmsu35.csv,34,68281.0,16,18,11,5,0,51.88235294117647,245,24,20.735294117647058,16
Category_Wikipedia_sockpuppets_of_Leicesterdedlock.csv,231,135956059.0,86,145,42,44,0,40.41558441558441,231,117,24.354978354978353,5
Category_Wikipedia_sockpuppets_of_Centralsgcdc.csv,6,65581.0,4,2,3,1,0,38.166666666666664,60,29,26.0,23
Category_Wikipedia_sockpuppets_of_Jeff_Defender.csv,375,62738443.0,88,287,46,42,0,45.04533333333333,214,58,21.976,4
Category_Wikipedia_sockpuppets_of_WooWooWooauauauaua543.csv,227,2647029.0,81,146,59,22,0,54.52422907488987,255,70,19.044052863436125,7
Category_Wikipedia_sockpuppets_of_AlexLevyOne.csv,29316,376373018.0,7064,22252,500,6564,0,39.52415063446582,500,72,16.528243962341385,3
Category_Wikipedia_sockpuppets_of_CycloneTu2014.csv,82,1296.0,34,48,12,22,0,64.45121951219512,207,31,15.158536585365853,10
Category_Wikipedia_sockpuppets_of_Rflores0915.csv,17,265908.0,11,6,9,2,0,21.41176470588235,144,29,20.705882352941178,11
Category_Wikipedia_sockpuppets_of_Jomontgeorge.csv,14327,77172290.0,5338,8989,500,4838,0,47.34927060794305,500,85,18.301668178962796,3
Category_Wikipedia_sockpuppets_of_MxonlightTea.csv,490,4738219.0,145,345,96,49,0,48.559183673469384,495,41,19.410204081632653,4
Category_Wikipedia_sockpuppets_of_SahibCollege.csv,4,171.0,3,1,3,0,0,73.25,189,17,13.5,10
Category_Wikipedia_sockpuppets_of_TreadingWater.csv,2046,36757935.0,554,1492,486,68,0,51.573802541544474,249,71,19.481915933528835,3
Category_Wikipedia_sockpuppets_of_IamJoarSabateOfficial.csv,38,24564931.0,8,30,3,5,0,66.1842105263158,208,53,27.026315789473685,12
Category_Wikipedia_sockpuppets_of_IamAGecko.csv,116,47186271.0,41,75,19,22,0,45.4051724137931,206,48,23.025862068965516,7
Category_Wikipedia_sockpuppets_of_Groot_singh.csv,26,93792.0,18,8,17,1,7,41.15384615384615,207,14,11.23076923076923,6
Category_Wikipedia_sockpuppets_of_Dovemancare.csv,20,151043.0,9,11,2,7,0,43.9,162,18,12.0,6
Category_Wikipedia_sockpuppets_of_Rumelwapbd.csv,353,210879863.0,122,231,50,72,0,43.155807365439095,307,53,21.144475920679888,5
Category_Wikipedia_sockpuppets_of_HakonH2304.csv,9,1461.0,4,5,4,0,3,64.11111111111111,133,7,6.555555555555555,6
Category_Wikipedia_sockpuppets_of_Interestedindividual.csv,80,413960321.0,24,56,24,0,0,54.55,254,56,17.8,9
Category_Wikipedia_sockpuppets_of_Frys104.csv,321,72460568.0,115,206,74,41,0,30.12772585669782,215,36,15.59190031152648,4
Category_Wikipedia_sockpuppets_of_Felix.kilonzo.csv,200,393945.0,109,91,75,34,0,42.705,255,43,22.54,12
Category_Wikipedia_sockpuppets_of_Gurvinder_Singh_Chhabra_(_Vicky_).csv,142,20099596.0,52,90,31,21,0,50.070422535211264,494,55,23.204225352112676,9
Category_Wikipedia_sockpuppets_of_Ziggyroscoe.csv,1574,9586192.0,604,970,319,285,0,26.221092757306227,255,48,21.024777636594663,6
Category_Wikipedia_sockpuppets_of_Tricdl27.csv,3164,41831015.0,1126,2038,500,626,0,49.597029077117575,255,68,20.329329962073324,3
Category_Wikipedia_sockpuppets_of_Mappase.csv,4036,74654226.0,1100,2936,500,600,0,36.59737363726462,255,51,22.64544103072349,3
Category_Wikipedia_sockpuppets_of_AbhijitSonavane.csv,254,71002322.0,113,141,64,49,0,45.78740157480315,210,46,18.04724409448819,5
Category_Wikipedia_sockpuppets_of_Kolkatacine.csv,1737,114309182.0,674,1063,500,174,0,31.63097294185377,496,46,16.43350604490501,5
Category_Wikipedia_sockpuppets_of_Bsidfbsidufbsdimfsdfsdf.csv,153,4156093.0,47,106,26,21,0,64.30065359477125,255,59,20.431372549019606,1
Category_Wikipedia_sockpuppets_of_Skinnylegend999.csv,10,998.0,5,5,5,0,0,65.2,188,15,14.1,12
Category_Wikipedia_sockpuppets_of_Dfroberg.csv,200,272239464.0,72,128,70,2,0,49.375,191,38,26.055,3
Category_Wikipedia_sockpuppets_of_Selva2pepul.csv,26,613267.0,7,19,4,3,0,51.03846153846154,231,53,33.80769230769231,16
Category_Wikipedia_sockpuppets_of_IAMBeing.csv,22,89361.0,9,13,7,2,3,35.72727272727273,152,50,50.0,50
Category_Wikipedia_sockpuppets_of_Slyguy1255.csv,396,166797223.0,132,264,65,67,0,41.21969696969697,280,53,15.017676767676768,3
Category_Wikipedia_sockpuppets_of_Tha_D.f4c3r.csv,2032,215143361.0,695,1337,201,494,0,38.357283464566926,483,59,15.734744094488189,3
Category_Wikipedia_sockpuppets_of_Malkawi99.csv,1196,248057347.0,434,762,433,1,0,45.547658862876254,496,72,21.430602006688964,6
Category_Wikipedia_sockpuppets_of_Burim_Ademi_Vines.csv,16,6943215.0,7,9,5,2,0,57.1875,208,25,24.0,23
Category_Wikipedia_sockpuppets_of_Nicolastico23.csv,43,48606.0,15,28,11,4,2,70.90697674418605,361,22,15.13953488372093,7
Category_Wikipedia_sockpuppets_of_Michelle3801.csv,369,5636628.0,104,265,65,39,0,29.983739837398375,173,38,22.75609756097561,10
Category_Wikipedia_sockpuppets_of_Webdesignbb.csv,2,239.0,2,0,2,0,23,29.0,35,21,21.0,21
Category_Wikipedia_sockpuppets_of_Mr_Hall_of_England.csv,2049,262256962.0,829,1220,500,329,0,42.68033186920449,376,59,31.851634943875062,5
Category_Wikipedia_sockpuppets_of_Anaspida.csv,722,19790267.0,247,475,31,216,0,63.78947368421053,230,54,14.731301939058172,3
Category_Wikipedia_sockpuppets_of_Hamry875.csv,55,2579384.0,16,39,5,11,0,63.56363636363636,511,41,18.272727272727273,5
Category_Wikipedia_sockpuppets_of_Fishiehelper2.csv,2799,66240330.0,1000,1799,500,500,0,54.11897106109325,255,74,25.803143979992853,5
Category_Wikipedia_sockpuppets_of_Xqlusivevan.csv,94,6754452.0,63,31,54,9,0,28.319148936170212,196,53,19.73404255319149,9
Category_Wikipedia_sockpuppets_of_LuigiGamer64.csv,424,15880701.0,105,319,95,10,0,44.51650943396226,234,42,15.089622641509434,3
Category_Wikipedia_sockpuppets_of_SilvioRo.csv,1,0.0,1,0,1,0,0,0.0,0,35,35.0,35
Category_Wikipedia_sockpuppets_of_RoyalHeritageAlb.csv,1980,107006267.0,532,1448,500,32,0,58.803030303030305,500,54,13.427777777777777,3
Category_Wikipedia_sockpuppets_of_Pmanderson.csv,3560,383244765.0,1000,2560,500,500,0,56.907303370786515,467,83,29.927808988764045,3
Category_Wikipedia_sockpuppets_of_Wikihonestyjsw12345.csv,35,8019001.0,19,16,14,5,0,43.0,202,38,25.542857142857144,19
Category_Wikipedia_sockpuppets_of_Consure_Medicals.csv,7,274671.0,5,2,5,0,0,25.142857142857142,43,34,34.0,34
Category_Wikipedia_sockpuppets_of_Lucifer2000.csv,5236,385320846.0,1873,3363,500,1373,0,48.77979373567609,460,82,28.090527119938884,4
Category_Wikipedia_sockpuppets_of_Rfefr4r4f.csv,2810,130438043.0,755,2055,399,356,0,41.297508896797154,491,52,16.515658362989324,5
Category_Wikipedia_sockpuppets_of_Qwaserty.csv,10,311757.0,8,2,6,2,0,45.3,119,11,11.0,11
Category_Wikipedia_sockpuppets_of_Daniel_B._Choromanski.csv,375,10432930.0,115,260,103,12,0,53.797333333333334,249,48,26.946666666666665,14
Category_Wikipedia_sockpuppets_of_DozenPlus.csv,48,4069219.0,22,26,14,8,0,53.0,156,53,32.416666666666664,6
Category_Wikipedia_sockpuppets_of_The_Ghost_Pirates_Are_Coming.csv,15,2944.0,7,8,7,0,0,68.26666666666667,209,26,20.066666666666666,13
Category_Wikipedia_sockpuppets_of_Kandreyev.csv,162,32915234.0,58,104,56,2,0,37.339506172839506,252,49,24.0,10
Category_Wikipedia_sockpuppets_of_Jeremy9901.csv,301,37404882.0,127,174,56,71,0,44.269102990033225,395,74,19.21262458471761,8
Category_Wikipedia_sockpuppets_of_Calxb1.csv,65,16676855.0,25,40,13,12,0,68.66153846153846,253,37,15.861538461538462,4
Category_Wikipedia_sockpuppets_of_Jerrycantrell12.csv,72,929368.0,53,19,28,25,0,45.77777777777778,226,14,13.36111111111111,9
Category_Wikipedia_sockpuppets_of_◊î-◊ñ◊§◊®.csv,2940,6869341.0,912,2028,500,412,0,43.1891156462585,255,62,17.64829931972789,3
Category_Wikipedia_sockpuppets_of_Eritrean_Camel.csv,274,21600793.0,79,195,58,21,0,55.36131386861314,297,34,14.343065693430656,5
Category_Wikipedia_sockpuppets_of_Stiarts_erid.csv,865,66449848.0,307,558,220,87,0,54.76300578034682,255,50,20.464739884393065,5
Category_Wikipedia_sockpuppets_of_Drnvikramaditya.csv,28,1401970.0,11,17,11,0,0,23.785714285714285,114,52,16.107142857142858,5
Category_Wikipedia_sockpuppets_of_HighlyLogicalVulcan.csv,2679,2248145.0,803,1876,500,303,0,49.8615154908548,496,74,19.29787234042553,4
Category_Wikipedia_sockpuppets_of_Nastradumas_2001.csv,2049,32370986.0,536,1513,500,36,0,38.50219619326501,395,57,18.28794533918985,5
Category_Wikipedia_sockpuppets_of_Sarahmcguckinpr.csv,27,9152447.0,18,9,14,4,0,54.2962962962963,200,21,21.0,21
Category_Wikipedia_sockpuppets_of_AlexTylersMail.csv,2220,48185962.0,562,1658,499,63,0,42.98288288288288,254,49,16.2481981981982,2
Category_Wikipedia_sockpuppets_of_Azial_Xarel_Druda.csv,728,27263770.0,223,505,204,19,0,44.74313186813187,217,34,16.3489010989011,4
Category_Wikipedia_sockpuppets_of_VladimirGotShot.csv,134,93242.0,37,97,23,14,0,24.28358208955224,185,22,13.761194029850746,7
Category_Wikipedia_sockpuppets_of_Malusia22.csv,4936,92503190.0,1836,3100,355,1481,0,38.59177471636953,255,70,22.36264181523501,1
Category_Wikipedia_sockpuppets_of_Marta_Abello.csv,20,31196.0,8,12,8,0,0,48.35,102,35,32.4,21
Category_Wikipedia_sockpuppets_of_Wzagieboylo.csv,36,57320267.0,11,25,8,3,0,74.80555555555556,288,32,18.22222222222222,9
Category_Wikipedia_sockpuppets_of_Misssinformative.csv,433,20098045.0,151,282,89,62,0,41.61662817551963,199,53,24.524249422632796,7
Category_Wikipedia_sockpuppets_of_Prvi_zdrug.csv,72,429500.0,36,36,36,0,0,55.916666666666664,196,34,21.48611111111111,14
Category_Wikipedia_sockpuppets_of_Corduenekingdom.csv,144,1066747.0,50,94,28,22,0,55.125,337,34,14.625,4
Category_Wikipedia_sockpuppets_of_Asdasfdasdfasdfasf.csv,127,6465917.0,39,88,13,26,0,75.90551181102362,979,34,16.913385826771652,4
Category_Wikipedia_sockpuppets_of_Architect_134.csv,13953,230254347.0,4360,9593,500,3860,0,68.95907690102487,500,94,21.16053895219666,2
Category_Wikipedia_sockpuppets_of_Lovemankind.csv,299,115900839.0,100,199,87,13,0,41.876254180602004,219,50,23.14715719063545,10
Category_Wikipedia_sockpuppets_of_Rathfelder.csv,3141,223265744.0,1087,2054,500,587,0,52.0945558739255,495,94,26.898439987265203,4
Category_Wikipedia_sockpuppets_of_Qwerty_dirty_flirty.csv,71,41771857.0,26,45,14,12,0,37.25352112676056,184,36,21.830985915492956,13
Category_Wikipedia_sockpuppets_of_IskandarRoCkEt.csv,172,6920154.0,67,105,51,16,0,58.26744186046512,309,47,20.38372093023256,6
Category_Wikipedia_sockpuppets_of_Zquad100.csv,1080,11619309.0,372,708,355,17,0,39.97314814814815,255,26,12.743518518518519,4
Category_Wikipedia_sockpuppets_of_Arashinc.csv,1295,115284104.0,521,774,500,21,0,46.32046332046332,508,63,18.633204633204635,5
Category_Wikipedia_sockpuppets_of_Talatastan.csv,1183,4565170.0,362,821,342,20,0,51.23245984784446,500,82,30.009298393913777,4
Category_Wikipedia_sockpuppets_of_Tevearar.csv,35,9229264.0,28,7,16,12,0,7.571428571428571,60,20,18.65714285714286,13
Category_Wikipedia_sockpuppets_of_Adiisunlay.csv,14,4158124.0,10,4,6,4,0,12.857142857142858,107,13,5.285714285714286,4
Category_Wikipedia_sockpuppets_of_Samansadeghy.csv,63,66527623.0,31,32,15,16,0,34.698412698412696,225,65,28.3015873015873,17
Category_Wikipedia_sockpuppets_of_Checkpoint_Delta.csv,57,31359979.0,26,31,22,4,0,50.08771929824562,244,39,25.42105263157895,12
Category_Wikipedia_sockpuppets_of_MarieOra.csv,141,15960388.0,29,112,20,9,0,58.219858156028366,255,66,19.929078014184398,6
Category_Wikipedia_sockpuppets_of_UponAShiningStar.csv,136,43469166.0,35,101,18,17,0,51.0735294117647,220,34,17.264705882352942,9
Category_Wikipedia_sockpuppets_of_Keraun21.csv,4,4783.0,3,1,3,0,33,66.75,107,11,11.0,11
Category_Wikipedia_sockpuppets_of_Ccore.csv,298,80189671.0,148,150,148,0,0,34.88926174496644,234,23,15.825503355704697,12
Category_Wikipedia_sockpuppets_of_Wcain12.csv,41,73371679.0,17,24,15,2,0,38.170731707317074,199,33,29.317073170731707,14
Category_Wikipedia_sockpuppets_of_Trendae.csv,7,71617.0,4,3,4,0,0,42.857142857142854,196,52,31.0,17
Category_Wikipedia_sockpuppets_of_Qqqsjdjsdj.csv,104,59080475.0,30,74,16,14,0,78.4423076923077,471,52,19.66346153846154,5
Category_Wikipedia_sockpuppets_of_Hyilix.csv,850,54172106.0,291,559,182,109,0,51.762352941176474,255,57,20.488235294117647,3
Category_Wikipedia_sockpuppets_of_Knowitallfortoday.csv,329,29659964.0,163,166,115,48,0,35.45592705167173,249,47,20.598784194528875,12
Category_Wikipedia_sockpuppets_of_Julio189red.csv,763,171205607.0,192,571,57,135,0,46.93315858453473,370,35,14.35386631716907,4
Category_Wikipedia_sockpuppets_of_Rjrya395.csv,5968,139025007.0,1690,4278,500,1190,0,48.76239946380697,500,97,25.559986595174262,2
Category_Wikipedia_sockpuppets_of_LeaFarthington.csv,18,138110.0,12,6,6,6,16,28.72222222222222,88,16,16.0,16
Category_Wikipedia_sockpuppets_of_Pewny~enwiki.csv,105,142330786.0,43,62,37,6,0,40.39047619047619,221,22,16.00952380952381,10
Category_Wikipedia_sockpuppets_of_Imkaidenlol.csv,1162,26635087.0,561,601,494,67,0,111.53614457831326,496,51,16.290017211703958,4
Category_Wikipedia_sockpuppets_of_Vivekok.csv,303,9171898.0,84,219,32,52,0,52.445544554455445,286,62,18.7986798679868,3
Category_Wikipedia_sockpuppets_of_Marteau.csv,1934,4031530.0,602,1332,500,102,0,69.26215098241985,453,54,20.066184074457084,3
Category_Wikipedia_sockpuppets_of_Wiki-psyc.csv,1561,369023956.0,509,1052,500,9,0,59.083920563741195,496,53,22.3613068545804,5
Category_Wikipedia_sockpuppets_of_TheLEKReports.csv,949,22825700.0,275,674,89,186,0,63.983140147523706,498,55,18.82191780821918,4
Category_Wikipedia_sockpuppets_of_ÏßÄÏΩî_(Í∞ÄÏàò).csv,233,5596333.0,123,110,28,95,0,46.493562231759654,303,39,21.261802575107296,10
Category_Wikipedia_sockpuppets_of_Proclus27.csv,927,52164702.0,349,578,294,55,0,41.27292340884574,238,43,14.81661272923409,5
Category_Wikipedia_sockpuppets_of_Darensillo21.csv,131,37010234.0,41,90,30,11,0,55.99236641221374,241,34,12.755725190839694,9
Category_Wikipedia_sockpuppets_of_Vezaso.csv,319,12736212.0,104,215,94,10,0,27.156739811912225,188,59,18.06896551724138,5
Category_Wikipedia_sockpuppets_of_Arnobkhanakib.csv,30,81409315.0,9,21,9,0,0,53.8,487,26,18.233333333333334,11
Category_Wikipedia_sockpuppets_of_Nileshjambhulkar.csv,221,27726798.0,77,144,37,40,0,45.547511312217196,246,60,24.398190045248867,4
Category_Wikipedia_sockpuppets_of_BrandonSkyPimenta.csv,726,24230867.0,226,500,127,99,0,39.42286501377411,257,51,21.87465564738292,4
Category_Wikipedia_sockpuppets_of_Blelalersitre.csv,247,20154963.0,72,175,34,38,0,64.90688259109312,296,54,19.25910931174089,4
Category_Wikipedia_sockpuppets_of_Drama_panchi.csv,1498,21548265.0,572,926,333,239,0,24.41588785046729,255,59,22.66622162883845,7
Category_Wikipedia_sockpuppets_of_Thommuvtt.csv,367,92203958.0,152,215,147,5,0,36.45504087193461,251,52,17.059945504087192,6
Category_Wikipedia_sockpuppets_of_David_Shankbone.csv,3320,476281120.0,787,2533,500,287,0,50.0933734939759,387,62,17.26957831325301,3
Category_Wikipedia_sockpuppets_of_Temp20220629000.csv,303,5740545.0,187,116,84,103,0,48.72937293729373,267,67,23.617161716171616,3
Category_Wikipedia_sockpuppets_of_Bday1519.csv,43,256103.0,17,26,6,11,0,54.906976744186046,191,31,18.372093023255815,7
Category_Wikipedia_sockpuppets_of_LoVeNoTwAr101.csv,2728,4661524.0,918,1810,500,418,0,55.136730205278596,258,85,22.129032258064516,2
Category_Wikipedia_sockpuppets_of_Starbucks6789.csv,2876,231453211.0,1162,1714,500,662,0,41.66585535465925,488,67,30.581710709318497,11
Category_Wikipedia_sockpuppets_of_Hyperboreangiant.csv,211,1932259.0,66,145,47,19,0,47.25118483412322,207,36,22.824644549763033,9
Category_Wikipedia_sockpuppets_of_DragonGirl2012.csv,196,1934269.0,62,134,25,37,0,53.94387755102041,246,59,19.836734693877553,8
Category_Wikipedia_sockpuppets_of_Funfuntimes2.csv,17,620352.0,7,10,2,5,0,70.47058823529412,188,22,18.058823529411764,15
Category_Wikipedia_sockpuppets_of_Technologist9.csv,132,5184396.0,49,83,34,15,0,53.03030303030303,200,50,19.825757575757574,7
Category_Wikipedia_sockpuppets_of_Celeste6566.csv,28,5388476.0,12,16,12,0,0,29.214285714285715,150,27,17.75,11
Category_Wikipedia_sockpuppets_of_Accuracy21.csv,270,10390827.0,114,156,63,51,0,46.2,216,41,22.51851851851852,13
Category_Wikipedia_sockpuppets_of_TranslatorAli94.csv,91,16861352.0,40,51,34,6,0,84.9010989010989,388,25,21.439560439560438,15
Category_Wikipedia_sockpuppets_of_Yashi_Yadav.csv,104,26410786.0,21,83,13,8,0,47.02884615384615,255,53,21.423076923076923,8
Category_Wikipedia_sockpuppets_of_Interuniversalism1.csv,3,197.0,3,0,3,0,0,0.0,0,19,19.0,19
Category_Wikipedia_sockpuppets_of_SniperLight47.csv,963,15218433.0,405,558,311,94,0,31.767393561786086,500,50,15.077881619937695,8
Category_Wikipedia_sockpuppets_of_Enwiki23.csv,458,32587201.0,148,310,55,93,0,44.748908296943235,269,76,18.965065502183407,5
Category_Wikipedia_sockpuppets_of_Captainyoung.csv,78,32011001.0,30,48,11,19,0,38.14102564102564,186,37,18.73076923076923,9
Category_Wikipedia_sockpuppets_of_Ethanfgrant.csv,737,20248178.0,255,482,213,42,0,53.32293080054274,496,54,21.51696065128901,9
Category_Wikipedia_sockpuppets_of_Clamticore.csv,2379,16606529.0,592,1787,500,92,0,36.556956704497686,263,70,20.683060109289617,2
Category_Wikipedia_sockpuppets_of_Hazem_taha_hussein.csv,11,67908870.0,8,3,6,2,0,53.09090909090909,181,76,34.54545454545455,23
Category_Wikipedia_sockpuppets_of_Ashwing.csv,73,313535821.0,21,52,14,7,0,50.9041095890411,243,54,20.34246575342466,6
Category_Wikipedia_sockpuppets_of_Dipra_Dattasarma.csv,65,535616.0,39,26,37,2,0,40.93846153846154,165,90,41.90769230769231,4
Category_Wikipedia_sockpuppets_of_Jonathan_Albrardo_Alexis_Meza.csv,637,137641925.0,146,491,72,74,0,46.2574568288854,255,64,31.2276295133438,8
Category_Wikipedia_sockpuppets_of_Fgtwyyryrrr.csv,167,23001993.0,66,101,37,29,0,44.69461077844311,227,23,12.497005988023952,5
Category_Wikipedia_sockpuppets_of_Sher_Aziz.csv,865,54243032.0,313,552,190,123,0,46.33179190751445,255,29,11.366473988439306,1
Category_Wikipedia_sockpuppets_of_Bnguyen.csv,2673,65251047.0,853,1820,500,353,0,46.46913580246913,255,48,16.87878787878788,4
Category_Wikipedia_sockpuppets_of_Aloeveraistupid.csv,11,692.0,5,6,4,1,0,68.9090909090909,200,10,9.181818181818182,9
Category_Wikipedia_sockpuppets_of_VisitorSSS.csv,119,57867418.0,35,84,27,8,0,34.36134453781513,220,35,14.050420168067227,9
Category_Wikipedia_sockpuppets_of_ÿπÿ®ÿØÿßŸÑŸÑŸá_ÿØŸäÿ±Ÿä.csv,4094,43982235.0,1179,2915,500,679,0,33.77870053737176,451,75,24.660478749389352,3
Category_Wikipedia_sockpuppets_of_Jose.medez248.csv,97,456059.0,32,65,14,18,0,56.90721649484536,246,33,20.082474226804123,8
Category_Wikipedia_sockpuppets_of_OlympicFan.csv,494,62969842.0,186,308,93,93,0,44.75910931174089,197,48,20.51417004048583,14
Category_Wikipedia_sockpuppets_of_CreativeEndeavors.csv,14,9803254.0,12,2,6,6,0,40.5,124,47,42.0,17
Category_Wikipedia_sockpuppets_of_Pvn_kr.csv,18,36126.0,9,9,8,1,0,52.888888888888886,156,16,14.0,13
Category_Wikipedia_sockpuppets_of_Thigle.csv,6964,53314966.0,2538,4426,500,2038,0,44.0433658816772,255,52,17.596352670878805,3
Category_Wikipedia_sockpuppets_of_Pesf.csv,1270,56245998.0,422,848,256,166,0,32.43307086614173,250,46,15.5,4
Category_Wikipedia_sockpuppets_of_The_Salvator.csv,2377,35862514.0,565,1812,500,65,0,41.81909970551115,421,72,27.567101388304586,4
Category_Wikipedia_sockpuppets_of_Dinoboyaz.csv,2044,273744673.0,527,1517,500,27,0,53.20743639921722,491,68,27.3454011741683,5
Category_Wikipedia_sockpuppets_of_Chaitanya.agarwal35.csv,613,4418545.0,202,411,176,26,0,41.6884176182708,281,51,27.249592169657422,6
Category_Wikipedia_sockpuppets_of_Acomasga.csv,146,187621667.0,54,92,52,2,0,35.28767123287671,194,25,18.801369863013697,5
Category_Wikipedia_sockpuppets_of_Duncanjonny.csv,32,431639.0,7,25,7,0,0,51.28125,146,54,23.90625,5
Category_Wikipedia_sockpuppets_of_MrRosstheScientist.csv,51,310614.0,27,24,16,11,0,59.78431372549019,327,28,20.019607843137255,13
Category_Wikipedia_sockpuppets_of_Mackemfixer.csv,3388,109485485.0,1000,2388,500,500,0,56.20218417945691,250,87,20.55047225501771,3
Category_Wikipedia_sockpuppets_of_Russian.science.csv,289,14416948.0,118,171,68,50,0,40.69896193771626,221,28,14.858131487889274,10
Category_Wikipedia_sockpuppets_of_Shehroz911.csv,7,432615.0,4,3,3,1,0,24.142857142857142,121,10,8.857142857142858,6
Category_Wikipedia_sockpuppets_of_Guy_from_Sargodha.csv,41,11133973.0,13,28,6,7,0,42.073170731707314,205,21,10.829268292682928,10
Category_Wikipedia_sockpuppets_of_Hanam190552.csv,1248,21706149.0,456,792,388,68,0,42.25480769230769,255,52,25.033653846153847,7
Category_Wikipedia_sockpuppets_of_RR2.csv,88,10364501.0,26,62,17,9,0,19.261363636363637,96,39,17.28409090909091,13
Category_Wikipedia_sockpuppets_of_Jiangye.csv,154,77264240.0,81,73,79,2,0,46.1948051948052,500,29,12.993506493506494,10
Category_Wikipedia_sockpuppets_of_Tyuuuri.csv,963,14773147.0,579,384,293,286,0,23.370716510903428,255,59,23.5202492211838,5
Category_Wikipedia_sockpuppets_of_Antachor.csv,46,1729434.0,18,28,13,5,0,37.78260869565217,133,29,18.717391304347824,11
Category_Wikipedia_sockpuppets_of_Drnnwmn.csv,21,9946026.0,12,9,11,1,0,35.285714285714285,196,24,15.80952380952381,11
Category_Wikipedia_sockpuppets_of_Alexia_96.csv,19,158100584.0,7,12,4,3,0,40.94736842105263,211,19,13.578947368421053,8
Category_Wikipedia_sockpuppets_of_Canterbuyyy_conciiill.csv,32,4633.0,15,17,13,2,0,28.625,211,24,22.125,9
Category_Wikipedia_sockpuppets_of_Shemijoseph.csv,7,307435558.0,7,0,7,0,0,9.571428571428571,29,21,21.0,21
Category_Wikipedia_sockpuppets_of_Fatal1er.csv,228,61272400.0,94,134,94,0,0,37.24561403508772,236,27,14.236842105263158,5
Category_Wikipedia_sockpuppets_of_Suryoyo124.csv,646,35167832.0,245,401,229,16,0,48.190402476780186,255,55,18.972136222910216,7
Category_Wikipedia_sockpuppets_of_Divinemomentever.csv,653,36026889.0,196,457,184,12,0,53.36140888208269,495,37,11.759571209800919,5
Category_Wikipedia_sockpuppets_of_Kamiya_Khurana.csv,801,7970042.0,224,577,206,18,0,34.278401997503124,239,52,17.01498127340824,6
Category_Wikipedia_sockpuppets_of_Katie_daubney.csv,18,1921182.0,12,6,8,4,0,36.44444444444444,194,38,18.11111111111111,11
Category_Wikipedia_sockpuppets_of_SantiagoClaudio.csv,1369,3559809.0,500,869,500,0,0,29.909422936449964,255,73,25.015339663988314,7
Category_Wikipedia_sockpuppets_of_CAPTAIN_KOOKY.csv,844,8281419.0,282,562,211,71,0,64.18364928909952,418,60,16.740521327014218,5
Category_Wikipedia_sockpuppets_of_Canto2009.csv,2719,36469467.0,799,1920,482,317,0,36.696211842589186,233,55,17.12909157778595,3
Category_Wikipedia_sockpuppets_of_KaranSharma0445.csv,6472,115748774.0,1777,4695,305,1472,0,45.213226205191596,495,66,18.348114956736712,4
Category_Wikipedia_sockpuppets_of_Duegito_forlancito.csv,12,1274.0,5,7,3,2,0,47.333333333333336,180,30,22.083333333333332,16
Category_Wikipedia_sockpuppets_of_LUCPOL.csv,1797,158356196.0,574,1223,500,74,0,36.32554257095158,226,69,18.068447412353922,4
Category_Wikipedia_sockpuppets_of_FletcherPE.csv,736,17759136.0,290,446,96,194,0,47.52173913043478,500,47,15.035326086956522,4
Category_Wikipedia_sockpuppets_of_Oliverwoodall.csv,1,0.0,1,0,1,0,0,0.0,0,13,13.0,13
Category_Wikipedia_sockpuppets_of_Vineetpl7.csv,217,13126891.0,66,151,47,19,0,43.382488479262676,235,55,19.525345622119815,6
Category_Wikipedia_sockpuppets_of_SageGreenRiderGhost.csv,16,58628.0,11,5,10,1,0,43.5625,196,24,21.1875,19
Category_Wikipedia_sockpuppets_of_Benjaminpstein.csv,105,131232231.0,48,57,40,8,0,41.22857142857143,196,24,20.476190476190474,18
Category_Wikipedia_sockpuppets_of_Bcbryar643.csv,1090,13566212.0,376,714,172,204,0,37.29724770642202,272,48,20.994495412844035,4
Category_Wikipedia_sockpuppets_of_Mackoy20.csv,2495,12357783.0,869,1626,500,369,0,32.81482965931864,250,72,16.134669338677355,3
Category_Wikipedia_sockpuppets_of_WikiVPN888.csv,1,0.0,1,0,1,0,0,0.0,0,20,20.0,20
Category_Wikipedia_sockpuppets_of_Unity2020.csv,6,88132.0,6,0,4,2,0,6.0,20,39,39.0,39
Category_Wikipedia_sockpuppets_of_American_Samuel.csv,14,8608.0,6,8,4,2,25,41.857142857142854,76,37,31.785714285714285,22
Category_Wikipedia_sockpuppets_of_M.deSousa.csv,550,74467387.0,167,383,160,7,0,38.93636363636364,255,64,22.94,9
Category_Wikipedia_sockpuppets_of_Parkypark94.csv,54,6655149.0,47,7,42,5,0,27.185185185185187,196,25,17.574074074074073,12
Category_Wikipedia_sockpuppets_of_MarkIblog.csv,586,22242330.0,189,397,91,98,0,40.8839590443686,238,34,13.430034129692833,3
Category_Wikipedia_sockpuppets_of_Lakata.csv,142,1987431.0,60,82,54,6,0,43.33802816901409,209,54,27.711267605633804,16
Category_Wikipedia_sockpuppets_of_Iamafanofthissite123.csv,19,157193.0,5,14,4,1,0,37.31578947368421,152,24,21.57894736842105,19
Category_Wikipedia_sockpuppets_of_Anfisa_Foxcat.csv,6,953607.0,2,4,2,0,0,44.0,155,45,41.333333333333336,23
Category_Wikipedia_sockpuppets_of_DNA_Bubbles.csv,71,277724290.0,29,42,20,9,0,33.647887323943664,212,31,23.04225352112676,15
Category_Wikipedia_sockpuppets_of_Meeanaya.csv,1069,3203669.0,508,561,500,8,0,59.70533208606174,363,95,26.684752104770816,4
Category_Wikipedia_sockpuppets_of_Zsombor_wiki.csv,18,5472149.0,9,9,9,0,0,40.333333333333336,158,37,18.22222222222222,8
Category_Wikipedia_sockpuppets_of_Kokogilet.csv,12,80550.0,9,3,9,0,0,29.25,118,28,26.0,25
Category_Wikipedia_sockpuppets_of_Suciindia.csv,1103,52275893.0,511,592,368,143,0,39.361740707162284,232,48,31.03173164097915,6
Category_Wikipedia_sockpuppets_of_Leftowiki.csv,152,43652289.0,71,81,40,31,0,41.91447368421053,258,38,15.473684210526315,3
Category_Wikipedia_sockpuppets_of_Deonis_2012.csv,5595,133312451.0,2569,3026,500,2069,0,64.83163538873994,255,83,35.94620196604111,6
Category_Wikipedia_sockpuppets_of_Joebobaboba.csv,1057,12867544.0,377,680,356,21,0,37.61305581835383,235,55,27.70860927152318,8
Category_Wikipedia_sockpuppets_of_Simransertt.csv,329,35513215.0,111,218,54,57,0,50.26747720364742,496,58,18.65045592705167,4
Category_Wikipedia_sockpuppets_of_CCHYCC.csv,1,0.0,1,0,1,0,0,0.0,0,10,10.0,10
Category_Wikipedia_sockpuppets_of_Tamilpadai.csv,613,6518657.0,177,436,95,82,0,77.71288743882545,483,50,18.225122349102772,6
Category_Wikipedia_sockpuppets_of_Orijentolog.csv,3557,264759769.0,854,2703,500,354,0,43.807140849030084,255,50,14.904694967669384,3
Category_Wikipedia_sockpuppets_of_Khondoker_Jobair.csv,3083,91714918.0,946,2137,500,446,0,38.71942912747324,500,52,14.646772624067466,3
Category_Wikipedia_sockpuppets_of_Clark'tralana.csv,24,1640756.0,9,15,4,5,0,55.458333333333336,196,53,33.375,10
Category_Wikipedia_sockpuppets_of_AcceptJesus2020.csv,26,857461.0,15,11,15,0,0,57.57692307692308,196,62,31.53846153846154,12
Category_Wikipedia_sockpuppets_of_Klots888.csv,314,102627470.0,115,199,113,2,0,44.75796178343949,255,51,24.5,10
Category_Wikipedia_sockpuppets_of_Moustafa_Nour.csv,314,6605620.0,82,232,81,1,0,51.531847133757964,237,51,15.433121019108281,4
Category_Wikipedia_sockpuppets_of_Marin_Software.csv,5,7581.0,3,2,3,0,0,1.4,7,24,24.0,24
Category_Wikipedia_sockpuppets_of_Mehata_Aditya.csv,242,5326402.0,135,107,103,32,0,43.50413223140496,239,60,29.39669421487603,4
Category_Wikipedia_sockpuppets_of_Inilabas.csv,34,141.0,12,22,7,5,0,22.235294117647058,124,22,15.205882352941176,7
Category_Wikipedia_sockpuppets_of_AuggiePaoli.csv,30,3991501.0,7,23,7,0,0,43.2,181,23,21.133333333333333,16
Category_Wikipedia_sockpuppets_of_AndImAlreadyTires22.csv,7,411623.0,2,5,1,1,16,67.85714285714286,150,12,12.0,12
Category_Wikipedia_sockpuppets_of_Faster328.csv,548,5583986.0,250,298,211,39,0,54.2043795620438,410,47,17.470802919708028,12
Category_Wikipedia_sockpuppets_of_Akwarrior1988.csv,42,1256941.0,32,10,25,7,0,33.57142857142857,199,23,16.0,9
Category_Wikipedia_sockpuppets_of_CyberPython21.csv,683,55163275.0,232,451,223,9,0,48.174231332357245,254,30,17.38506588579795,8
Category_Wikipedia_sockpuppets_of_Briuns.csv,30,264907.0,15,15,11,4,0,75.06666666666666,454,27,21.233333333333334,14
Category_Wikipedia_sockpuppets_of_UnixBased.csv,606,48279860.0,217,389,190,27,0,50.77062706270627,500,74,31.226072607260726,7
Category_Wikipedia_sockpuppets_of_Mr._Whiskers_and_Eugenie.csv,74,868460.0,25,49,10,15,0,55.432432432432435,222,38,20.054054054054053,3
Category_Wikipedia_sockpuppets_of_ShazeTempain.csv,24,95746482.0,6,18,4,2,0,56.5,176,30,19.958333333333332,16
Category_Wikipedia_sockpuppets_of_SeriousHist.csv,1104,144824262.0,395,709,358,37,0,56.47644927536232,499,47,24.284420289855074,11
Category_Wikipedia_sockpuppets_of_Zaketo.csv,2251,66991968.0,481,1770,432,49,0,54.339848956019544,255,67,19.77165704131497,2
Category_Wikipedia_sockpuppets_of_FukDaNigas.csv,36,592744.0,23,13,10,13,0,43.083333333333336,200,27,20.166666666666668,7
Category_Wikipedia_sockpuppets_of_LesVegas.csv,1424,59917894.0,516,908,500,16,0,56.375,255,75,34.174157303370784,10
Category_Wikipedia_sockpuppets_of_Khonika.csv,90,227296437.0,35,55,21,14,0,51.87777777777778,269,57,38.36666666666667,17
Category_Wikipedia_sockpuppets_of_Remus00.csv,93,2565364.0,25,68,14,11,0,48.45161290322581,252,40,15.720430107526882,8
Category_Wikipedia_sockpuppets_of_TroySchulz.csv,2501,97549919.0,555,1946,500,55,0,35.21351459416233,386,54,17.88844462215114,5
Category_Wikipedia_sockpuppets_of_Ctway.csv,2883,143937810.0,956,1927,299,657,0,35.8182448838016,255,56,16.611168921262575,3
Category_Wikipedia_sockpuppets_of_Throwawayarb.csv,295,3633269.0,100,195,79,21,0,56.152542372881356,223,61,34.73898305084746,11
Category_Wikipedia_sockpuppets_of_Ohyababy1.csv,85,907659.0,25,60,8,17,0,49.62352941176471,221,24,12.576470588235294,4
Category_Wikipedia_sockpuppets_of_AnxFab.csv,40,109389426.0,11,29,11,0,12,59.95,193,22,19.825,11
Category_Wikipedia_sockpuppets_of_Amador_jover.csv,437,20560722.0,162,275,74,88,0,28.887871853546912,210,49,20.576659038901603,10
Category_Wikipedia_sockpuppets_of_Subtorp.csv,118,12357870.0,33,85,7,26,0,67.65254237288136,245,30,13.771186440677965,7
Category_Wikipedia_sockpuppets_of_Yep!_12345.csv,1,0.0,1,0,1,0,0,0.0,0,23,23.0,23
Category_Wikipedia_sockpuppets_of_Adam_Asrul.csv,588,21478592.0,180,408,79,101,0,40.30952380952381,276,45,16.668367346938776,4
Category_Wikipedia_sockpuppets_of_DonnaK97.csv,1251,11376674.0,518,733,500,18,0,44.820943245403676,242,33,24.327737809752197,4
Category_Wikipedia_sockpuppets_of_Ryanphelpshere.csv,328,4307702.0,110,218,17,93,0,50.5609756097561,255,44,22.097560975609756,10
Category_Wikipedia_sockpuppets_of_Bompally_Bhanu_teja.csv,147,2927088.0,42,105,33,9,0,37.42176870748299,238,37,19.13605442176871,7
Category_Wikipedia_sockpuppets_of_ArjunKapoor¬π¬≤.csv,136,624841.0,47,89,47,0,0,39.23529411764706,346,23,15.426470588235293,9
Category_Wikipedia_sockpuppets_of_Diyako_kazm.csv,206,252467273.0,52,154,43,9,0,47.70873786407767,285,46,18.92718446601942,5
Category_Wikipedia_sockpuppets_of_Vitalsines.csv,21,14390.0,12,9,12,0,0,57.61904761904762,239,20,15.761904761904763,10
Category_Wikipedia_sockpuppets_of_Vizorblaze.csv,184,1347286.0,66,118,39,27,0,53.79347826086956,334,62,22.559782608695652,3
Category_Wikipedia_sockpuppets_of_Lalitshastri.csv,141,429957360.0,45,96,36,9,0,54.226950354609926,253,48,18.404255319148938,12
Category_Wikipedia_sockpuppets_of_Huesantran.csv,4,69.0,2,2,2,0,0,0.0,0,25,25.0,25
Category_Wikipedia_sockpuppets_of_David_Gushee.csv,6,16829.0,4,2,2,2,34,134.0,195,19,15.666666666666666,15
Category_Wikipedia_sockpuppets_of_Jellyman12345.csv,31,95474.0,9,22,6,3,0,73.51612903225806,239,25,16.806451612903224,13
Category_Wikipedia_sockpuppets_of_Specified_Valid_Username.csv,53,607100.0,17,36,17,0,0,62.81132075471698,202,37,20.71698113207547,13
Category_Wikipedia_sockpuppets_of_Vodkapoise.csv,7037,78866235.0,1875,5162,190,1685,0,50.84979394628393,316,72,19.788546255506606,1
Category_Wikipedia_sockpuppets_of_Kalajan.csv,1359,5371898.0,481,878,200,281,0,38.26122148638705,230,68,20.19793966151582,5
Category_Wikipedia_sockpuppets_of_Maltisafi.csv,284,218491196.0,100,184,94,6,0,36.683098591549296,254,50,18.66549295774648,5
Category_Wikipedia_sockpuppets_of_Fratboy101.csv,84,50614282.0,28,56,25,3,0,38.73809523809524,164,61,15.214285714285714,5
Category_Wikipedia_sockpuppets_of_Marksanta123.csv,102,16952666.0,38,64,32,6,0,64.41176470588235,250,23,18.774509803921568,18
Category_Wikipedia_sockpuppets_of_ST4811.csv,2,2939964.0,2,0,1,1,0,0.0,0,15,15.0,15
Category_Wikipedia_sockpuppets_of_Mohammedwrya.csv,67,40495945.0,26,41,21,5,0,44.11940298507463,184,53,24.328358208955223,10
Category_Wikipedia_sockpuppets_of_Bhavs_Mo.csv,2,0.0,1,1,1,0,0,0.0,0,18,18.0,18
Category_Wikipedia_sockpuppets_of_Addie293.csv,2785,285812215.0,663,2122,447,216,0,58.70592459605027,500,63,21.719569120287254,4
Category_Wikipedia_sockpuppets_of_JustinBoy1267.csv,742,7513216.0,231,511,46,185,0,55.24797843665768,299,48,20.043126684636118,3
Category_Wikipedia_sockpuppets_of_Katerina_Spravtseva.csv,87,3627961.0,41,46,23,18,0,60.13793103448276,470,52,24.344827586206897,15
Category_Wikipedia_sockpuppets_of_InsideRecordings.csv,19,459100.0,15,4,7,8,0,47.05263157894737,241,11,11.0,11
Category_Wikipedia_sockpuppets_of_Isabellabean.csv,166,11638980.0,87,79,77,10,0,58.89156626506024,254,19,15.94578313253012,12
Category_Wikipedia_sockpuppets_of_Bkoohy.csv,11,383968.0,5,6,3,2,0,42.27272727272727,116,18,14.363636363636363,12
Category_Wikipedia_sockpuppets_of_Tawarvipinkumar.csv,21,675645.0,9,12,7,2,0,53.904761904761905,219,25,18.095238095238095,10
Category_Wikipedia_sockpuppets_of_VeryGoodBoy.csv,3195,473472735.0,963,2232,500,463,0,54.920500782472615,491,55,14.082942097026605,5
Category_Wikipedia_sockpuppets_of_Festermunk.csv,2346,34564762.0,656,1690,500,156,0,49.108695652173914,255,60,22.88832054560955,2
Category_Wikipedia_sockpuppets_of_Marsden.csv,2087,193223879.0,633,1454,500,133,0,44.95016770483948,232,92,26.68327743172017,5
Category_Wikipedia_sockpuppets_of_Maddytheemotrash.csv,12,2334632.0,4,8,3,1,5,60.916666666666664,163,29,18.333333333333332,12
Category_Wikipedia_sockpuppets_of_TheEditor22.csv,424,57334662.0,159,265,156,3,0,44.863207547169814,228,50,22.32547169811321,8
Category_Wikipedia_sockpuppets_of_Julliann_Ross.csv,238,4244042.0,78,160,39,39,0,46.22268907563025,247,38,17.630252100840337,7
Category_Wikipedia_sockpuppets_of_Oprahwasontv.csv,710,36484466.0,206,504,77,129,0,48.00985915492958,204,53,20.743661971830985,5
Category_Wikipedia_sockpuppets_of_Stonestoneeee.csv,387,132213607.0,88,299,13,75,0,55.333333333333336,348,47,21.087855297157624,7
Category_Wikipedia_sockpuppets_of_Jchasan.csv,118,120049400.0,24,94,23,1,0,47.86440677966102,227,21,13.720338983050848,6
Category_Wikipedia_sockpuppets_of_Doodlefaceright.csv,17,3985.0,10,7,6,4,3,31.41176470588235,137,14,12.176470588235293,11
Category_Wikipedia_sockpuppets_of_Robsdsu.csv,12,8272224.0,6,6,4,2,0,84.41666666666667,199,26,21.166666666666668,12
Category_Wikipedia_sockpuppets_of_Cazzaman.csv,1,0.0,1,0,1,0,13,13.0,13,11,11.0,11
Category_Wikipedia_sockpuppets_of_Tehseenahmad96.csv,317,4397616.0,111,206,88,23,0,30.91167192429022,236,31,16.52365930599369,8
Category_Wikipedia_sockpuppets_of_Truthserum213.csv,15,866900.0,8,7,5,3,13,80.53333333333333,257,19,12.066666666666666,11
Category_Wikipedia_sockpuppets_of_Aakashcla.csv,19,940740.0,9,10,9,0,0,55.94736842105263,183,26,22.157894736842106,17
Category_Wikipedia_sockpuppets_of_Trfc2019.csv,129,6383848.0,39,90,14,25,0,51.27906976744186,272,28,18.852713178294575,7
Category_Wikipedia_sockpuppets_of_Sumra_Jabeen.csv,11,4943.0,4,7,3,1,38,103.36363636363636,496,66,46.45454545454545,17
Category_Wikipedia_sockpuppets_of_Laks883.csv,988,15818397.0,410,578,206,204,0,50.322874493927124,499,42,17.62348178137652,7
Category_Wikipedia_sockpuppets_of_Locky1986.csv,2770,9614701.0,950,1820,500,450,0,43.525270758122744,395,42,16.666064981949457,3
Category_Wikipedia_sockpuppets_of_Stefanomione.csv,1389,230793404.0,506,883,500,6,0,55.52699784017279,342,61,29.873290136789056,9
Category_Wikipedia_sockpuppets_of_DrAgubua.csv,418,6316206.0,137,281,17,120,0,52.514354066985646,217,57,19.48803827751196,5
Category_Wikipedia_sockpuppets_of_Snoopzta.csv,33,1413.0,9,24,9,0,0,72.78787878787878,209,35,5.878787878787879,4
Category_Wikipedia_sockpuppets_of_Bbisgod333.csv,288,1218637.0,95,193,18,77,0,48.677083333333336,246,66,17.56597222222222,4
Category_Wikipedia_sockpuppets_of_Macnit.csv,5,330214.0,5,0,3,2,19,35.2,84,48,32.4,5
Category_Wikipedia_sockpuppets_of_Scieberking.csv,1436,32061889.0,551,885,500,51,0,49.63857938718663,255,55,22.11281337047354,4
Category_Wikipedia_sockpuppets_of_Bebo71.csv,1594,8161065.0,966,628,500,466,0,23.789209535759095,500,66,22.163739021329988,10
Category_Wikipedia_sockpuppets_of_Jzaooo.csv,204,2172622.0,69,135,35,34,0,70.24509803921569,417,24,14.485294117647058,10
Category_Wikipedia_sockpuppets_of_Christiancool123.csv,625,15281941.0,213,412,158,55,0,46.0848,364,51,18.8784,5
Category_Wikipedia_sockpuppets_of_Mathematica_kgb.csv,33,1384.0,13,20,8,5,0,34.60606060606061,203,43,23.151515151515152,15
Category_Wikipedia_sockpuppets_of_JarvisJones95.csv,321,24492586.0,128,193,37,91,0,51.19314641744548,496,71,25.707165109034268,10
Category_Wikipedia_sockpuppets_of_Capitalistmaniac.csv,142,5766959.0,47,95,43,4,0,32.767605633802816,204,43,27.922535211267604,4
Category_Wikipedia_sockpuppets_of_Ricardo_Torez.csv,6,81212.0,4,2,4,0,0,39.333333333333336,86,18,12.666666666666666,10
Category_Wikipedia_sockpuppets_of_Famiddleton.csv,72,260691685.0,21,51,16,5,0,56.18055555555556,231,37,23.819444444444443,7
Category_Wikipedia_sockpuppets_of_Daniel_David_Shafer.csv,127,1853707.0,106,21,106,0,0,14.952755905511811,135,32,31.74015748031496,29
Category_Wikipedia_sockpuppets_of_LordBirdWord.csv,590,40364996.0,211,379,207,4,0,51.78135593220339,497,87,33.22372881355932,6
Category_Wikipedia_sockpuppets_of_CrossHybridCollab2024.csv,5,547562.0,4,1,3,1,19,53.2,154,18,18.0,18
Category_Wikipedia_sockpuppets_of_Buseyisourtruesavior.csv,26,7457.0,11,15,5,6,0,62.69230769230769,225,24,15.076923076923077,10
Category_Wikipedia_sockpuppets_of_KashiXCP21.csv,4,44.0,2,2,2,0,27,87.25,174,25,25.0,25
Category_Wikipedia_sockpuppets_of_Loganrobert96.csv,488,210129868.0,150,338,52,98,0,44.31967213114754,248,68,21.01844262295082,6
Category_Wikipedia_sockpuppets_of_AntiHeroAnkit.csv,14,1653164.0,4,10,3,1,0,41.642857142857146,127,47,32.285714285714285,17
Category_Wikipedia_sockpuppets_of_Yourboi123321.csv,4,89.0,3,1,3,0,0,47.25,189,7,7.0,7
Category_Wikipedia_sockpuppets_of_Kawhilaugh42.csv,1258,8063722.0,463,795,383,80,0,50.70031796502385,500,63,33.37519872813991,4
Category_Wikipedia_sockpuppets_of_Le_Lis_et_le_Lion.csv,1329,32318252.0,612,717,500,112,0,31.562076749435665,496,80,40.99398043641836,10
Category_Wikipedia_sockpuppets_of_Warmlytech.csv,567,128143193.0,182,385,155,27,0,51.64902998236332,272,64,17.326278659611994,7
Category_Wikipedia_sockpuppets_of_Cptnite.csv,88,14661797.0,48,40,41,7,0,48.45454545454545,196,25,17.397727272727273,12
Category_Wikipedia_sockpuppets_of_Terpsfan4ever002.csv,21,16122001.0,7,14,6,1,0,31.19047619047619,131,44,24.80952380952381,12
Category_Wikipedia_sockpuppets_of_Last_rhino.csv,21,1730976.0,10,11,7,3,0,61.76190476190476,207,27,18.285714285714285,12
Category_Wikipedia_sockpuppets_of_DFC_Free_Oz.csv,132,12681051.0,45,87,18,27,0,38.64393939393939,199,67,25.78787878787879,7
Category_Wikipedia_sockpuppets_of_Applicant.csv,16,1307380.0,8,8,2,6,19,89.75,182,13,10.375,10
Category_Wikipedia_sockpuppets_of_Tkwikihelper.csv,828,60685503.0,267,561,257,10,0,48.138888888888886,255,62,15.765700483091788,5
Category_Wikipedia_sockpuppets_of_Hollybh.csv,462,12895914.0,163,299,88,75,0,42.4025974025974,294,54,27.365800865800868,8
Category_Wikipedia_sockpuppets_of_Garfield_Garfield.csv,2224,8361823.0,697,1527,500,197,0,46.26618705035971,255,36,18.77338129496403,7
Category_Wikipedia_sockpuppets_of_Natces.csv,25,43921.0,9,16,6,3,0,35.96,116,61,37.2,16
Category_Wikipedia_sockpuppets_of_Maxadamia.csv,2534,255553570.0,1060,1474,419,641,0,43.617600631412785,436,103,18.01578531965272,5
Category_Wikipedia_sockpuppets_of_Futurepilot1999.csv,3945,14265478.0,1037,2908,500,537,0,52.3617237008872,255,54,21.4489226869455,7
Category_Wikipedia_sockpuppets_of_James0293.csv,11,3622198.0,8,3,5,3,0,53.27272727272727,132,19,19.0,19
Category_Wikipedia_sockpuppets_of_Mattewjohnes.csv,3,276.0,3,0,3,0,42,100.66666666666667,215,44,44.0,44
Category_Wikipedia_sockpuppets_of_Wise_As_Angel.csv,74,38956582.0,18,56,12,6,0,46.013513513513516,220,36,30.83783783783784,4
Category_Wikipedia_sockpuppets_of_Solaris5296.csv,840,35184835.0,319,521,292,27,0,43.679761904761904,496,61,28.314285714285713,7
Category_Wikipedia_sockpuppets_of_Johngoodman2015.csv,4,3870.0,4,0,4,0,0,12.0,16,32,32.0,32
Category_Wikipedia_sockpuppets_of_Garlicguy.csv,89,774662.0,33,56,20,13,0,41.46067415730337,168,27,15.629213483146067,9
Category_Wikipedia_sockpuppets_of_Fireguy012345.csv,15,7346.0,8,7,5,3,0,26.2,130,27,13.0,6
Category_Wikipedia_sockpuppets_of_Vivek.k.Verma.csv,1184,160010550.0,390,794,277,113,0,45.69763513513514,308,63,17.97972972972973,4
Category_Wikipedia_sockpuppets_of_Girmv.csv,256,21060096.0,90,166,21,69,0,47.15234375,254,53,18.08984375,5
Category_Wikipedia_sockpuppets_of_Vexillographer.csv,411,14716680.0,108,303,60,48,0,55.352798053527984,263,47,21.447688564476884,6
Category_Wikipedia_sockpuppets_of_Troll258.csv,11,2417.0,7,4,7,0,0,57.81818181818182,201,18,16.90909090909091,12
Category_Wikipedia_sockpuppets_of_President26.csv,40,353231.0,15,25,12,3,0,65.775,249,46,21.975,5
Category_Wikipedia_sockpuppets_of_Califa22651.csv,532,38700574.0,180,352,94,86,0,53.475563909774436,231,41,20.415413533834588,9
Category_Wikipedia_sockpuppets_of_Freakee73.csv,210,64535386.0,63,147,27,36,0,44.30952380952381,215,78,25.995238095238093,12
Category_Wikipedia_sockpuppets_of_Carliniphoto.csv,90,33166818.0,30,60,29,1,0,30.944444444444443,186,44,24.322222222222223,11
Category_Wikipedia_sockpuppets_of_ZitoND.csv,2153,22540221.0,684,1469,439,245,0,53.11658151416628,500,66,28.824431026474688,4
Category_Wikipedia_sockpuppets_of_KoolCid69.csv,11,14983.0,8,3,7,1,0,26.545454545454547,178,39,35.81818181818182,32
Category_Wikipedia_sockpuppets_of_Shikari_123.csv,2280,13455056.0,650,1630,500,150,0,42.94824561403509,255,64,18.07938596491228,5
Category_Wikipedia_sockpuppets_of_Mansand1000.csv,167,22284181.0,54,113,31,23,0,56.65868263473054,254,49,20.437125748502993,10
Category_Wikipedia_sockpuppets_of_Raptor_Red.csv,1483,50299907.0,469,1014,209,260,0,40.599460552933245,248,82,20.906945380984492,7
Category_Wikipedia_sockpuppets_of_Jhony_jhony_yes_papa.csv,1545,36215191.0,363,1182,64,299,0,47.618770226537215,255,59,22.089967637540454,5
Category_Wikipedia_sockpuppets_of_I_d_like_watch.csv,308,2850668.0,82,226,26,56,0,39.717532467532465,327,47,18.801948051948052,6
Category_Wikipedia_sockpuppets_of_Jitendra_singh_123444.csv,6,972.0,4,2,3,1,9,68.66666666666667,169,17,17.0,17
Category_Wikipedia_sockpuppets_of_Aethelwolf_Emsworth.csv,3059,9298310.0,1214,1845,500,714,0,49.68813337692056,500,70,22.097090552468128,5
Category_Wikipedia_sockpuppets_of_Pal√§otechnologe.csv,14,1460398.0,4,10,3,1,0,58.0,196,25,24.857142857142858,24
Category_Wikipedia_sockpuppets_of_Twotrees11.csv,27,157836451.0,10,17,9,1,0,35.22222222222222,129,5,5.0,5
Category_Wikipedia_sockpuppets_of_Bubble_hunter_2000.csv,58,432967.0,27,31,15,12,0,44.03448275862069,186,12,7.706896551724138,5
Category_Wikipedia_sockpuppets_of_Oro2.csv,2327,107475630.0,633,1694,500,133,0,45.41856467554791,255,57,16.020197679415556,2
Category_Wikipedia_sockpuppets_of_GhanaDa.csv,6479,331147387.0,2000,4479,500,1500,0,39.11359777743479,376,102,22.24062355301744,3
Category_Wikipedia_sockpuppets_of_Dodo_bird_die3.csv,19,15777.0,11,8,8,3,0,47.78947368421053,238,36,23.894736842105264,19
Category_Wikipedia_sockpuppets_of_Patil7320.csv,1,0.0,1,0,1,0,140,140.0,140,19,19.0,19
Category_Wikipedia_sockpuppets_of_Erich_Mayer.csv,354,60116.0,133,221,121,12,0,64.30225988700565,250,49,18.39830508474576,9
Category_Wikipedia_sockpuppets_of_KINGOFSPIN1.csv,28,1350509.0,8,20,4,4,0,63.714285714285715,184,38,18.428571428571427,7
Category_Wikipedia_sockpuppets_of_Geena22718.csv,35,509608.0,13,22,12,1,0,40.0,175,20,10.342857142857143,4
Category_Wikipedia_sockpuppets_of_Lockean_One.csv,1083,12638165.0,534,549,500,34,0,52.901200369344416,255,50,22.261311172668513,14
Category_Wikipedia_sockpuppets_of_Roo996.csv,198,54753486.0,159,39,80,79,0,13.863636363636363,197,18,13.025252525252526,13
Category_Wikipedia_sockpuppets_of_ToxiclemonadePoisonedcrackerss.csv,79,179398.0,31,48,17,14,0,44.87341772151899,232,42,16.544303797468356,7
Category_Wikipedia_sockpuppets_of_Alex_Litt.csv,2,0.0,1,1,1,0,48,48.0,48,14,14.0,14
Category_Wikipedia_sockpuppets_of_PatriciaAnn1992.csv,280,227818369.0,56,224,54,2,0,53.56071428571428,249,30,17.107142857142858,7
Category_Wikipedia_sockpuppets_of_Zvartnotz2.csv,655,17896464.0,198,457,62,136,0,41.14351145038168,250,30,12.677862595419848,4
Category_Wikipedia_sockpuppets_of_Icewhiz.csv,14420,71188200.0,4500,9920,500,4000,0,59.739736477115116,500,93,24.564563106796115,3
Category_Wikipedia_sockpuppets_of_Podzemmik.csv,79,410470.0,48,31,46,2,0,29.59493670886076,253,17,12.949367088607595,5
Category_Wikipedia_sockpuppets_of_Neiltaculod.csv,34,9835507.0,20,14,16,4,0,29.5,196,21,16.0,12
Category_Wikipedia_sockpuppets_of_Junaid2747.csv,110,4561720.0,23,87,15,8,0,64.04545454545455,223,51,17.327272727272728,8
Category_Wikipedia_sockpuppets_of_Bahntier.csv,39,501837.0,34,5,24,10,0,19.641025641025642,215,33,16.025641025641026,12
Category_Wikipedia_sockpuppets_of_Macbookfackbook.csv,15,1297491.0,9,6,3,6,0,93.2,180,51,23.333333333333332,19
Category_Wikipedia_sockpuppets_of_Don't_Feed_the_Zords.csv,1561,223971512.0,609,952,42,567,0,45.25816784112748,255,67,27.030108904548367,5
Category_Wikipedia_sockpuppets_of_John_pascal.csv,84,185796633.0,27,57,25,2,0,45.48809523809524,292,49,18.5,16
Category_Wikipedia_sockpuppets_of_Hadgimarvi.csv,174,8790931.0,89,85,67,22,0,49.701149425287355,239,51,20.20689655172414,5
Category_Wikipedia_sockpuppets_of_Zakibosaso.csv,267,6134076.0,173,94,62,111,0,33.265917602996254,253,36,10.307116104868914,5
Category_Wikipedia_sockpuppets_of_FlappyBird.csv,515,5232009.0,201,314,46,155,0,65.51067961165049,255,43,13.833009708737864,3
Category_Wikipedia_sockpuppets_of_Godofwarfan333.csv,2028,4778148.0,712,1316,500,212,0,48.45611439842209,496,67,23.985207100591715,4
Category_Wikipedia_sockpuppets_of_Valerie_Smaldone.csv,37,60489.0,26,11,19,7,0,8.35135135135135,124,22,16.81081081081081,16
Category_Wikipedia_sockpuppets_of_Maqs1231.csv,152,28830516.0,43,109,38,5,0,65.9407894736842,251,67,23.730263157894736,6
Category_Wikipedia_sockpuppets_of_Sonic_N800.csv,2197,62644534.0,700,1497,500,200,0,52.258989531178884,270,53,16.90760127446518,1
Category_Wikipedia_sockpuppets_of_Adriem915.csv,418,3396068.0,173,245,153,20,0,51.688995215311,339,81,18.961722488038276,6
Category_Wikipedia_sockpuppets_of_Poojjan_ccresta.csv,1939,53297122.0,606,1333,123,483,0,40.891181021144924,255,57,16.609076843733884,4
Category_Wikipedia_sockpuppets_of_Gwb4391.csv,7,155640.0,2,5,1,1,0,83.14285714285714,289,38,37.285714285714285,37
Category_Wikipedia_sockpuppets_of_Givingbacktosociety.csv,641,1872581.0,173,468,173,0,0,55.00780031201248,460,54,28.784711388455538,12
Category_Wikipedia_sockpuppets_of_Rehmat_Ullah_Khan.csv,57,32079392.0,16,41,16,0,0,63.19298245614035,218,30,15.421052631578947,5
Category_Wikipedia_sockpuppets_of_Lala953.csv,13,528652.0,4,9,2,2,0,41.0,143,53,44.38461538461539,12
Category_Wikipedia_sockpuppets_of_Marielopez124.csv,979,17513343.0,345,634,150,195,0,52.66496424923391,255,76,19.43309499489275,6
Category_Wikipedia_sockpuppets_of_Cody6.csv,2929,173681477.0,779,2150,500,279,0,46.413451689996585,255,58,19.882553772618643,3
Category_Wikipedia_sockpuppets_of_BallSniff544.csv,870,23760840.0,287,583,140,147,0,64.38505747126437,505,48,15.704597701149424,6
Category_Wikipedia_sockpuppets_of_CyberRuler.csv,7,74854.0,5,2,3,2,0,23.285714285714285,43,23,23.0,23
Category_Wikipedia_sockpuppets_of_LionFlandres.csv,1396,47064215.0,474,922,107,367,0,47.616045845272204,429,62,17.125358166189113,3
Category_Wikipedia_sockpuppets_of_Fioranoweb.csv,243,41231736.0,79,164,28,51,0,34.98765432098765,187,80,23.246913580246915,3
Category_Wikipedia_sockpuppets_of_Reid62.csv,466,15204615.0,175,291,123,52,0,52.75965665236051,253,54,18.80472103004292,11
Category_Wikipedia_sockpuppets_of_Faizan_Abbasi05.csv,32,6107699.0,15,17,7,8,0,60.5625,205,25,10.6875,5
Category_Wikipedia_sockpuppets_of_Geldryk.csv,85,114814773.0,30,55,19,11,0,48.28235294117647,201,26,18.529411764705884,14
Category_Wikipedia_sockpuppets_of_Human_anatomy.csv,409,30838568.0,135,274,120,15,0,48.00488997555012,250,52,16.91442542787286,4
Category_Wikipedia_sockpuppets_of_Lardland.csv,18,295.0,8,10,8,0,0,4.0,53,34,19.27777777777778,4
Category_Wikipedia_sockpuppets_of_Prasannakumarbg.csv,224,111371434.0,64,160,38,26,0,55.026785714285715,559,60,21.276785714285715,7
Category_Wikipedia_sockpuppets_of_Film1024.csv,8,182.0,4,4,4,0,16,39.75,131,52,31.0,14
Category_Wikipedia_sockpuppets_of_Fifidonis.csv,6712,32106304.0,2620,4092,500,2120,0,31.367699642431464,255,61,33.23018474374255,3
Category_Wikipedia_sockpuppets_of_WPUCU1.csv,540,369932.0,232,308,203,29,0,51.492592592592594,232,50,19.409259259259258,7
Category_Wikipedia_sockpuppets_of_WhatOn.csv,54,2160776.0,19,35,9,10,0,38.629629629629626,196,30,22.25925925925926,14
Category_Wikipedia_sockpuppets_of_Wldyevn.csv,788,8037795.0,272,516,113,159,0,36.013959390862944,247,65,24.73984771573604,7
Category_Wikipedia_sockpuppets_of_Idontknowhwatimdoing.csv,3,392.0,2,1,1,1,19,67.33333333333333,164,17,17.0,17
Category_Wikipedia_sockpuppets_of_Music4ibc.csv,202,47352839.0,76,126,37,39,0,47.113861386138616,229,30,18.321782178217823,7
Category_Wikipedia_sockpuppets_of_JashonCuyler14.csv,122,15382989.0,37,85,24,13,0,53.0655737704918,235,52,20.598360655737704,8
Category_Wikipedia_sockpuppets_of_The_Afghan_Times.csv,20,299119.0,16,4,16,0,8,38.85,129,21,16.6,12
Category_Wikipedia_sockpuppets_of_ChiCubsfan44.csv,190,30077740.0,50,140,47,3,0,59.8,268,39,20.521052631578947,7
Category_Wikipedia_sockpuppets_of_Raymonddanner1.csv,8,2912.0,4,4,3,1,14,66.25,163,11,11.0,11
Category_Wikipedia_sockpuppets_of_Shallmonthly.csv,70,27048211.0,36,34,33,3,0,41.857142857142854,230,45,29.114285714285714,14
Category_Wikipedia_sockpuppets_of_MariosK.csv,10,6479.0,5,5,3,2,0,55.2,220,32,32.0,32
Category_Wikipedia_sockpuppets_of_Azar_Rafiee.csv,716,138048119.0,338,378,237,101,0,38.29050279329609,340,42,17.881284916201118,10
Category_Wikipedia_sockpuppets_of_GaryFG8125.csv,2006,23984158.0,516,1490,500,16,0,41.33050847457627,253,49,15.69840478564307,4
Category_Wikipedia_sockpuppets_of_Martimc123.csv,20051,215220531.0,6605,13446,500,6105,0,33.96050072315595,515,68,20.668794573836717,3
Category_Wikipedia_sockpuppets_of_Mkpan.csv,30,80322.0,24,6,24,0,2,22.566666666666666,58,15,15.0,15
Category_Wikipedia_sockpuppets_of_Haami2018.csv,111,19771522.0,51,60,14,37,0,57.972972972972975,196,53,26.53153153153153,14
Category_Wikipedia_sockpuppets_of_Pinoysports.csv,1711,215947778.0,599,1112,500,99,0,39.75803623611923,377,74,19.936294564582116,6
Category_Wikipedia_sockpuppets_of_KINGPORUS.csv,325,8433970.0,143,182,116,27,0,40.56307692307692,237,35,10.72,5
Category_Wikipedia_sockpuppets_of_Moorehaus.csv,933,115443580.0,227,706,194,33,0,40.755627009646304,229,78,17.265809217577708,3
Category_Wikipedia_sockpuppets_of_Bodiadub.csv,12201,380560355.0,3757,8444,442,3315,0,40.95688877960823,502,100,17.835177444471764,3
Category_Wikipedia_sockpuppets_of_Harryisbest.csv,12,164691.0,8,4,4,4,0,53.75,205,21,18.5,16
Category_Wikipedia_sockpuppets_of_PutaCu45.csv,4703,17591327.0,1399,3304,500,899,0,37.59323835849458,508,67,21.07739740591112,3
Category_Wikipedia_sockpuppets_of_Sana.Naz_HR.csv,41,27730194.0,12,29,7,5,0,37.926829268292686,243,53,21.951219512195124,7
Category_Wikipedia_sockpuppets_of_JI_Hawkins.csv,2111,44139591.0,624,1487,17,607,0,52.58503079109427,255,85,17.982472761724303,4
Category_Wikipedia_sockpuppets_of_Denizgezmis557761.csv,73,1126.0,28,45,28,0,0,52.273972602739725,253,34,14.178082191780822,9
Category_Wikipedia_sockpuppets_of_Aedwardmoch.csv,1796,425771483.0,583,1213,500,83,0,50.86247216035635,511,53,19.707683741648108,4
Category_Wikipedia_sockpuppets_of_JJhorvath5.csv,37,5708604.0,14,23,11,3,0,47.83783783783784,222,17,13.243243243243244,7
Category_Wikipedia_sockpuppets_of_Mgtguru.csv,269,332487716.0,81,188,42,39,0,56.6728624535316,247,50,21.587360594795538,5
Category_Wikipedia_sockpuppets_of_TheSausageMonster.csv,31,1775595.0,8,23,8,0,0,72.45161290322581,207,26,14.193548387096774,10
Category_Wikipedia_sockpuppets_of_Harry_gucc.csv,19,1739764.0,7,12,6,1,0,62.73684210526316,206,13,11.421052631578947,11
Category_Wikipedia_sockpuppets_of_InvaderSora.csv,1696,7443569.0,525,1171,500,25,0,35.200471698113205,250,59,22.47936320754717,3
Category_Wikipedia_sockpuppets_of_Teambk.csv,2413,36093507.0,1007,1406,500,507,0,35.863240779113134,255,46,29.27144633236635,11
Category_Wikipedia_sockpuppets_of_Shaista_Usta1.csv,14,31241.0,5,9,3,2,10,49.142857142857146,165,37,21.0,5
Category_Wikipedia_sockpuppets_of_Digihand_india.csv,1,0.0,1,0,1,0,0,0.0,0,53,53.0,53
Category_Wikipedia_sockpuppets_of_DeathOne3.csv,37,5333585.0,11,26,11,0,16,58.486486486486484,193,45,29.43243243243243,11
Category_Wikipedia_sockpuppets_of_Oluboy.csv,942,109761970.0,400,542,388,12,0,41.21656050955414,307,72,21.29511677282378,4
Category_Wikipedia_sockpuppets_of_Balla33225.csv,102,34190961.0,40,62,36,4,0,46.029411764705884,230,46,19.96078431372549,9
Category_Wikipedia_sockpuppets_of_Ahwa85.csv,112,25157492.0,46,66,36,10,0,36.544642857142854,208,23,13.982142857142858,8
Category_Wikipedia_sockpuppets_of_ReturnOfTheYooda.csv,51,3551713.0,24,27,10,14,0,50.19607843137255,175,27,20.03921568627451,17
Category_Wikipedia_sockpuppets_of_Mootpoot.csv,9,121073.0,4,5,3,1,0,26.22222222222222,57,18,16.555555555555557,13
Category_Wikipedia_sockpuppets_of_Saturnian.csv,1123,293005963.0,502,621,500,2,0,51.762243989314335,283,67,23.185218165627784,5
Category_Wikipedia_sockpuppets_of_Lifeline4.csv,556,213355612.0,225,331,214,11,0,43.14568345323741,252,59,22.413669064748202,10
Category_Wikipedia_sockpuppets_of_Mmmovie.csv,477,56946951.0,149,328,149,0,0,46.339622641509436,250,46,13.81132075471698,4
Category_Wikipedia_sockpuppets_of_AnanthSV.csv,18,5029820.0,5,13,2,3,0,46.388888888888886,147,32,21.38888888888889,9
Category_Wikipedia_sockpuppets_of_Patrick_emerson.csv,39,2139657.0,15,24,11,4,0,53.92307692307692,232,25,20.666666666666668,18
Category_Wikipedia_sockpuppets_of_I_love_you.csv,1634,504829868.0,464,1170,194,270,0,41.02692778457772,496,48,18.387392900856792,3
Category_Wikipedia_sockpuppets_of_Phoenix0316.csv,2116,52590984.0,818,1298,500,318,0,53.93525519848771,255,102,23.36672967863894,2
Category_Wikipedia_sockpuppets_of_Hits_hits.csv,1866,117684479.0,608,1258,500,108,0,41.12433011789925,255,62,28.393354769560556,8
Category_Wikipedia_sockpuppets_of_Krishna7888.csv,74,244946.0,29,45,23,6,0,56.027027027027025,239,27,18.06756756756757,7
Category_Wikipedia_sockpuppets_of_QBWRIST.csv,191,31868831.0,78,113,61,17,0,38.94240837696335,250,33,11.340314136125654,5
Category_Wikipedia_sockpuppets_of_I_Am_Mclovin.csv,82,1210464.0,23,59,12,11,0,50.609756097560975,190,25,13.670731707317072,3
Category_Wikipedia_sockpuppets_of_Vinvinkid.csv,216,7079446.0,106,110,73,33,0,56.25,194,17,12.49074074074074,6
Category_Wikipedia_sockpuppets_of_Atlantico_000.csv,2089,5529636.0,680,1409,500,180,0,44.33030157970321,496,59,23.936333173767352,5
Category_Wikipedia_sockpuppets_of_User-4488.csv,9055,78210901.0,2938,6117,500,2438,0,57.4375483158476,425,78,23.426836002208724,3
Category_Wikipedia_sockpuppets_of_Kolombus.csv,674,32202696.0,263,411,184,79,0,35.40504451038576,250,49,16.80860534124629,5
Category_Wikipedia_sockpuppets_of_JBWiou.csv,59,5362621.0,41,18,18,23,0,49.79661016949152,494,82,37.47457627118644,15
Category_Wikipedia_sockpuppets_of_Smart.maverick.csv,89,202722.0,37,52,34,3,0,42.42696629213483,246,45,20.179775280898877,10
Category_Wikipedia_sockpuppets_of_Sultan_Nawab_Khan.csv,19,13238.0,10,9,9,1,0,29.57894736842105,133,18,13.789473684210526,13
Category_Wikipedia_sockpuppets_of_Passsword.csv,19,750327.0,9,10,9,0,0,39.526315789473685,134,17,12.105263157894736,6
Category_Wikipedia_sockpuppets_of_Lovesexy189.csv,98,15045221.0,32,66,8,24,0,46.39795918367347,177,46,24.23469387755102,14
Category_Wikipedia_sockpuppets_of_ShreyGuleri.csv,165,43833060.0,111,54,88,23,0,18.727272727272727,250,44,22.424242424242426,15
Category_Wikipedia_sockpuppets_of_Doerrman.csv,4755,141805427.0,1549,3206,310,1239,0,27.487486855941114,226,62,20.060357518401684,3
Category_Wikipedia_sockpuppets_of_Tobystso6222.csv,16,5857.0,8,8,8,0,0,14.9375,43,23,11.5625,6
Category_Wikipedia_sockpuppets_of_Mctom54.csv,12,645690.0,8,4,4,4,6,50.416666666666664,158,20,16.666666666666668,16
Category_Wikipedia_sockpuppets_of_Ckellam.csv,13,816.0,6,7,5,1,0,89.3076923076923,220,14,11.384615384615385,5
Category_Wikipedia_sockpuppets_of_Trefoil13.csv,669,35572470.0,219,450,173,46,0,53.25560538116592,316,55,27.753363228699552,5
Category_Wikipedia_sockpuppets_of_Kentuckycapital.csv,3,48022.0,2,1,1,1,125,165.66666666666666,200,15,15.0,15
Category_Wikipedia_sockpuppets_of_Airgomig.csv,34,522101.0,20,14,18,2,0,29.294117647058822,186,26,14.411764705882353,5
Category_Wikipedia_sockpuppets_of_Managerjamesh.csv,1880,16948804.0,548,1332,500,48,0,71.68351063829788,311,60,19.841489361702127,4
Category_Wikipedia_sockpuppets_of_‡¶ú‡¶æ‡¶¨‡¶ø‡¶∞‡¶ü‡¶ü‡¶ï.csv,1197,136431349.0,314,883,281,33,0,52.56474519632415,496,47,19.32080200501253,4
Category_Wikipedia_sockpuppets_of_Bettersmiley.csv,573,4224290.0,219,354,211,8,0,45.610820244328096,255,66,24.024432809773124,6
Category_Wikipedia_sockpuppets_of_The_journal_of_Medicine_Law_&_Public_Health.csv,33,4451.0,10,23,10,0,0,75.06060606060606,292,26,16.242424242424242,12
Category_Wikipedia_sockpuppets_of_Acepot123.csv,28,345892.0,10,18,10,0,0,35.107142857142854,201,28,20.357142857142858,17
Category_Wikipedia_sockpuppets_of_Aynan678.csv,162,33485691.0,34,128,22,12,0,56.2037037037037,231,23,9.135802469135802,4
Category_Wikipedia_sockpuppets_of_DragonDance.csv,1558,355539056.0,429,1129,357,72,0,45.97560975609756,255,55,20.094993581514764,3
Category_Wikipedia_sockpuppets_of_Arisenband.csv,2,849.0,2,0,2,0,28,112.5,197,15,15.0,15
Category_Wikipedia_sockpuppets_of_GrayToday.csv,45,2756943.0,11,34,6,5,0,43.022222222222226,199,45,20.955555555555556,7
Category_Wikipedia_sockpuppets_of_Andreas2009.csv,3173,30309835.0,975,2198,245,730,0,41.610463283958396,252,48,13.585565710683895,3
Category_Wikipedia_sockpuppets_of_Certifiedallergist.csv,74,1006247.0,45,29,40,5,0,50.445945945945944,243,54,44.7027027027027,23
Category_Wikipedia_sockpuppets_of_Chenoo.csv,22,320857.0,7,15,6,1,0,62.90909090909091,172,23,16.181818181818183,5
Category_Wikipedia_sockpuppets_of_ViperNerd.csv,1656,8955045.0,537,1119,500,37,0,56.193236714975846,224,62,21.255434782608695,2
Category_Wikipedia_sockpuppets_of_Priyashi1599.csv,39,32641057.0,12,27,9,3,0,61.97435897435897,194,79,39.38461538461539,15
Category_Wikipedia_sockpuppets_of_Yellowdiomondisacheese.csv,14,85073.0,11,3,4,7,11,36.5,152,19,15.857142857142858,15
Category_Wikipedia_sockpuppets_of_Speedmeter.csv,10,546.0,5,5,3,2,0,57.0,182,7,4.1,3
Category_Wikipedia_sockpuppets_of_Rodhullandemu.csv,3594,6313028.0,1000,2594,500,500,0,67.09738452977184,250,73,19.703672787979965,3
Category_Wikipedia_sockpuppets_of_Gobautista.csv,1176,43602971.0,568,608,500,68,0,47.96258503401361,500,49,20.477891156462587,4
Category_Wikipedia_sockpuppets_of_Siddiqsazzad001.csv,1556,41174337.0,567,989,500,67,0,60.21143958868895,395,64,21.281491002570693,4
Category_Wikipedia_sockpuppets_of_HiroSaki2024.csv,134,281181.0,90,44,52,38,0,36.57462686567164,241,38,18.432835820895523,5
Category_Wikipedia_sockpuppets_of_TrueLightWiki.csv,182,1230853.0,88,94,53,35,0,65.65384615384616,246,49,21.763736263736263,12
Category_Wikipedia_sockpuppets_of_A21sauce.csv,3064,51746573.0,1095,1969,500,595,0,47.39360313315927,500,62,17.297323759791123,3
Category_Wikipedia_sockpuppets_of_Sirjustinflames.csv,116,8039005.0,37,79,29,8,0,51.73275862068966,216,38,12.301724137931034,8
Category_Wikipedia_sockpuppets_of_Justin760.csv,216,85968398.0,77,139,55,22,0,51.24074074074074,246,58,24.72685185185185,11
Category_Wikipedia_sockpuppets_of_New_England_Cop.csv,1019,351898071.0,276,743,189,87,0,57.99116781157998,500,75,24.75956820412169,4
Category_Wikipedia_sockpuppets_of_◊ñ◊ô◊ï◊î_◊î◊û◊î◊û◊û◊™.csv,50,2676462.0,20,30,8,12,0,54.52,234,26,11.68,8
Category_Wikipedia_sockpuppets_of_Meena_Kurian.csv,1830,127802366.0,522,1308,269,253,0,47.77049180327869,500,45,19.175409836065572,3
Category_Wikipedia_sockpuppets_of_IronAngelAlice.csv,3464,479157868.0,1031,2433,500,531,0,61.05600461893764,430,46,18.004041570438797,6
Category_Wikipedia_sockpuppets_of_Barbie_Jane_Amarga.csv,2616,25318727.0,805,1811,500,305,0,25.884174311926607,285,59,23.240825688073393,2
Category_Wikipedia_sockpuppets_of_Juhrisel.csv,129,562709.0,59,70,50,9,0,67.47286821705427,494,48,26.93798449612403,10
Category_Wikipedia_sockpuppets_of_Fly787.csv,580,33887749.0,166,414,104,62,0,67.38103448275862,503,48,25.224137931034484,8
Category_Wikipedia_sockpuppets_of_Mooroolbark777.csv,34,6922822.0,20,14,20,0,0,35.294117647058826,199,24,21.352941176470587,20
Category_Wikipedia_sockpuppets_of_AntiRacistSwede.csv,991,145286530.0,336,655,94,242,0,70.2452068617558,425,55,18.441977800201816,4
Category_Wikipedia_sockpuppets_of_Jinny_Cha.csv,46,4766248.0,23,23,20,3,0,55.108695652173914,236,30,13.065217391304348,3
Category_Wikipedia_sockpuppets_of_Nareshrana01.csv,226,5207034.0,99,127,76,23,0,43.31858407079646,253,26,11.61504424778761,4
Category_Wikipedia_sockpuppets_of_Jbertho88.csv,22,3288972.0,14,8,14,0,0,73.18181818181819,253,22,16.772727272727273,11
Category_Wikipedia_sockpuppets_of_Keisha_Sean_Waites.csv,2,0.0,1,1,1,0,0,0.0,0,28,28.0,28
Category_Wikipedia_sockpuppets_of_Superpolochile.csv,112,391482324.0,58,54,51,7,0,32.026785714285715,255,15,15.0,15
Category_Wikipedia_sockpuppets_of_Khalil_Berro.csv,63,126983.0,20,43,12,8,0,68.33333333333333,231,42,18.238095238095237,5
Category_Wikipedia_sockpuppets_of_Thedoubleunit2016.csv,56,20234296.0,23,33,18,5,0,34.142857142857146,236,53,22.089285714285715,9
Category_Wikipedia_sockpuppets_of_Mohammadahasanofficial.csv,45,9993794.0,22,23,17,5,0,42.22222222222222,196,32,26.822222222222223,17
Category_Wikipedia_sockpuppets_of_SAT85.csv,749,266125014.0,277,472,194,83,0,43.47263017356475,255,55,24.595460614152202,8
Category_Wikipedia_sockpuppets_of_Allycrusher.csv,15,1070.0,7,8,4,3,0,39.86666666666667,237,36,17.4,7
Category_Wikipedia_sockpuppets_of_Jeslyjose9656.csv,2,1467.0,2,0,1,1,0,97.5,195,23,23.0,23
Category_Wikipedia_sockpuppets_of_Pkulkarni.csv,1678,64850629.0,620,1058,228,392,0,32.60667461263409,255,47,15.67818831942789,4
Category_Wikipedia_sockpuppets_of_Light2Shadow.csv,6449,80805221.0,2115,4334,500,1615,0,43.66444409986045,255,77,25.45402387967127,2
Category_Wikipedia_sockpuppets_of_Ramniram.csv,105,1197382.0,48,57,48,0,0,33.56190476190476,249,44,23.99047619047619,13
Category_Wikipedia_sockpuppets_of_Ketshalom12.csv,85,12354494.0,24,61,11,13,0,43.44705882352941,418,49,22.44705882352941,7
Category_Wikipedia_sockpuppets_of_Aviation_fan_guy.csv,236,2691935.0,111,125,97,14,0,70.89406779661017,496,52,23.8135593220339,8
Category_Wikipedia_sockpuppets_of_Cloudbearer.csv,828,16664706.0,247,581,204,43,0,60.15700483091788,507,54,20.14009661835749,6
Category_Wikipedia_sockpuppets_of_Thatguythatmadeausername.csv,9,541.0,6,3,4,2,0,48.666666666666664,173,10,10.0,10
Category_Wikipedia_sockpuppets_of_Hotrodsurf.csv,152,595222.0,57,95,41,16,0,23.335526315789473,142,44,18.032894736842106,7
Category_Wikipedia_sockpuppets_of_Plastic_Beach.csv,2902,59346093.0,1376,1526,148,1228,0,35.04755341144038,258,70,22.033769813921435,4
Category_Wikipedia_sockpuppets_of_Param.arora.csv,869,1332218.0,254,615,181,73,0,65.82738780207134,500,36,11.80897583429229,3
Category_Wikipedia_sockpuppets_of_Anselmidavide9981.csv,46,47415762.0,15,31,8,7,0,56.130434782608695,196,47,23.717391304347824,10
Category_Wikipedia_sockpuppets_of_Sunakshi1993.csv,10,362552.0,3,7,3,0,11,66.3,187,38,23.9,14
Category_Wikipedia_sockpuppets_of_Chance90.csv,68,53754694.0,47,21,33,14,0,45.88235294117647,494,38,27.176470588235293,17
Category_Wikipedia_sockpuppets_of_Authorincharge.csv,594,32859131.0,241,353,215,26,0,48.533670033670035,255,50,21.112794612794612,9
Category_Wikipedia_sockpuppets_of_KingjorbstheGuy498.csv,8,625423.0,6,2,5,1,0,38.625,102,28,27.125,23
Category_Wikipedia_sockpuppets_of_Fallonser.csv,329,1206318.0,73,256,17,56,0,43.765957446808514,238,52,20.009118541033434,7
Category_Wikipedia_sockpuppets_of_Opopopdavay.csv,119,13562309.0,52,67,38,14,0,43.831932773109244,238,48,18.983193277310924,5
Category_Wikipedia_sockpuppets_of_Pranabrulez.csv,281,27908479.0,82,199,74,8,0,35.644128113879006,226,47,15.298932384341636,5
Category_Wikipedia_sockpuppets_of_Farhan_Tanvir_628.csv,304,185345895.0,112,192,36,76,0,56.641447368421055,246,49,21.00986842105263,7
Category_Wikipedia_sockpuppets_of_Sifler.csv,64,553319.0,23,41,11,12,0,44.0,199,33,18.296875,7
Category_Wikipedia_sockpuppets_of_Souhaib_napolii.csv,26,2773.0,16,10,16,0,0,18.307692307692307,185,28,25.53846153846154,12
Category_Wikipedia_sockpuppets_of_SagiSatya.csv,8,2369447.0,6,2,3,3,0,34.0,82,20,19.5,19
Category_Wikipedia_sockpuppets_of_Jwes115.csv,65,93124159.0,13,52,12,1,0,45.41538461538462,161,32,17.723076923076924,3
Category_Wikipedia_sockpuppets_of_Jimbo_Wales.csv,1766,99909484.0,500,1266,500,0,0,55.32672706681767,495,59,23.335220838052095,10
Category_Wikipedia_sockpuppets_of_Ranvijayy321.csv,135,126697289.0,51,84,29,22,0,62.903703703703705,300,52,21.42222222222222,9
Category_Wikipedia_sockpuppets_of_Musiclover0000758.csv,627,13813961.0,218,409,215,3,0,43.014354066985646,313,49,18.748006379585327,3
Category_Wikipedia_sockpuppets_of_Armaansinghips.csv,231,84352076.0,94,137,41,53,0,42.926406926406926,494,44,32.1948051948052,11
Category_Wikipedia_sockpuppets_of_PuppyLover25.csv,33,607287.0,16,17,8,8,0,37.84848484848485,138,27,22.515151515151516,18
Category_Wikipedia_sockpuppets_of_UserPerson1210.csv,75,3174553.0,28,47,20,8,0,51.22666666666667,261,24,17.533333333333335,10
Category_Wikipedia_sockpuppets_of_Uptoniter.csv,736,248621.0,380,356,100,280,0,27.83695652173913,496,37,17.05163043478261,6
Category_Wikipedia_sockpuppets_of_Huayu-Huayu.csv,2773,1827495.0,1080,1693,443,637,0,32.20447169130905,240,72,21.635412910205552,2
Category_Wikipedia_sockpuppets_of_Nishikanthprabhu.csv,306,175590364.0,122,184,92,30,0,50.10130718954248,500,51,22.104575163398692,9
Category_Wikipedia_sockpuppets_of_JohnBradley2015X.csv,253,253265875.0,87,166,82,5,0,42.237154150197625,232,31,14.110671936758893,10
Category_Wikipedia_sockpuppets_of_Supersupersmartperson.csv,64,1985318.0,17,47,8,9,0,60.125,198,41,20.046875,12
Category_Wikipedia_sockpuppets_of_Rachem2.csv,56,6244062.0,24,32,9,15,0,64.71428571428571,171,19,13.142857142857142,11
Category_Wikipedia_sockpuppets_of_891_mm.csv,6066,298973961.0,2209,3857,500,1709,0,35.15743488295417,261,70,19.933728981206727,3
Category_Wikipedia_sockpuppets_of_ChakkaDev.csv,26,323204.0,9,17,8,1,0,84.0,210,20,14.26923076923077,13
Category_Wikipedia_sockpuppets_of_Simran_Jyothika_Bagga_Suriya.csv,2739,5209586.0,966,1773,500,466,0,35.05330412559328,401,68,16.40781307046367,3
Category_Wikipedia_sockpuppets_of_Grvpatel.csv,15,2857628.0,9,6,7,2,5,31.333333333333332,176,27,27.0,27
Category_Wikipedia_sockpuppets_of_nsmutte.csv,85,84666170.0,23,62,15,8,0,52.92941176470588,250,42,21.788235294117648,14
Category_Wikipedia_sockpuppets_of_Abcdefmegaman.csv,74,59618889.0,25,49,20,5,0,52.16216216216216,254,23,14.54054054054054,5
Category_Wikipedia_sockpuppets_of_Mvaatv.csv,12,64076881.0,4,8,2,2,0,45.416666666666664,157,23,12.5,6
Category_Wikipedia_sockpuppets_of_Audiograhy.csv,7,2151.0,7,0,7,0,0,34.57142857142857,195,15,15.0,15
Category_Wikipedia_sockpuppets_of_Truth_Sayer.csv,33,3272270.0,19,14,17,2,0,46.42424242424242,218,21,11.454545454545455,8
Category_Wikipedia_sockpuppets_of_AceCasino.csv,44,37675.0,41,3,41,0,0,22.522727272727273,196,31,15.863636363636363,14
Category_Wikipedia_sockpuppets_of_Howlinforfallon.csv,13,3623596.0,5,8,4,1,0,23.53846153846154,88,42,15.23076923076923,11
Category_Wikipedia_sockpuppets_of_Shikharghimirey.csv,16,11660.0,5,11,3,2,0,35.0,100,53,41.8125,16
Category_Wikipedia_sockpuppets_of_Kajal1985_srivastav.csv,7267,36140959.0,2678,4589,500,2178,0,35.965047474886475,496,59,18.043346635475437,5
Category_Wikipedia_sockpuppets_of_Oggi1321.csv,2010,23924127.0,821,1189,487,334,0,37.322388059701495,496,69,17.46865671641791,5
Category_Wikipedia_sockpuppets_of_Cathy_Stubble.csv,12,704.0,4,8,2,2,0,53.333333333333336,130,27,19.5,9
Category_Wikipedia_sockpuppets_of_Oli2000s.csv,3306,27149782.0,1137,2169,500,637,0,45.2102238354507,500,65,31.403206291591047,4
Category_Wikipedia_sockpuppets_of_HelenF33.csv,9,1811423.0,6,3,3,3,0,47.666666666666664,137,19,15.11111111111111,14
Category_Wikipedia_sockpuppets_of_Kingbeaver.csv,5,706.0,3,2,3,0,28,42.0,63,20,20.0,20
Category_Wikipedia_sockpuppets_of_Classic.cigarettes.csv,4,791.0,2,2,2,0,0,37.75,73,19,18.0,17
Category_Wikipedia_sockpuppets_of_Oldstone_James.csv,6356,51591075.0,1509,4847,500,1009,0,58.26825047199497,500,75,18.749370673379484,1
Category_Wikipedia_sockpuppets_of_Uhj122.csv,997,33127474.0,239,758,144,95,0,56.02106318956871,255,52,17.58876629889669,6
Category_Wikipedia_sockpuppets_of_Aydƒ±n_memmedov2000.csv,2436,66930366.0,712,1724,261,451,0,51.500821018062396,445,61,17.735221674876847,6
Category_Wikipedia_sockpuppets_of_Gfstudent21.csv,572,3146459.0,274,298,158,116,0,58.52097902097902,502,55,36.76048951048951,4
Category_Wikipedia_sockpuppets_of_Wheres_Dan.csv,743,5348952.0,245,498,196,49,0,52.943472409152086,249,59,17.109017496635264,1
Category_Wikipedia_sockpuppets_of_Daisy404.csv,564,188492695.0,166,398,117,49,0,42.17198581560284,247,59,20.356382978723403,3
Category_Wikipedia_sockpuppets_of_Arandomuser11.csv,20,95401.0,7,13,5,2,0,76.7,264,17,14.1,10
Category_Wikipedia_sockpuppets_of_ANZER.AYOUB.csv,2227,358464222.0,866,1361,500,366,0,54.08082622361922,386,96,21.894027840143693,1
Category_Wikipedia_sockpuppets_of_YuRiPa.csv,981,134499644.0,256,725,187,69,0,41.45158002038736,250,45,15.787971457696228,9
Category_Wikipedia_sockpuppets_of_Bro_jackson.csv,25,1802.0,10,15,6,4,0,72.12,196,4,2.2,1
Category_Wikipedia_sockpuppets_of_Elektronik.csv,1148,16660776.0,249,899,171,78,0,30.997386759581882,193,51,14.244773519163763,3
Category_Wikipedia_sockpuppets_of_Suarez12.csv,1726,75702756.0,1000,726,500,500,0,45.96349942062572,425,49,19.87369640787949,9
Category_Wikipedia_sockpuppets_of_Bobkaka.csv,310,48542094.0,77,233,34,43,0,43.91935483870968,214,27,15.32258064516129,6
Category_Wikipedia_sockpuppets_of_Aounzia.csv,56,2990102.0,24,32,8,16,0,37.714285714285715,152,43,24.767857142857142,2
Category_Wikipedia_sockpuppets_of_Parpann.csv,163,9758563.0,94,69,87,7,0,44.74233128834356,201,18,15.325153374233128,12
Category_Wikipedia_sockpuppets_of_South_Bay.csv,6760,14436284.0,1400,5360,500,900,0,59.3991124260355,249,78,17.65636094674556,1
Category_Wikipedia_sockpuppets_of_Chloedeval.csv,5,3513.0,5,0,5,0,0,0.0,0,17,11.0,7
Category_Wikipedia_sockpuppets_of_Paligun.csv,627,12588528.0,235,392,80,155,0,45.494417862838915,249,42,16.04306220095694,3
Category_Wikipedia_sockpuppets_of_Qais13.csv,1660,187055086.0,501,1159,321,180,0,41.24578313253012,255,49,23.14457831325301,8
Category_Wikipedia_sockpuppets_of_Amalloyz.csv,29,24188189.0,25,4,16,9,0,36.310344827586206,161,12,12.0,12
Category_Wikipedia_sockpuppets_of_Dblama.csv,2598,72393713.0,1027,1571,500,527,0,36.34526558891455,255,188,18.94072363356428,3
Category_Wikipedia_sockpuppets_of_AKR619.csv,2717,42664947.0,663,2054,500,163,0,43.8052999631947,228,55,18.818917924181083,4
Category_Wikipedia_sockpuppets_of_Bertrand101.csv,16069,385750202.0,5336,10733,500,4836,0,38.19061547078225,439,71,18.317070135042627,3
Category_Wikipedia_sockpuppets_of_Jamestwo.csv,15,533206.0,8,7,8,0,0,38.53333333333333,152,47,30.533333333333335,13
Category_Wikipedia_sockpuppets_of_DaveRight.csv,1219,18402650.0,532,687,350,182,0,40.8498769483183,195,72,30.131255127153405,9
Category_Wikipedia_sockpuppets_of_Husayn_Shah_Mirza.csv,1259,40117797.0,498,761,240,258,0,36.14694201747419,255,45,15.166004765687052,3
Category_Wikipedia_sockpuppets_of_Primus_Sanctus_Don_Bosco.csv,573,695744.0,224,349,173,51,0,51.45724258289703,437,40,21.666666666666668,11
Category_Wikipedia_sockpuppets_of_Sendtel_+.csv,1876,311587066.0,407,1469,320,87,0,53.74733475479744,496,53,19.13272921108742,4
Category_Wikipedia_sockpuppets_of_Wicked_Sunnnnnyyyyy.csv,2377,51669781.0,793,1584,303,490,0,38.35801430374421,330,50,33.05721497686159,8
Category_Wikipedia_sockpuppets_of_Blaine2344.csv,15,70396.0,9,6,6,3,0,51.8,175,39,23.0,18
Category_Wikipedia_sockpuppets_of_Aniketkumar7.csv,125,111262086.0,25,100,13,12,0,42.168,255,21,12.336,5
Category_Wikipedia_sockpuppets_of_Ashlynnrobertson361.csv,596,226991192.0,195,401,109,86,0,48.61744966442953,254,77,24.58724832214765,5
Category_Wikipedia_sockpuppets_of_ŸáŸÇÿßÿ≥Ÿàÿ≥Ÿàÿ≥ÿ™ÿ´ÿ™Ÿà€åŸà€åŸà.csv,95,2432129.0,73,22,66,7,0,13.905263157894737,166,26,19.49473684210526,15
Category_Wikipedia_sockpuppets_of_Dquintero2017.csv,18,1467451.0,6,12,6,0,0,52.94444444444444,195,53,34.666666666666664,18
Category_Wikipedia_sockpuppets_of_ZekeBachman.csv,1,0.0,1,0,1,0,46,46.0,46,21,21.0,21
Category_Wikipedia_sockpuppets_of_DITWIN_GRIM.csv,4476,45205513.0,1155,3321,500,655,0,48.39767649687221,254,69,18.867739052725646,4
Category_Wikipedia_sockpuppets_of_Cristofolikeeling.csv,53,24518679.0,39,14,35,4,0,52.41509433962264,195,17,17.0,17
Category_Wikipedia_sockpuppets_of_Eleuterio_strifizza.csv,156,161810912.0,37,119,27,10,0,59.88461538461539,481,29,15.85897435897436,7
Category_Wikipedia_sockpuppets_of_JustSomeone08.csv,2618,118985606.0,982,1636,500,482,0,44.8659281894576,497,54,18.363254392666157,5
Category_Wikipedia_sockpuppets_of_Batteryoperated2012.csv,136,165815540.0,60,76,47,13,0,46.661764705882355,235,32,25.24264705882353,21
Category_Wikipedia_sockpuppets_of_XxBROWZxX.csv,287,856739.0,106,181,90,16,0,26.979094076655052,200,47,24.334494773519165,9
Category_Wikipedia_sockpuppets_of_Admirenepal.csv,3546,101406057.0,1166,2380,500,666,0,45.5682459108855,255,62,14.170896785109983,2
Category_Wikipedia_sockpuppets_of_Pakistanpedia.csv,14756,170803077.0,5273,9483,500,4773,0,38.70974518839794,509,65,15.853280021686095,4
Category_Wikipedia_sockpuppets_of_Ashishvcmtech.csv,94,12831373.0,34,60,28,6,0,39.797872340425535,235,40,16.20212765957447,6
Category_Wikipedia_sockpuppets_of_Alden_Loveshade.csv,3023,325306170.0,888,2135,500,388,0,50.824346675487924,496,54,19.648031756533246,4
Category_Wikipedia_sockpuppets_of_XxXDylanWillard.csv,3970,7792107.0,1138,2832,500,638,0,37.900755667506296,250,48,14.855667506297229,3
Category_Wikipedia_sockpuppets_of_Josepha_Marschke.csv,70,2017521.0,25,45,22,3,0,49.628571428571426,209,49,21.7,10
Category_Wikipedia_sockpuppets_of_Helloo_68.csv,1060,65329124.0,287,773,205,82,0,37.0377358490566,496,53,16.181132075471698,6
Category_Wikipedia_sockpuppets_of_Wander857.csv,15,57369.0,8,7,6,2,0,34.0,142,46,31.466666666666665,5
Category_Wikipedia_sockpuppets_of_Spekkommissie.csv,41,217045.0,16,25,9,7,0,54.21951219512195,170,30,19.048780487804876,13
Category_Wikipedia_sockpuppets_of_Harry_(singer).csv,1929,52565978.0,1121,808,258,863,0,28.42923794712286,255,69,18.93727319854847,3
Category_Wikipedia_sockpuppets_of_Harshith_Suvarna.csv,18,2266.0,11,7,8,3,0,32.27777777777778,344,10,10.0,10
Category_Wikipedia_sockpuppets_of_Anonymous_Leader1342.csv,32,4294.0,14,18,7,7,10,57.78125,221,17,15.78125,4
Category_Wikipedia_sockpuppets_of_Kanganpur.csv,46,135521.0,42,4,41,1,0,32.891304347826086,176,9,9.0,9
Category_Wikipedia_sockpuppets_of_Longago78.csv,31,2418775.0,17,14,14,3,0,60.12903225806452,439,43,34.25806451612903,27
Category_Wikipedia_sockpuppets_of_Yimingguo.csv,638,3274124.0,213,425,152,61,0,51.10031347962382,255,38,14.910658307210031,5
Category_Wikipedia_sockpuppets_of_WeLoveBeth.csv,102,878986.0,26,76,21,5,0,48.81372549019608,215,22,12.990196078431373,3
Category_Wikipedia_sockpuppets_of_Ivyramon.csv,61,3541893.0,47,14,29,18,0,40.442622950819676,213,18,12.39344262295082,12
Category_Wikipedia_sockpuppets_of_Wordsmithmusic.csv,4,72805.0,2,2,2,0,0,26.5,46,52,52.0,52
Category_Wikipedia_sockpuppets_of_Cammy892.csv,29,26344676.0,7,22,5,2,0,47.89655172413793,166,27,14.89655172413793,6
Category_Wikipedia_sockpuppets_of_Employer_Square3.csv,216,1375664.0,59,157,50,9,0,64.11111111111111,298,48,15.875,10
Category_Wikipedia_sockpuppets_of_Bhinegar.csv,3112,106294634.0,1221,1891,500,721,0,41.25674807197944,426,89,19.694408740359897,1
Category_Wikipedia_sockpuppets_of_Troychapman.csv,237,344703658.0,83,154,67,16,0,56.333333333333336,322,38,26.447257383966246,11
Category_Wikipedia_sockpuppets_of_Swamz_Water_Mug.csv,9,1450488.0,7,2,6,1,0,37.666666666666664,84,25,24.555555555555557,21
Category_Wikipedia_sockpuppets_of_Heteroticstringtheory.csv,28,3563581.0,13,15,10,3,0,61.82142857142857,303,21,15.464285714285714,9
Category_Wikipedia_sockpuppets_of_Alyson_Burajiru.csv,147,8561311.0,34,113,19,15,0,37.80952380952381,230,36,25.904761904761905,20
Category_Wikipedia_sockpuppets_of_Loverofediting.csv,4191,66920701.0,1124,3067,380,744,0,57.93820090670484,500,47,13.821045096635649,4
Category_Wikipedia_sockpuppets_of_Bengz_Mann_kishor.csv,9,53587.0,5,4,3,2,0,123.55555555555556,500,21,21.0,21
Category_Wikipedia_sockpuppets_of_ÂúãÂÜ¨Á¶Æ.csv,113,70562064.0,48,65,39,9,0,55.07079646017699,255,45,21.548672566371682,8
Category_Wikipedia_sockpuppets_of_Mrmasum1.csv,36,8017269.0,19,17,9,10,0,43.166666666666664,175,47,30.38888888888889,16
Category_Wikipedia_sockpuppets_of_HailKingDonaldTrump.csv,22,7351161.0,8,14,5,3,0,72.18181818181819,203,36,23.5,12
Category_Wikipedia_sockpuppets_of_Peershafqatalishah.csv,27,5709219.0,8,19,6,2,0,48.370370370370374,164,29,19.85185185185185,8
Category_Wikipedia_sockpuppets_of_Juliano202.csv,45,3124060.0,28,17,27,1,0,37.31111111111111,196,38,15.422222222222222,6
Category_Wikipedia_sockpuppets_of_Champ254.csv,1,0.0,1,0,1,0,25,25.0,25,7,7.0,7
Category_Wikipedia_sockpuppets_of_RegularBreaker.csv,749,52640176.0,167,582,125,42,0,44.02803738317757,215,48,18.672897196261683,4
Category_Wikipedia_sockpuppets_of_Wiki.editior9551.csv,36,319733.0,22,14,22,0,0,40.638888888888886,165,40,20.75,9
Category_Wikipedia_sockpuppets_of_Well_sevanew.csv,38,50039.0,11,27,3,8,0,40.39473684210526,203,31,22.31578947368421,11
Category_Wikipedia_sockpuppets_of_Juliusvergara.csv,2,1976.0,2,0,2,0,0,0.0,0,23,23.0,23
Category_Wikipedia_sockpuppets_of_Gantlet.csv,4642,266865967.0,1370,3272,500,870,0,39.03123653597587,255,67,18.348987505385608,5
Category_Wikipedia_sockpuppets_of_Bhupesh210.csv,28,9373336.0,19,9,9,10,0,54.464285714285715,373,25,15.642857142857142,8
Category_Wikipedia_sockpuppets_of_Maggiejhan1.csv,47,19471514.0,28,19,12,16,0,40.48936170212766,194,19,12.617021276595745,11
Category_Wikipedia_sockpuppets_of_Mark2SF.csv,25,706140.0,13,12,13,0,0,30.52,77,45,27.6,15
Category_Wikipedia_sockpuppets_of_Produde94.csv,280,36106638.0,71,209,36,35,0,44.43571428571428,199,58,22.15714285714286,5
Category_Wikipedia_sockpuppets_of_Amytrish.csv,20,2239604.0,11,9,10,1,0,51.4,196,53,38.6,21
Category_Wikipedia_sockpuppets_of_Absolution_provider_1999.csv,531,1015761.0,139,392,59,80,0,58.61393596986817,254,50,16.566854990583803,4
Category_Wikipedia_sockpuppets_of_Daniel234Ok.csv,34,15646442.0,16,18,12,4,0,101.5,369,21,16.58823529411765,15
Category_Wikipedia_sockpuppets_of_DERPDERP1.csv,3,75.0,2,1,2,0,0,49.0,147,6,6.0,6
Category_Wikipedia_sockpuppets_of_Derwishi10.csv,1745,36980789.0,491,1254,199,292,0,46.57134670487106,500,44,14.656160458452723,7
Category_Wikipedia_sockpuppets_of_DeniseJZ.csv,162,114220519.0,73,89,56,17,0,47.01851851851852,253,33,17.549382716049383,10
Category_Wikipedia_sockpuppets_of_OrcaFan2000.csv,131,683503.0,96,35,60,36,0,18.755725190839694,248,28,14.083969465648854,11
Category_Wikipedia_sockpuppets_of_Theabsman.csv,100,2590948.0,50,50,24,26,0,27.3,178,60,26.77,9
Category_Wikipedia_sockpuppets_of_Generouscontributor.csv,99,29210354.0,41,58,39,2,0,48.26262626262626,207,32,14.282828282828282,8
Category_Wikipedia_sockpuppets_of_Movieuk.csv,20,15252.0,7,13,3,4,0,20.2,98,46,46.0,46
Category_Wikipedia_sockpuppets_of_Quest09.csv,2793,31733569.0,728,2065,500,228,0,43.5968492660222,250,65,33.13390619405657,8
Category_Wikipedia_sockpuppets_of_TheAlan360.csv,178,70597315.0,54,124,17,37,0,52.13483146067416,230,39,20.269662921348313,6
Category_Wikipedia_sockpuppets_of_Thricecube.csv,3716,379107662.0,1000,2716,500,500,0,44.06216361679225,494,49,16.51399354144241,4
Category_Wikipedia_sockpuppets_of_CrazyAces489.csv,1615,39694438.0,578,1037,500,78,0,49.640866873065015,255,86,27.017956656346747,8
Category_Wikipedia_sockpuppets_of_Atlasm2.csv,5,905061.0,4,1,3,1,0,91.6,226,16,15.2,15
Category_Wikipedia_sockpuppets_of_Simon9987.csv,6,14554.0,2,4,1,1,22,78.0,146,22,20.666666666666668,18
Category_Wikipedia_sockpuppets_of_Djsnake86.csv,2088,73420108.0,729,1359,173,556,0,39.24568965517241,255,87,16.902298850574713,3
Category_Wikipedia_sockpuppets_of_Telseria.csv,15,10439410.0,13,2,12,1,0,19.8,169,13,6.466666666666667,6
Category_Wikipedia_sockpuppets_of_This-is-name.csv,653,38721018.0,181,472,179,2,0,53.48392036753446,254,63,21.597243491577334,3
Category_Wikipedia_sockpuppets_of_Escapeeyes.csv,588,62591431.0,273,315,196,77,0,48.164965986394556,237,31,16.277210884353742,11
Category_Wikipedia_sockpuppets_of_Edggjhh.csv,2280,98183720.0,516,1764,483,33,0,38.68289473684211,255,62,22.930263157894736,4
Category_Wikipedia_sockpuppets_of_Dixitssumit.csv,15,7747729.0,3,12,3,0,0,19.8,77,37,22.733333333333334,6
Category_Wikipedia_sockpuppets_of_Tornado99.csv,281,62225242.0,96,185,83,13,0,32.18149466192171,212,23,9.064056939501778,3
Category_Wikipedia_sockpuppets_of_Aardlion67.csv,74,11607.0,30,44,20,10,0,57.36486486486486,448,46,21.2027027027027,10
Category_Wikipedia_sockpuppets_of_Pestcamel44.csv,1784,18455215.0,586,1198,159,427,0,51.13396860986547,255,82,17.364349775784753,3
Category_Wikipedia_sockpuppets_of_Catsandgurdies.csv,201,14892832.0,110,91,104,6,0,41.92537313432836,475,49,18.129353233830845,11
Category_Wikipedia_sockpuppets_of_Rob.HUN.csv,1564,258327573.0,531,1033,500,31,0,49.58631713554987,437,90,25.400255754475705,6
Category_Wikipedia_sockpuppets_of_Eugen_Simion_14.csv,1458,425743935.0,514,944,500,14,0,46.559670781893004,496,55,25.847736625514404,5
Category_Wikipedia_sockpuppets_of_Motique.csv,2892,8387421.0,1013,1879,500,513,0,33.6804979253112,255,57,17.932572614107883,4
Category_Wikipedia_sockpuppets_of_Hpfan9374.csv,179,31420325.0,57,122,54,3,0,32.54189944134078,189,77,19.407821229050278,6
Category_Wikipedia_sockpuppets_of_Potterharrymorion.csv,133,4639739.0,28,105,25,3,0,48.045112781954884,220,28,15.714285714285714,10
Category_Wikipedia_sockpuppets_of_Danmalloy.csv,12,4111501.0,5,7,4,1,0,46.083333333333336,243,24,21.666666666666668,20
Category_Wikipedia_sockpuppets_of_Raahulpk.csv,19,2120359.0,15,4,13,2,0,33.8421052631579,243,18,17.842105263157894,17
Category_Wikipedia_sockpuppets_of_Sptx.csv,18,1417.0,5,13,2,3,0,70.72222222222223,163,29,15.0,5
Category_Wikipedia_sockpuppets_of_Danielwoody.csv,663,61603641.0,243,420,96,147,0,45.582202111613874,255,91,21.79185520361991,5
Category_Wikipedia_sockpuppets_of_AfterOtso06.csv,1107,4238255.0,370,737,106,264,0,35.02258355916892,258,45,16.208672086720867,3
Category_Wikipedia_sockpuppets_of_Peterx45678.csv,239,3086298.0,78,161,66,12,0,47.13807531380753,261,95,16.648535564853557,5
Category_Wikipedia_sockpuppets_of_GlendermanGamingYT.csv,249,36407030.0,87,162,71,16,0,47.63855421686747,494,51,27.349397590361445,5
Category_Wikipedia_sockpuppets_of_Toogitstudios.csv,18,1418.0,7,11,7,0,0,58.888888888888886,252,11,10.333333333333334,7
Category_Wikipedia_sockpuppets_of_The_Maiden_City.csv,3379,61882206.0,1252,2127,500,752,0,46.08848771825984,250,74,21.408108907960933,4
Category_Wikipedia_sockpuppets_of_Neapen.csv,94,418112013.0,33,61,29,4,0,45.5531914893617,494,31,19.20212765957447,11
Category_Wikipedia_sockpuppets_of_Skinny_McGee.csv,1470,553584467.0,501,969,500,1,0,45.59251700680272,496,75,19.925850340136055,4
Category_Wikipedia_sockpuppets_of_Green_Kirby.csv,1478,88382179.0,566,912,500,66,0,36.43031123139377,235,44,21.08998646820027,5
Category_Wikipedia_sockpuppets_of_Omarsiddiqui728.csv,35,1525879.0,10,25,5,5,0,64.11428571428571,193,40,12.8,3
Category_Wikipedia_sockpuppets_of_ImageAppeal1.csv,91,507031.0,46,45,16,30,0,60.2967032967033,496,33,15.384615384615385,8
Category_Wikipedia_sockpuppets_of_CPawx.csv,59,2434.0,15,44,8,7,0,64.88135593220339,199,42,14.305084745762711,1
Category_Wikipedia_sockpuppets_of_Blackknight1234567890.csv,2001,21257085.0,657,1344,500,157,0,39.20289855072464,500,75,27.991504247876062,6
Category_Wikipedia_sockpuppets_of_Xenophobehater.csv,327,5640333.0,101,226,51,50,0,41.599388379204896,220,60,19.189602446483182,10
Category_Wikipedia_sockpuppets_of_Justforasecond.csv,2774,262626193.0,800,1974,500,300,0,46.25054073540014,251,91,20.229992790194665,3
Category_Wikipedia_sockpuppets_of_Meanperson1234567.csv,35,91017.0,27,8,15,12,0,47.857142857142854,197,21,15.2,10
Category_Wikipedia_sockpuppets_of_Agnescooper.csv,16,20673699.0,6,10,3,3,0,47.75,143,41,19.5625,10
Category_Wikipedia_sockpuppets_of_Stumptowner.csv,1042,118949024.0,326,716,144,182,0,39.39827255278311,241,67,20.020153550863725,4
Category_Wikipedia_sockpuppets_of_Jan_Ian_Reforzado.csv,70,93846.0,24,46,10,14,0,59.24285714285714,208,31,24.514285714285716,18
Category_Wikipedia_sockpuppets_of_Flyer22.csv,94,1836256.0,31,63,31,0,0,58.787234042553195,232,20,13.23404255319149,6
Category_Wikipedia_sockpuppets_of_Serio1.csv,22,980225.0,9,13,6,3,0,47.09090909090909,197,17,14.363636363636363,11
Category_Wikipedia_sockpuppets_of_Bennyblanco10.csv,4345,59031445.0,1694,2651,500,1194,0,38.89919447640967,502,49,15.43590333716916,3
Category_Wikipedia_sockpuppets_of_BellHooksSucks.csv,15,1360.0,7,8,5,2,0,74.73333333333333,203,27,18.066666666666666,10
Category_Wikipedia_sockpuppets_of_Big_Towel.csv,1364,1482159.0,805,559,406,399,0,26.134897360703814,253,74,38.68475073313783,7
Category_Wikipedia_sockpuppets_of_Webmasteralex.csv,33,16905142.0,11,22,9,2,0,46.15151515151515,253,21,16.12121212121212,12
Category_Wikipedia_sockpuppets_of_Shrekfan22.csv,2452,40591963.0,668,1784,500,168,0,42.07830342577488,476,66,22.051386623164763,4
Category_Wikipedia_sockpuppets_of_Jonathan_Yip.csv,2721,61687309.0,700,2021,144,556,0,40.723631018008085,255,51,20.640940830576994,4
Category_Wikipedia_sockpuppets_of_Camdoc2001.csv,243,59431467.0,100,143,74,26,0,42.135802469135804,247,47,21.094650205761315,8
Category_Wikipedia_sockpuppets_of_Livingdead6666.csv,236,9084121.0,60,176,18,42,0,48.28813559322034,255,35,20.135593220338983,6
Category_Wikipedia_sockpuppets_of_Ravikrishnam.csv,736,414270946.0,243,493,241,2,0,41.81521739130435,302,68,15.388586956521738,5
Category_Wikipedia_sockpuppets_of_Bongi663.csv,346,523897.0,156,190,70,86,0,43.2485549132948,224,54,26.927745664739884,15
Category_Wikipedia_sockpuppets_of_Ln_of_x.csv,1701,96839606.0,492,1209,23,469,0,46.86596119929453,238,50,17.95767195767196,5
Category_Wikipedia_sockpuppets_of_FidelityTree.csv,79,16944290.0,22,57,13,9,0,49.88607594936709,175,68,26.59493670886076,9
Category_Wikipedia_sockpuppets_of_Michael_Cambridge.csv,890,334470993.0,215,675,149,66,0,59.87865168539326,319,47,21.669662921348316,4
Category_Wikipedia_sockpuppets_of_Atomic_Meltdown.csv,19901,234563315.0,5136,14765,500,4636,0,45.41088387518215,500,78,18.515652479774886,3
Category_Wikipedia_sockpuppets_of_IAmEleventy.csv,3,732159.0,3,0,3,0,0,0.0,0,18,18.0,18
Category_Wikipedia_sockpuppets_of_Jen0810.csv,14,65425587.0,5,9,3,2,0,86.5,193,30,27.214285714285715,17
Category_Wikipedia_sockpuppets_of_Dung247.csv,2399,6052586.0,745,1654,500,245,0,34.00041684035015,255,51,8.490621092121717,3
Category_Wikipedia_sockpuppets_of_Arnab2803.csv,248,85147562.0,147,101,143,4,0,32.625,227,60,45.58467741935484,19
Category_Wikipedia_sockpuppets_of_Thatsoddd.csv,1628,14304730.0,811,817,500,311,0,32.48218673218673,491,38,18.838452088452087,4
Category_Wikipedia_sockpuppets_of_Syed_Kumail_Haider_Kazmi.csv,149,47824080.0,42,107,41,1,0,56.67785234899329,280,54,21.241610738255034,6
Category_Wikipedia_sockpuppets_of_JohnMark0909.csv,18,213410.0,6,12,4,2,0,42.44444444444444,203,29,21.11111111111111,15
Category_Wikipedia_sockpuppets_of_FBKTechnology.csv,42,92381789.0,22,20,21,1,0,43.23809523809524,261,23,19.0,16
Category_Wikipedia_sockpuppets_of_Mayscarlat.csv,16,578810.0,8,8,5,3,0,12.5625,56,46,46.0,46
Category_Wikipedia_sockpuppets_of_Iqinn.csv,1013,30373128.0,510,503,500,10,0,56.678183613030605,245,80,26.73938795656466,5
Category_Wikipedia_sockpuppets_of_EnlightenmentNow1792.csv,1802,25592680.0,600,1202,500,100,0,60.04605993340733,500,51,22.10599334073252,5
Category_Wikipedia_sockpuppets_of_FactStraight.csv,2509,366463867.0,622,1887,500,122,0,46.92148266241531,499,85,26.252291749701076,6
Category_Wikipedia_sockpuppets_of_UY4Xe8VM5VYxaQQ.csv,1978,72863515.0,629,1349,500,129,0,44.54145601617796,255,79,21.795753286147622,3
Category_Wikipedia_sockpuppets_of_Codetruth.csv,166,4645409.0,64,102,47,17,0,49.373493975903614,250,43,22.734939759036145,14
Category_Wikipedia_sockpuppets_of_WikiAgent20.csv,20,67545285.0,11,9,11,0,0,59.2,218,23,23.0,23
Category_Wikipedia_sockpuppets_of_Wikiauthor37.csv,41,1801494.0,36,5,36,0,0,30.121951219512194,308,46,27.878048780487806,17
Category_Wikipedia_sockpuppets_of_HappyCricketer.csv,87,1993461.0,32,55,21,11,0,57.7816091954023,212,24,13.195402298850574,7
Category_Wikipedia_sockpuppets_of_Jeromels.csv,1615,97035169.0,611,1004,500,111,0,49.253250773993805,250,80,19.639009287925695,3
Category_Wikipedia_sockpuppets_of_Callmarcus.csv,5220,116625871.0,1131,4089,500,631,0,32.148084291187736,229,80,16.471072796934866,1
Category_Wikipedia_sockpuppets_of_Cpsspag.csv,4,1569.0,4,0,3,1,0,0.0,0,16,16.0,16
Category_Wikipedia_sockpuppets_of_Sumatro.csv,2942,79600444.0,967,1975,489,478,0,50.7899388171312,255,54,14.324269204622706,4
Category_Wikipedia_sockpuppets_of_CJEDJCRobertiPARMMSCTBrown2000s-2010s-2020s.csv,1789,106930293.0,549,1240,47,502,0,55.12632755729458,500,67,21.98882057015092,4
Category_Wikipedia_sockpuppets_of_Writer_media.csv,133,53590277.0,43,90,16,27,0,61.81954887218045,255,42,13.451127819548873,6
Category_Wikipedia_sockpuppets_of_Kiava.csv,481,46378479.0,205,276,165,40,0,46.58419958419958,496,66,19.638253638253637,5
Category_Wikipedia_sockpuppets_of_Callmeanidiot.csv,328,19009061.0,104,224,85,19,0,39.832317073170735,251,36,22.033536585365855,5
Category_Wikipedia_sockpuppets_of_RemyBot.csv,17,259577.0,10,7,5,5,0,62.64705882352941,200,20,14.470588235294118,10
Category_Wikipedia_sockpuppets_of_Grandy_Grandy.csv,2662,17209078.0,1004,1658,500,504,0,42.22501878287002,240,85,19.201352366641622,5
Category_Wikipedia_sockpuppets_of_Bobby_Boulders~enwiki.csv,47,322223844.0,14,33,13,1,0,34.148936170212764,210,38,17.70212765957447,7
Category_Wikipedia_sockpuppets_of_Douglaseivindhallgerber.csv,1188,424951135.0,271,917,180,91,0,47.33754208754209,324,45,17.286195286195287,3
Category_Wikipedia_sockpuppets_of_Lubeslilts.csv,6,939.0,4,2,3,1,0,58.5,157,20,10.0,8
Category_Wikipedia_sockpuppets_of_Ivanzhourocks.csv,60,6129472.0,26,34,19,7,0,43.45,228,25,18.916666666666668,17
Category_Wikipedia_sockpuppets_of_Persecuted_editors.csv,33,1034999.0,12,21,12,0,0,51.54545454545455,218,28,18.333333333333332,10
Category_Wikipedia_sockpuppets_of_MFIreland.csv,3443,93040092.0,980,2463,500,480,0,44.763287830380484,255,71,19.13011908219576,3
Category_Wikipedia_sockpuppets_of_Stop_global_warming.csv,9,44499.0,5,4,5,0,0,59.888888888888886,163,29,13.88888888888889,4
Category_Wikipedia_sockpuppets_of_Darklord245.csv,22,84048.0,21,1,8,13,0,7.045454545454546,155,5,5.0,5
Category_Wikipedia_sockpuppets_of_Bilal_Meets.csv,71,11944815.0,25,46,15,10,0,44.32394366197183,196,28,18.014084507042252,13
Category_Wikipedia_sockpuppets_of_Beth_Behrendt.csv,530,14795967.0,161,369,117,44,0,46.366037735849055,277,75,25.022641509433964,5
Category_Wikipedia_sockpuppets_of_Nyan_Lin_Set.csv,11,2062529.0,7,4,3,4,0,81.63636363636364,186,5,5.0,5
Category_Wikipedia_sockpuppets_of_Ghaffarmasomi.csv,67,62244647.0,18,49,9,9,0,29.686567164179106,175,35,15.059701492537313,3
Category_Wikipedia_sockpuppets_of_Chateaufalaise.csv,39,1468128.0,28,11,26,2,0,38.717948717948715,197,24,21.0,18
Category_Wikipedia_sockpuppets_of_Mikay_Travels.csv,762,24707318.0,249,513,141,108,0,27.787401574803148,270,52,15.691601049868767,5
Category_Wikipedia_sockpuppets_of_Shubhamghodke3904.csv,988,23712463.0,410,578,353,57,0,48.35627530364373,259,60,20.96153846153846,4
Category_Wikipedia_sockpuppets_of_Statistics_have_shown.csv,68,3428470.0,21,47,16,5,0,42.544117647058826,194,39,23.014705882352942,4
Category_Wikipedia_sockpuppets_of_PhoebeWalter.csv,57,55301417.0,32,25,19,13,0,33.59649122807018,255,35,25.42105263157895,22
Category_Wikipedia_sockpuppets_of_Whitmorewolveyr.csv,523,7279056.0,127,396,127,0,0,42.23900573613767,226,97,21.91778202676864,5
Category_Wikipedia_sockpuppets_of_Sriharsh1234.csv,1800,14040323.0,552,1248,500,52,0,62.86611111111111,241,61,18.863333333333333,3
Category_Wikipedia_sockpuppets_of_MarcelS789.csv,16,29711224.0,4,12,3,1,13,71.375,241,22,21.4375,21
Category_Wikipedia_sockpuppets_of_Raw_potatoe.csv,44,424205.0,13,31,9,4,0,55.04545454545455,194,35,32.54545454545455,16
Category_Wikipedia_sockpuppets_of_Gross8090.csv,125,29677496.0,71,54,44,27,0,49.352,496,49,17.936,8
Category_Wikipedia_sockpuppets_of_Ahmadkhankipathsala.csv,22,1576018.0,9,13,2,7,0,39.77272727272727,116,49,35.95454545454545,19
Category_Wikipedia_sockpuppets_of_Khanya_Arosi.csv,2864,55686775.0,1021,1843,500,521,0,42.78491620111732,368,46,19.762569832402235,2
Category_Wikipedia_sockpuppets_of_Alfredprufrock.csv,247,10576528.0,223,24,23,200,0,5.303643724696356,206,14,14.0,14
Category_Wikipedia_sockpuppets_of_wallflowers98.csv,25,29647185.0,5,20,4,1,0,37.16,225,34,25.68,16
Category_Wikipedia_sockpuppets_of_Ftheoldies.csv,53,3464188.0,37,16,9,28,0,48.43396226415094,201,9,7.962264150943396,4
Category_Wikipedia_sockpuppets_of_Slatercj01.csv,1729,146970289.0,551,1178,152,399,0,48.66975130133025,366,88,25.27993059572007,4
Category_Wikipedia_sockpuppets_of_TannerGoethals3.csv,1973,71740967.0,514,1459,251,263,0,48.706031424227064,395,75,19.401419158641662,4
Category_Wikipedia_sockpuppets_of_Loosmark.csv,3183,346420274.0,1068,2115,500,568,0,43.6861451460886,376,90,23.819666980835688,3
Category_Wikipedia_sockpuppets_of_Callmeseetea.csv,262,70120484.0,71,191,45,26,0,58.55343511450382,388,30,17.549618320610687,4
Category_Wikipedia_sockpuppets_of_Ilyasozgur.csv,110,3942120.0,26,84,18,8,0,46.17272727272727,232,26,10.309090909090909,3
Category_Wikipedia_sockpuppets_of_Educator57.csv,762,9161905.0,204,558,127,77,0,55.001312335958005,255,56,17.5498687664042,2
Category_Wikipedia_sockpuppets_of_Wattsj528.csv,1912,18733429.0,591,1321,217,374,0,45.46391213389121,263,77,22.809100418410043,3
Category_Wikipedia_sockpuppets_of_Personpersonperson12345.csv,1619,36604228.0,497,1122,217,280,0,46.408276714021,378,70,28.919703520691787,1
Category_Wikipedia_sockpuppets_of_MichaelQSchmidt2009.csv,36,20481.0,12,24,5,7,0,48.69444444444444,199,41,15.527777777777779,4
Category_Wikipedia_sockpuppets_of_Thesoundkillers.csv,290,70420149.0,75,215,29,46,0,53.53103448275862,248,32,12.60344827586207,4
Category_Wikipedia_sockpuppets_of_StarryNightSky11.csv,1827,22472719.0,517,1310,500,17,0,54.97153804050356,499,72,16.988505747126435,3
Category_Wikipedia_sockpuppets_of_Prasad17ram.csv,46,7916724.0,34,12,30,4,0,32.91304347826087,197,27,18.717391304347824,11
"Category_Wikipedia_sockpuppets_of_Me,_Myself,_I_and_DAVE_THE_DRAGON.csv",124,14251287.0,51,73,47,4,0,56.346774193548384,255,54,21.524193548387096,6
Category_Wikipedia_sockpuppets_of_Bowloffruit.csv,68,371682.0,44,24,14,30,0,32.529411764705884,219,30,13.852941176470589,13
Category_Wikipedia_sockpuppets_of_Khampalak.csv,1125,22094266.0,435,690,286,149,0,44.19555555555556,254,50,20.792,5
Category_Wikipedia_sockpuppets_of_Marshathomas2023.csv,50,1122181.0,17,33,14,3,0,61.4,278,26,14.04,7
Category_Wikipedia_sockpuppets_of_ShirleyTH.csv,254,4295577.0,104,150,83,21,0,49.60236220472441,255,63,41.688976377952756,11
Category_Wikipedia_sockpuppets_of_Limpbreaker.csv,52,1156928.0,17,35,17,0,0,25.51923076923077,134,44,24.46153846153846,12
Category_Wikipedia_sockpuppets_of_Carlpeterson300.csv,9,3822753.0,3,6,3,0,0,55.0,166,38,26.0,15
Category_Wikipedia_sockpuppets_of_Narlysurfer2004.csv,25,960123.0,16,9,16,0,0,23.6,199,30,24.8,17
Category_Wikipedia_sockpuppets_of_Matthewcarleton214.csv,1448,240741992.0,353,1095,125,228,0,48.517265193370164,338,41,16.051795580110497,4
Category_Wikipedia_sockpuppets_of_Eddtoro642.csv,29,96790955.0,8,21,8,0,0,55.241379310344826,254,29,26.517241379310345,20
Category_Wikipedia_sockpuppets_of_WMGBusiness.csv,10,954831.0,8,2,6,2,0,35.2,163,24,22.8,21
Category_Wikipedia_sockpuppets_of_Madezyma10.csv,6,173506.0,2,4,1,1,1,67.16666666666667,121,31,26.0,16
Category_Wikipedia_sockpuppets_of_A._Katechis_Mpourtoulis.csv,1961,70833205.0,689,1272,500,189,0,51.76695563488016,317,59,18.36206017338093,4
Category_Wikipedia_sockpuppets_of_Ransara_Jey.csv,109,198278262.0,27,82,27,0,0,59.03669724770642,267,47,16.880733944954127,13
Category_Wikipedia_sockpuppets_of_Plant's_Strider.csv,5106,103782981.0,1259,3847,500,759,0,49.83157070113592,255,56,18.52252252252252,4
Category_Wikipedia_sockpuppets_of_SUBODH1509.csv,22,20551071.0,10,12,5,5,0,49.18181818181818,146,38,26.727272727272727,17
Category_Wikipedia_sockpuppets_of_Ejiro4.csv,64,273544916.0,21,43,21,0,0,58.015625,228,34,17.34375,14
Category_Wikipedia_sockpuppets_of_Cookiecutteramaru.csv,174,18183146.0,81,93,69,12,0,53.39080459770115,249,79,24.57471264367816,4
Category_Wikipedia_sockpuppets_of_Myreasonwhy.csv,51,126857915.0,38,13,25,13,0,54.13725490196079,199,49,23.92156862745098,17
Category_Wikipedia_sockpuppets_of_Photopinka.csv,252,44935153.0,81,171,59,22,0,37.595238095238095,246,63,19.11904761904762,5
Category_Wikipedia_sockpuppets_of_Sabirusmani.csv,83,5107513.0,50,33,21,29,0,29.228915662650603,199,39,19.337349397590362,11
Category_Wikipedia_sockpuppets_of_Broken_nutshell.csv,1973,189964736.0,512,1461,500,12,0,51.20273694880892,484,66,21.315762797769892,3
Category_Wikipedia_sockpuppets_of_Joestella.csv,1216,36112169.0,504,712,304,200,0,31.480263157894736,203,87,27.013980263157894,4
Category_Wikipedia_sockpuppets_of_CHENG.Michael.csv,7,76459.0,5,2,5,0,0,60.42857142857143,197,30,27.857142857142858,25
Category_Wikipedia_sockpuppets_of_Signature_editing_group.csv,618,57186642.0,134,484,92,42,0,49.07119741100323,318,50,16.284789644012946,5
Category_Wikipedia_sockpuppets_of_89burger.csv,190,9751106.0,52,138,23,29,0,50.689473684210526,306,51,25.00526315789474,8
Category_Wikipedia_sockpuppets_of_Keith161.csv,2971,71989323.0,836,2135,407,429,0,55.859979804779535,363,51,13.332884550656345,3
Category_Wikipedia_sockpuppets_of_ReeceTheProtogen.csv,32,1818058.0,18,14,9,9,0,42.375,221,29,20.65625,19
Category_Wikipedia_sockpuppets_of_Ktoameh.csv,103,1113019.0,75,28,28,47,0,37.349514563106794,183,22,17.728155339805824,17
Category_Wikipedia_sockpuppets_of_Dollallama.csv,491,318031747.0,123,368,86,37,0,45.44602851323829,250,37,14.975560081466394,6
Category_Wikipedia_sockpuppets_of_Agarc192.csv,43,1070072.0,23,20,11,12,0,56.116279069767444,208,44,21.348837209302324,10
Category_Wikipedia_sockpuppets_of_Jungleewan.csv,120,122856384.0,30,90,15,15,0,39.125,210,27,19.741666666666667,17
Category_Wikipedia_sockpuppets_of_KRISHNA_cool.csv,54,109271.0,13,41,13,0,0,26.22222222222222,157,39,14.203703703703704,6
Category_Wikipedia_sockpuppets_of_Hassantaiwo.csv,676,15918355.0,318,358,229,89,0,31.106508875739646,255,55,17.61390532544379,6
Category_Wikipedia_sockpuppets_of_Martin_Van_Buren.csv,127,3191767.0,40,87,22,18,0,31.11023622047244,200,50,26.070866141732285,11
Category_Wikipedia_sockpuppets_of_Mark.e.wright.csv,12,6639639.0,5,7,3,2,0,39.0,70,31,23.083333333333332,17
Category_Wikipedia_sockpuppets_of_DetectiveRoy007.csv,28,1391494.0,13,15,6,7,0,56.785714285714285,192,33,23.928571428571427,13
Category_Wikipedia_sockpuppets_of_JimFrank4800.csv,2250,41153084.0,633,1617,455,178,0,45.40533333333333,385,59,18.96488888888889,2
Category_Wikipedia_sockpuppets_of_Syed_Aawaiz.csv,162,3652342.0,55,107,40,15,0,50.882716049382715,255,45,22.339506172839506,10
Category_Wikipedia_sockpuppets_of_Sajjad0261.csv,695,34409633.0,250,445,154,96,0,17.506474820143886,212,49,21.637410071942448,10
Category_Wikipedia_sockpuppets_of_Toolen.csv,1848,27240819.0,509,1339,500,9,0,45.96536796536797,255,59,19.874458874458874,4
Category_Wikipedia_sockpuppets_of_Anuttamadasi.csv,170,813242.0,87,83,70,17,0,48.076470588235296,220,52,34.88235294117647,16
Category_Wikipedia_sockpuppets_of_Avinashretnam.csv,5,1308756.0,4,1,3,1,0,61.6,145,44,44.0,44
Category_Wikipedia_sockpuppets_of_Jill_alper.csv,30,16663453.0,24,6,16,8,0,22.466666666666665,140,22,14.533333333333333,10
Category_Wikipedia_sockpuppets_of_Jinnhoppan.csv,102,701097.0,50,52,18,32,0,43.88235294117647,234,19,12.284313725490197,5
Category_Wikipedia_sockpuppets_of_Usapan.csv,422,371546.0,131,291,44,87,0,67.61611374407583,255,66,18.914691943127963,3
Category_Wikipedia_sockpuppets_of_TnT_Corporation.csv,76,22775.0,44,32,44,0,0,13.276315789473685,185,8,3.986842105263158,3
Category_Wikipedia_sockpuppets_of_The_Turkinator.csv,95,17476410.0,39,56,23,16,0,72.88421052631578,322,44,18.010526315789473,4
Category_Wikipedia_sockpuppets_of_Ardwiki02.csv,44,33849015.0,17,27,15,2,0,48.45454545454545,261,53,30.65909090909091,18
Category_Wikipedia_sockpuppets_of_Akhilkumarwiki.csv,43,5370589.0,10,33,9,1,0,55.116279069767444,214,47,18.813953488372093,5
Category_Wikipedia_sockpuppets_of_AminQdek.csv,654,24332036.0,231,423,96,135,0,58.46177370030581,496,56,19.792048929663608,5
Category_Wikipedia_sockpuppets_of_Silveriver.csv,1228,27400286.0,605,623,500,105,0,26.80700325732899,200,67,20.478827361563518,3
Category_Wikipedia_sockpuppets_of_LustyRoars.csv,2352,121215732.0,688,1664,311,377,0,43.37329931972789,255,114,18.33843537414966,3
Category_Wikipedia_sockpuppets_of_CRZYQUEST441.csv,53,5067473.0,27,26,20,7,0,46.79245283018868,196,40,20.50943396226415,12
Category_Wikipedia_sockpuppets_of_Jdc.cas.csv,104,4145562.0,49,55,40,9,0,35.73076923076923,178,39,16.326923076923077,6
Category_Wikipedia_sockpuppets_of_Daniel_Brandt.csv,131,51987892.0,29,102,23,6,0,33.37404580152672,187,68,33.74809160305343,10
Category_Wikipedia_sockpuppets_of_RukshanaNewa.csv,750,70104225.0,258,492,113,145,0,50.592,359,62,20.596,5
Category_Wikipedia_sockpuppets_of_TheNotoriousSildeSoiler.csv,12,255741.0,8,4,6,2,0,70.66666666666667,178,34,14.0,10
Category_Wikipedia_sockpuppets_of_Gdroel.csv,36,120851.0,9,27,6,3,0,60.333333333333336,243,30,17.583333333333332,7
Category_Wikipedia_sockpuppets_of_Thitojhapali.csv,277,35711573.0,92,185,49,43,0,40.0072202166065,165,53,26.3971119133574,17
Category_Wikipedia_sockpuppets_of_Sotavino.csv,641,37343194.0,209,432,49,160,0,55.36973478939158,496,37,14.895475819032761,7
Category_Wikipedia_sockpuppets_of_KLM3618.csv,31,38264545.0,9,22,9,0,0,37.41935483870968,102,33,24.419354838709676,17
Category_Wikipedia_sockpuppets_of_WzMG5LJ.csv,241,2768758.0,88,153,62,26,0,29.485477178423235,236,53,30.62240663900415,8
Category_Wikipedia_sockpuppets_of_Mach7X77.csv,239,2742287.0,89,150,80,9,0,58.76987447698745,241,27,15.234309623430962,9
Category_Wikipedia_sockpuppets_of_DrYoosef.csv,50,441163.0,26,24,10,16,0,32.1,118,53,20.68,13
Category_Wikipedia_sockpuppets_of_Dweeby123.csv,4603,109473970.0,1087,3516,500,587,0,44.673473821420814,255,61,16.683250054312406,3
Category_Wikipedia_sockpuppets_of_Onemoreforyou.csv,273,37575186.0,148,125,86,62,0,52.45421245421245,248,36,21.0,17
Category_Wikipedia_sockpuppets_of_Gibari_Sultan.csv,647,14731737.0,291,356,221,70,0,42.13292117465224,302,53,18.698608964451314,5
Category_Wikipedia_sockpuppets_of_RetroTetra.csv,270,7641783.0,116,154,61,55,0,78.47777777777777,500,67,31.35925925925926,10
Category_Wikipedia_sockpuppets_of_Manishrajput6395.csv,112,4400453.0,37,75,14,23,0,59.857142857142854,367,47,16.785714285714285,8
Category_Wikipedia_sockpuppets_of_Philbox17.csv,657,50027679.0,280,377,168,112,0,43.665144596651444,217,47,26.525114155251142,6
Category_Wikipedia_sockpuppets_of_Georgette2.csv,1668,4914785.0,580,1088,500,80,0,50.439448441247,245,62,18.961630695443645,3
Category_Wikipedia_sockpuppets_of_JKLlamera.csv,2192,68538944.0,1000,1192,500,500,0,43.574361313868614,496,66,24.205291970802918,5
Category_Wikipedia_sockpuppets_of_Micky02car.csv,153,10302216.0,44,109,17,27,0,22.954248366013072,226,29,15.581699346405228,9
Category_Wikipedia_sockpuppets_of_General_Mannino.csv,679,35605640.0,244,435,238,6,0,28.662739322533138,218,66,23.830633284241532,6
Category_Wikipedia_sockpuppets_of_Eric18880.csv,37,15945687.0,12,25,10,2,0,56.54054054054054,241,45,18.08108108108108,8
Category_Wikipedia_sockpuppets_of_Klaksonn.csv,4203,184860150.0,1137,3066,472,665,0,43.16607185343802,246,81,18.273614085177254,2
Category_Wikipedia_sockpuppets_of_Holmes4212.csv,32,605868.0,24,8,20,4,0,80.09375,185,20,11.84375,11
Category_Wikipedia_sockpuppets_of_Pcmishradigital.csv,660,254245074.0,232,428,62,170,0,46.88787878787879,384,64,22.49848484848485,5
Category_Wikipedia_sockpuppets_of_Editor895.csv,736,136968215.0,312,424,79,233,0,34.24184782608695,233,54,22.816576086956523,10
Category_Wikipedia_sockpuppets_of_Dtreeter15.csv,35,33738453.0,7,28,2,5,0,41.885714285714286,212,31,13.0,5
Category_Wikipedia_sockpuppets_of_Moonlitcat2022.csv,129,19726481.0,40,89,40,0,0,50.007751937984494,229,27,13.550387596899224,5
Category_Wikipedia_sockpuppets_of_Naruto2839.csv,108,23118938.0,50,58,20,30,0,89.79629629629629,248,44,20.462962962962962,16
Category_Wikipedia_sockpuppets_of_Kenydevburman.csv,33,1060787.0,26,7,15,11,0,34.09090909090909,139,23,21.757575757575758,20
Category_Wikipedia_sockpuppets_of_ShahabKhanJadoon1.csv,4733,45697083.0,1148,3585,370,778,0,49.867525882104374,500,70,20.623705894781324,2
Category_Wikipedia_sockpuppets_of_Fuerdai_to_the_gas_chambers.csv,28,111365.0,12,16,8,4,0,67.60714285714286,246,39,16.571428571428573,5
Category_Wikipedia_sockpuppets_of_Md_Sunnat_Ali_Mollik.csv,754,55039813.0,245,509,56,189,0,57.06896551724138,417,65,17.92970822281167,5
Category_Wikipedia_sockpuppets_of_DCGeist.csv,3052,186490036.0,1000,2052,500,500,0,63.623525557011796,255,65,16.46526867627785,4
Category_Wikipedia_sockpuppets_of_Mr_Baron_von_Fenton.csv,24,782352.0,19,5,14,5,0,58.208333333333336,196,53,29.041666666666668,22
Category_Wikipedia_sockpuppets_of_Dingothefish.csv,35,204304.0,16,19,8,8,0,50.25714285714286,194,46,24.914285714285715,5
Category_Wikipedia_sockpuppets_of_Stepan_Bandera.csv,34,2186513.0,16,18,16,0,0,35.588235294117645,202,9,9.0,9
Category_Wikipedia_sockpuppets_of_Billy_Beagle.csv,401,33358070.0,143,258,132,11,0,59.52618453865337,499,61,20.379052369077307,8
Category_Wikipedia_sockpuppets_of_Rangeview.csv,186,68857884.0,45,141,40,5,0,64.15053763440861,242,19,11.295698924731182,7
Category_Wikipedia_sockpuppets_of_Russian_historian.csv,11,558881.0,5,6,3,2,0,65.72727272727273,144,23,19.272727272727273,11
Category_Wikipedia_sockpuppets_of_Avinav_kumar_yadav.csv,69,20716420.0,29,40,16,13,0,39.507246376811594,300,28,18.92753623188406,17
Category_Wikipedia_sockpuppets_of_John254.csv,64572,109340672.0,21041,43531,500,20541,0,39.259075140927955,264,90,24.323499349563278,2
Category_Wikipedia_sockpuppets_of_Rttyplt.csv,153,2018450.0,63,90,30,33,0,55.490196078431374,217,49,32.87581699346405,6
Category_Wikipedia_sockpuppets_of_Shreyansh_K_Jain.csv,889,63298424.0,338,551,331,7,0,28.791901012373454,255,41,15.011248593925758,2
Category_Wikipedia_sockpuppets_of_Sly-eye.csv,113,20280804.0,34,79,25,9,0,35.92035398230089,199,51,11.63716814159292,5
Category_Wikipedia_sockpuppets_of_Omniscient256.csv,128,4441626.0,39,89,28,11,0,45.4375,269,53,24.109375,6
Category_Wikipedia_sockpuppets_of_Migosyrn.csv,89,3036495.0,20,69,4,16,0,61.87640449438202,220,54,23.741573033707866,5
Category_Wikipedia_sockpuppets_of_Max_Mux.csv,1705,18418580.0,702,1003,500,202,0,30.35425219941349,255,112,21.32316715542522,9
Category_Wikipedia_sockpuppets_of_AaryaDon.csv,30,6944430.0,13,17,6,7,0,47.3,248,21,14.4,4
Category_Wikipedia_sockpuppets_of_Candykingandgod.csv,93,36115815.0,27,66,18,9,0,62.29032258064516,249,24,9.935483870967742,4
Category_Wikipedia_sockpuppets_of_MSUalum08.csv,60,1601064.0,23,37,14,9,0,45.86666666666667,215,46,17.116666666666667,9
Category_Wikipedia_sockpuppets_of_Tinylagoon007.csv,119,23952647.0,47,72,24,23,0,42.134453781512605,254,26,18.840336134453782,13
Category_Wikipedia_sockpuppets_of_Sushil_Chhetri.csv,24,323685.0,11,13,11,0,0,57.291666666666664,196,24,21.875,13
Category_Wikipedia_sockpuppets_of_Gani_Gashi_piktor.csv,34,17445438.0,17,17,9,8,0,61.0,219,30,26.11764705882353,13
Category_Wikipedia_sockpuppets_of_Loubnan.csv,198,16521481.0,76,122,64,12,0,33.292929292929294,196,42,22.2979797979798,7
Category_Wikipedia_sockpuppets_of_Kmrhistory.csv,1867,22744411.0,598,1269,218,380,0,49.647562935190145,255,53,16.59025174076058,5
Category_Wikipedia_sockpuppets_of_YABACAN2074.csv,77,1149.0,28,49,8,20,0,58.675324675324674,220,33,16.98701298701299,5
Category_Wikipedia_sockpuppets_of_FreeSteele.csv,112,56673677.0,37,75,7,30,0,61.169642857142854,218,15,8.732142857142858,7
Category_Wikipedia_sockpuppets_of_Pakistani548.csv,62,699450.0,40,22,22,18,0,29.983870967741936,194,36,24.758064516129032,4
Category_Wikipedia_sockpuppets_of_Muhammad_Ebad123.csv,263,3409094.0,110,153,34,76,0,56.954372623574145,496,45,31.216730038022813,7
Category_Wikipedia_sockpuppets_of_Nacho_Librarian.csv,395,346837.0,120,275,70,50,0,30.8126582278481,171,63,16.01772151898734,3
Category_Wikipedia_sockpuppets_of_Afghkgjasdh.csv,13,352.0,6,7,6,0,0,34.92307692307692,154,30,18.615384615384617,6
Category_Wikipedia_sockpuppets_of_Spofficial555.csv,6,258388.0,5,1,4,1,0,42.666666666666664,136,23,19.0,17
Category_Wikipedia_sockpuppets_of_Wetmnt1.csv,13,269525.0,7,6,4,3,4,44.53846153846154,194,78,47.38461538461539,18
Category_Wikipedia_sockpuppets_of_Poobearikkk.csv,2,49.0,2,0,2,0,11,15.0,19,22,22.0,22
Category_Wikipedia_sockpuppets_of_Milind1984.csv,6,2170550.0,4,2,4,0,10,41.666666666666664,131,20,14.666666666666666,12
Category_Wikipedia_sockpuppets_of_Lilkim.xl.csv,210,30602997.0,76,134,76,0,0,30.938095238095237,274,33,13.428571428571429,6
Category_Wikipedia_sockpuppets_of_Abdullah_Al_Imran_(Cyber_Security_Specialist).csv,147,13214122.0,82,65,69,13,0,51.78231292517007,500,55,19.952380952380953,6
Category_Wikipedia_sockpuppets_of_Ankitfnp.csv,1,0.0,1,0,1,0,18,18.0,18,13,13.0,13
Category_Wikipedia_sockpuppets_of_Mrs._Jan_Cola.csv,685,58601505.0,186,499,155,31,0,43.105109489051095,255,52,22.938686131386863,4
Category_Wikipedia_sockpuppets_of_Jafaz.csv,3687,79837635.0,1254,2433,500,754,0,50.48413344182262,500,79,24.05831299159208,1
Category_Wikipedia_sockpuppets_of_Watermarker.csv,45,4133719.0,11,34,7,4,0,34.24444444444445,183,32,16.133333333333333,12
Category_Wikipedia_sockpuppets_of_VSNAGGUR.csv,25,4710.0,10,15,5,5,0,31.8,140,27,20.16,7
Category_Wikipedia_sockpuppets_of_Dilip_rajeev.csv,1342,354861492.0,503,839,500,3,0,45.32414307004471,247,52,26.62071535022355,7
Category_Wikipedia_sockpuppets_of_Nikolai_Boyanov.csv,1354,16753074.0,502,852,500,2,0,43.33234859675037,318,52,17.206056129985228,3
Category_Wikipedia_sockpuppets_of_Ammar_chechenistan.csv,104,60227765.0,34,70,13,21,0,54.625,250,57,25.423076923076923,14
Category_Wikipedia_sockpuppets_of_Marywilso.csv,3,3216.0,2,1,1,1,10,134.0,196,16,14.666666666666666,14
Category_Wikipedia_sockpuppets_of_Vitcat123.csv,7,151648.0,4,3,4,0,0,38.142857142857146,218,17,14.285714285714286,12
Category_Wikipedia_sockpuppets_of_Alquin_Yaell_G._Rafales.csv,304,1011591.0,116,188,90,26,0,55.588815789473685,254,46,20.473684210526315,9
Category_Wikipedia_sockpuppets_of_Karateaniket.csv,232,182818411.0,65,167,22,43,0,46.25,244,45,20.525862068965516,9
Category_Wikipedia_sockpuppets_of_Jaymovez.csv,82,6851972.0,47,35,37,10,0,39.25609756097561,276,18,13.817073170731707,11
Category_Wikipedia_sockpuppets_of_Jj0909jj.csv,1449,56231418.0,434,1015,173,261,0,41.873706004140786,255,57,18.791580400276054,1
Category_Wikipedia_sockpuppets_of_Christopherfisherington.csv,74,13107055.0,19,55,18,1,0,64.5945945945946,247,22,5.594594594594595,3
Category_Wikipedia_sockpuppets_of_Toadforthe7.csv,3099,31466361.0,1177,1922,311,866,0,50.877057115198454,498,55,16.465311390771216,4
Category_Wikipedia_sockpuppets_of_Manson48.csv,392,98359300.0,154,238,149,5,0,38.75,238,51,19.316326530612244,9
Category_Wikipedia_sockpuppets_of_TableSalt342.csv,443,20980921.0,170,273,114,56,0,56.67720090293454,370,54,18.553047404063207,5
Category_Wikipedia_sockpuppets_of_Cellulosewiki.csv,15,559334.0,6,9,4,2,0,38.06666666666667,193,29,13.666666666666666,7
Category_Wikipedia_sockpuppets_of_S1312.csv,1528,106628192.0,509,1019,500,9,0,45.087041884816756,255,59,19.93913612565445,2
Category_Wikipedia_sockpuppets_of_Pabitra2204.csv,11,7123675.0,3,8,3,0,28,67.63636363636364,142,45,35.81818181818182,16
Category_Wikipedia_sockpuppets_of_Fargo44.csv,1207,233875827.0,401,806,370,31,0,44.67108533554267,259,72,20.306545153272577,4
Category_Wikipedia_sockpuppets_of_Marathi.Wiki.Editor.csv,141,3292577.0,58,83,32,26,0,54.53191489361702,218,58,20.673758865248228,5
Category_Wikipedia_sockpuppets_of_Tommy6987.csv,504,11619298.0,181,323,127,54,0,39.79761904761905,275,38,16.71031746031746,8
Category_Wikipedia_sockpuppets_of_FunnyDuckIsFunny.csv,273,695033.0,95,178,64,31,0,55.1025641025641,225,91,34.13186813186813,7
Category_Wikipedia_sockpuppets_of_Miner7347.csv,106,2045463.0,37,69,32,5,0,48.0377358490566,255,59,20.71698113207547,8
Category_Wikipedia_sockpuppets_of_Ktwestside.csv,67,9204453.0,20,47,16,4,0,50.28358208955224,178,46,15.507462686567164,5
Category_Wikipedia_sockpuppets_of_Oeukerteu.csv,1229,237430991.0,318,911,79,239,0,48.877949552481695,493,67,24.15947925142392,6
Category_Wikipedia_sockpuppets_of_Nauman335.csv,5358,23624524.0,1757,3601,500,1257,0,46.649309443822325,500,67,18.973684210526315,4
Category_Wikipedia_sockpuppets_of_Governmentbarrow.csv,254,3560495.0,115,139,33,82,0,44.36614173228347,233,57,21.45275590551181,5
Category_Wikipedia_sockpuppets_of_Kendy2020.csv,107,76235749.0,43,64,19,24,0,51.271028037383175,253,84,27.672897196261683,9
Category_Wikipedia_sockpuppets_of_CAH75.csv,6,9583871.0,4,2,2,2,13,48.833333333333336,130,23,23.0,23
Category_Wikipedia_sockpuppets_of_Highlands_Coffee.csv,36,612873.0,16,20,13,3,0,47.166666666666664,196,26,19.72222222222222,9
Category_Wikipedia_sockpuppets_of_Trentond2003.csv,139,444405.0,43,96,23,20,0,48.489208633093526,250,48,21.359712230215827,8
Category_Wikipedia_sockpuppets_of_WOLfan112.csv,4396,41444280.0,1561,2835,500,1061,0,53.12147406733394,250,88,22.94267515923567,3
Category_Wikipedia_sockpuppets_of_Tekkneek.csv,2,33.0,2,0,2,0,0,16.0,32,14,14.0,14
Category_Wikipedia_sockpuppets_of_Jeremykcarter.csv,513,11085836.0,163,350,16,147,0,49.74074074074074,255,51,19.894736842105264,4
Category_Wikipedia_sockpuppets_of_Delnex.csv,1723,131851778.0,445,1278,259,186,0,40.12420197330238,245,57,13.227510156703424,3
Category_Wikipedia_sockpuppets_of_Hatkkk.csv,26,160338.0,13,13,11,2,0,23.46153846153846,178,16,13.26923076923077,1
Category_Wikipedia_sockpuppets_of_Wiki_Elvis.csv,178,6739628.0,71,107,29,42,0,38.59550561797753,225,51,19.51123595505618,6
Category_Wikipedia_sockpuppets_of_Unitarian9999.csv,95,8726131.0,48,47,36,12,0,56.09473684210526,316,45,23.105263157894736,5
Category_Wikipedia_sockpuppets_of_Top_Gun.csv,6806,107304111.0,2298,4508,500,1798,0,39.152365559800174,255,84,27.3245665589186,4
Category_Wikipedia_sockpuppets_of_LieutenantJames20.csv,196,11988346.0,63,133,60,3,0,38.51020408163265,249,31,19.091836734693878,6
Category_Wikipedia_sockpuppets_of_LaurelWest.csv,865,14717780.0,342,523,174,168,0,42.83815028901734,386,48,19.09479768786127,5
Category_Wikipedia_sockpuppets_of_Atticus765.csv,194,249726.0,60,134,47,13,0,35.45360824742268,195,24,12.329896907216495,3
Category_Wikipedia_sockpuppets_of_Jagbir_Singh_Jimmy.csv,265,8567518.0,99,166,73,26,0,38.82641509433962,335,44,15.041509433962265,4
Category_Wikipedia_sockpuppets_of_The_basis_of.csv,217,2679872.0,91,126,86,5,0,57.62672811059908,406,47,35.08755760368663,13
Category_Wikipedia_sockpuppets_of_Benahol.csv,897,3882877.0,309,588,274,35,0,49.860646599777034,323,54,23.33221850613155,5
Category_Wikipedia_sockpuppets_of_Evamedia55.csv,34,7339936.0,11,23,6,5,0,34.35294117647059,127,41,24.058823529411764,15
Category_Wikipedia_sockpuppets_of_Siredejoinville.csv,1117,119095627.0,509,608,500,9,0,37.339301700984784,255,58,18.109221128021485,10
Category_Wikipedia_sockpuppets_of_Itlook.csv,2,80.0,2,0,2,0,0,17.5,35,44,27.5,11
Category_Wikipedia_sockpuppets_of_Sheikh_surfuddin.csv,83,168234204.0,49,34,13,36,0,43.433734939759034,228,39,31.228915662650603,16
Category_Wikipedia_sockpuppets_of_I_want_to_see_the_little_sausage.csv,9,244.0,5,4,1,4,10,25.0,89,16,16.0,16
Category_Wikipedia_sockpuppets_of_Albaredd.csv,122,167532937.0,40,82,35,5,0,46.59016393442623,466,29,22.10655737704918,17
Category_Wikipedia_sockpuppets_of_Bs5522.csv,49,6497621.0,30,19,18,12,0,75.16326530612245,231,5,5.0,5
Category_Wikipedia_sockpuppets_of_Christian_Trautenberg.csv,84,5097167.0,38,46,34,4,0,83.32142857142857,299,52,25.05952380952381,10
Category_Wikipedia_sockpuppets_of_Pandyan123.csv,116,10241318.0,48,68,35,13,0,49.956896551724135,232,36,18.379310344827587,13
Category_Wikipedia_sockpuppets_of_Pmmp1234.csv,211,2756403.0,134,77,106,28,0,48.985781990521325,483,55,27.99526066350711,18
Category_Wikipedia_sockpuppets_of_Hammerhard18.csv,229,4565831.0,108,121,55,53,0,49.65938864628821,318,72,28.148471615720524,8
Category_Wikipedia_sockpuppets_of_TenzinLosang.csv,25,1730906.0,18,7,14,4,0,61.2,153,22,19.08,6
Category_Wikipedia_sockpuppets_of_ArinaVardanyan.csv,22,4041019.0,7,15,3,4,0,50.36363636363637,163,24,16.863636363636363,8
Category_Wikipedia_sockpuppets_of_Tony85poon.csv,1335,2659397.0,542,793,500,42,0,51.41198501872659,995,69,28.856928838951312,4
Category_Wikipedia_sockpuppets_of_TaylanUB.csv,1431,115906035.0,569,862,470,99,0,69.09084556254368,488,65,23.62683438155136,6
Category_Wikipedia_sockpuppets_of_GohanIlimI.csv,634,37120107.0,263,371,236,27,0,52.91167192429022,363,50,23.48422712933754,5
Category_Wikipedia_sockpuppets_of_JamesKillsFour.csv,234,49525673.0,69,165,64,5,0,64.58119658119658,364,65,22.568376068376068,8
Category_Wikipedia_sockpuppets_of_Tvman2020.csv,36,138526901.0,17,19,8,9,0,41.75,153,42,20.72222222222222,8
Category_Wikipedia_sockpuppets_of_Robvanden.csv,131,1257667.0,63,68,58,5,0,44.12977099236641,246,31,19.908396946564885,13
Category_Wikipedia_sockpuppets_of_BlueSisyphus.csv,749,347323108.0,273,476,271,2,0,60.26034712950601,391,54,16.59679572763685,3
Category_Wikipedia_sockpuppets_of_Eliteware.csv,79,3292692.0,20,59,20,0,0,38.924050632911396,228,24,11.69620253164557,7
Category_Wikipedia_sockpuppets_of_Neyoa.csv,11,30786.0,8,3,5,3,0,14.090909090909092,110,35,31.727272727272727,23
Category_Wikipedia_sockpuppets_of_Daphnaz.csv,65,87564850.0,15,50,15,0,0,50.04615384615385,200,12,11.307692307692308,10
Category_Wikipedia_sockpuppets_of_Davidfrankforpresident.csv,14,1474827.0,12,2,9,3,0,35.142857142857146,144,11,11.0,11
Category_Wikipedia_sockpuppets_of_Anonymousbananas.csv,2931,47221077.0,965,1966,500,465,0,42.831456840668714,257,72,23.588536335721596,4
Category_Wikipedia_sockpuppets_of_LennyPerez44.csv,130,30280789.0,52,78,50,2,0,43.80769230769231,227,51,22.092307692307692,4
Category_Wikipedia_sockpuppets_of_Joshmathews2022.csv,29,79003.0,25,4,15,10,0,9.379310344827585,20,44,24.689655172413794,16
Category_Wikipedia_sockpuppets_of_Aiden_Stocking.csv,151,58427915.0,43,108,34,9,0,40.549668874172184,287,36,20.635761589403973,14
Category_Wikipedia_sockpuppets_of_Mountain_Child.csv,66,42247972.0,26,40,19,7,0,38.84848484848485,230,53,21.242424242424242,10
Category_Wikipedia_sockpuppets_of_TiberiasTiberias.csv,2541,246992548.0,929,1612,500,429,0,53.69067296340024,397,99,18.185753640299094,4
Category_Wikipedia_sockpuppets_of_Rudra.shukla.csv,2057,203143114.0,518,1539,203,315,0,45.481283422459896,257,56,17.65629557608167,5
Category_Wikipedia_sockpuppets_of_Alechkoist.csv,1910,200008942.0,672,1238,280,392,0,47.64502617801047,255,76,20.14450261780105,5
Category_Wikipedia_sockpuppets_of_Superiorsuperstar.csv,104,65627214.0,32,72,29,3,0,45.25,224,16,11.634615384615385,11
Category_Wikipedia_sockpuppets_of_Horhey420.csv,3894,59066822.0,1725,2169,500,1225,0,48.47996918335902,255,55,25.2211093990755,5
Category_Wikipedia_sockpuppets_of_Maheshworld.csv,1029,63502348.0,430,599,344,86,0,51.31195335276968,496,56,17.44703595724004,5
Category_Wikipedia_sockpuppets_of_Ecopave.csv,1091,51870408.0,390,701,163,227,0,33.35655362053162,213,52,15.643446379468378,5
Category_Wikipedia_sockpuppets_of_Calgarydog101.csv,35,28927.0,16,19,9,7,0,50.91428571428571,231,40,22.428571428571427,18
Category_Wikipedia_sockpuppets_of_Ativerb.csv,67,64533179.0,21,46,12,9,0,41.8955223880597,198,20,11.134328358208956,4
Category_Wikipedia_sockpuppets_of_Nitinpatkar194.csv,184,20301202.0,69,115,25,44,0,51.78260869565217,272,54,19.91304347826087,7
Category_Wikipedia_sockpuppets_of_User000315.csv,64,9602605.0,31,33,30,1,0,62.203125,268,38,17.3125,5
Category_Wikipedia_sockpuppets_of_Juliesimmons1987.csv,18,4985760.0,11,7,5,6,0,26.833333333333332,193,9,9.0,9
Category_Wikipedia_sockpuppets_of_Rbkasr.csv,245,241345777.0,66,179,58,8,0,39.61224489795919,403,64,14.751020408163265,6
Category_Wikipedia_sockpuppets_of_Nithin_Gowda_1992.csv,101,178012.0,75,26,74,1,0,26.11881188118812,219,29,13.712871287128714,9
Category_Wikipedia_sockpuppets_of_Childrenpokemon.csv,530,22890869.0,131,399,71,60,0,46.01509433962264,228,42,29.637735849056604,7
Category_Wikipedia_sockpuppets_of_Mlulu.csv,65,10486086.0,22,43,19,3,0,35.292307692307695,248,24,16.107692307692307,12
Category_Wikipedia_sockpuppets_of_Vacilandoish.csv,12,15932.0,11,1,10,1,0,26.916666666666668,144,14,14.0,14
Category_Wikipedia_sockpuppets_of_Felipemassa123.csv,2811,53487106.0,969,1842,500,469,0,40.62753468516542,255,50,19.7940234791889,7
Category_Wikipedia_sockpuppets_of_KCapone.csv,95,4747667.0,74,21,46,28,0,27.063157894736843,476,27,22.042105263157893,17
Category_Wikipedia_sockpuppets_of_Johnny_castro.csv,1,0.0,1,0,1,0,72,72.0,72,45,45.0,45
Category_Wikipedia_sockpuppets_of_Rainbowofpeace.csv,1434,403739555.0,502,932,500,2,0,40.05160390516039,376,60,21.38981868898187,4
Category_Wikipedia_sockpuppets_of_Mehmoodj.csv,83,10103141.0,20,63,19,1,0,41.855421686746986,224,53,26.433734939759034,5
Category_Wikipedia_sockpuppets_of_AlexFurman.csv,132,71917827.0,61,71,59,2,0,36.96212121212121,250,35,26.65909090909091,15
Category_Wikipedia_sockpuppets_of_Alexx04.csv,2614,130775472.0,739,1875,500,239,0,26.942234123947973,255,50,16.899005355776588,7
Category_Wikipedia_sockpuppets_of_McAusten.csv,2496,170096213.0,882,1614,500,382,0,33.03445512820513,255,85,23.840945512820515,3
Category_Wikipedia_sockpuppets_of_SILQCX.csv,4,23293.0,2,2,1,1,0,34.25,77,44,44.0,44
Category_Wikipedia_sockpuppets_of_Zing84.csv,634,9434173.0,205,429,105,100,0,67.43375394321767,255,57,17.55205047318612,5
Category_Wikipedia_sockpuppets_of_Kathmandu-Rasuwa_Nepali_Congress.csv,606,10808914.0,285,321,157,128,0,36.896039603960396,255,57,18.585808580858085,3
Category_Wikipedia_sockpuppets_of_ConsumersDistributingonline.csv,14451,137956014.0,4594,9857,500,4094,0,41.70790948723272,500,67,13.857449311466334,3
Category_Wikipedia_sockpuppets_of_DaWn_ODG.csv,222,91983453.0,80,142,33,47,0,40.427927927927925,255,53,17.045045045045047,4
Category_Wikipedia_sockpuppets_of_Brickleberryy.csv,79,1881587.0,21,58,7,14,0,54.40506329113924,192,30,20.063291139240505,10
Category_Wikipedia_sockpuppets_of_Oglesruins.csv,6296,10720089.0,1874,4422,500,1374,0,40.264135959339264,255,65,19.95187420584498,3
Category_Wikipedia_sockpuppets_of_MP_NT_C.csv,82,138046.0,38,44,19,19,0,66.82926829268293,277,24,14.341463414634147,5
Category_Wikipedia_sockpuppets_of_Paradocks.csv,8,39980162.0,2,6,1,1,0,69.5,147,26,25.375,21
Category_Wikipedia_sockpuppets_of_Manster1.csv,1181,31460910.0,576,605,500,76,0,43.843353090601184,356,61,28.023708721422523,8
Category_Wikipedia_sockpuppets_of_Fidelis_ofoajoku.csv,270,53219893.0,66,204,48,18,0,46.52962962962963,255,59,19.451851851851853,7
Category_Wikipedia_sockpuppets_of_Valterre.csv,453,24655948.0,210,243,135,75,0,45.86534216335541,246,52,15.75055187637969,7
Category_Wikipedia_sockpuppets_of_Usama_Boss.csv,104,91910.0,47,57,42,5,0,44.65384615384615,196,27,9.836538461538462,5
Category_Wikipedia_sockpuppets_of_Yousefsw07.csv,460,18506420.0,156,304,71,85,0,56.27173913043478,500,56,23.13695652173913,8
Category_Wikipedia_sockpuppets_of_Babygotback6969.csv,12,517.0,7,5,3,4,0,70.33333333333333,151,22,22.0,22
Category_Wikipedia_sockpuppets_of_MetroEarth.csv,1812,60053552.0,794,1018,500,294,0,30.538079470198674,496,48,23.29580573951435,4
Category_Wikipedia_sockpuppets_of_MD-10_Project.csv,26,471855.0,21,5,11,10,0,30.03846153846154,197,23,20.923076923076923,18
Category_Wikipedia_sockpuppets_of_Foo_Bar_Buzz_Netz.csv,241,14486370.0,90,151,75,15,0,56.788381742738586,238,45,20.78423236514523,6
Category_Wikipedia_sockpuppets_of_Othoaliraza2.csv,63,41396329.0,31,32,30,1,0,55.65079365079365,180,32,28.0,12
Category_Wikipedia_sockpuppets_of_Football_Etc_Pedant.csv,131,11642019.0,69,62,66,3,0,31.435114503816795,250,64,39.85496183206107,12
Category_Wikipedia_sockpuppets_of_Praelongum.csv,204,118022885.0,62,142,55,7,0,49.19607843137255,355,45,19.014705882352942,8
Category_Wikipedia_sockpuppets_of_Sidjain111.csv,23,4688584.0,9,14,8,1,0,55.52173913043478,251,48,17.565217391304348,6
Category_Wikipedia_sockpuppets_of_MihaiVanda34.csv,34,878143.0,20,14,12,8,0,46.029411764705884,141,26,16.08823529411765,12
Category_Wikipedia_sockpuppets_of_Bradley_Crossman.csv,1510,17271248.0,597,913,500,97,0,36.117218543046356,250,34,18.158940397350992,9
Category_Wikipedia_sockpuppets_of_Minecraftgamerpc64.csv,1468,107658443.0,425,1043,402,23,0,47.87942779291553,395,58,16.155313351498638,3
Category_Wikipedia_sockpuppets_of_Sham_Kumar_Monger.csv,120,66159547.0,38,82,20,18,0,44.85,183,53,23.008333333333333,6
Category_Wikipedia_sockpuppets_of_Guessing_Game.csv,3046,207712488.0,973,2073,500,473,0,47.14149704530532,255,64,21.442219304005253,3
Category_Wikipedia_sockpuppets_of_Philip126.csv,3140,56963939.0,804,2336,75,729,0,40.94490445859873,255,57,15.586305732484076,3
Category_Wikipedia_sockpuppets_of_Shelfoozle.csv,14,200.0,4,10,4,0,0,104.71428571428571,219,44,19.857142857142858,5
Category_Wikipedia_sockpuppets_of_Ugur_none.csv,501,26448652.0,123,378,21,102,0,59.02794411177645,273,43,19.07185628742515,3
Category_Wikipedia_sockpuppets_of_Bcoll95478.csv,59,268898.0,51,8,46,5,0,31.593220338983052,196,25,20.16949152542373,10
Category_Wikipedia_sockpuppets_of_RyossStefano72.csv,11,487819.0,4,7,3,1,0,54.63636363636363,148,52,33.45454545454545,10
Category_Wikipedia_sockpuppets_of_Olesachem.csv,731,71259965.0,406,325,328,78,0,41.3406292749658,229,50,14.969904240766073,8
Category_Wikipedia_sockpuppets_of_Jmplaton.csv,126,13219381.0,50,76,31,19,0,62.11904761904762,196,38,20.126984126984127,10
Category_Wikipedia_sockpuppets_of_Jaktheladz.csv,21136,188867731.0,5832,15304,379,5453,0,49.3285862982589,501,90,16.04172975018925,2
Category_Wikipedia_sockpuppets_of_Charlotte135.csv,1699,56716795.0,551,1148,500,51,0,53.83284284873455,255,53,24.10594467333726,6
Category_Wikipedia_sockpuppets_of_Asfd777.csv,147,4132623.0,67,80,65,2,0,37.08843537414966,177,41,20.693877551020407,10
Category_Wikipedia_sockpuppets_of_Harvici.csv,3000,8796055.0,959,2041,500,459,0,64.861,496,66,22.498333333333335,3
Category_Wikipedia_sockpuppets_of_F√£_do_rap_americano_e_brasileiro.csv,2141,12366533.0,754,1387,266,488,0,34.21158337225596,500,52,17.73797290985521,3
Category_Wikipedia_sockpuppets_of_AmericanHistorianEducated1.csv,19,925344.0,15,4,12,3,0,125.42105263157895,502,36,16.736842105263158,6
Category_Wikipedia_sockpuppets_of_JAWAD1P.csv,1031,8125704.0,362,669,96,266,0,43.013579049466536,300,53,17.32395732298739,5
Category_Wikipedia_sockpuppets_of_Drpremrajpushpakaran.csv,1516,183352433.0,508,1008,500,8,0,36.190633245382585,255,56,22.318601583113455,4
Category_Wikipedia_sockpuppets_of_Suicidndsjnfienosf.csv,7,695.0,5,2,3,2,13,56.285714285714285,182,18,18.0,18
Category_Wikipedia_sockpuppets_of_Taolabomay.csv,6268,78216374.0,1989,4279,500,1489,0,40.514199106573066,499,78,14.879227823867263,1
Category_Wikipedia_sockpuppets_of_Yeajjj.csv,10,842.0,5,5,5,0,0,52.6,174,18,17.2,16
Category_Wikipedia_sockpuppets_of_Wikigender.csv,7,1332540.0,4,3,4,0,0,24.142857142857142,66,49,36.57142857142857,20
Category_Wikipedia_sockpuppets_of_Makotojs.csv,96,200014.0,28,68,20,8,0,55.979166666666664,238,45,31.270833333333332,19
Category_Wikipedia_sockpuppets_of_GuardianZ.csv,1108,33813793.0,423,685,279,144,0,41.398014440433215,255,64,25.626353790613717,7
Category_Wikipedia_sockpuppets_of_Hary1mo.csv,624,23679781.0,187,437,68,119,0,66.3573717948718,496,56,18.71955128205128,7
Category_Wikipedia_sockpuppets_of_Shaykh217.csv,95,47157613.0,47,48,45,2,0,44.642105263157895,231,19,12.810526315789474,6
Category_Wikipedia_sockpuppets_of_Giratto.csv,170,43624983.0,40,130,17,23,0,54.38235294117647,330,47,21.1,8
Category_Wikipedia_sockpuppets_of_Daveygp.csv,1337,89692039.0,460,877,134,326,0,35.43904263275991,240,43,19.963350785340314,4
Category_Wikipedia_sockpuppets_of_BhaskerDeepak.csv,205,79881751.0,108,97,59,49,0,46.71707317073171,311,69,22.082926829268292,7
Category_Wikipedia_sockpuppets_of_Padlokasul.csv,213,582374.0,70,143,58,12,0,57.16901408450704,225,25,14.220657276995306,5
Category_Wikipedia_sockpuppets_of_Keonismith2531.csv,8,569661.0,8,0,4,4,0,178.0,420,32,22.375,17
Category_Wikipedia_sockpuppets_of_Uipropitome.csv,1,0.0,1,0,1,0,14,14.0,14,29,29.0,29
Category_Wikipedia_sockpuppets_of_Phillip_Taylor_Smumtummersonson.csv,74,429045.0,30,44,13,17,0,70.77027027027027,236,53,17.7027027027027,4
Category_Wikipedia_sockpuppets_of_AndreaGotts.csv,379,61327275.0,123,256,74,49,0,44.854881266490764,271,57,15.931398416886543,6
Category_Wikipedia_sockpuppets_of_Senseagent223.csv,235,16696966.0,47,188,15,32,0,28.140425531914893,249,41,15.438297872340426,5
Category_Wikipedia_sockpuppets_of_Bolgitalianissimano.csv,237,11685951.0,128,109,84,44,0,32.70464135021097,211,55,14.413502109704641,4
Category_Wikipedia_sockpuppets_of_Jerry_Z._Liu.csv,88,217438.0,21,67,18,3,0,48.18181818181818,256,39,18.84090909090909,5
Category_Wikipedia_sockpuppets_of_Vanray.csv,61,195592086.0,13,48,12,1,0,59.73770491803279,218,45,13.37704918032787,9
Category_Wikipedia_sockpuppets_of_Krishnaballesh.csv,1441,186661582.0,659,782,417,242,0,33.07217210270645,255,42,16.91880638445524,6
Category_Wikipedia_sockpuppets_of_Nationalist.csv,4706,34451133.0,1781,2925,500,1281,0,32.0129621759456,255,66,19.75796855078623,3
Category_Wikipedia_sockpuppets_of_Carlivanvcalayag.csv,17,177412.0,6,11,4,2,0,35.05882352941177,162,41,31.176470588235293,12
Category_Wikipedia_sockpuppets_of_Michaellevineassistant.csv,548,372730260.0,185,363,181,4,0,45.29014598540146,499,68,21.593065693430656,5
Category_Wikipedia_sockpuppets_of_Definatly_Not_Anonymous.csv,413,56528167.0,118,295,80,38,0,54.93946731234867,496,41,20.818401937046005,5
Category_Wikipedia_sockpuppets_of_Kalpesh.popat.csv,21,173260955.0,6,15,6,0,0,55.142857142857146,211,49,19.761904761904763,16
Category_Wikipedia_sockpuppets_of_Canterberry.csv,4988,51897132.0,1982,3006,500,1482,0,33.508620689655174,252,67,25.34703287890938,4
Category_Wikipedia_sockpuppets_of_Roliverpoliver.csv,20,171199.0,7,13,6,1,0,56.45,185,15,9.4,7
Category_Wikipedia_sockpuppets_of_EwersonVSantos.csv,380,27488849.0,190,190,184,6,0,34.86052631578947,238,36,21.660526315789475,10
Category_Wikipedia_sockpuppets_of_Iamhrkk.csv,9,12000.0,8,1,6,2,0,25.333333333333332,149,41,12.555555555555555,9
Category_Wikipedia_sockpuppets_of_Js82.csv,1067,72542076.0,326,741,101,225,0,58.53701968134958,255,49,15.724461105904405,5
Category_Wikipedia_sockpuppets_of_TheMasterMind321.csv,627,39203987.0,165,462,103,62,0,57.01275917065391,490,52,18.71451355661882,3
Category_Wikipedia_sockpuppets_of_Witchy2006.csv,3034,22114146.0,1148,1886,500,648,0,37.567237969676995,261,52,22.748187211601845,2
Category_Wikipedia_sockpuppets_of_Ralphreretort.csv,1,0.0,1,0,1,0,0,0.0,0,34,34.0,34
Category_Wikipedia_sockpuppets_of_Fripri.csv,33,8703.0,12,21,12,0,0,35.45454545454545,194,32,20.545454545454547,14
Category_Wikipedia_sockpuppets_of_Larastabata.csv,129,8798979.0,57,72,48,9,0,39.17054263565891,202,36,25.410852713178294,11
Category_Wikipedia_sockpuppets_of_SockPuppet42.csv,34,8977003.0,19,15,12,7,0,56.94117647058823,208,48,25.676470588235293,14
Category_Wikipedia_sockpuppets_of_Sudhakittu.csv,952,16520975.0,329,623,303,26,0,28.689075630252102,255,56,16.24579831932773,4
Category_Wikipedia_sockpuppets_of_Jalfano73.csv,77,2405934.0,49,28,46,3,0,25.493506493506494,196,29,12.025974025974026,6
Category_Wikipedia_sockpuppets_of_Zizu101.csv,10,20267.0,8,2,3,5,20,34.5,165,12,12.0,12
Category_Wikipedia_sockpuppets_of_Justinzimmer868.csv,228,2328658.0,75,153,59,16,0,40.05263157894737,238,35,18.42105263157895,5
Category_Wikipedia_sockpuppets_of_Weak81.csv,20,604490.0,10,10,8,2,10,80.6,204,11,9.2,9
Category_Wikipedia_sockpuppets_of_Jean_Seberg's_Ghost.csv,47,24085.0,35,12,35,0,0,18.914893617021278,88,24,24.0,24
Category_Wikipedia_sockpuppets_of_Createitnow114.csv,26,1269782.0,22,4,14,8,0,28.73076923076923,112,9,9.0,9
Category_Wikipedia_sockpuppets_of_Rolandi+.csv,4255,19616329.0,1337,2918,500,837,0,40.16192714453584,255,51,15.826086956521738,3
Category_Wikipedia_sockpuppets_of_RK777713.csv,123,8724204.0,52,71,47,5,0,36.260162601626014,192,22,18.83739837398374,17
Category_Wikipedia_sockpuppets_of_Dylan_Cerbone_2018.csv,1057,41227965.0,474,583,182,292,0,53.142857142857146,310,48,27.226111636707664,5
Category_Wikipedia_sockpuppets_of_Keepitreal42.csv,458,3761166.0,152,306,98,54,0,52.68995633187773,486,73,27.216157205240176,12
Category_Wikipedia_sockpuppets_of_SKMDRONY.csv,2,17888.0,2,0,2,0,0,47.0,94,18,15.5,13
Category_Wikipedia_sockpuppets_of_Richprentice.csv,538,60271370.0,179,359,109,70,0,50.1635687732342,250,54,26.45167286245353,7
Category_Wikipedia_sockpuppets_of_Captchadefiner.csv,101,2346109.0,34,67,24,10,0,50.86138613861386,199,41,20.207920792079207,10
Category_Wikipedia_sockpuppets_of_Shxtlebell.csv,120,47949735.0,49,71,15,34,0,40.28333333333333,194,21,13.383333333333333,11
Category_Wikipedia_sockpuppets_of_Meh_Nachu_Arai.csv,625,432003.0,202,423,172,30,0,57.5328,263,34,14.5792,7
Category_Wikipedia_sockpuppets_of_Logan_Fruchtman.csv,487,36462862.0,139,348,130,9,0,49.80287474332649,255,58,22.93839835728953,7
Category_Wikipedia_sockpuppets_of_Cada_mori.csv,719,77685890.0,214,505,207,7,0,52.2865090403338,255,73,23.666203059805284,5
Category_Wikipedia_sockpuppets_of_El_Cubano_153.csv,1109,34720925.0,450,659,194,256,0,47.59422903516682,392,62,29.200180342651038,8
Category_Wikipedia_sockpuppets_of_Tomgglass.csv,90,135751871.0,30,60,16,14,0,55.233333333333334,244,50,27.977777777777778,12
Category_Wikipedia_sockpuppets_of_Lodha_Palava_City.csv,28,7918.0,12,16,11,1,0,33.892857142857146,166,27,13.964285714285714,11
Category_Wikipedia_sockpuppets_of_Razorback2011.csv,54,5531732.0,33,21,16,17,0,30.444444444444443,231,49,27.90740740740741,12
Category_Wikipedia_sockpuppets_of_Igedazbrahg.csv,129,4522073.0,33,96,29,4,0,43.4031007751938,234,32,17.844961240310077,5
Category_Wikipedia_sockpuppets_of_Collision787.csv,600,84801160.0,198,402,86,112,0,50.153333333333336,255,39,17.688333333333333,4
Category_Wikipedia_sockpuppets_of_Aeronandre.csv,921,25148162.0,523,398,460,63,0,28.05211726384365,231,44,25.271444082519,13
Category_Wikipedia_sockpuppets_of_Rodoval.csv,310,114404672.0,114,196,84,30,0,39.648387096774194,216,54,18.261290322580646,6
Category_Wikipedia_sockpuppets_of_Loshgr.csv,262,60324230.0,135,127,135,0,0,36.62595419847328,230,53,23.12213740458015,11
Category_Wikipedia_sockpuppets_of_Capitalistteabagger.csv,31,6507775.0,12,19,12,0,0,93.03225806451613,255,71,46.774193548387096,15
Category_Wikipedia_sockpuppets_of_PandaBuzzLightyear.csv,1033,19864596.0,318,715,90,228,0,49.04646660212972,485,48,15.253630203291385,4
Category_Wikipedia_sockpuppets_of_Nbafan62.csv,418,10619279.0,131,287,114,17,0,43.16985645933014,294,38,16.954545454545453,7
Category_Wikipedia_sockpuppets_of_It's.dylan.csv,46,120323733.0,12,34,7,5,0,50.08695652173913,192,23,12.673913043478262,7
Category_Wikipedia_sockpuppets_of_Danielmartin22.csv,26,75740352.0,9,17,3,6,0,63.57692307692308,170,12,12.0,12
Category_Wikipedia_sockpuppets_of_Rhelen305.csv,384,61497260.0,236,148,210,26,0,26.0859375,233,50,17.768229166666668,10
Category_Wikipedia_sockpuppets_of_Angelalive.csv,804,362626578.0,241,563,82,159,0,49.01990049751244,395,69,24.37313432835821,4
Category_Wikipedia_sockpuppets_of_Mrwiki1220.csv,328,35068119.0,143,185,116,27,0,53.47256097560975,434,47,19.73170731707317,6
Category_Wikipedia_sockpuppets_of_Pwningall.csv,139,1899374.0,57,82,26,31,0,83.09352517985612,231,36,14.071942446043165,5
Category_Wikipedia_sockpuppets_of_HowardStrong.csv,2573,7251761.0,1023,1550,500,523,0,46.315584920326465,255,68,16.991061018266613,1
Category_Wikipedia_sockpuppets_of_Websoftnew.csv,34,556236.0,17,17,16,1,0,75.26470588235294,227,20,14.441176470588236,11
Category_Wikipedia_sockpuppets_of_Raif2007.csv,167,20063960.0,52,115,52,0,0,56.275449101796404,449,44,20.778443113772454,9
Category_Wikipedia_sockpuppets_of_Kamosuke.csv,3335,14532482.0,667,2668,500,167,0,38.629385307346325,227,53,12.693253373313343,5
Category_Wikipedia_sockpuppets_of_BlueSalix.csv,3414,20464460.0,1581,1833,500,1081,0,48.32601054481547,255,107,33.934387814879905,3
Category_Wikipedia_sockpuppets_of_Binazir1987.csv,416,34913979.0,229,187,219,10,0,33.83413461538461,266,53,25.46153846153846,12
Category_Wikipedia_sockpuppets_of_Sahajhist.csv,1170,50890747.0,522,648,500,22,0,32.705128205128204,200,72,19.772649572649573,5
Category_Wikipedia_sockpuppets_of_Kƒ±zƒ±lB√∂r√º1071.csv,3075,112989031.0,980,2095,104,876,0,44.343739837398374,485,53,18.59739837398374,6
Category_Wikipedia_sockpuppets_of_Azifast_Andhra.csv,779,120790537.0,187,592,60,127,0,49.41848523748396,307,51,17.80359435173299,7
Category_Wikipedia_sockpuppets_of_Moulton.csv,890,39253418.0,500,390,500,0,0,57.90898876404494,203,51,23.06179775280899,10
Category_Wikipedia_sockpuppets_of_4310'channel.csv,130,641648.0,77,53,67,10,0,31.96923076923077,199,31,19.06153846153846,8
Category_Wikipedia_sockpuppets_of_Seasonalweathers.csv,35,195385.0,16,19,13,3,0,71.31428571428572,239,26,17.771428571428572,15
Category_Wikipedia_sockpuppets_of_SnakeyDoDar.csv,20,73033.0,14,6,8,6,0,52.75,146,50,25.7,13
Category_Wikipedia_sockpuppets_of_Mrbenjelloun.csv,49,21713559.0,21,28,20,1,0,51.755102040816325,224,36,23.571428571428573,17
Category_Wikipedia_sockpuppets_of_PH0071401.csv,15,794919.0,7,8,5,2,0,85.73333333333333,236,14,9.333333333333334,9
Category_Wikipedia_sockpuppets_of_Melarnik.csv,155,17100772.0,65,90,58,7,0,51.13548387096774,250,22,9.283870967741935,7
Category_Wikipedia_sockpuppets_of_Shonakash.csv,1421,15716330.0,771,650,146,625,0,35.381421534130894,423,55,17.24982406755806,9
Category_Wikipedia_sockpuppets_of_Meghan.reilly.csv,616,22494915.0,234,382,127,107,0,41.30357142857143,257,45,17.72077922077922,4
Category_Wikipedia_sockpuppets_of_AgentKB.csv,9,4339.0,4,5,4,0,0,35.77777777777778,113,42,35.77777777777778,14
Category_Wikipedia_sockpuppets_of_Marcus_Brute.csv,2936,1227202.0,896,2040,500,396,0,64.14237057220708,261,63,20.142370572207085,3
Category_Wikipedia_sockpuppets_of_AIAVENUE1.csv,33,11009175.0,14,19,9,5,8,80.96969696969697,217,47,17.03030303030303,2
Category_Wikipedia_sockpuppets_of_Historiador1923.csv,9,408514.0,4,5,4,0,0,48.333333333333336,118,51,29.77777777777778,15
Category_Wikipedia_sockpuppets_of_Iluvdonuts.csv,107,37806023.0,37,70,28,9,0,59.85981308411215,250,48,17.598130841121495,8
Category_Wikipedia_sockpuppets_of_Imveracious.csv,3801,30424239.0,1069,2732,500,569,0,51.55564325177585,255,98,19.597737437516443,3
Category_Wikipedia_sockpuppets_of_Cbennett0811.csv,495,361941209.0,153,342,148,5,0,49.03030303030303,230,27,15.75959595959596,3
Category_Wikipedia_sockpuppets_of_Unnamed_17.csv,56,608969.0,25,31,21,4,0,45.94642857142857,190,46,25.910714285714285,10
Category_Wikipedia_sockpuppets_of_Rinku125.csv,280,5330646.0,84,196,23,61,0,39.107142857142854,255,41,18.492857142857144,5
Category_Wikipedia_sockpuppets_of_Archietherave10.csv,578,93166718.0,217,361,95,122,0,65.47231833910034,250,57,17.242214532871973,9
Category_Wikipedia_sockpuppets_of_Rdsoxfa.csv,70,164067.0,47,23,47,0,0,19.085714285714285,199,24,21.357142857142858,10
Category_Wikipedia_sockpuppets_of_Jcutrufo.csv,35,111470766.0,7,28,7,0,0,34.885714285714286,164,27,22.6,18
Category_Wikipedia_sockpuppets_of_A_Nobody.csv,2550,187315903.0,856,1694,500,356,0,38.74470588235294,237,100,26.288235294117648,4
Category_Wikipedia_sockpuppets_of_Jungkook420.csv,2158,8376103.0,586,1572,500,86,0,76.02780352177942,499,66,17.047265987025025,2
Category_Wikipedia_sockpuppets_of_I_Am_Chuck.csv,67,3209074.0,20,47,17,3,0,58.208955223880594,175,26,12.044776119402986,5
Category_Wikipedia_sockpuppets_of_Perfect_Red_Cube.csv,407,22833681.0,136,271,68,68,0,54.96314496314496,255,52,17.331695331695332,4
Category_Wikipedia_sockpuppets_of_Tommyelia.csv,24,16220.0,10,14,7,3,0,43.0,162,19,11.5,10
Category_Wikipedia_sockpuppets_of_InterestInThing.csv,53,199844517.0,13,40,11,2,0,46.77358490566038,173,30,20.07547169811321,14
Category_Wikipedia_sockpuppets_of_Timothy_McGuire.csv,1392,226965648.0,522,870,500,22,0,42.61925287356322,347,87,24.085488505747126,4
Category_Wikipedia_sockpuppets_of_Brendanm2129.csv,275,27681985.0,102,173,94,8,0,57.70181818181818,273,56,20.21818181818182,6
Category_Wikipedia_sockpuppets_of_Itzikziat.csv,50,33318865.0,16,34,12,4,0,49.62,196,67,18.5,16
Category_Wikipedia_sockpuppets_of_Dafturd.csv,55,805250.0,32,23,28,4,0,13.4,174,48,19.581818181818182,8
Category_Wikipedia_sockpuppets_of_Utk2.csv,78,1596670.0,40,38,39,1,0,60.61538461538461,255,23,17.564102564102566,13
Category_Wikipedia_sockpuppets_of_The_adarshsahu.csv,107,1199697.0,41,66,41,0,0,37.19626168224299,205,64,26.738317757009344,6
Category_Wikipedia_sockpuppets_of_Hedgehog_officer.csv,43,335232.0,23,20,22,1,0,89.4186046511628,243,54,28.651162790697676,17
Category_Wikipedia_sockpuppets_of_Liliana_Dabic.csv,12,5001.0,9,3,8,1,0,40.833333333333336,194,64,25.666666666666668,18
Category_Wikipedia_sockpuppets_of_UDAcommander.csv,93,7433266.0,35,58,19,16,0,30.301075268817204,199,30,19.096774193548388,10
Category_Wikipedia_sockpuppets_of_Angel_and_the_flock.csv,48,660505.0,20,28,8,12,0,93.6875,255,33,21.8125,10
Category_Wikipedia_sockpuppets_of_Nikolay.kozhukharenko.csv,128,43943281.0,37,91,36,1,0,44.234375,266,38,21.984375,8
Category_Wikipedia_sockpuppets_of_Sujay_1803.csv,1537,11457958.0,433,1104,345,88,0,39.98893949251789,454,46,17.6402081977879,5
Category_Wikipedia_sockpuppets_of_Hpushkas318.csv,921,165313734.0,324,597,278,46,0,49.214983713355046,386,61,20.623235613463628,6
Category_Wikipedia_sockpuppets_of_DesignOk.csv,3,35.0,2,1,2,0,0,129.33333333333334,194,24,24.0,24
Category_Wikipedia_sockpuppets_of_Bebolink.csv,25,906031.0,9,16,9,0,0,60.0,163,33,14.24,4
Category_Wikipedia_sockpuppets_of_Dejanmilic.csv,212,286025568.0,93,119,92,1,0,41.344339622641506,232,29,16.650943396226417,14
Category_Wikipedia_sockpuppets_of_Dallas_Chokeboys.csv,55,21294.0,29,26,10,19,0,64.49090909090908,232,27,21.163636363636364,8
Category_Wikipedia_sockpuppets_of_Bcai388.csv,736,19824150.0,199,537,124,75,0,37.27853260869565,242,46,18.508152173913043,4
Category_Wikipedia_sockpuppets_of_BHolman123.csv,1,0.0,1,0,1,0,49,49.0,49,10,10.0,10
Category_Wikipedia_sockpuppets_of_Ericssonlg2023.csv,4,58706.0,3,1,1,2,21,56.75,139,11,11.0,11
Category_Wikipedia_sockpuppets_of_Maryyolifarz.csv,424,16776954.0,142,282,137,5,0,43.469339622641506,231,65,21.17688679245283,10
Category_Wikipedia_sockpuppets_of_I_Own_This_Land.csv,31,2020.0,13,18,13,0,0,32.83870967741935,199,26,17.64516129032258,13
Category_Wikipedia_sockpuppets_of_Be_Like_Me.csv,932,212260084.0,343,589,331,12,0,44.337982832618025,486,63,21.46459227467811,5
Category_Wikipedia_sockpuppets_of_Swaggucciyolo3339.csv,11,1259.0,6,5,4,2,0,24.0,144,27,23.818181818181817,20
Category_Wikipedia_sockpuppets_of_Behrozaltaf.csv,386,84424798.0,134,252,134,0,0,41.11139896373057,231,28,20.072538860103627,7
Category_Wikipedia_sockpuppets_of_Teykell.csv,224,23486216.0,58,166,21,37,0,55.169642857142854,254,40,20.383928571428573,7
Category_Wikipedia_sockpuppets_of_Linde_Place.csv,3527,70927247.0,1135,2392,500,635,0,42.6606180890275,605,73,22.963425007088176,4
Category_Wikipedia_sockpuppets_of_Mikebauer.csv,46,536124.0,24,22,16,8,0,26.195652173913043,162,52,33.84782608695652,19
Category_Wikipedia_sockpuppets_of_Brookerbs.csv,197,3097554.0,116,81,58,58,0,39.68020304568528,197,41,18.21319796954315,4
Category_Wikipedia_sockpuppets_of_CarlandEllie_991.csv,238,48279124.0,79,159,29,50,0,44.76470588235294,255,39,17.01260504201681,4
Category_Wikipedia_sockpuppets_of_Vic1234567.csv,4,116.0,2,2,2,0,0,71.0,128,20,16.5,13
Category_Wikipedia_sockpuppets_of_JoeScarce.csv,4616,36477466.0,1500,3116,500,1000,0,52.605069324090124,500,83,23.743067590987867,4
Category_Wikipedia_sockpuppets_of_Alidlevrai.csv,27,12126.0,14,13,14,0,0,28.11111111111111,185,37,15.25925925925926,7
Category_Wikipedia_sockpuppets_of_Locomotive999.csv,779,141809984.0,165,614,163,2,0,51.844672657252886,249,47,17.553273427471115,3
Category_Wikipedia_sockpuppets_of_Aura_Ranger.csv,38,368902.0,13,25,12,1,0,23.473684210526315,265,33,21.710526315789473,11
Category_Wikipedia_sockpuppets_of_Komskie.csv,583,2524503.0,234,349,197,37,0,53.524871355060036,328,65,20.46655231560892,3
Category_Wikipedia_sockpuppets_of_1misha.csv,65,14552977.0,22,43,22,0,0,23.646153846153847,208,47,41.753846153846155,16
Category_Wikipedia_sockpuppets_of_Mostly_shoaib.csv,2930,39660491.0,1088,1842,500,588,0,51.33412969283277,498,89,19.79283276450512,3
Category_Wikipedia_sockpuppets_of_KapamilyaAdventurer.csv,1296,21683569.0,520,776,500,20,0,41.25077160493827,354,73,27.378858024691358,4
Category_Wikipedia_sockpuppets_of_AlbertHog.csv,340,22768746.0,135,205,91,44,0,48.48823529411764,321,55,20.176470588235293,4
Category_Wikipedia_sockpuppets_of_Acid_Of_Carbon.csv,1544,5821164.0,563,981,500,63,0,47.16580310880829,280,60,23.22085492227979,5
Category_Wikipedia_sockpuppets_of_Bestadigg.csv,105,2115576.0,39,66,25,14,0,57.77142857142857,241,39,19.01904761904762,4
Category_Wikipedia_sockpuppets_of_Mashhoor.csv,1423,19611209.0,462,961,390,72,0,25.914265635980325,255,59,19.281799016163035,4
Category_Wikipedia_sockpuppets_of_Vivekkhanna123456.csv,229,41057903.0,117,112,67,50,0,34.38864628820961,248,34,20.231441048034934,12
Category_Wikipedia_sockpuppets_of_Subhamsahoo2008.csv,2401,31976079.0,773,1628,490,283,0,38.13452728029988,483,60,19.06122448979592,5
Category_Wikipedia_sockpuppets_of_Shayb27.csv,342,26562033.0,97,245,16,81,0,49.16081871345029,460,49,15.850877192982455,5
Category_Wikipedia_sockpuppets_of_Erock23432.csv,4654,38012238.0,1329,3325,500,829,0,41.49505801461109,261,72,18.006231198968628,2
Category_Wikipedia_sockpuppets_of_Middim13.csv,1265,22494727.0,502,763,500,2,0,69.29802371541501,249,40,18.970750988142292,6
Category_Wikipedia_sockpuppets_of_Gadurr.csv,243,7107324.0,104,139,39,65,0,56.83539094650206,255,36,20.82716049382716,8
Category_Wikipedia_sockpuppets_of_Kalakannija.csv,757,82537829.0,236,521,236,0,0,43.4887714663144,255,45,18.606340819022456,4
Category_Wikipedia_sockpuppets_of_Moorishistorian.csv,223,2351965.0,53,170,26,27,0,57.143497757847534,302,34,12.766816143497758,5
Category_Wikipedia_sockpuppets_of_Basuper.csv,137,7269922.0,47,90,40,7,0,45.70802919708029,210,38,18.291970802919707,4
Category_Wikipedia_sockpuppets_of_FlyboyExeter.csv,2458,22265992.0,841,1617,500,341,0,69.30187144019528,500,82,21.442229454841335,5
Category_Wikipedia_sockpuppets_of_Atmnn.csv,4239,47568640.0,1103,3136,182,921,0,55.03845246520406,363,79,14.617362585515451,1
Category_Wikipedia_sockpuppets_of_ChaosMaster16.csv,1345,2783593.0,515,830,500,15,0,48.43420074349442,253,57,26.5910780669145,6
Category_Wikipedia_sockpuppets_of_Star_Goodkid.csv,162,9314930.0,95,67,29,66,0,37.2962962962963,196,53,24.72222222222222,12
Category_Wikipedia_sockpuppets_of_Glam_metal_fan_5150.csv,726,4345841.0,214,512,90,124,0,48.95316804407714,376,53,21.045454545454547,7
Category_Wikipedia_sockpuppets_of_Wtgtam.csv,74,9094729.0,22,52,15,7,0,73.66216216216216,335,72,22.95945945945946,9
Category_Wikipedia_sockpuppets_of_Sanghvi6722.csv,61,17669966.0,24,37,22,2,0,36.885245901639344,201,64,27.9672131147541,8
Category_Wikipedia_sockpuppets_of_Jbamb.csv,2001,98318822.0,513,1488,500,13,0,44.88455772113943,250,85,27.849075462268864,3
Category_Wikipedia_sockpuppets_of_Luke_Davies_852.csv,25,422090.0,8,17,7,1,0,68.92,255,25,13.12,8
Category_Wikipedia_sockpuppets_of_–°—Ç–∞–Ω–∏—Å–ª–∞–≤_–ú–∏–Ω–∫–æ–≤.csv,274,4206986.0,93,181,79,14,0,37.15693430656934,485,78,15.908759124087592,4
Category_Wikipedia_sockpuppets_of_Tannerg45.csv,41,432908.0,16,25,6,10,0,40.48780487804878,146,53,24.21951219512195,5
Category_Wikipedia_sockpuppets_of_Can_up_you_lol.csv,106,2877591.0,36,70,20,16,0,57.72641509433962,237,35,18.5188679245283,5
Category_Wikipedia_sockpuppets_of_Apollo1975.csv,80,276876.0,43,37,42,1,0,30.6375,177,30,22.0375,18
Category_Wikipedia_sockpuppets_of_Lebellisliar.csv,1,0.0,1,0,1,0,12,12.0,12,11,11.0,11
Category_Wikipedia_sockpuppets_of_John_Wallace_Rich.csv,657,46421807.0,258,399,250,8,0,46.15677321156773,200,77,23.78843226788432,8
Category_Wikipedia_sockpuppets_of_Everyone_Calls_Me_Lol.csv,1120,16540847.0,500,620,500,0,0,30.950892857142858,272,57,18.10625,7
Category_Wikipedia_sockpuppets_of_RonaldClownsterMcDonaldHater.csv,52,228660.0,33,19,33,0,0,63.17307692307692,199,38,25.173076923076923,9
Category_Wikipedia_sockpuppets_of_Bland167.csv,136,16353580.0,60,76,13,47,0,54.161764705882355,255,32,15.352941176470589,7
Category_Wikipedia_sockpuppets_of_Bieber.oned.csv,99,152898501.0,41,58,24,17,0,51.92929292929293,240,24,14.505050505050505,13
Category_Wikipedia_sockpuppets_of_Cappack.csv,296,223633746.0,122,174,52,70,0,50.9222972972973,494,75,25.60135135135135,7
Category_Wikipedia_sockpuppets_of_Lordpermaximum.csv,1914,134165529.0,496,1418,365,131,0,55.262800417972834,432,51,26.00365726227795,1
Category_Wikipedia_sockpuppets_of_Justforivermectin.csv,15,66644.0,5,10,4,1,0,83.53333333333333,213,19,15.8,15
Category_Wikipedia_sockpuppets_of_Garretgwozdz13.csv,95,7183640.0,39,56,38,1,0,40.48421052631579,219,41,18.66315789473684,3
Category_Wikipedia_sockpuppets_of_Hafiz_ansi.csv,2629,15130443.0,884,1745,292,592,0,49.17459109927729,289,103,18.265880562951693,4
Category_Wikipedia_sockpuppets_of_Raysum1.csv,24,5321719.0,9,15,9,0,0,49.916666666666664,168,46,32.25,5
Category_Wikipedia_sockpuppets_of_Kokikoki2011.csv,28,4218874.0,8,20,4,4,0,46.57142857142857,149,23,17.642857142857142,15
Category_Wikipedia_sockpuppets_of_Khalafvand.csv,1037,102361801.0,348,689,123,225,0,47.85149469623915,500,53,20.485053037608488,4
Category_Wikipedia_sockpuppets_of_Kingshowman.csv,7941,164765669.0,2972,4969,500,2472,0,63.1279435839315,500,92,25.41292028711749,4
Category_Wikipedia_sockpuppets_of_0Bammer.csv,2570,47274270.0,731,1839,500,231,0,42.44046692607004,222,89,20.3295719844358,2
Category_Wikipedia_sockpuppets_of_Susie8876.csv,121,1749259.0,35,86,6,29,0,41.82644628099174,230,47,19.826446280991735,5
Category_Wikipedia_sockpuppets_of_Dataking231.csv,601,7849524.0,251,350,77,174,0,52.28119800332779,255,45,18.108153078202996,5
Category_Wikipedia_sockpuppets_of_Ballroom01.csv,97,7095655.0,22,75,13,9,0,59.22680412371134,258,53,30.04123711340206,10
Category_Wikipedia_sockpuppets_of_Jgbuford.csv,152,121619606.0,65,87,46,19,0,54.05921052631579,235,38,19.960526315789473,9
Category_Wikipedia_sockpuppets_of_Romanonia10.csv,78,47223100.0,56,22,52,4,0,20.064102564102566,202,36,31.128205128205128,13
Category_Wikipedia_sockpuppets_of_Texast99.csv,2,38.0,2,0,2,0,0,41.5,83,21,21.0,21
Category_Wikipedia_sockpuppets_of_Tarheelarmybrat.csv,4,77836.0,3,1,2,1,0,7.5,30,14,14.0,14
Category_Wikipedia_sockpuppets_of_Ammar_Idris_Muhammad.csv,73,5798576.0,22,51,12,10,0,43.84931506849315,159,47,33.43835616438356,5
Category_Wikipedia_sockpuppets_of_JohannesAugustin.csv,783,191207766.0,340,443,339,1,0,32.23243933588761,255,65,19.859514687100894,5
Category_Wikipedia_sockpuppets_of_Bjburke.csv,32,161637.0,21,11,8,13,0,34.8125,220,19,14.03125,8
Category_Wikipedia_sockpuppets_of_Jeremyraves4.csv,85,12876042.0,35,50,7,28,0,37.529411764705884,233,34,19.058823529411764,12
Category_Wikipedia_sockpuppets_of_Mason_Decker.csv,925,47633113.0,234,691,104,130,0,43.94486486486486,245,30,10.964324324324325,3
Category_Wikipedia_sockpuppets_of_Aparna_rajesh.csv,2235,64116579.0,784,1451,500,284,0,38.9579418344519,234,54,16.517225950782997,4
Category_Wikipedia_sockpuppets_of_Nmwalsh.csv,1604,180570012.0,660,944,500,160,0,41.62094763092269,376,63,19.607231920199503,8
Category_Wikipedia_sockpuppets_of_HiRayne.csv,172,63104890.0,46,126,16,30,0,63.73255813953488,240,43,18.180232558139537,6
Category_Wikipedia_sockpuppets_of_Fadix.csv,1920,67690899.0,759,1161,500,259,0,38.7015625,218,105,28.286458333333332,5
Category_Wikipedia_sockpuppets_of_Amirkayani.csv,172,1653480.0,65,107,32,33,0,45.86046511627907,200,24,8.273255813953488,7
Category_Wikipedia_sockpuppets_of_–õ–∞–≥—ñ—á–Ω–∞_—Ä—ç–≤–∞–ª—é—Ü—ã–π–Ω—ã.csv,92,3205.0,26,66,15,11,0,34.01086956521739,231,42,17.76086956521739,3
Category_Wikipedia_sockpuppets_of_ERHaxhiu.csv,1670,97027882.0,480,1190,326,154,0,34.68263473053892,255,51,24.034730538922155,4
Category_Wikipedia_sockpuppets_of_–°–µ–¥–∞–î—É–¥—É—Ä–∫–∞–µ–≤–∞.csv,88,12525432.0,34,54,15,19,0,56.75,496,36,19.545454545454547,13
Category_Wikipedia_sockpuppets_of_Verbatimusia.csv,504,238587901.0,141,363,99,42,0,53.611111111111114,255,50,18.708333333333332,4
Category_Wikipedia_sockpuppets_of_Babasalichai.csv,3314,198133541.0,1206,2108,494,712,0,46.74532287266144,255,67,23.431804465902232,5
Category_Wikipedia_sockpuppets_of_Daggerz101.csv,33,77965.0,13,20,6,7,0,45.18181818181818,227,28,13.727272727272727,3
Category_Wikipedia_sockpuppets_of_A_Humble_Foot_Soldier_in_Archangel_Michael's_Army.csv,36,14089361.0,14,22,10,4,0,50.94444444444444,233,59,27.444444444444443,14
Category_Wikipedia_sockpuppets_of_Texasfirsttoo.csv,21,1026385.0,13,8,10,3,19,112.0,363,24,20.19047619047619,19
Category_Wikipedia_sockpuppets_of_MountainKurd.csv,834,5924293.0,251,583,141,110,0,51.800959232613906,496,47,18.02757793764988,3
Category_Wikipedia_sockpuppets_of_Himthy.csv,8,447.0,5,3,5,0,0,29.75,108,10,10.0,10
Category_Wikipedia_sockpuppets_of_Makhdoomshahab.csv,1,0.0,1,0,1,0,0,0.0,0,26,26.0,26
Category_Wikipedia_sockpuppets_of_Killaahkelsey.csv,16,3987.0,12,4,8,4,0,61.875,248,7,7.0,7
Category_Wikipedia_sockpuppets_of_Shamshul_Mia.csv,160,31068649.0,81,79,18,63,0,45.75,247,29,13.36875,8
Category_Wikipedia_sockpuppets_of_GWRTEAM.csv,121,16377525.0,56,65,32,24,0,53.03305785123967,250,29,19.25619834710744,8
Category_Wikipedia_sockpuppets_of_Yashrajkumarjha.csv,429,98910382.0,128,301,112,16,0,40.06759906759907,232,60,23.6013986013986,7
Category_Wikipedia_sockpuppets_of_Amanjol.csv,1265,182605741.0,505,760,464,41,0,51.93596837944664,487,47,16.225296442687746,5
Category_Wikipedia_sockpuppets_of_Ksweith.csv,369,13804630.0,90,279,61,29,0,51.13279132791328,216,42,16.62059620596206,4
Category_Wikipedia_sockpuppets_of_Bosco.bosco9.csv,8,172463.0,4,4,4,0,12,49.125,165,9,9.0,9
Category_Wikipedia_sockpuppets_of_Dazcameron1990.csv,41,782762.0,13,28,12,1,0,56.90243902439025,194,19,12.634146341463415,7
Category_Wikipedia_sockpuppets_of_More_package_.csv,249,22712333.0,69,180,4,65,0,50.493975903614455,250,35,16.55421686746988,5
Category_Wikipedia_sockpuppets_of_Mirkoviƒá_Sta≈°a.csv,44,12057397.0,36,8,31,5,0,25.931818181818183,152,26,20.227272727272727,19
Category_Wikipedia_sockpuppets_of_ŒîŒ¥.csv,11,154367.0,6,5,6,0,0,9.545454545454545,51,31,18.181818181818183,12
Category_Wikipedia_sockpuppets_of_Arcaxon01.csv,1223,1106557.0,390,833,278,112,0,49.823385118560914,439,58,17.069501226492232,1
Category_Wikipedia_sockpuppets_of_jnl0031.csv,81,7877524.0,27,54,27,0,0,37.41975308641975,125,28,22.25925925925926,17
Category_Wikipedia_sockpuppets_of_Judy_Poz_Loves_My_Schnoz.csv,6,8646.0,2,4,2,0,24,53.666666666666664,120,18,14.666666666666666,13
Category_Wikipedia_sockpuppets_of_Madeline18B.csv,217,79633821.0,79,138,50,29,0,45.9815668202765,249,44,14.28110599078341,4
Category_Wikipedia_sockpuppets_of_Lygdamis.csv,399,3940516.0,124,275,64,60,0,34.526315789473685,199,44,13.829573934837093,4
Category_Wikipedia_sockpuppets_of_AbCaesar.csv,54,1771081.0,32,22,23,9,0,49.25925925925926,230,46,33.092592592592595,18
Category_Wikipedia_sockpuppets_of_Davis100.csv,2689,54447656.0,966,1723,500,466,0,32.216065451840834,239,42,15.94905169207884,3
Category_Wikipedia_sockpuppets_of_Daniel_Morales.csv,94,10909377.0,24,70,23,1,0,39.808510638297875,188,40,20.54255319148936,11
Category_Wikipedia_sockpuppets_of_Bikash9778.csv,8,10493.0,4,4,2,2,0,109.75,424,29,12.875,10
Category_Wikipedia_sockpuppets_of_Glittersnap.csv,205,20292704.0,117,88,93,24,0,36.89756097560976,281,52,39.91219512195122,9
Category_Wikipedia_sockpuppets_of_Comix03072011.csv,118,4467827.0,48,70,30,18,0,55.96610169491525,243,51,33.610169491525426,11
Category_Wikipedia_sockpuppets_of_DigiHarsh.csv,36,83402.0,11,25,7,4,0,50.30555555555556,135,21,13.694444444444445,7
Category_Wikipedia_sockpuppets_of_RobScheurwater.csv,1,0.0,1,0,1,0,0,0.0,0,50,50.0,50
Category_Wikipedia_sockpuppets_of_Aristocratic_536.csv,4207,11929809.0,1352,2855,500,852,0,59.11861183741384,500,67,17.33848347991443,4
Category_Wikipedia_sockpuppets_of_Moldyman_who_kills_the_yawners.csv,10,639305.0,3,7,2,1,0,83.9,178,55,20.2,4
Category_Wikipedia_sockpuppets_of_Rkjtc.csv,215,21900066.0,66,149,59,7,0,60.50697674418605,255,96,32.82325581395349,11
Category_Wikipedia_sockpuppets_of_Mcssanceo.csv,3,15299256.0,2,1,2,0,0,10.666666666666666,25,19,19.0,19
Category_Wikipedia_sockpuppets_of_Cid_Campeador.csv,782,79668473.0,191,591,183,8,0,41.80179028132992,230,49,15.358056265984654,4
Category_Wikipedia_sockpuppets_of_Fdcwvn.csv,28,2335458.0,13,15,10,3,0,48.857142857142854,225,26,12.0,1
Category_Wikipedia_sockpuppets_of_Stylox_Vai_Official.csv,38,45386487.0,16,22,7,9,0,56.71052631578947,249,77,21.157894736842106,11
Category_Wikipedia_sockpuppets_of_Europiummeow.csv,61,378041.0,20,41,11,9,0,54.14754098360656,255,34,20.19672131147541,11
Category_Wikipedia_sockpuppets_of_CIK_Telecom_Inc..csv,14,81715.0,9,5,9,0,0,33.142857142857146,189,26,26.0,26
Category_Wikipedia_sockpuppets_of_I-210.csv,22,10282.0,13,9,6,7,28,99.9090909090909,153,27,21.09090909090909,14
Category_Wikipedia_sockpuppets_of_Penwap.csv,23,30478.0,9,14,7,2,0,14.956521739130435,47,21,15.434782608695652,13
Category_Wikipedia_sockpuppets_of_Encyclopediaofalabama.csv,260,17342901.0,57,203,26,31,0,47.15,222,38,20.25769230769231,7
Category_Wikipedia_sockpuppets_of_Sklocke.csv,1026,20448275.0,285,741,154,131,0,41.98245614035088,199,57,18.99317738791423,1
Category_Wikipedia_sockpuppets_of_Mormonfaith101.csv,476,3047798.0,248,228,216,32,0,36.365546218487395,248,44,18.581932773109244,10
Category_Wikipedia_sockpuppets_of_Bobamaisalizard.csv,10,8296688.0,7,3,3,4,16,97.8,239,36,34.4,20
Category_Wikipedia_sockpuppets_of_Hilldalespace.csv,28,76476336.0,10,18,7,3,0,44.75,238,26,16.392857142857142,7
Category_Wikipedia_sockpuppets_of_Ficzere21.csv,860,218255498.0,296,564,286,10,0,50.75697674418605,409,38,14.508139534883721,9
Category_Wikipedia_sockpuppets_of_Brentmwatkins.csv,14,33221.0,11,3,8,3,0,19.642857142857142,50,45,42.0,24
Category_Wikipedia_sockpuppets_of_Morganoflahrity.csv,224,66451079.0,78,146,20,58,0,59.933035714285715,290,61,20.486607142857142,10
Category_Wikipedia_sockpuppets_of_Jakeshapiro.csv,235,60741392.0,114,121,65,49,0,26.382978723404257,186,17,11.91063829787234,4
Category_Wikipedia_sockpuppets_of_Wasitthewalrus.csv,7,91686.0,5,2,3,2,0,18.714285714285715,62,49,49.0,49
Category_Wikipedia_sockpuppets_of_Fernando_2020b.csv,9,3856.0,9,0,9,0,0,59.0,492,23,20.22222222222222,18
Category_Wikipedia_sockpuppets_of_Guitarlegs.csv,336,27067634.0,109,227,67,42,0,45.19642857142857,199,21,12.30952380952381,9
Category_Wikipedia_sockpuppets_of_DavideVeloria88.csv,3866,75055462.0,901,2965,500,401,0,50.38541127780652,519,70,17.070615623383343,3
Category_Wikipedia_sockpuppets_of_Kivkiv78952.csv,35,1471.0,10,25,9,1,0,60.57142857142857,178,16,7.3428571428571425,3
Category_Wikipedia_sockpuppets_of_JamesKofi1959.csv,11,10644139.0,9,2,4,5,0,34.27272727272727,164,12,12.0,12
Category_Wikipedia_sockpuppets_of_Torygreen84.csv,11167,88539504.0,3414,7753,500,2914,0,46.7149637324259,500,95,25.667502462613058,3
Category_Wikipedia_sockpuppets_of_Changingfilm.csv,38,9875141.0,12,26,7,5,0,57.23684210526316,196,44,21.894736842105264,11
Category_Wikipedia_sockpuppets_of_Diva206.csv,279,1616133.0,96,183,50,46,0,48.34767025089606,256,49,16.74910394265233,8
Category_Wikipedia_sockpuppets_of_Blue_42_Strike.csv,19,319999.0,12,7,8,4,0,26.842105263157894,94,30,24.736842105263158,19
Category_Wikipedia_sockpuppets_of_Britisharchitecturefoundation23.csv,414,481749.0,226,188,68,158,0,26.920289855072465,199,72,21.82850241545894,9
Category_Wikipedia_sockpuppets_of_Itsxerox.csv,1522,30838728.0,700,822,500,200,0,38.07884362680684,432,64,21.560446780551906,3
Category_Wikipedia_sockpuppets_of_Spreadmediaglobal.csv,2021,106997072.0,685,1336,182,503,0,41.91340920336467,496,64,20.09203364670955,4
Category_Wikipedia_sockpuppets_of_It's_gonna_be_awesome.csv,11915,125178200.0,4018,7897,500,3518,0,53.998992866135126,504,121,20.62089802769618,2
Category_Wikipedia_sockpuppets_of_Antimyth.csv,34,104522.0,21,13,16,5,0,30.558823529411764,132,69,14.441176470588236,5
Category_Wikipedia_sockpuppets_of_Wikiedits11323e2.csv,19,283667.0,6,13,4,2,0,38.0,156,22,11.263157894736842,10
Category_Wikipedia_sockpuppets_of_Danbur.csv,306,47667935.0,87,219,56,31,0,54.27124183006536,218,62,14.9640522875817,4
Category_Wikipedia_sockpuppets_of_Abcassionchan.csv,898,14610178.0,333,565,319,14,0,38.65033407572383,266,70,20.848552338530066,5
Category_Wikipedia_sockpuppets_of_Dm89263.csv,283,117826548.0,73,210,54,19,0,50.78091872791519,356,67,24.250883392226147,4
Category_Wikipedia_sockpuppets_of_Georgemohan88.csv,394,62208824.0,173,221,132,41,0,38.464467005076145,256,78,19.596446700507613,8
Category_Wikipedia_sockpuppets_of_Footballpassion13.csv,23,8722463.0,13,10,10,3,0,21.391304347826086,129,52,31.73913043478261,17
Category_Wikipedia_sockpuppets_of_EditorManagerPH.csv,139,1256366.0,61,78,52,9,0,63.23741007194245,319,53,30.546762589928058,10
Category_Wikipedia_sockpuppets_of_Mischa_991.csv,18,721370.0,9,9,5,4,0,28.88888888888889,151,31,14.055555555555555,8
Category_Wikipedia_sockpuppets_of_FrankEM.csv,1443,219663408.0,479,964,126,353,0,56.08038808038808,255,62,21.814968814968815,5
Category_Wikipedia_sockpuppets_of_Eva-loran.csv,28,9306337.0,13,15,6,7,0,21.535714285714285,189,42,30.428571428571427,17
Category_Wikipedia_sockpuppets_of_Mupplan.csv,1039,7206390.0,263,776,162,101,0,33.932627526467755,226,54,24.76612127045236,7
Category_Wikipedia_sockpuppets_of_Editingforgk.csv,432,45231934.0,150,282,77,73,0,50.398148148148145,258,68,19.645833333333332,6
Category_Wikipedia_sockpuppets_of_S201050066.csv,1110,40469247.0,635,475,500,135,0,49.82432432432432,360,51,42.86036036036036,16
Category_Wikipedia_sockpuppets_of_Dominic_Ye.csv,217,26184994.0,73,144,42,31,0,47.774193548387096,232,36,18.56221198156682,5
Category_Wikipedia_sockpuppets_of_LewisIsDaBesta.csv,62,68210042.0,14,48,12,2,0,35.016129032258064,186,31,13.741935483870968,8
Category_Wikipedia_sockpuppets_of_Licinius.csv,1038,12422044.0,336,702,164,172,0,32.028901734104046,181,51,19.6242774566474,7
Category_Wikipedia_sockpuppets_of_Ghriscore.csv,2075,171362250.0,752,1323,357,395,0,48.929638554216865,255,68,23.935421686746988,6
Category_Wikipedia_sockpuppets_of_Tomasz1123.csv,237,41903652.0,72,165,61,11,0,53.59493670886076,255,53,19.831223628691983,6
Category_Wikipedia_sockpuppets_of_Gob_Lofa.csv,2896,70683542.0,680,2216,500,180,0,52.68439226519337,255,66,20.05421270718232,4
Category_Wikipedia_sockpuppets_of_Gumerperu.csv,316,109172792.0,116,200,89,27,0,39.75316455696203,228,57,30.088607594936708,10
Category_Wikipedia_sockpuppets_of_Emanuel300422.csv,46,6367264.0,28,18,14,14,0,51.02173913043478,253,52,43.130434782608695,35
Category_Wikipedia_sockpuppets_of_Komalezhathu_Chekavar.csv,87,181265.0,46,41,29,17,0,45.49425287356322,255,30,26.735632183908045,15
Category_Wikipedia_sockpuppets_of_John_Rayn.csv,91,20535459.0,82,9,20,62,0,18.34065934065934,487,24,21.032967032967033,12
Category_Wikipedia_sockpuppets_of_NMedit.csv,35,105569617.0,18,17,9,9,0,58.05714285714286,233,22,13.142857142857142,12
Category_Wikipedia_sockpuppets_of_T.shan56.csv,840,265860536.0,373,467,72,301,0,45.86666666666667,326,55,21.21309523809524,7
Category_Wikipedia_sockpuppets_of_Sheena_Malhotra.csv,645,75785499.0,234,411,212,22,0,49.437209302325584,275,42,21.517829457364343,6
Category_Wikipedia_sockpuppets_of_Lithuaniaball2.csv,897,56514256.0,272,625,27,245,0,61.30992196209588,496,54,17.16833890746934,7
Category_Wikipedia_sockpuppets_of_Zhengan_Chen.csv,47,6203433.0,23,24,23,0,0,35.97872340425532,148,22,17.70212765957447,6
Category_Wikipedia_sockpuppets_of_Tcave08.csv,16,1215.0,12,4,7,5,0,23.0625,192,12,12.0,12
Category_Wikipedia_sockpuppets_of_Skporganic.csv,233,10101680.0,96,137,91,5,0,45.776824034334766,199,47,18.952789699570815,5
Category_Wikipedia_sockpuppets_of_ArticlesForRedemption.csv,301,1606720.0,124,177,76,48,0,40.142857142857146,199,89,35.20265780730897,6
Category_Wikipedia_sockpuppets_of_Deepakbarh.csv,91,227411679.0,30,61,30,0,0,34.824175824175825,235,27,9.527472527472527,8
Category_Wikipedia_sockpuppets_of_Matt72in.csv,6,5687.0,3,3,3,0,0,31.666666666666668,116,12,9.166666666666666,7
Category_Wikipedia_sockpuppets_of_Bobi987_Ivanov.csv,596,56467176.0,273,323,226,47,0,43.13758389261745,233,50,19.605704697986578,8
Category_Wikipedia_sockpuppets_of_Kian_barazandeh.csv,135,1619941.0,56,79,44,12,0,48.992592592592594,289,44,21.562962962962963,6
Category_Wikipedia_sockpuppets_of_Sirrussellott.csv,14,25200483.0,4,10,4,0,0,38.07142857142857,140,29,22.285714285714285,17
Category_Wikipedia_sockpuppets_of_Wilzz99.csv,2621,201673500.0,801,1820,428,373,0,41.573826783670356,308,48,15.897748950782145,4
Category_Wikipedia_sockpuppets_of_0HH0LYN1GHT.csv,1555,13913687.0,622,933,293,329,0,38.60771704180064,495,39,17.6064308681672,7
Category_Wikipedia_sockpuppets_of_Savary34.csv,1403,59593650.0,729,674,438,291,0,51.09693513898788,373,62,28.493228795438345,6
Category_Wikipedia_sockpuppets_of_Un-username.csv,81,11227500.0,25,56,10,15,0,55.91358024691358,266,40,23.666666666666668,8
Category_Wikipedia_sockpuppets_of_Joshuarooney.csv,1794,58309936.0,568,1226,397,171,0,35.86231884057971,250,60,23.973801560758083,4
Category_Wikipedia_sockpuppets_of_Syona123.csv,10,5708.0,7,3,5,2,0,37.8,129,6,3.9,3
Category_Wikipedia_sockpuppets_of_Fujiko_Pro.csv,68,9876178.0,26,42,8,18,0,48.220588235294116,245,47,19.205882352941178,6
Category_Wikipedia_sockpuppets_of_Skoojal.csv,3863,135403570.0,1510,2353,500,1010,0,44.18508930882734,255,65,22.078954180688584,5
Category_Wikipedia_sockpuppets_of_Indianscientists.csv,67,43034549.0,26,41,16,10,0,50.38805970149254,194,40,21.388059701492537,11
Category_Wikipedia_sockpuppets_of_Dominiqueyoungunique.csv,23,16016631.0,10,13,7,3,0,53.73913043478261,196,44,28.52173913043478,21
Category_Wikipedia_sockpuppets_of_Bigsean0300.csv,20539,62370310.0,5325,15214,500,4825,0,54.27864063488972,255,73,15.504747066556307,2
Category_Wikipedia_sockpuppets_of_Odonnellmegan22.csv,38,1909394.0,31,7,25,6,0,26.763157894736842,309,28,28.0,28
Category_Wikipedia_sockpuppets_of_Hamilton010604.csv,6,3472152.0,2,4,1,1,14,79.33333333333333,146,17,14.5,12
Category_Wikipedia_sockpuppets_of_MEENAKACHORA.csv,325,12094620.0,111,214,88,23,0,52.07692307692308,251,40,12.993846153846153,5
Category_Wikipedia_sockpuppets_of_Farell01.csv,1817,39161650.0,743,1074,500,243,0,34.86626307099615,255,42,14.771051183269124,4
Category_Wikipedia_sockpuppets_of_Balls123454321.csv,28,1469.0,9,19,9,0,0,41.67857142857143,190,25,19.285714285714285,6
Category_Wikipedia_sockpuppets_of_Duck.co.csv,286,782035.0,106,180,97,9,0,51.92307692307692,240,47,15.307692307692308,3
Category_Wikipedia_sockpuppets_of_AdibMurshed.csv,270,17974748.0,90,180,73,17,0,50.02962962962963,255,54,14.148148148148149,4
Category_Wikipedia_sockpuppets_of_Jfinens.csv,1661,73534432.0,526,1135,500,26,0,44.796508127633956,255,85,18.568332329921734,2
Category_Wikipedia_sockpuppets_of_Nawab_Afridi.csv,1416,19759023.0,504,912,399,105,0,52.38206214689266,500,59,20.824858757062145,2
Category_Wikipedia_sockpuppets_of_Lalbichbongas.csv,4,898.0,3,1,2,1,3,21.75,61,6,6.0,6
Category_Wikipedia_sockpuppets_of_Jeffrey_lightfoot.csv,22,2484.0,7,15,7,0,0,66.31818181818181,227,17,14.090909090909092,7
Category_Wikipedia_sockpuppets_of_A.arvind.arasu.csv,1584,61064239.0,436,1148,436,0,0,39.23358585858586,250,71,20.450757575757574,6
Category_Wikipedia_sockpuppets_of_NaserBanaqeeb.csv,780,64614028.0,283,497,237,46,0,41.73717948717949,255,56,21.444871794871794,7
Category_Wikipedia_sockpuppets_of_Jack1985IE.csv,4389,178582530.0,1178,3211,500,678,0,50.509911141490086,431,54,21.196855775803144,7
Category_Wikipedia_sockpuppets_of_IrishChick2012.csv,531,265522336.0,190,341,121,69,0,51.717514124293785,312,81,23.32391713747646,9
Category_Wikipedia_sockpuppets_of_HixBricks.csv,16,2796867.0,7,9,4,3,0,53.4375,229,30,18.75,5
Category_Wikipedia_sockpuppets_of_Bens12345.csv,181,1077002.0,65,116,20,45,0,41.209944751381215,255,43,23.486187845303867,8
Category_Wikipedia_sockpuppets_of_Party_like_it's_1488.csv,355,1878021.0,119,236,64,55,0,54.64507042253521,441,51,19.847887323943663,4
Category_Wikipedia_sockpuppets_of_Nick_Dillinger.csv,2001,23938024.0,502,1499,500,2,0,24.29335332333833,200,61,19.54072963518241,3
Category_Wikipedia_sockpuppets_of_Ajayjetavat.csv,74,86333417.0,16,58,14,2,0,52.810810810810814,225,22,12.743243243243244,6
Category_Wikipedia_sockpuppets_of_Naknak251.csv,28,4109.0,13,15,9,4,0,47.607142857142854,185,29,21.142857142857142,6
Category_Wikipedia_sockpuppets_of_Qaqwewew.csv,2613,11525832.0,936,1677,500,436,0,41.07079984691925,255,87,28.50440107156525,4
Category_Wikipedia_sockpuppets_of_Williamchaupin.csv,57,1472039.0,32,25,13,19,0,42.36842105263158,484,23,18.42105263157895,11
Category_Wikipedia_sockpuppets_of_GEORGIEGIBBONS.csv,3983,29979368.0,1530,2453,500,1030,0,53.062013557619885,250,89,27.573437107707758,2
Category_Wikipedia_sockpuppets_of_Queenkong1.csv,62,44009711.0,23,39,19,4,0,40.903225806451616,187,53,23.677419354838708,4
Category_Wikipedia_sockpuppets_of_Nephiliskos.csv,1218,63298065.0,526,692,500,26,0,46.59113300492611,255,54,16.29146141215107,4
Category_Wikipedia_sockpuppets_of_Pitchlumins.csv,98,23933354.0,35,63,27,8,0,56.91836734693877,349,47,16.979591836734695,11
Category_Wikipedia_sockpuppets_of_Ritiks.csv,114,1744512.0,62,52,42,20,0,50.56140350877193,196,91,48.26315789473684,9
Category_Wikipedia_sockpuppets_of_Soundalivenow.csv,12,1220953.0,7,5,7,0,0,34.833333333333336,133,17,10.25,8
Category_Wikipedia_sockpuppets_of_Jojo_siwa_th4.csv,40,798.0,13,27,6,7,0,73.575,496,26,16.975,16
Category_Wikipedia_sockpuppets_of_Sk8erPrince.csv,1960,51588462.0,526,1434,500,26,0,54.64387755102041,500,63,25.68520408163265,3
Category_Wikipedia_sockpuppets_of_Cjlaforest.csv,36,104502.0,18,18,14,4,4,75.66666666666667,192,27,22.97222222222222,22
Category_Wikipedia_sockpuppets_of_JibinGs.csv,21,3485726.0,13,8,9,4,0,39.714285714285715,196,21,15.380952380952381,11
Category_Wikipedia_sockpuppets_of_Trafalk09.csv,1278,226204679.0,514,764,500,14,0,33.870892018779344,508,44,27.49374021909233,9
Category_Wikipedia_sockpuppets_of_Jhyunxtina.csv,51,39846450.0,22,29,13,9,0,41.86274509803921,227,25,17.745098039215687,12
Category_Wikipedia_sockpuppets_of_Jab7842.csv,1621,14073817.0,603,1018,500,103,0,39.06785934608266,263,87,26.05737199259716,4
Category_Wikipedia_sockpuppets_of_Trowla.csv,1,0.0,1,0,1,0,196,196.0,196,15,15.0,15
Category_Wikipedia_sockpuppets_of_DwyerSP.csv,337,15635801.0,118,219,55,63,0,50.87833827893175,250,50,19.833827893175073,4
Category_Wikipedia_sockpuppets_of_Martialarts22.csv,65,113604.0,23,42,19,4,0,68.64615384615385,360,23,17.076923076923077,13
Category_Wikipedia_sockpuppets_of_Botaylor456.csv,716,3707472.0,265,451,105,160,0,25.011173184357542,199,30,10.856145251396647,2
Category_Wikipedia_sockpuppets_of_James8333.csv,2868,84208007.0,1077,1791,199,878,0,46.90411436541144,494,48,19.39818688981869,3
Category_Wikipedia_sockpuppets_of_Lexusnexus123.csv,65,2315698.0,31,34,24,7,0,38.44615384615385,228,17,13.184615384615384,9
Category_Wikipedia_sockpuppets_of_Vivahk.csv,429,283910104.0,167,262,117,50,0,32.22377622377623,214,27,12.221445221445222,7
Category_Wikipedia_sockpuppets_of_ETH.P...4eva!.csv,124,4831827.0,60,64,19,41,0,20.967741935483872,215,61,30.89516129032258,11
Category_Wikipedia_sockpuppets_of_Den5.csv,817,30839183.0,295,522,264,31,0,47.591187270501834,255,45,15.995104039167687,4
Category_Wikipedia_sockpuppets_of_Benjiwolf.csv,2079,5739677.0,706,1373,500,206,0,38.73785473785474,211,37,15.523328523328523,4
Category_Wikipedia_sockpuppets_of_Legchild.csv,15,1911.0,11,4,7,4,0,44.46666666666667,183,13,7.4,7
Category_Wikipedia_sockpuppets_of_Basimji_zulfkar.csv,244,54045275.0,111,133,103,8,0,34.80327868852459,225,53,23.758196721311474,13
Category_Wikipedia_sockpuppets_of_Tachyonbursts.csv,686,59950010.0,216,470,108,108,0,55.99562682215743,221,49,27.966472303207,13
Category_Wikipedia_sockpuppets_of_LFWG.csv,117,60487935.0,29,88,15,14,0,51.0,234,25,14.136752136752136,5
Category_Wikipedia_sockpuppets_of_Writeindia.csv,639,355545748.0,220,419,212,8,0,45.31924882629108,250,56,23.953051643192488,5
Category_Wikipedia_sockpuppets_of_AshishPoudel98.csv,1,0.0,1,0,1,0,101,101.0,101,21,21.0,21
Category_Wikipedia_sockpuppets_of_Kilimotz.csv,29,442245.0,12,17,5,7,0,42.275862068965516,177,33,24.17241379310345,7
Category_Wikipedia_sockpuppets_of_Castor_Lang.csv,385,233194761.0,81,304,21,60,0,45.592207792207795,234,40,13.272727272727273,3
Category_Wikipedia_sockpuppets_of_Chairman_Loh_Shi_San.csv,511,8634422.0,191,320,139,52,0,35.79060665362035,255,34,14.34050880626223,7
Category_Wikipedia_sockpuppets_of_Prakash_Kumar_Meher.csv,277,33978809.0,121,156,46,75,0,37.16606498194946,206,43,21.71480144404332,8
Category_Wikipedia_sockpuppets_of_The_Librarian_at_Terminus.csv,2006,278772465.0,691,1315,500,191,0,47.96061814556331,374,64,16.808574277168496,3
Category_Wikipedia_sockpuppets_of_VinylJoe.csv,260,5873441.0,103,157,73,30,0,48.87692307692308,190,47,27.130769230769232,10
Category_Wikipedia_sockpuppets_of_AbbasAliAkbar.csv,42,37775.0,29,13,17,12,0,58.45238095238095,233,20,5.142857142857143,3
Category_Wikipedia_sockpuppets_of_Abdighaf.csv,64,1866222.0,37,27,36,1,0,44.484375,239,27,21.640625,12
Category_Wikipedia_sockpuppets_of_Rzheng97.csv,134,9007564.0,61,73,46,15,0,43.43283582089552,244,26,17.48507462686567,6
Category_Wikipedia_sockpuppets_of_HistoryOfTurkic.csv,232,4001861.0,85,147,40,45,0,50.91379310344828,500,25,13.452586206896552,4
Category_Wikipedia_sockpuppets_of_San_culottes.csv,2689,15370521.0,972,1717,378,594,0,45.8267013759762,255,68,20.96169579769431,2
Category_Wikipedia_sockpuppets_of_Alayewiki.csv,59,6226407.0,24,35,20,4,0,48.59322033898305,273,53,23.983050847457626,4
Category_Wikipedia_sockpuppets_of_Devonnubia.csv,3,1643.0,2,1,1,1,121,310.3333333333333,412,10,10.0,10
Category_Wikipedia_sockpuppets_of_Alex_Cupper.csv,1196,9323223.0,364,832,303,61,0,51.22826086956522,369,51,12.274247491638796,4
Category_Wikipedia_sockpuppets_of_Rohith_Kilari.csv,71,78191603.0,22,49,18,4,0,68.84507042253522,240,29,16.12676056338028,6
Category_Wikipedia_sockpuppets_of_AndyCrogonka.csv,414,21908776.0,136,278,68,68,0,45.64975845410628,255,97,27.669082125603865,5
Category_Wikipedia_sockpuppets_of_BalPakna2021.csv,446,8012864.0,148,298,66,82,0,43.8542600896861,513,60,18.55156950672646,5
Category_Wikipedia_sockpuppets_of_Nobody.csv,4,72.0,2,2,2,0,33,74.75,108,29,22.5,16
Category_Wikipedia_sockpuppets_of_Urklistre.csv,1581,104942715.0,609,972,278,331,0,44.3270082226439,250,49,18.55154965211891,7
Category_Wikipedia_sockpuppets_of_Planita13.csv,100,282660667.0,20,80,19,1,0,53.87,214,32,19.68,7
Category_Wikipedia_sockpuppets_of_Nklouua.csv,69,4629.0,36,33,6,30,0,69.91304347826087,223,29,14.81159420289855,11
Category_Wikipedia_sockpuppets_of_TheSomeGuy97.csv,2400,68973370.0,566,1834,500,66,0,38.84583333333333,255,43,17.487083333333334,7
Category_Wikipedia_sockpuppets_of_Hannibal_Corrector.csv,3670,139796726.0,1117,2553,500,617,0,67.41362397820164,469,92,23.4850136239782,2
Category_Wikipedia_sockpuppets_of_Filmassoc.csv,38,30583600.0,15,23,10,5,0,44.3421052631579,159,53,34.526315789473685,13
Category_Wikipedia_sockpuppets_of_DickLukens.csv,85,10816864.0,17,68,15,2,0,36.84705882352941,183,30,14.635294117647058,6
Category_Wikipedia_sockpuppets_of_Darryl.jensen.csv,3584,51503982.0,1126,2458,500,626,0,61.711216517857146,497,82,19.940290178571427,4
Category_Wikipedia_sockpuppets_of_Ayan2312003.csv,40,236504.0,29,11,24,5,0,149.85,499,23,12.825,6
Category_Wikipedia_sockpuppets_of_Validbanks_34.csv,326,16919133.0,114,212,97,17,0,60.99079754601227,208,61,18.5920245398773,5
Category_Wikipedia_sockpuppets_of_Fatim1.csv,28,499579.0,14,14,12,2,0,64.0,198,26,17.785714285714285,11
Category_Wikipedia_sockpuppets_of_Asnjjasvonk.csv,697,4770331.0,208,489,161,47,0,54.440459110473455,255,50,26.01721664275466,6
Category_Wikipedia_sockpuppets_of_Cutlerowns19.csv,783,3152324.0,280,503,93,187,0,51.158365261813536,223,58,24.738186462324393,4
Category_Wikipedia_sockpuppets_of_Cats2.csv,251,1221142.0,101,150,77,24,0,33.91633466135458,255,41,26.199203187250998,5
Category_Wikipedia_sockpuppets_of_Stinkytinkycuntikkylicklickmeow.csv,18,76107.0,11,7,8,3,0,66.94444444444444,204,43,23.72222222222222,10
Category_Wikipedia_sockpuppets_of_Politike_14.csv,48,5993094.0,15,33,9,6,0,47.1875,227,29,19.9375,12
Category_Wikipedia_sockpuppets_of_GHOST-G56.csv,4,12418.0,3,1,3,0,0,50.75,160,26,24.75,21
Category_Wikipedia_sockpuppets_of_The_captain_rommel_of_the_desert.csv,1091,16082306.0,279,812,114,165,0,41.010999083409715,222,97,24.28230980751604,3
Category_Wikipedia_sockpuppets_of_Hamish6600.csv,96,42235475.0,36,60,28,8,0,45.96875,221,65,44.427083333333336,11
Category_Wikipedia_sockpuppets_of_Pethics.csv,48,11186324.0,16,32,10,6,0,70.27083333333333,227,39,25.791666666666668,20
Category_Wikipedia_sockpuppets_of_DrkWebber.csv,494,4120688.0,145,349,142,3,0,47.15587044534413,299,48,18.72672064777328,4
Category_Wikipedia_sockpuppets_of_Jumpingyim.csv,98,698308.0,31,67,20,11,0,67.73469387755102,215,40,21.591836734693878,5
Category_Wikipedia_sockpuppets_of_Ggxoxo15.csv,8,75329.0,5,3,3,2,0,24.125,106,42,26.75,12
Category_Wikipedia_sockpuppets_of_Skyz7888.csv,91,582331.0,37,54,35,2,0,43.824175824175825,259,34,14.582417582417582,5
Category_Wikipedia_sockpuppets_of_Nono64.csv,5345,212347285.0,2000,3345,500,1500,0,46.87876520112255,264,109,19.31468662301216,3
Category_Wikipedia_sockpuppets_of_S.Meliere.csv,138,5019435.0,37,101,11,26,0,42.18840579710145,211,41,18.81159420289855,5
Category_Wikipedia_sockpuppets_of_SARZ_Music_Studio.csv,6,92.0,4,2,4,0,14,26.166666666666668,65,26,26.0,26
Category_Wikipedia_sockpuppets_of_Blue_Mango_Juice.csv,2554,62557247.0,855,1699,213,642,0,45.53797963978074,496,73,20.01018010963195,3
Category_Wikipedia_sockpuppets_of_Mandeep_Rumana.csv,1213,15921338.0,433,780,394,39,0,21.103050288540807,256,49,19.818631492168176,9
Category_Wikipedia_sockpuppets_of_Abs2010.csv,50,606071.0,46,4,20,26,0,26.2,248,23,23.0,23
Category_Wikipedia_sockpuppets_of_PavelChekov01.csv,1530,337517190.0,593,937,424,169,0,52.69019607843137,416,50,21.68235294117647,5
Category_Wikipedia_sockpuppets_of_Bcsoftware.csv,5,2722.0,3,2,2,1,0,26.6,133,34,34.0,34
Category_Wikipedia_sockpuppets_of_Mustafa_Flim_Industries.csv,14,18498.0,9,5,4,5,11,57.07142857142857,196,36,30.071428571428573,28
Category_Wikipedia_sockpuppets_of_Rajmahajanmoxx.csv,530,117136740.0,164,366,62,102,0,46.264150943396224,252,71,22.786792452830188,3
Category_Wikipedia_sockpuppets_of_Yuan.C.Lee.csv,948,59957892.0,307,641,173,134,0,31.626582278481013,200,53,16.310126582278482,2
Category_Wikipedia_sockpuppets_of_Johnlowenstein.csv,59,1613200.0,25,34,17,8,0,29.016949152542374,241,59,33.32203389830509,12
Category_Wikipedia_sockpuppets_of_SuperTroll.csv,56,81575.0,15,41,8,7,0,47.339285714285715,200,64,29.678571428571427,4
Category_Wikipedia_sockpuppets_of_Somebody356.csv,135,27100392.0,45,90,31,14,0,63.4,440,47,19.20740740740741,5
Category_Wikipedia_sockpuppets_of_D1061024473ec8f5506d933d3464966c8606dad6.csv,1055,166484422.0,332,723,241,91,0,40.57251184834123,260,76,19.107109004739335,3
Category_Wikipedia_sockpuppets_of_Pradip_garala.csv,1821,149069431.0,458,1363,453,5,0,36.10982976386601,255,52,16.42613948380011,4
Category_Wikipedia_sockpuppets_of_Cooldc19.csv,235,3978304.0,109,126,22,87,0,31.140425531914893,199,38,17.73191489361702,12
Category_Wikipedia_sockpuppets_of_Ofus.csv,2103,513263970.0,607,1496,500,107,0,54.494056110318596,349,71,21.982406086543033,2
Category_Wikipedia_sockpuppets_of_Agfkxydbxjsosnvjxbshxjx_dndhxjxbd.csv,511,6448249.0,182,329,96,86,0,49.986301369863014,255,84,27.84344422700587,3
Category_Wikipedia_sockpuppets_of_Ignitepictures.csv,31,666036.0,18,13,6,12,0,48.483870967741936,196,51,39.03225806451613,12
Category_Wikipedia_sockpuppets_of_Hayden5650.csv,3521,19043695.0,1040,2481,500,540,0,48.78216415790968,250,68,22.606645839250213,3
Category_Wikipedia_sockpuppets_of_Kay_Sieverding.csv,1690,130265159.0,672,1018,500,172,0,61.81479289940828,253,89,36.79526627218935,6
Category_Wikipedia_sockpuppets_of_Rrmmll22.csv,1317,5749229.0,535,782,500,35,0,43.782839787395595,431,75,21.32953682611997,5
Category_Wikipedia_sockpuppets_of_Dingbat1987.csv,31,2072.0,17,14,17,0,0,19.29032258064516,182,29,13.290322580645162,4
Category_Wikipedia_sockpuppets_of_Nate_Speed.csv,3653,444702541.0,872,2781,500,372,0,42.25869148644949,381,59,19.402135231316727,3
Category_Wikipedia_sockpuppets_of_Tangoio22.csv,43,137189.0,17,26,9,8,0,31.627906976744185,117,42,13.465116279069768,9
Category_Wikipedia_sockpuppets_of_Prerak020.csv,201,4269553.0,59,142,46,13,0,56.67164179104478,287,57,22.223880597014926,4
Category_Wikipedia_sockpuppets_of_Sarabveer.csv,467,75255324.0,171,296,161,10,0,50.563169164882225,255,55,22.430406852248392,3
Category_Wikipedia_sockpuppets_of_Ranjan_Mistry.csv,5,592.0,2,3,2,0,0,23.8,60,28,24.0,18
Category_Wikipedia_sockpuppets_of_Kiron_Krishnan.csv,307,117018160.0,87,220,63,24,0,53.71335504885994,286,50,19.993485342019543,4
Category_Wikipedia_sockpuppets_of_Sherzo.csv,1386,76096497.0,500,886,500,0,0,44.37229437229437,246,71,24.42207792207792,4
Category_Wikipedia_sockpuppets_of_Lokeshwaran_V_R.csv,2317,29155424.0,797,1520,500,297,0,51.48769961156668,423,63,26.88821752265861,5
Category_Wikipedia_sockpuppets_of_King_Lopez.csv,1444,37256913.0,503,941,500,3,0,50.62257617728532,250,54,18.984764542936286,3
Category_Wikipedia_sockpuppets_of_Cazzzaazzzaaazaaaazaza.csv,15,1813.0,10,5,2,8,10,132.4,248,14,14.0,14
Category_Wikipedia_sockpuppets_of_Hrmsunil2.csv,89,129345777.0,29,60,18,11,0,62.46067415730337,228,56,20.370786516853933,8
Category_Wikipedia_sockpuppets_of_Bbovie22.csv,10,1085.0,9,1,9,0,12,47.2,124,18,18.0,18
Category_Wikipedia_sockpuppets_of_Enricodalupan.csv,199,7333824.0,93,106,53,40,0,32.76381909547739,230,52,29.537688442211056,19
Category_Wikipedia_sockpuppets_of_Yukon198.csv,997,39019225.0,335,662,333,2,0,56.64593781344032,495,73,23.708124373119357,5
Category_Wikipedia_sockpuppets_of_Beajhure.csv,251,2460550.0,75,176,63,12,0,47.191235059760956,235,62,20.159362549800797,8
Category_Wikipedia_sockpuppets_of_Ostoneo.csv,116,16783235.0,43,73,13,30,0,67.87068965517241,225,43,17.603448275862068,13
Category_Wikipedia_sockpuppets_of_Leocadii.csv,549,12974802.0,173,376,166,7,0,62.73406193078324,497,133,21.845173041894352,3
Category_Wikipedia_sockpuppets_of_Rocckker13.csv,564,51597461.0,233,331,168,65,0,45.388297872340424,250,64,20.28900709219858,5
Category_Wikipedia_sockpuppets_of_EAUK1.csv,7,8718502.0,6,1,5,1,19,48.0,81,26,22.857142857142858,15
Category_Wikipedia_sockpuppets_of_M.D_Lawes.csv,388,26727203.0,148,240,34,114,0,41.324742268041234,206,39,17.25515463917526,10
Category_Wikipedia_sockpuppets_of_Sjutt.csv,1452,116314966.0,552,900,104,448,0,48.540633608815426,496,89,17.334022038567493,3
Category_Wikipedia_sockpuppets_of_TOTT.csv,165,9651664.0,51,114,42,9,0,49.93939393939394,237,47,17.2,6
Category_Wikipedia_sockpuppets_of_CoopDEtat19.csv,712,26628569.0,162,550,160,2,0,60.646067415730336,355,34,16.004213483146067,5
Category_Wikipedia_sockpuppets_of_Winningjahofficial.csv,64,64445918.0,16,48,7,9,0,50.0,255,56,26.46875,6
Category_Wikipedia_sockpuppets_of_SanjayMurugesan2221.csv,229,58408288.0,104,125,83,21,0,48.58951965065502,417,45,24.30131004366812,14
Category_Wikipedia_sockpuppets_of_Rachelandrachel.csv,16,27385.0,10,6,6,4,0,23.1875,182,20,14.5,12
Category_Wikipedia_sockpuppets_of_Camponhoyle.csv,943,109475173.0,306,637,76,230,0,46.50265111346766,234,61,22.62460233297985,3
Category_Wikipedia_sockpuppets_of_Redgolpe.csv,1593,90993346.0,506,1087,500,6,0,50.02824858757062,421,79,16.412429378531073,1
Category_Wikipedia_sockpuppets_of_Alyssa3125.csv,12,2466499.0,3,9,2,1,0,64.0,161,35,33.333333333333336,15
Category_Wikipedia_sockpuppets_of_Kavakdere.csv,876,103747007.0,192,684,179,13,0,67.76940639269407,500,71,20.660958904109588,3
Category_Wikipedia_sockpuppets_of_Annett1988.csv,11,1923466.0,3,8,1,2,0,50.54545454545455,110,18,15.363636363636363,9
Category_Wikipedia_sockpuppets_of_Mbtshop.csv,1,0.0,1,0,1,0,44,44.0,44,25,25.0,25
Category_Wikipedia_sockpuppets_of_Hamkar_99.csv,1551,42899049.0,531,1020,420,111,0,50.861379754996776,500,47,15.488072211476467,4
Category_Wikipedia_sockpuppets_of_Jorgito0246.csv,1715,54605457.0,498,1217,355,143,0,32.83206997084548,215,50,18.68804664723032,4
Category_Wikipedia_sockpuppets_of_Madgaonkar.csv,311,14976675.0,118,193,81,37,0,63.79421221864952,255,41,16.459807073954984,5
Category_Wikipedia_sockpuppets_of_TungstenCarbide.csv,1927,175389088.0,605,1322,161,444,0,39.183186299948105,247,61,22.419823559937726,3
Category_Wikipedia_sockpuppets_of_Rjbear178.csv,239,98134553.0,77,162,52,25,0,46.82426778242678,233,60,22.397489539748953,4
Category_Wikipedia_sockpuppets_of_Aimiff82.csv,373,6324615.0,139,234,70,69,0,37.924932975871315,496,34,16.80697050938338,5
Category_Wikipedia_sockpuppets_of_Jadeveon41.csv,605,24651452.0,194,411,159,35,0,48.23471074380165,251,87,20.70413223140496,4
Category_Wikipedia_sockpuppets_of_Numbers_not_news.csv,12,865826.0,8,4,6,2,0,55.166666666666664,196,43,31.416666666666668,21
Category_Wikipedia_sockpuppets_of_Crookmigo.csv,2,53871811.0,2,0,1,1,0,41.5,83,19,19.0,19
Category_Wikipedia_sockpuppets_of_Secularyear2023.csv,790,19608105.0,303,487,56,247,0,47.6253164556962,298,61,20.77848101265823,4
Category_Wikipedia_sockpuppets_of_Suitcivil133.csv,3873,168655476.0,1094,2779,500,594,0,56.05138135812032,498,92,20.239091143816164,4
Category_Wikipedia_sockpuppets_of_OMI_KASHYAP.csv,52,142221594.0,17,35,14,3,0,56.28846153846154,170,39,25.903846153846153,14
Category_Wikipedia_sockpuppets_of_Nomalungelo_Mbulelo-Brown.csv,770,7388458.0,294,476,183,111,0,38.67142857142857,336,47,17.08961038961039,5
Category_Wikipedia_sockpuppets_of_Fashiondiva2015.csv,20,334204.0,5,15,4,1,0,33.0,146,52,39.65,33
Category_Wikipedia_sockpuppets_of_Alacante45.csv,786,1942355.0,317,469,273,44,0,49.64885496183206,250,54,21.717557251908396,5
Category_Wikipedia_sockpuppets_of_Hooliverson.csv,130,59426591.0,47,83,43,4,0,48.86153846153846,239,47,17.576923076923077,4
Category_Wikipedia_sockpuppets_of_DieterMartinez.csv,934,4648964.0,288,646,272,16,0,37.686295503211994,251,42,18.18629550321199,4
Category_Wikipedia_sockpuppets_of_Milton.warden.csv,12,3808041.0,8,4,5,3,0,14.75,41,49,49.0,49
Category_Wikipedia_sockpuppets_of_Hwjcnsb.csv,6,1721052.0,4,2,2,2,10,36.833333333333336,131,24,15.5,7
Category_Wikipedia_sockpuppets_of_Izukumidoriya1227.csv,2501,52700501.0,903,1598,500,403,0,38.27309076369452,513,60,22.12874850059976,4
Category_Wikipedia_sockpuppets_of_NeilTurkIsMySugardaddy.csv,11,332510.0,8,3,8,0,0,64.54545454545455,160,9,9.0,9
Category_Wikipedia_sockpuppets_of_Darkl1yy.csv,148,11391141.0,63,85,32,31,0,45.027027027027025,496,33,24.12837837837838,5
Category_Wikipedia_sockpuppets_of_Sheldonium.csv,1510,91311931.0,617,893,500,117,0,47.70198675496689,373,48,17.11456953642384,5
Category_Wikipedia_sockpuppets_of_Abhijeet_jahazi.csv,62,224336109.0,34,28,20,14,0,51.46774193548387,261,47,25.741935483870968,20
Category_Wikipedia_sockpuppets_of_Arshifakhan61.csv,12552,587854654.0,4489,8063,500,3989,0,53.25278840025494,500,85,19.503346080305928,3
Category_Wikipedia_sockpuppets_of_Sam_Birkins_dad.csv,17,945.0,10,7,7,3,5,35.8235294117647,157,40,23.235294117647058,17
Category_Wikipedia_sockpuppets_of_Kxings.csv,242,968188.0,184,58,115,69,0,21.06198347107438,199,64,25.880165289256198,4
Category_Wikipedia_sockpuppets_of_ProudTeslaDriver.csv,25,6489080.0,8,17,6,2,0,64.4,224,20,12.4,6
Category_Wikipedia_sockpuppets_of_TJLAMBERT21.csv,22,92521.0,15,7,12,3,0,21.272727272727273,199,30,21.09090909090909,16
Category_Wikipedia_sockpuppets_of_Aradic-es.csv,3078,56046322.0,1041,2037,500,541,0,37.47400909681611,250,81,20.562053281351528,2
Category_Wikipedia_sockpuppets_of_Sayoon3.csv,185,2730289.0,71,114,45,26,0,70.76216216216216,250,54,31.2,16
Category_Wikipedia_sockpuppets_of_Chickenbigman.csv,263,12886278.0,97,166,24,73,0,39.22433460076046,234,33,18.247148288973385,9
Category_Wikipedia_sockpuppets_of_Opinion786.csv,540,27280068.0,259,281,162,97,0,41.983333333333334,250,25,15.605555555555556,12
Category_Wikipedia_sockpuppets_of_Qabbalah.csv,207,1051591.0,65,142,35,30,0,28.570048309178745,157,41,15.792270531400966,6
Category_Wikipedia_sockpuppets_of_Gustin_Kelly.csv,119,3906813.0,55,64,36,19,0,49.890756302521005,273,54,29.050420168067227,11
Category_Wikipedia_sockpuppets_of_Charlie_P_Ryan.csv,2,0.0,1,1,1,0,29,29.0,29,55,55.0,55
Category_Wikipedia_sockpuppets_of_Piuollk.csv,67,94922.0,39,28,21,18,0,35.73134328358209,141,47,21.238805970149254,12
Category_Wikipedia_sockpuppets_of_EJBanks.csv,3409,14855168.0,711,2698,306,405,0,28.227632736872984,208,57,16.025227339395716,5
Category_Wikipedia_sockpuppets_of_Dfhtt.csv,93,1818851.0,40,53,28,12,0,51.913978494623656,213,27,13.602150537634408,9
Category_Wikipedia_sockpuppets_of_Seth_hilton_discography.csv,12,361483.0,10,2,10,0,0,40.083333333333336,199,33,33.0,33
Category_Wikipedia_sockpuppets_of_RALFFPL.csv,1127,35530630.0,508,619,500,8,0,48.59627329192546,499,77,21.914818101153504,5
Category_Wikipedia_sockpuppets_of_Space_Group_(Kolkata).csv,1,0.0,1,0,1,0,36,36.0,36,23,23.0,23
Category_Wikipedia_sockpuppets_of_Vipul_Sharma.csv,11,243978.0,5,6,3,2,3,76.72727272727273,253,22,16.272727272727273,15
Category_Wikipedia_sockpuppets_of_AK0934.csv,127,13206198.0,51,76,34,17,0,61.661417322834644,500,45,21.346456692913385,6
Category_Wikipedia_sockpuppets_of_Fdery.csv,2140,21859452.0,657,1483,177,480,0,38.390654205607476,488,52,20.3696261682243,11
Category_Wikipedia_sockpuppets_of_Benipittman.csv,136,11152033.0,84,52,16,68,0,36.713235294117645,196,30,18.86764705882353,12
Category_Wikipedia_sockpuppets_of_ZEdzEd3168.csv,106,59862193.0,54,52,53,1,0,32.056603773584904,222,47,21.537735849056602,10
Category_Wikipedia_sockpuppets_of_Supercrazy_1001.csv,21,162539.0,9,12,6,3,0,46.95238095238095,181,35,17.428571428571427,10
Category_Wikipedia_sockpuppets_of_Kuchtoh.csv,18,146004.0,11,7,6,5,0,59.111111111111114,224,32,11.666666666666666,9
Category_Wikipedia_sockpuppets_of_Jeb2003.csv,609,43034336.0,220,389,111,109,0,33.32512315270936,237,57,25.436781609195403,6
Category_Wikipedia_sockpuppets_of_Kurd√ÆmHeval.csv,1121,95360929.0,321,800,227,94,0,51.02319357716325,502,50,18.8135593220339,4
Category_Wikipedia_sockpuppets_of_Malaysian_Burger.csv,109,4611054.0,41,68,21,20,0,44.4954128440367,226,69,20.091743119266056,6
Category_Wikipedia_sockpuppets_of_Bright888.csv,903,19639267.0,322,581,173,149,0,31.73200442967885,247,40,14.995570321151716,5
Category_Wikipedia_sockpuppets_of_Hoppybunny.csv,2007,22887331.0,581,1426,500,81,0,34.711011459890386,249,63,26.140009965122072,6
Category_Wikipedia_sockpuppets_of_Pararubbas.csv,7426,157972410.0,2698,4728,500,2198,0,26.808914624293024,250,60,17.445461890654457,4
Category_Wikipedia_sockpuppets_of_Rsharpsharp.csv,45,53394180.0,9,36,6,3,0,40.266666666666666,180,19,8.733333333333333,5
Category_Wikipedia_sockpuppets_of_Bram.kievit.csv,12,1344.0,11,1,6,5,16,38.75,128,14,9.416666666666666,9
Category_Wikipedia_sockpuppets_of_Michaelito25.csv,17,126409.0,6,11,4,2,0,35.05882352941177,151,14,12.117647058823529,6
Category_Wikipedia_sockpuppets_of_Mrs_Kippling.csv,74,801753.0,26,48,17,9,0,47.75675675675676,245,48,19.60810810810811,8
Category_Wikipedia_sockpuppets_of_Shaikhyasae.csv,8,544086.0,6,2,5,1,0,101.0,231,13,11.75,8
Category_Wikipedia_sockpuppets_of_BabbaQ.csv,1660,418942491.0,576,1084,500,76,0,41.87289156626506,494,100,20.77289156626506,4
Category_Wikipedia_sockpuppets_of_SICK_NUT.csv,28,248262.0,20,8,14,6,0,39.17857142857143,179,21,17.785714285714285,14
Category_Wikipedia_sockpuppets_of_Sudarshandz.csv,36,18598417.0,13,23,12,1,0,64.88888888888889,276,44,14.333333333333334,9
Category_Wikipedia_sockpuppets_of_Mitch9harry.csv,13,1869654.0,9,4,8,1,0,37.15384615384615,156,44,10.76923076923077,7
Category_Wikipedia_sockpuppets_of_Mya1234.csv,57,362288.0,37,20,27,10,0,23.736842105263158,236,67,66.15789473684211,66
Category_Wikipedia_sockpuppets_of_DDP-Trooper1777.csv,1470,81712099.0,403,1067,170,233,0,46.448299319727894,396,57,17.298639455782315,3
Category_Wikipedia_sockpuppets_of_Anythingworx23.csv,375,13296362.0,115,260,106,9,0,73.32,419,36,20.184,6
Category_Wikipedia_sockpuppets_of_SlidingD.csv,557,5487144.0,194,363,159,35,0,34.885098743267505,466,47,17.59245960502693,4
Category_Wikipedia_sockpuppets_of_Meanie.csv,908,238238980.0,262,646,199,63,0,40.27092511013216,253,75,26.4284140969163,4
Category_Wikipedia_sockpuppets_of_MinnesotaMethods.csv,304,8294148.0,85,219,14,71,0,59.29276315789474,328,40,16.14144736842105,9
Category_Wikipedia_sockpuppets_of_Dope99.csv,81,173973.0,45,36,36,9,0,43.4320987654321,213,51,27.753086419753085,7
Category_Wikipedia_sockpuppets_of_Parappa664.csv,806,391232544.0,289,517,196,93,0,50.8424317617866,255,65,22.796526054590572,7
Category_Wikipedia_sockpuppets_of_Aliciacuccia.csv,35,177650.0,13,22,7,6,0,55.34285714285714,187,19,11.457142857142857,3
Category_Wikipedia_sockpuppets_of_NoobMiester96.csv,1943,15529145.0,641,1302,500,141,0,44.56767884714359,494,66,26.586206896551722,6
Category_Wikipedia_sockpuppets_of_Truecrypt-end.csv,50,4321337.0,25,25,15,10,0,79.06,237,41,17.92,9
Category_Wikipedia_sockpuppets_of_Sopher99.csv,2885,68481883.0,1059,1826,500,559,0,56.86655112651646,255,64,28.16221837088388,3
Category_Wikipedia_sockpuppets_of_Kabil_Vignesh.csv,69,857416.0,46,23,29,17,0,38.04347826086956,324,20,9.492753623188406,4
Category_Wikipedia_sockpuppets_of_Îã§ÎÇòÏä§.csv,28,400671.0,21,7,9,12,0,57.42857142857143,161,16,11.5,11
Category_Wikipedia_sockpuppets_of_HaryanaMayil.csv,3444,47507250.0,1358,2086,500,858,0,38.4904181184669,499,56,24.865853658536587,4
Category_Wikipedia_sockpuppets_of_556greentip.csv,1030,21407628.0,353,677,247,106,0,38.737864077669904,496,65,17.615533980582523,4
Category_Wikipedia_sockpuppets_of_WikiUserThree33.csv,14,3488377.0,11,3,9,2,19,152.14285714285714,488,11,11.0,11
Category_Wikipedia_sockpuppets_of_Rose_Singh2712.csv,131,2611543.0,95,36,39,56,0,14.297709923664122,255,19,14.038167938931299,9
Category_Wikipedia_sockpuppets_of_AttackOfTheSnailDemons.csv,460,14340778.0,129,331,67,62,0,55.33695652173913,255,92,18.8,3
Category_Wikipedia_sockpuppets_of_KenworthFan101.csv,87,2547.0,28,59,28,0,0,43.04597701149425,200,54,21.620689655172413,13
Category_Wikipedia_sockpuppets_of_Rangersarecool.csv,113,5790097.0,36,77,35,1,0,42.9646017699115,143,58,14.044247787610619,5
Category_Wikipedia_sockpuppets_of_Mattconsto.csv,74,107932664.0,22,52,18,4,0,49.36486486486486,255,47,19.7972972972973,12
Category_Wikipedia_sockpuppets_of_Nralhan.csv,19,221266.0,12,7,6,6,0,42.94736842105263,103,25,16.789473684210527,12
Category_Wikipedia_sockpuppets_of_HistoryofPashtuns.csv,433,5105955.0,137,296,100,37,0,53.34180138568129,492,37,14.28406466512702,5
Category_Wikipedia_sockpuppets_of_Yarivrock.csv,107,53828446.0,38,69,32,6,0,42.299065420560744,236,66,16.0,10
Category_Wikipedia_sockpuppets_of_Howdypardner.csv,114,201527.0,52,62,31,21,0,59.28947368421053,200,47,35.719298245614034,20
Category_Wikipedia_sockpuppets_of_YUEUE.csv,360,51936219.0,107,253,77,30,0,42.90833333333333,322,24,12.866666666666667,8
Category_Wikipedia_sockpuppets_of_Johnson05678.csv,168,6842206.0,64,104,57,7,0,43.726190476190474,340,32,18.50595238095238,10
Category_Wikipedia_sockpuppets_of_Ukgbgbra.csv,68,1376906.0,25,43,14,11,0,95.38235294117646,369,30,15.544117647058824,13
Category_Wikipedia_sockpuppets_of_Freeandaware.csv,127,304214708.0,53,74,35,18,0,41.46456692913386,226,17,11.803149606299213,11
Category_Wikipedia_sockpuppets_of_Matbfpo.csv,4,181112.0,4,0,3,1,0,104.0,194,20,19.75,19
Category_Wikipedia_sockpuppets_of_Vikas2007shukla.csv,424,4768445.0,133,291,95,38,0,32.716981132075475,195,52,19.38679245283019,6
Category_Wikipedia_sockpuppets_of_Liborbital.csv,6388,136072101.0,1918,4470,500,1418,0,53.242172824045085,500,79,21.605353788353163,1
Category_Wikipedia_sockpuppets_of_MillTown.csv,218,6927135.0,70,148,39,31,0,54.26605504587156,237,34,15.541284403669724,4
Category_Wikipedia_sockpuppets_of_Lizricole.csv,1,0.0,1,0,1,0,0,0.0,0,32,32.0,32
Category_Wikipedia_sockpuppets_of_Hemanth_Hullukere_mandya.csv,29,467747.0,7,22,6,1,0,83.24137931034483,496,37,17.17241379310345,10
Category_Wikipedia_sockpuppets_of_Mdfaisalahmedhimel.csv,346,99253798.0,88,258,87,1,0,41.23410404624278,259,25,13.84971098265896,5
Category_Wikipedia_sockpuppets_of_Liechtensteiner50.csv,8,13906490.0,3,5,1,2,0,63.25,200,17,17.0,17
Category_Wikipedia_sockpuppets_of_Bt8257.csv,2599,12251362.0,740,1859,500,240,0,37.714120815698344,255,62,26.419776837245095,2
Category_Wikipedia_sockpuppets_of_Bob2445554.csv,32,251034.0,19,13,7,12,0,33.6875,172,16,9.625,6
Category_Wikipedia_sockpuppets_of_Tonyinman.csv,1758,381329727.0,527,1231,500,27,0,63.641638225255974,500,101,21.41240045506257,5
Category_Wikipedia_sockpuppets_of_Thunderalam717.csv,627,112883798.0,129,498,116,13,0,43.39553429027113,252,58,19.83732057416268,6
Category_Wikipedia_sockpuppets_of_Thenotgabe.csv,59,39117402.0,23,36,14,9,0,56.32203389830509,196,20,15.338983050847459,14
Category_Wikipedia_sockpuppets_of_Bagusa4.csv,73,37979460.0,21,52,13,8,0,31.10958904109589,220,37,20.82191780821918,13
Category_Wikipedia_sockpuppets_of_Elnencatala.csv,1077,54318756.0,321,756,88,233,0,52.83379758588672,331,53,17.152274837511605,3
Category_Wikipedia_sockpuppets_of_Lakepupulake.csv,140,5699407.0,43,97,17,26,0,52.292857142857144,266,55,16.557142857142857,5
Category_Wikipedia_sockpuppets_of_Nian_at_behindwoods.csv,77,5867670.0,26,51,23,3,0,51.1948051948052,213,48,19.0,11
Category_Wikipedia_sockpuppets_of_LupinoJacky.csv,1274,53978213.0,435,839,201,234,0,53.05651491365777,255,56,25.667974882260598,5
Category_Wikipedia_sockpuppets_of_MarshalIsInVillage.csv,8,1523.0,4,4,3,1,24,72.75,145,42,22.5,16
Category_Wikipedia_sockpuppets_of_Drinkreader.csv,578,207208884.0,181,397,178,3,0,57.44809688581315,341,47,22.55017301038062,4
Category_Wikipedia_sockpuppets_of_GodwinCollins.csv,286,3450986.0,87,199,43,44,0,63.76573426573427,249,60,14.926573426573427,4
Category_Wikipedia_sockpuppets_of_Bobvans1487.csv,58,301595.0,30,28,28,2,0,55.12068965517241,507,27,14.586206896551724,12
Category_Wikipedia_sockpuppets_of_Momh12.csv,23,71117119.0,9,14,8,1,0,63.43478260869565,178,32,20.347826086956523,11
Category_Wikipedia_sockpuppets_of_Sixpacz.csv,2090,275643390.0,501,1589,500,1,0,39.04688995215311,447,68,18.082296650717705,3
Category_Wikipedia_sockpuppets_of_SpaceGoofsGeekerBoy.csv,1673,9030206.0,503,1170,500,3,0,44.92528392109982,256,75,25.334728033472803,6
Category_Wikipedia_sockpuppets_of_Apple731a.csv,49,183427.0,24,25,15,9,0,33.714285714285715,133,63,43.326530612244895,12
Category_Wikipedia_sockpuppets_of_NikolajPeter1810.csv,263,2318619.0,98,165,92,6,0,41.460076045627375,255,50,17.85171102661597,9
Category_Wikipedia_sockpuppets_of_Zjholder.csv,4217,84782197.0,1215,3002,402,813,0,57.10386530709035,497,72,23.184254209153426,3
Category_Wikipedia_sockpuppets_of_Mac_and_cheese_king.csv,52,67952.0,18,34,17,1,0,47.51923076923077,152,41,21.807692307692307,18
Category_Wikipedia_sockpuppets_of_Fern518.csv,19,157679.0,15,4,8,7,0,46.63157894736842,195,26,21.210526315789473,12
Category_Wikipedia_sockpuppets_of_Incredible93.csv,5553,38383348.0,3147,2406,500,2647,0,34.31442463533225,463,34,17.005762650819378,7
Category_Wikipedia_sockpuppets_of_Sl99dl.csv,79,2161537.0,31,48,18,13,0,78.67088607594937,241,16,9.848101265822784,6
Category_Wikipedia_sockpuppets_of_Joseph_Prasad.csv,4878,77859641.0,1353,3525,500,853,0,53.103321033210335,255,97,19.173226732267324,3
Category_Wikipedia_sockpuppets_of_Ugothe6ok.csv,657,12330912.0,178,479,59,119,0,46.112633181126334,464,36,14.765601217656013,3
Category_Wikipedia_sockpuppets_of_Vin_Florida.csv,4,66357.0,3,1,2,1,27,39.75,44,47,16.25,6
Category_Wikipedia_sockpuppets_of_Rajesh_rao_kumar.csv,3064,51939912.0,1115,1949,420,695,0,39.96475195822455,255,40,15.340404699738903,3
Category_Wikipedia_sockpuppets_of_Manish7503413894.csv,1,0.0,1,0,1,0,22,22.0,22,20,20.0,20
Category_Wikipedia_sockpuppets_of_Sfacets.csv,3052,218060574.0,1027,2025,500,527,0,52.313237221494106,254,78,23.641874180865006,4
Category_Wikipedia_sockpuppets_of_Raval_Bhandal.csv,2,0.0,1,1,1,0,69,69.0,69,28,28.0,28
Category_Wikipedia_sockpuppets_of_Guptalab.csv,45,29030159.0,16,29,4,12,0,54.91111111111111,191,48,24.755555555555556,15
Category_Wikipedia_sockpuppets_of_GreatPersonLikeMe.csv,1205,8809195.0,371,834,329,42,0,55.341908713692945,461,61,15.608298755186722,3
Category_Wikipedia_sockpuppets_of_Sanjay98chhimpa.csv,139,10805656.0,40,99,10,30,0,45.18705035971223,395,53,21.050359712230215,8
Category_Wikipedia_sockpuppets_of_TheDevNegi.csv,42,3250274.0,19,23,12,7,0,42.95238095238095,255,19,14.238095238095237,5
Category_Wikipedia_sockpuppets_of_Lamberd.csv,1049,187248890.0,440,609,390,50,0,38.489037178265015,494,64,17.738798856053386,4
Category_Wikipedia_sockpuppets_of_Str8skinny.csv,322,26027513.0,183,139,178,5,0,39.84782608695652,296,22,12.391304347826088,9
Category_Wikipedia_sockpuppets_of_Joliya147.csv,642,32335447.0,190,452,13,177,0,51.585669781931465,251,72,16.85514018691589,4
Category_Wikipedia_sockpuppets_of_Ttv_tchoin.csv,37,1785.0,17,20,9,8,0,29.7027027027027,162,22,11.972972972972974,8
Category_Wikipedia_sockpuppets_of_Mark_Boron.csv,720,3541737.0,384,336,272,112,0,36.44722222222222,366,72,25.954166666666666,15
Category_Wikipedia_sockpuppets_of_Stinckunnt.csv,19,28445034.0,5,14,5,0,0,80.89473684210526,199,48,24.473684210526315,20
Category_Wikipedia_sockpuppets_of_Bayurmdhn11.csv,5,1685.0,5,0,5,0,0,0.0,0,26,26.0,26
Category_Wikipedia_sockpuppets_of_Dimetrio_Greene.csv,140,993607.0,40,100,25,15,0,54.97142857142857,271,31,17.764285714285716,4
Category_Wikipedia_sockpuppets_of_MySuperBelt85.csv,15,91391.0,9,6,9,0,0,90.2,208,23,13.666666666666666,9
Category_Wikipedia_sockpuppets_of_Gerard_Baker.csv,63,94712.0,33,30,26,7,0,90.76190476190476,233,56,21.015873015873016,12
Category_Wikipedia_sockpuppets_of_Dr._R._Friedrich.csv,25,5791408.0,23,2,11,12,0,78.48,493,35,21.24,14
Category_Wikipedia_sockpuppets_of_Haylettd18.csv,171,1719976.0,59,112,51,8,0,49.62573099415204,229,42,18.81286549707602,8
Category_Wikipedia_sockpuppets_of_Drdubey27.csv,59,121686374.0,13,46,12,1,0,49.11864406779661,208,33,21.694915254237287,5
Category_Wikipedia_sockpuppets_of_Tomato_soup_and_Spam.csv,18,2435779.0,15,3,7,8,3,74.72222222222223,455,33,19.5,18
Category_Wikipedia_sockpuppets_of_Troublemaker1949.csv,1225,9856395.0,418,807,278,140,0,34.707755102040814,259,66,24.49142857142857,5
Category_Wikipedia_sockpuppets_of_Deathtrap100.csv,1,0.0,1,0,1,0,0,0.0,0,5,5.0,5
Category_Wikipedia_sockpuppets_of_Bremskraft.csv,976,2274124.0,551,425,500,51,0,41.4969262295082,250,47,16.78073770491803,8
Category_Wikipedia_sockpuppets_of_Ssybesma.csv,507,289800390.0,134,373,130,4,0,54.400394477317555,249,64,22.812623274161737,4
Category_Wikipedia_sockpuppets_of_McBeavis.csv,86,50018339.0,35,51,16,19,0,77.26744186046511,243,31,13.279069767441861,11
Category_Wikipedia_sockpuppets_of_Dalw02.csv,27,164342996.0,11,16,4,7,0,49.44444444444444,160,29,16.037037037037038,11
Category_Wikipedia_sockpuppets_of_Carpetlice.csv,251,15547514.0,82,169,61,21,0,49.96414342629482,477,38,18.243027888446214,8
Category_Wikipedia_sockpuppets_of_Justicejayant.csv,1728,2589072.0,500,1228,500,0,0,48.108217592592595,250,76,20.77199074074074,4
Category_Wikipedia_sockpuppets_of_Goranmp.csv,30,12131861.0,25,5,16,9,0,11.166666666666666,47,43,28.833333333333332,14
Category_Wikipedia_sockpuppets_of_Ashton_29.csv,4448,447035097.0,972,3476,500,472,0,49.65445143884892,489,66,17.594874100719423,4
Category_Wikipedia_sockpuppets_of_Horlo.csv,1775,179198641.0,509,1266,500,9,0,42.57577464788732,242,73,18.965633802816903,4
Category_Wikipedia_sockpuppets_of_Mhsohaib.csv,9297,229743301.0,3157,6140,500,2657,0,33.46800043024631,500,72,19.041196084758525,4
Category_Wikipedia_sockpuppets_of_Mixero_27.csv,1160,5171844.0,415,745,154,261,0,26.686206896551724,255,52,17.662068965517243,5
Category_Wikipedia_sockpuppets_of_Cjshoes.csv,161,1797092.0,38,123,23,15,0,60.96894409937888,424,36,12.950310559006212,8
Category_Wikipedia_sockpuppets_of_Heres_The_Dealio.csv,241,79481491.0,205,36,11,194,0,25.20746887966805,160,29,23.236514522821576,14
Category_Wikipedia_sockpuppets_of_AtomicMarcusKitten.csv,1328,4097115.0,500,828,500,0,0,36.23192771084337,250,65,22.98418674698795,9
Category_Wikipedia_sockpuppets_of_Urali_gounder_Tn45.csv,79,743241.0,39,40,15,24,0,51.21518987341772,342,31,15.354430379746836,9
Category_Wikipedia_sockpuppets_of_Monopoly123.csv,20,379721.0,9,11,3,6,0,28.6,184,41,37.55,16
Category_Wikipedia_sockpuppets_of_Orangemoody.csv,4671,60973105.0,1603,3068,104,1499,0,40.6739456219225,257,59,18.28709055876686,3
Category_Wikipedia_sockpuppets_of_Sir_Thiago.csv,555,4752243.0,248,307,245,3,0,55.51171171171171,415,54,29.90990990990991,13
Category_Wikipedia_sockpuppets_of_Rqquju.csv,92,19427952.0,23,69,19,4,0,32.47826086956522,186,41,31.01086956521739,10
Category_Wikipedia_sockpuppets_of_Quadra_Drive_II.csv,29,1369754.0,17,12,14,3,0,46.03448275862069,146,25,16.517241379310345,5
Category_Wikipedia_sockpuppets_of_Yarock.csv,125,391067790.0,29,96,24,5,0,48.904,236,41,25.72,8
Category_Wikipedia_sockpuppets_of_Ukrainetz1.csv,1717,12989268.0,505,1212,500,5,0,57.225975538730346,255,74,22.344205008736168,4
Category_Wikipedia_sockpuppets_of_Blair_Sullivan.csv,1985,15057974.0,500,1485,224,276,0,36.54760705289672,325,43,17.574307304785894,5
Category_Wikipedia_sockpuppets_of_Polllilur.csv,140,4875988.0,54,86,13,41,0,44.857142857142854,229,41,20.814285714285713,4
Category_Wikipedia_sockpuppets_of_Jwjkp.csv,13,255123401.0,6,7,4,2,7,43.76923076923077,199,35,19.307692307692307,18
Category_Wikipedia_sockpuppets_of_StevenBInc.csv,34,38832622.0,11,23,7,4,0,51.23529411764706,228,35,21.794117647058822,17
Category_Wikipedia_sockpuppets_of_Govindduc.csv,18,44920312.0,5,13,3,2,0,53.388888888888886,135,41,29.555555555555557,14
Category_Wikipedia_sockpuppets_of_Happybunny5859.csv,56,17247192.0,20,36,13,7,0,41.785714285714285,238,68,29.607142857142858,12
Category_Wikipedia_sockpuppets_of_Airtuna08.csv,4791,353740900.0,1494,3297,500,994,0,42.32498434564809,255,80,21.06616572740555,4
Category_Wikipedia_sockpuppets_of_Sheikh_Rehan_Shahid.csv,8,96694.0,4,4,4,0,5,61.5,155,16,16.0,16
Category_Wikipedia_sockpuppets_of_Js0822.csv,140,37005157.0,46,94,33,13,0,64.3,239,43,17.728571428571428,10
Category_Wikipedia_sockpuppets_of_Kenwood_3000.csv,895,12221516.0,249,646,83,166,0,25.91173184357542,195,31,13.912849162011174,4
Category_Wikipedia_sockpuppets_of_Mason8252.csv,366,31458366.0,135,231,53,82,0,39.25136612021858,230,54,28.896174863387976,9
Category_Wikipedia_sockpuppets_of_Ylightflight.csv,1570,96156811.0,502,1068,500,2,0,42.64203821656051,255,82,20.9,5
Category_Wikipedia_sockpuppets_of_Krishna_Pagadala.csv,1,0.0,1,0,1,0,29,29.0,29,24,24.0,24
Category_Wikipedia_sockpuppets_of_Simransharma7440.csv,53,169435.0,23,30,16,7,0,61.339622641509436,202,26,16.660377358490567,5
Category_Wikipedia_sockpuppets_of_Happypillsjr.csv,669,30083645.0,250,419,250,0,0,45.10014947683109,367,56,22.076233183856502,7
Category_Wikipedia_sockpuppets_of_Ulvimamedov57.csv,35,33606803.0,10,25,9,1,0,59.114285714285714,337,27,13.885714285714286,10
Category_Wikipedia_sockpuppets_of_Iamdopo.csv,76,1393062.0,29,47,18,11,0,46.35526315789474,241,15,7.144736842105263,4
Category_Wikipedia_sockpuppets_of_Lukabeograd.csv,2280,346663175.0,588,1692,500,88,0,29.111842105263158,287,61,19.785087719298247,6
Category_Wikipedia_sockpuppets_of_ShkoDevAct.csv,8439,84312409.0,2764,5675,500,2264,0,44.01125725796896,500,73,18.508472567839792,3
Category_Wikipedia_sockpuppets_of_Sanmarg_Jain.csv,336,3247288.0,151,185,139,12,0,42.208333333333336,263,30,13.538690476190476,6
Category_Wikipedia_sockpuppets_of_Sdfghjkhgfdsdf.csv,17,2455.0,9,8,5,4,0,69.94117647058823,152,44,38.35294117647059,12
Category_Wikipedia_sockpuppets_of_Marginataen.csv,1610,4466726.0,509,1101,500,9,0,56.725465838509315,500,55,17.84968944099379,4
Category_Wikipedia_sockpuppets_of_PSPbothmanlol.csv,24,2863.0,15,9,13,2,0,27.666666666666668,162,57,48.666666666666664,29
Category_Wikipedia_sockpuppets_of_26jtran6.csv,322,259943.0,122,200,107,15,0,37.86024844720497,308,30,15.788819875776397,4
Category_Wikipedia_sockpuppets_of_BillClinternet.csv,1737,34057705.0,520,1217,500,20,0,58.865284974093264,496,66,23.620034542314336,3
Category_Wikipedia_sockpuppets_of_Arcangel21.csv,42,11165359.0,9,33,8,1,0,56.07142857142857,222,15,12.80952380952381,11
Category_Wikipedia_sockpuppets_of_JoeUly.csv,83,4078408.0,19,64,11,8,0,33.626506024096386,150,47,28.06024096385542,12
Category_Wikipedia_sockpuppets_of_Sherryargov.csv,721,6741175.0,259,462,257,2,0,42.930651872399444,239,46,21.75728155339806,10
Category_Wikipedia_sockpuppets_of_ÿ≠ŸÖ€åÿØ_ŸÖ€åÿ±ÿ≤ÿß€å€å.csv,50,6396537.0,46,4,22,24,0,23.5,196,44,22.08,7
Category_Wikipedia_sockpuppets_of_Tenkaiack.csv,91,7696437.0,33,58,32,1,0,43.142857142857146,214,32,14.648351648351648,9
Category_Wikipedia_sockpuppets_of_Terrigentry.csv,20,8366.0,7,13,4,3,0,44.4,73,50,23.5,18
Category_Wikipedia_sockpuppets_of_Aliceharmon007.csv,9,7587.0,5,4,3,2,7,117.0,258,23,13.0,5
Category_Wikipedia_sockpuppets_of_Kasidet29.csv,2073,69036831.0,833,1240,500,333,0,31.425952725518574,255,76,27.722624216111914,4
Category_Wikipedia_sockpuppets_of_SandisoNgcamu.csv,189,3143310.0,68,121,34,34,0,43.05291005291005,217,34,16.49206349206349,5
Category_Wikipedia_sockpuppets_of_WikiGuru100.csv,46,7514639.0,11,35,11,0,0,46.69565217391305,191,35,24.67391304347826,16
Category_Wikipedia_sockpuppets_of_Sladbob.csv,133,46375526.0,59,74,19,40,0,49.045112781954884,233,51,20.30827067669173,12
Category_Wikipedia_sockpuppets_of_TheFingerer.csv,56,6060.0,17,39,16,1,0,35.964285714285715,127,47,22.785714285714285,14
Category_Wikipedia_sockpuppets_of_EmeraldWicket9947.csv,5636,318804887.0,1507,4129,500,1007,0,50.944464158978,500,67,21.50887154009936,5
Category_Wikipedia_sockpuppets_of_GreenCows.csv,6176,57209002.0,1632,4544,500,1132,0,68.23575129533678,500,89,22.65835492227979,4
Category_Wikipedia_sockpuppets_of_Theologiae.csv,1904,129033712.0,506,1398,500,6,0,46.24632352941177,255,46,16.14548319327731,3
Category_Wikipedia_sockpuppets_of_SSSI-SIBA.csv,114,9580552.0,48,66,21,27,0,56.25438596491228,240,35,18.87719298245614,16
Category_Wikipedia_sockpuppets_of_Modernrocker4.csv,834,20261797.0,435,399,421,14,0,26.918465227817745,255,50,23.47841726618705,5
Category_Wikipedia_sockpuppets_of_Knightrises10.csv,9268,65131987.0,3211,6057,500,2711,0,63.76316357358653,500,89,21.9073154941735,2
Category_Wikipedia_sockpuppets_of_Aponmanik.csv,21,371545.0,7,14,7,0,0,52.0,255,22,16.095238095238095,14
Category_Wikipedia_sockpuppets_of_Irist6882.csv,104,35754420.0,30,74,20,10,0,69.47115384615384,346,24,16.35576923076923,6
Category_Wikipedia_sockpuppets_of_Sobhashna_Milan_Laljibhai.csv,15,1150305.0,6,9,6,0,0,23.533333333333335,64,25,14.333333333333334,5
Category_Wikipedia_sockpuppets_of_Frankn12345.csv,146,6335770.0,55,91,53,2,0,33.678082191780824,199,40,20.26027397260274,9
Category_Wikipedia_sockpuppets_of_Enemymakes2.csv,20,2176.0,11,9,6,5,0,50.55,174,26,22.25,21
Category_Wikipedia_sockpuppets_of_Abraham_nomura.csv,356,25390052.0,118,238,74,44,0,44.22191011235955,288,60,29.286516853932586,11
Category_Wikipedia_sockpuppets_of_Qiu.Huan.csv,36,161833.0,36,0,6,30,4,10.805555555555555,19,29,26.305555555555557,11
Category_Wikipedia_sockpuppets_of_Vost.csv,1294,197341673.0,349,945,252,97,0,59.239567233384854,250,50,19.917310664605875,4
Category_Wikipedia_sockpuppets_of_Russians_Don`t_give_up.csv,76,39990342.0,35,41,17,18,0,46.3421052631579,196,73,32.223684210526315,17
Category_Wikipedia_sockpuppets_of_Joshi_punekar.csv,1984,167871666.0,799,1185,217,582,0,58.947076612903224,500,50,18.679435483870968,5
Category_Wikipedia_sockpuppets_of_JEES_Mohan.csv,98,1439794.0,54,44,44,10,0,43.60204081632653,505,31,17.846938775510203,8
Category_Wikipedia_sockpuppets_of_Rayondelune.csv,3151,3130751.0,840,2311,500,340,0,42.07807045382418,323,56,14.586480482386545,3
Category_Wikipedia_sockpuppets_of_NSWelshman.csv,2743,379093805.0,813,1930,500,313,0,45.66423623769595,252,74,16.444039372949327,3
Category_Wikipedia_sockpuppets_of_Thatperson.csv,2003,78122857.0,509,1494,500,9,0,44.66949575636545,218,55,16.754867698452323,3
Category_Wikipedia_sockpuppets_of_ErinaEffe.csv,133,1122649.0,49,84,32,17,0,38.30827067669173,246,31,19.285714285714285,11
Category_Wikipedia_sockpuppets_of_Sam.WikiKiwi.csv,2321,7881393.0,1082,1239,500,582,0,49.00043084877208,500,58,19.105127100387765,4
Category_Wikipedia_sockpuppets_of_Viu_MIT.csv,34,1984702.0,15,19,10,5,0,71.76470588235294,286,35,20.88235294117647,12
Category_Wikipedia_sockpuppets_of_Talwarman.csv,1812,118700399.0,649,1163,500,149,0,49.38134657836645,499,93,18.65066225165563,6
Category_Wikipedia_sockpuppets_of_Quince_Quincy.csv,1081,5599772.0,297,784,239,58,0,58.92784458834413,232,59,20.421831637372804,2
Category_Wikipedia_sockpuppets_of_Flor_Silvestre.csv,904,39076013.0,265,639,155,110,0,39.38053097345133,202,54,18.457964601769913,5
Category_Wikipedia_sockpuppets_of_WillStrom.csv,62,28914.0,38,24,33,5,0,33.693548387096776,94,45,23.79032258064516,14
Category_Wikipedia_sockpuppets_of_Plusnow.csv,1363,13495533.0,458,905,240,218,0,36.02641232575202,352,49,17.22083639031548,3
Category_Wikipedia_sockpuppets_of_UGAdawgs2010.csv,1515,55933149.0,403,1112,190,213,0,56.66006600660066,250,71,21.671287128712873,5
Category_Wikipedia_sockpuppets_of_Patrickstephenbrown.csv,692,6735540.0,266,426,205,61,0,63.88728323699422,292,56,24.86994219653179,6
Category_Wikipedia_sockpuppets_of_Ylevental.csv,1382,47442511.0,524,858,500,24,0,51.72214182344428,478,75,25.563675832127352,6
Category_Wikipedia_sockpuppets_of_Amenable.csv,168,7494958.0,84,84,42,42,0,30.99404761904762,191,38,25.25595238095238,12
Category_Wikipedia_sockpuppets_of_Kcfan90.csv,692,83899876.0,159,533,158,1,0,41.884393063583815,228,61,22.3757225433526,7
Category_Wikipedia_sockpuppets_of_RicegoneWILD.csv,1603,436463650.0,384,1219,382,2,0,42.838427947598255,264,77,18.704304429195258,4
Category_Wikipedia_sockpuppets_of_MarkBA.csv,378,35989804.0,146,232,62,84,0,45.24074074074074,207,69,17.83068783068783,4
Category_Wikipedia_sockpuppets_of_Sakaraomooba.csv,35,946867.0,17,18,15,2,0,71.08571428571429,255,48,30.114285714285714,23
Category_Wikipedia_sockpuppets_of_Antichristos.csv,3286,310117985.0,1338,1948,440,898,0,45.66707242848448,318,54,21.441874619598295,6
Category_Wikipedia_sockpuppets_of_Scorpion293.csv,4279,43100799.0,1683,2596,500,1183,0,42.13040430007011,622,81,20.94274363168965,3
Category_Wikipedia_sockpuppets_of_WikiWoo.csv,2285,43729326.0,1165,1120,500,665,0,42.98687089715536,241,83,25.101094091903718,6
Category_Wikipedia_sockpuppets_of_IBelieveAliensExistAndVisitMeWhenISleep.csv,377,24808916.0,128,249,104,24,0,51.54111405835544,254,52,21.46153846153846,3
Category_Wikipedia_sockpuppets_of_Chernobog95.csv,1464,173825907.0,502,962,484,18,0,51.05122950819672,255,51,25.095628415300546,5
Category_Wikipedia_sockpuppets_of_Blade-of-the-South.csv,1141,5789238.0,507,634,500,7,0,44.14373356704645,255,55,28.919368974583698,14
Category_Wikipedia_sockpuppets_of_LienChing19811.csv,95,299246.0,40,55,22,18,0,47.578947368421055,179,53,27.36842105263158,13
Category_Wikipedia_sockpuppets_of_Aaron-Brandon.csv,24,1389.0,9,15,6,3,2,84.125,213,27,16.041666666666668,5
Category_Wikipedia_sockpuppets_of_Djajay_lobo_djay_tushar.csv,173,279327734.0,60,113,37,23,0,46.971098265895954,227,64,23.589595375722542,6
Category_Wikipedia_sockpuppets_of_NeotheoneReal.csv,559,249242315.0,216,343,192,24,0,39.77817531305904,372,68,26.77638640429338,5
Category_Wikipedia_sockpuppets_of_Germanlight.csv,157,3102244.0,52,105,50,2,0,60.50955414012739,247,45,20.96815286624204,11
Category_Wikipedia_sockpuppets_of_Gauravsaral.csv,576,24013458.0,154,422,82,72,0,70.14409722222223,255,51,17.255208333333332,6
Category_Wikipedia_sockpuppets_of_Khupmang21.csv,33,13846826.0,23,10,21,2,0,22.09090909090909,229,36,11.181818181818182,2
Category_Wikipedia_sockpuppets_of_KRMDev.csv,24,3287815.0,20,4,11,9,0,4.916666666666667,18,24,23.833333333333332,23
Category_Wikipedia_sockpuppets_of_Historyindia1.csv,324,25056266.0,131,193,101,30,0,54.29012345679013,496,52,19.65432098765432,9
Category_Wikipedia_sockpuppets_of_Marianne_Johnson.csv,192,6302590.0,48,144,34,14,0,66.99479166666667,225,40,12.401041666666666,4
Category_Wikipedia_sockpuppets_of_Kartiksharma6.csv,32,3028549.0,13,19,9,4,0,51.03125,282,39,20.625,10
Category_Wikipedia_sockpuppets_of_Polylepsis.csv,14348,40630981.0,4667,9681,500,4167,0,37.97518817953722,255,80,22.094717033732923,2
Category_Wikipedia_sockpuppets_of_Hurrygane.csv,4047,159062060.0,1368,2679,500,868,0,53.4978996787744,499,104,26.896219421793923,3
Category_Wikipedia_sockpuppets_of_Morning277.csv,16891,463580912.0,5617,11274,500,5117,0,42.0926528920727,407,90,18.04061334438458,1
Category_Wikipedia_sockpuppets_of_Johnwest1999.csv,2557,284395946.0,525,2032,500,25,0,41.895580758701605,357,58,18.632381697301525,3
Category_Wikipedia_sockpuppets_of_Navarre0107.csv,1779,212949100.0,661,1118,500,161,0,52.40697020798201,500,88,26.93142214727375,3
Category_Wikipedia_sockpuppets_of_Woasclub.csv,45,729789.0,18,27,16,2,0,66.93333333333334,489,53,37.266666666666666,12
Category_Wikipedia_sockpuppets_of_Aliceguyblache.csv,30,32887583.0,19,11,11,8,0,65.96666666666667,217,48,46.06666666666667,19
Category_Wikipedia_sockpuppets_of_Harmanderr.csv,82,8223194.0,24,58,12,12,0,53.96341463414634,225,53,22.548780487804876,5
Category_Wikipedia_sockpuppets_of_Chatterjee95.csv,1330,6825627.0,559,771,500,59,0,37.41428571428571,496,84,21.366917293233083,7
Category_Wikipedia_sockpuppets_of_CUDz.csv,171,3982197.0,125,46,22,103,0,53.97076023391813,199,21,16.257309941520468,11
Category_Wikipedia_sockpuppets_of_Jonathanburkhart.csv,1,0.0,1,0,1,0,28,28.0,28,11,11.0,11
Category_Wikipedia_sockpuppets_of_MovieMayhem.csv,178,153856861.0,51,127,21,30,0,40.556179775280896,247,40,17.786516853932586,9
Category_Wikipedia_sockpuppets_of_Kung_Hibbe.csv,8442,202220467.0,2068,6374,500,1568,0,44.90997393982469,476,67,21.123193556029378,1
Category_Wikipedia_sockpuppets_of_KodigoMuch.csv,93,164101.0,50,43,45,5,0,41.473118279569896,285,23,13.978494623655914,7
Category_Wikipedia_sockpuppets_of_BumpBoBmansw.csv,17,5435232.0,5,12,4,1,0,44.470588235294116,153,29,15.529411764705882,6
Category_Wikipedia_sockpuppets_of_Lethabo_Exp.csv,91,9077925.0,30,61,19,11,0,53.967032967032964,266,43,13.461538461538462,6
Category_Wikipedia_sockpuppets_of_Resdtyeswerf.csv,420,9518717.0,139,281,21,118,0,35.98809523809524,312,31,16.233333333333334,6
Category_Wikipedia_sockpuppets_of_Asad_Ali_Palijo.8.csv,24,275097.0,6,18,5,1,0,91.29166666666667,227,22,14.0,6
Category_Wikipedia_sockpuppets_of_TJ_Spyke.csv,2723,262456317.0,631,2092,500,131,0,37.796915167095115,255,94,21.016158648549393,2
Category_Wikipedia_sockpuppets_of_Editor-Editing.csv,11,8586.0,7,4,7,0,0,12.363636363636363,26,26,26.0,26
Category_Wikipedia_sockpuppets_of_HaLIHianl.csv,126,6656539.0,44,82,31,13,0,51.214285714285715,215,39,16.61904761904762,5
Category_Wikipedia_sockpuppets_of_Aali2204.csv,32,23265.0,9,23,5,4,0,64.4375,183,29,10.84375,4
Category_Wikipedia_sockpuppets_of_UCRGrad.csv,1219,155037913.0,541,678,500,41,0,49.5980311730927,229,64,34.28712059064807,10
Category_Wikipedia_sockpuppets_of_ViamarisBalbi.csv,3086,52812826.0,1086,2000,377,709,0,46.25340246273493,255,66,19.509397278029812,4
Category_Wikipedia_sockpuppets_of_Xylon_Draganthus.csv,87,320656065.0,19,68,17,2,0,60.4367816091954,257,26,14.67816091954023,7
Category_Wikipedia_sockpuppets_of_Magichero1234.csv,2990,217336205.0,742,2248,500,242,0,54.06521739130435,494,59,14.812709030100335,4
Category_Wikipedia_sockpuppets_of_Kalbe_Sadiq_110.csv,329,43277769.0,123,206,27,96,0,44.54103343465046,286,57,21.382978723404257,10
Category_Wikipedia_sockpuppets_of_Marvello123.csv,2594,14332056.0,837,1757,390,447,0,49.2621434078643,255,103,20.477255204317657,3
Category_Wikipedia_sockpuppets_of_Cyperuspapyrus.csv,9068,73114736.0,3118,5950,500,2618,0,30.859505955006618,255,70,17.88718570798412,3
Category_Wikipedia_sockpuppets_of_Powertolife.csv,110,1580875.0,42,68,28,14,0,42.85454545454545,278,48,23.654545454545456,7
Category_Wikipedia_sockpuppets_of_Amahadevan99.csv,113,102936742.0,26,87,25,1,0,52.9646017699115,236,35,22.646017699115045,7
Category_Wikipedia_sockpuppets_of_Sherrzo.csv,5,406.0,4,1,4,0,0,82.4,199,22,14.6,11
Category_Wikipedia_sockpuppets_of_Gordimalo.csv,3625,111903036.0,1125,2500,302,823,0,50.486620689655176,499,63,26.080827586206897,4
Category_Wikipedia_sockpuppets_of_Arieina_monni.csv,253,5104036.0,113,140,75,38,0,61.18577075098814,400,34,15.051383399209486,4
Category_Wikipedia_sockpuppets_of_Akedia1.csv,1331,372507033.0,365,966,359,6,0,48.12471825694966,398,41,16.63786626596544,4
Category_Wikipedia_sockpuppets_of_Seasideplace.csv,1835,12524832.0,426,1409,47,379,0,41.13514986376022,234,71,14.70517711171662,4
Category_Wikipedia_sockpuppets_of_Kandinsky11.csv,58,87557942.0,28,30,12,16,0,35.98275862068966,203,24,13.344827586206897,6
Category_Wikipedia_sockpuppets_of_Givemedonuts.csv,15708,17286003.0,5351,10357,500,4851,0,49.735230455818694,467,102,16.802075375604787,3
Category_Wikipedia_sockpuppets_of_Echavando.csv,1406,141787207.0,698,708,367,331,0,65.7275960170697,253,54,16.788762446657184,7
Category_Wikipedia_sockpuppets_of_Allendrew.csv,432,19101950.0,177,255,63,114,0,48.94675925925926,373,45,17.21064814814815,4
Category_Wikipedia_sockpuppets_of_Critical_Reader.csv,1312,74672945.0,513,799,428,85,0,46.31631097560975,218,52,23.810213414634145,5
Category_Wikipedia_sockpuppets_of_Banjokazooing.csv,4,160.0,3,1,3,0,0,34.25,117,26,26.0,26
Category_Wikipedia_sockpuppets_of_Sulthan_ameer.csv,1791,108880474.0,610,1181,231,379,0,41.71189279731993,255,51,17.174762702400894,5
Category_Wikipedia_sockpuppets_of_Angel_Williamz_Owakabi.csv,3,4613.0,2,1,2,0,11,13.666666666666666,19,24,24.0,24
Category_Wikipedia_sockpuppets_of_Soupenstein.csv,22,87848.0,16,6,9,7,0,35.5,151,24,16.5,15
Category_Wikipedia_sockpuppets_of_Tgabarro.csv,35,1518880.0,15,20,15,0,0,28.857142857142858,140,21,15.285714285714286,9
Category_Wikipedia_sockpuppets_of_TheDarkPyrano.csv,1336,61267835.0,420,916,375,45,0,35.19011976047904,254,57,21.69610778443114,5
Category_Wikipedia_sockpuppets_of_Cambios.csv,510,283524917.0,149,361,143,6,0,45.707843137254905,234,51,22.715686274509803,7
Category_Wikipedia_sockpuppets_of_Shraddhaaa1702.csv,1,0.0,1,0,1,0,0,0.0,0,53,53.0,53
Category_Wikipedia_sockpuppets_of_Superhonestreliablesource.csv,123,5275286.0,45,78,17,28,0,72.71544715447155,443,35,19.910569105691057,4
Category_Wikipedia_sockpuppets_of_Aschlafl.csv,865,8582917.0,236,629,39,197,0,58.18728323699422,255,50,18.409248554913294,3
Category_Wikipedia_sockpuppets_of_FixtheBorder.csv,506,1735899.0,209,297,150,59,0,41.784584980237156,203,53,19.64624505928854,9
Category_Wikipedia_sockpuppets_of_Muhammed_Zafwan.csv,4,3007724.0,3,1,2,1,0,55.5,194,29,20.0,11
Category_Wikipedia_sockpuppets_of_Meister_und_Margarita.csv,844,93862440.0,520,324,500,20,0,34.920616113744074,310,70,38.1042654028436,9
Category_Wikipedia_sockpuppets_of_Wikibreaking.csv,1754,123144463.0,807,947,500,307,0,60.11174458380844,429,59,15.029076396807298,3
Category_Wikipedia_sockpuppets_of_Nrcprm2026.csv,27563,450611590.0,8921,18642,500,8421,0,53.23302978630773,500,106,22.185066937561224,2
Category_Wikipedia_sockpuppets_of_BurritoSlayer.csv,7423,102036588.0,2202,5221,465,1737,0,48.275899232116394,261,86,17.549104135794153,3
Category_Wikipedia_sockpuppets_of_Anlie8.csv,16,31236.0,6,10,5,1,0,38.5625,199,45,26.5,16
Category_Wikipedia_sockpuppets_of_Zel00005.csv,82,613047.0,51,31,31,20,0,34.98780487804878,215,29,20.402439024390244,16
Category_Wikipedia_sockpuppets_of_Stemwinders.csv,335,192133277.0,67,268,57,10,0,69.03283582089553,296,41,15.892537313432836,6
Category_Wikipedia_sockpuppets_of_Brusier420.csv,80,9089138.0,46,34,22,24,0,70.475,209,27,27.0,27
Category_Wikipedia_sockpuppets_of_Owen_Lampret.csv,12,1044644.0,5,7,3,2,13,25.75,49,44,22.0,12
Category_Wikipedia_sockpuppets_of_Dr.d.prabu.csv,65,15820974.0,28,37,13,15,0,43.12307692307692,195,34,15.553846153846154,6
Category_Wikipedia_sockpuppets_of_Cybornetics.csv,187,59143237.0,61,126,33,28,0,46.49197860962567,225,49,25.037433155080215,12
Category_Wikipedia_sockpuppets_of_Bluhaze777.csv,1597,18445334.0,500,1097,500,0,0,47.45648090169067,264,53,17.56042579837195,4
Category_Wikipedia_sockpuppets_of_Speaktruth29.csv,136,11745983.0,49,87,27,22,0,61.0,256,31,16.191176470588236,9
Category_Wikipedia_sockpuppets_of_Shirleyraghu.csv,60,45516559.0,27,33,16,11,0,62.733333333333334,206,46,26.716666666666665,14
Category_Wikipedia_sockpuppets_of_Chaulin_humberto_tuteto.csv,1398,49130906.0,411,987,379,32,0,42.48426323319027,255,55,26.401287553648068,3
Category_Wikipedia_sockpuppets_of_RAJNEESHKSAXENA.csv,21,12074674.0,14,7,4,10,0,66.95238095238095,162,27,15.857142857142858,11
Category_Wikipedia_sockpuppets_of_Taddeus45.csv,108,19930212.0,53,55,38,15,0,53.351851851851855,214,57,18.203703703703702,8
Category_Wikipedia_sockpuppets_of_CreativeNerd.csv,46,286079.0,14,32,9,5,0,54.93478260869565,196,22,18.217391304347824,14
Category_Wikipedia_sockpuppets_of_Favoredkitty.csv,133,82925171.0,57,76,20,37,0,40.4812030075188,196,42,23.06766917293233,13
Category_Wikipedia_sockpuppets_of_Dajudem.csv,2986,185819047.0,1116,1870,500,616,0,43.39082384460817,224,112,28.690890823844608,3
Category_Wikipedia_sockpuppets_of_Shutterbug.csv,2530,101078607.0,679,1851,500,179,0,54.628063241106716,246,60,19.98181818181818,3
Category_Wikipedia_sockpuppets_of_Ridryman.csv,1946,12122570.0,638,1308,500,138,0,33.70811921891059,255,51,17.210688591983555,3
Category_Wikipedia_sockpuppets_of_LowKeyFame.csv,90,22397257.0,18,72,14,4,0,58.8,255,46,17.377777777777776,4
Category_Wikipedia_sockpuppets_of_TechnicalEngineerA3.csv,635,890390.0,205,430,111,94,0,44.746456692913384,250,54,23.941732283464567,4
Category_Wikipedia_sockpuppets_of_Ryuken123.csv,160,2246414.0,115,45,82,33,0,38.325,205,33,18.95,5
Category_Wikipedia_sockpuppets_of_QarryMotter.csv,94,6589434.0,26,68,20,6,0,70.97872340425532,311,72,25.93617021276596,3
Category_Wikipedia_sockpuppets_of_Pleasuresofleng.csv,1370,13056057.0,690,680,500,190,0,52.567153284671534,361,38,9.258394160583942,5
Category_Wikipedia_sockpuppets_of_QLA1412.csv,45,112498.0,15,30,6,9,0,80.02222222222223,302,13,7.555555555555555,5
Category_Wikipedia_sockpuppets_of_13sj05.csv,5,127.0,2,3,2,0,0,43.6,178,19,16.6,15
Category_Wikipedia_sockpuppets_of_John_choudhary.csv,1486,7334965.0,511,975,500,11,0,33.082099596231494,253,34,14.527590847913864,3
Category_Wikipedia_sockpuppets_of_Thenaeemkhan32.csv,24,4839002.0,7,17,4,3,0,18.083333333333332,89,41,36.958333333333336,20
Category_Wikipedia_sockpuppets_of_Toprace2345.csv,21,1572473.0,13,8,10,3,0,14.142857142857142,69,52,20.38095238095238,9
Category_Wikipedia_sockpuppets_of_Nishitgrylls.csv,22,22817946.0,10,12,8,2,0,37.63636363636363,195,35,15.818181818181818,7
Category_Wikipedia_sockpuppets_of_AOCJedi.csv,1308,8504056.0,403,905,389,14,0,39.030581039755354,250,69,20.798165137614678,3
Category_Wikipedia_sockpuppets_of_Dilraj_Singh_hada_12.csv,78,394892.0,34,44,20,14,0,52.37179487179487,229,42,18.73076923076923,6
Category_Wikipedia_sockpuppets_of_Rbarlow1.csv,10,270572.0,9,1,5,4,0,33.8,140,26,14.3,13
Category_Wikipedia_sockpuppets_of_IndependentInformer.csv,59,585875.0,25,34,17,8,0,56.13559322033898,361,48,23.389830508474578,12
Category_Wikipedia_sockpuppets_of_Nationmaster.csv,66,30144269.0,20,46,11,9,0,37.24242424242424,184,51,32.54545454545455,20
Category_Wikipedia_sockpuppets_of_Bruno_P._Dori.csv,4543,49329998.0,1258,3285,500,758,0,33.14505833149901,243,56,17.087167070217916,4
Category_Wikipedia_sockpuppets_of_Agustin_Sepulveda_Venegas_2004_Fan.csv,8418,262052705.0,2548,5870,500,2048,0,47.269303872653836,500,83,19.993228795438345,1
Category_Wikipedia_sockpuppets_of_Molana_Ijaz.csv,140,15675087.0,42,98,19,23,0,70.3,374,54,22.05,4
Category_Wikipedia_sockpuppets_of_Samar_Layoun.csv,251,7321867.0,82,169,36,46,0,40.430278884462155,196,51,14.55378486055777,5
Category_Wikipedia_sockpuppets_of_Andrecanada.csv,156,5573939.0,60,96,40,20,0,52.88461538461539,260,51,25.92948717948718,4
Category_Wikipedia_sockpuppets_of_Pouter.csv,189,5412479.0,69,120,27,42,0,45.74074074074074,255,47,26.64021164021164,9
Category_Wikipedia_sockpuppets_of_Gameboy1947.csv,1478,10598606.0,501,977,483,18,0,37.802435723951284,253,66,30.382273342354534,5
Category_Wikipedia_sockpuppets_of_Samuel_Luo.csv,4084,49318801.0,1823,2261,500,1323,0,48.986532810969635,236,59,21.81709108716944,8
Category_Wikipedia_sockpuppets_of_Martinvito.csv,2070,59989697.0,1027,1043,500,527,0,36.74541062801932,416,57,34.265700483091784,2
Category_Wikipedia_sockpuppets_of_Woodstock2010.csv,518,5702714.0,160,358,54,106,0,39.996138996138995,200,38,15.81081081081081,6
Category_Wikipedia_sockpuppets_of_Smatprt.csv,2226,142643091.0,693,1533,500,193,0,65.00943396226415,255,67,30.643755615453728,6
Category_Wikipedia_sockpuppets_of_Learntruck.csv,114,326177.0,35,79,35,0,0,51.05263157894737,250,54,22.763157894736842,3
Category_Wikipedia_sockpuppets_of_Expewikiwriter.csv,994,29696613.0,363,631,351,12,0,41.00804828973843,262,58,23.095573440643864,3
Category_Wikipedia_sockpuppets_of_California_South_University.csv,17,23727.0,11,6,4,7,0,51.588235294117645,179,37,25.529411764705884,14
Category_Wikipedia_sockpuppets_of_Umbrella_yellow.csv,32,2266944.0,9,23,2,7,0,51.96875,161,65,17.28125,5
Category_Wikipedia_sockpuppets_of_Km14.csv,189,21757461.0,58,131,26,32,0,37.17460317460318,244,42,15.010582010582011,5
Category_Wikipedia_sockpuppets_of_Azazaqq.csv,66,14009552.0,19,47,18,1,0,53.09090909090909,141,50,24.772727272727273,5
Category_Wikipedia_sockpuppets_of_Elmakkan.csv,345,74648683.0,102,243,74,28,0,48.23768115942029,248,62,17.765217391304347,1
Category_Wikipedia_sockpuppets_of_BubblySnowflake.csv,1414,33023229.0,475,939,442,33,0,40.25247524752475,274,72,17.49009900990099,5
Category_Wikipedia_sockpuppets_of_ChronicleBooks885.csv,1557,17996137.0,455,1102,115,340,0,59.93898522800257,496,58,18.54335260115607,2
Category_Wikipedia_sockpuppets_of_Dab2.csv,2242,255440782.0,628,1614,500,128,0,56.54148082069581,253,58,18.566012488849243,3
Category_Wikipedia_sockpuppets_of_Famioeu.csv,37,3381763.0,13,24,10,3,0,25.37837837837838,125,30,22.756756756756758,12
Category_Wikipedia_sockpuppets_of_Itaylo8629.csv,18,2433942.0,5,13,4,1,0,96.61111111111111,225,14,13.333333333333334,12
Category_Wikipedia_sockpuppets_of_Alkclark.csv,2123,24315640.0,633,1490,500,133,0,39.64437117286858,259,62,21.08243052284503,5
Category_Wikipedia_sockpuppets_of_Sspsspsspssp.csv,165,9666952.0,106,59,47,59,0,35.50909090909091,251,26,11.242424242424242,10
Category_Wikipedia_sockpuppets_of_Guitaristani.csv,19,449805.0,10,9,4,6,0,51.0,178,11,9.421052631578947,7
Category_Wikipedia_sockpuppets_of_GRLI_Foundation.csv,4,25625.0,3,1,3,0,0,9.75,39,17,17.0,17
Category_Wikipedia_sockpuppets_of_Javito1993.csv,4377,28429909.0,1963,2414,500,1463,0,34.70916152615947,500,78,35.81242860406671,5
Category_Wikipedia_sockpuppets_of_Pappu_pr25.csv,53,7342039.0,27,26,15,12,0,61.132075471698116,254,24,12.075471698113208,8
Category_Wikipedia_sockpuppets_of_Chucknorisboy22.csv,10,779.0,6,4,3,3,0,56.4,243,10,10.0,10
Category_Wikipedia_sockpuppets_of_EnthusiastFRANCE.csv,3438,6685544.0,1514,1924,500,1014,0,24.86852821407795,249,73,17.90692262943572,4
Category_Wikipedia_sockpuppets_of_Juror134.csv,618,13518365.0,239,379,126,113,0,56.85275080906149,496,63,18.948220064724918,5
Category_Wikipedia_sockpuppets_of_Dicklyon.csv,2766,288182267.0,767,1999,500,267,0,49.995661605206074,438,72,23.625090383224872,3
Category_Wikipedia_sockpuppets_of_Luigi-2016.csv,232,14865896.0,104,128,64,40,0,47.202586206896555,237,46,19.413793103448278,9
Category_Wikipedia_sockpuppets_of_Brownie005.csv,3,641.0,2,1,1,1,47,101.33333333333333,138,31,31.0,31
Category_Wikipedia_sockpuppets_of_Reema_Welling.csv,156,47114168.0,71,85,56,15,0,38.166666666666664,196,30,19.51923076923077,8
Category_Wikipedia_sockpuppets_of_Docomic123.csv,87,9417680.0,56,31,46,10,0,54.96551724137931,238,22,13.183908045977011,4
Category_Wikipedia_sockpuppets_of_Starship9000.csv,1791,105678837.0,648,1143,500,148,0,44.70519262981575,255,71,23.179787828029035,4
Category_Wikipedia_sockpuppets_of_Smick750.csv,2440,135224111.0,576,1864,463,113,0,34.08975409836066,250,80,17.42172131147541,4
Category_Wikipedia_sockpuppets_of_K.mancheva.csv,5,2393440.0,4,1,3,1,15,105.2,196,23,19.8,16
Category_Wikipedia_sockpuppets_of_Everton61.csv,163,233492777.0,70,93,48,22,0,48.83435582822086,228,68,15.14723926380368,9
Category_Wikipedia_sockpuppets_of_Obiwana.csv,2702,30278819.0,848,1854,229,619,0,59.11287934863064,500,69,19.22501850481125,1
"Category_Wikipedia_sockpuppets_of_HTML5,_CSS3!.csv",1178,25907725.0,562,616,500,62,0,40.398132427843805,496,63,21.97113752122241,5
Category_Wikipedia_sockpuppets_of_Tiger_Eye_27.csv,784,26794830.0,321,463,201,120,0,29.914540816326532,256,40,15.73469387755102,7
Category_Wikipedia_sockpuppets_of_Alaminoid.csv,165,8237783.0,51,114,21,30,0,40.981818181818184,395,26,14.854545454545455,7
Category_Wikipedia_sockpuppets_of_Shameel_Done.csv,625,90632429.0,239,386,32,207,0,44.2528,386,44,17.352,7
Category_Wikipedia_sockpuppets_of_Hemantwps.csv,63,3016950.0,18,45,15,3,0,67.58730158730158,255,43,23.158730158730158,7
Category_Wikipedia_sockpuppets_of_Empire_AS.csv,1809,29227131.0,631,1178,500,131,0,50.606412382531786,341,77,20.851299060254284,4
Category_Wikipedia_sockpuppets_of_John21rope.csv,76,4561904.0,27,49,24,3,0,30.86842105263158,83,53,33.30263157894737,15
Category_Wikipedia_sockpuppets_of_Darkstriker152.csv,13,611729.0,6,7,4,2,0,75.46153846153847,196,50,26.76923076923077,22
Category_Wikipedia_sockpuppets_of_Eighteen_Commandments.csv,53,2130.0,28,25,16,12,0,93.16981132075472,258,34,23.0188679245283,8
Category_Wikipedia_sockpuppets_of_Dosmil2011.csv,1338,128244719.0,498,840,495,3,0,34.67563527653214,255,69,18.2847533632287,4
Category_Wikipedia_sockpuppets_of_Ajeya_Raj_Sumargi.csv,7,2682728.0,5,2,5,0,0,31.857142857142858,195,30,30.0,30
Category_Wikipedia_sockpuppets_of_Medporn.csv,312,138416436.0,116,196,13,103,0,74.53205128205128,500,34,17.137820512820515,5
Category_Wikipedia_sockpuppets_of_Pooq.in.csv,74,3791321.0,25,49,11,14,0,33.648648648648646,376,26,15.864864864864865,6
Category_Wikipedia_sockpuppets_of_DeltaSquad833.csv,1590,4633290.0,608,982,500,108,0,55.801886792452834,496,53,24.09496855345912,5
Category_Wikipedia_sockpuppets_of_Castawayred.csv,85,1158118.0,24,61,16,8,0,42.694117647058825,200,46,30.36470588235294,5
Category_Wikipedia_sockpuppets_of_Vivsparx.csv,854,68155748.0,224,630,217,7,0,47.22950819672131,255,57,18.014051522248245,3
Category_Wikipedia_sockpuppets_of_Caresgenius.csv,743,23142863.0,238,505,41,197,0,44.82099596231494,496,54,19.380888290713326,5
Category_Wikipedia_sockpuppets_of_Zimentrepreneurs.csv,4,33467543.0,3,1,3,0,0,30.25,108,35,28.25,26
Category_Wikipedia_sockpuppets_of_Cramyourspam.csv,2300,119749186.0,500,1800,500,0,0,59.036521739130436,494,65,16.848695652173912,3
Category_Wikipedia_sockpuppets_of_Holdenmcrutch.csv,39,3788903.0,13,26,10,3,0,57.76923076923077,166,30,10.717948717948717,3
Category_Wikipedia_sockpuppets_of_Eddy23.csv,2511,405810377.0,668,1843,500,168,0,44.2847471127041,338,78,20.673436877737952,3
Category_Wikipedia_sockpuppets_of_Deucalionite.csv,6659,454584748.0,1985,4674,500,1485,0,56.7655804174801,443,83,17.489112479351252,4
Category_Wikipedia_sockpuppets_of_A3789.csv,106,132368905.0,48,58,32,16,0,34.056603773584904,255,13,13.0,13
Category_Wikipedia_sockpuppets_of_L.L.King.csv,800,12699186.0,310,490,57,253,0,41.88125,220,43,18.8825,9
Category_Wikipedia_sockpuppets_of_SonofaYaathz.csv,13,99550.0,10,3,6,4,0,55.61538461538461,151,29,24.153846153846153,22
Category_Wikipedia_sockpuppets_of_559a283.csv,7,287.0,5,2,5,0,0,20.142857142857142,58,22,17.571428571428573,9
Category_Wikipedia_sockpuppets_of_Fahimburney.csv,6,152474.0,5,1,3,2,0,54.333333333333336,196,24,24.0,24
Category_Wikipedia_sockpuppets_of_Keenanthedogg.csv,574,37495993.0,197,377,187,10,0,34.7595818815331,255,41,16.693379790940767,4
Category_Wikipedia_sockpuppets_of_Soft_skin.csv,995,117945789.0,245,750,47,198,0,54.8,255,56,32.663316582914575,4
Category_Wikipedia_sockpuppets_of_Berry_Hut.csv,21,11636662.0,6,15,3,3,0,43.42857142857143,203,31,18.523809523809526,12
Category_Wikipedia_sockpuppets_of_Ahsan007.csv,21,44264.0,18,3,13,5,0,35.857142857142854,169,16,14.80952380952381,6
Category_Wikipedia_sockpuppets_of_Kaustritten.csv,316,28311499.0,92,224,85,7,0,61.063291139240505,282,50,15.949367088607595,6
Category_Wikipedia_sockpuppets_of_Freshboy2216.csv,604,149346016.0,194,410,180,14,0,40.14900662251656,500,33,14.594370860927153,4
Category_Wikipedia_sockpuppets_of_Mikeyadams.csv,5,3629661.0,3,2,3,0,0,31.6,103,25,21.8,21
Category_Wikipedia_sockpuppets_of_Protect_the_children.csv,2,0.0,1,1,1,0,0,0.0,0,17,17.0,17
Category_Wikipedia_sockpuppets_of_Curvesall.csv,979,16359849.0,357,622,131,226,0,46.706843718079675,230,69,19.44943820224719,2
Category_Wikipedia_sockpuppets_of_Harronn.csv,45,1049978.0,21,24,9,12,0,63.82222222222222,205,28,19.88888888888889,12
Category_Wikipedia_sockpuppets_of_TV5Ozamiz.csv,573,36715626.0,197,376,76,121,0,34.390924956369986,234,58,21.8673647469459,4
Category_Wikipedia_sockpuppets_of_SneakySoyMeat.csv,3741,551379489.0,759,2982,359,400,0,52.31863138198343,367,67,16.655172413793103,3
Category_Wikipedia_sockpuppets_of_Legaiaflame.csv,2889,11674512.0,1060,1829,500,560,0,46.05538248528903,493,78,16.315680166147455,3
Category_Wikipedia_sockpuppets_of_RebelHeart23.csv,31,1993070.0,12,19,9,3,0,41.38709677419355,196,24,15.709677419354838,11
Category_Wikipedia_sockpuppets_of_Edia4545m.csv,63,726568.0,25,38,15,10,0,60.523809523809526,219,47,22.428571428571427,6
Category_Wikipedia_sockpuppets_of_Truworthy.csv,191,14066851.0,88,103,64,24,0,47.79057591623037,434,53,27.67539267015707,13
Category_Wikipedia_sockpuppets_of_Tamsier.csv,1404,407173131.0,517,887,500,17,0,52.5519943019943,500,75,22.745726495726494,4
Category_Wikipedia_sockpuppets_of_Bito4u.csv,80,4617711.0,56,24,41,15,0,41.2875,217,20,14.525,14
Category_Wikipedia_sockpuppets_of_Virbhadrayumnam.csv,126,300881156.0,41,85,40,1,0,44.03174603174603,244,47,14.468253968253968,9
Category_Wikipedia_sockpuppets_of_WILIPEDIA_EDIT.csv,13,50460.0,9,4,4,5,0,28.307692307692307,192,18,16.46153846153846,16
Category_Wikipedia_sockpuppets_of_Tb.123.csv,236,5523933.0,100,136,15,85,0,34.95762711864407,234,88,23.68220338983051,7
Category_Wikipedia_sockpuppets_of_SEFPRODUCTIONS.csv,522,103656403.0,188,334,43,145,0,51.342911877394634,255,58,21.90038314176245,6
Category_Wikipedia_sockpuppets_of_PartyJoe.csv,677,10033850.0,227,450,126,101,0,48.95273264401772,250,47,21.590841949778433,7
Category_Wikipedia_sockpuppets_of_TotalTruthTeller24.csv,38606,243399836.0,11380,27226,500,10880,0,42.80777599336891,521,94,20.128969590219135,2
Category_Wikipedia_sockpuppets_of_Jeneral28.csv,6773,264017372.0,2015,4758,500,1515,0,43.88675623800384,265,73,23.773955411191494,3
Category_Wikipedia_sockpuppets_of_Peace_Selector.csv,3,30.0,2,1,2,0,46,46.666666666666664,47,28,24.666666666666668,23
Category_Wikipedia_sockpuppets_of_Mulholandrive777.csv,5,1219.0,4,1,4,0,0,32.4,162,25,25.0,25
Category_Wikipedia_sockpuppets_of_4Babylon.csv,66,95577963.0,31,35,16,15,0,52.696969696969695,219,24,18.818181818181817,12
Category_Wikipedia_sockpuppets_of_User201212.csv,67,1129216.0,30,37,16,14,0,30.26865671641791,196,56,21.611940298507463,17
Category_Wikipedia_sockpuppets_of_Ras-By-ras.csv,140,123901124.0,89,51,48,41,0,37.07857142857143,236,30,16.22142857142857,6
Category_Wikipedia_sockpuppets_of_Benjohnofbom.csv,457,6478680.0,141,316,103,38,0,51.53391684901532,255,45,19.673960612691467,4
Category_Wikipedia_sockpuppets_of_Young_hoonss.csv,172,5042997.0,67,105,25,42,0,57.56976744186046,254,39,16.976744186046513,6
Category_Wikipedia_sockpuppets_of_Creator_of_all_cats.csv,2,0.0,1,1,1,0,0,0.0,0,13,13.0,13
Category_Wikipedia_sockpuppets_of_Sangbabaji.csv,18,255122.0,17,1,14,3,30,125.83333333333333,177,23,18.055555555555557,15
Category_Wikipedia_sockpuppets_of_Cm1804.csv,24,5825.0,12,12,11,1,0,54.041666666666664,191,45,25.083333333333332,13
Category_Wikipedia_sockpuppets_of_Ahmaddler.csv,17,306588.0,9,8,2,7,18,72.70588235294117,196,25,19.235294117647058,12
Category_Wikipedia_sockpuppets_of_Farshidvard.csv,596,40823850.0,169,427,147,22,0,48.68624161073826,254,52,14.919463087248323,4
Category_Wikipedia_sockpuppets_of_Aryankhodakarami.csv,514,57582437.0,169,345,33,136,0,55.23929961089494,500,60,20.912451361867703,5
Category_Wikipedia_sockpuppets_of_Sadiq_Khan.M.csv,814,20454173.0,395,419,391,4,0,24.898034398034397,259,37,16.625307125307124,6
Category_Wikipedia_sockpuppets_of_Honeyak.csv,1,0.0,1,0,1,0,30,30.0,30,17,17.0,17
Category_Wikipedia_sockpuppets_of_Africamr.csv,465,257898493.0,93,372,93,0,0,43.01720430107527,252,34,11.748387096774193,5
Category_Wikipedia_sockpuppets_of_ABCForKidsLover234.csv,276,14569250.0,100,176,68,32,0,81.82246376811594,268,56,23.51086956521739,13
Category_Wikipedia_sockpuppets_of_Pacc888.csv,22,141358056.0,7,15,5,2,0,45.22727272727273,201,20,13.818181818181818,13
Category_Wikipedia_sockpuppets_of_Jimmysonoma.csv,2199,367251345.0,640,1559,500,140,0,45.60891314233743,254,81,22.353797180536606,3
Category_Wikipedia_sockpuppets_of_Gazifikator.csv,1995,18600218.0,641,1354,500,141,0,45.52781954887218,250,66,22.88020050125313,5
Category_Wikipedia_sockpuppets_of_Daniellecelestebrown.csv,86,81628422.0,23,63,20,3,0,39.627906976744185,308,41,31.27906976744186,18
Category_Wikipedia_sockpuppets_of_Otis1017.csv,137,49930963.0,53,84,49,4,0,60.81021897810219,231,31,13.737226277372264,11
Category_Wikipedia_sockpuppets_of_Axmann8.csv,1381,45888280.0,503,878,500,3,0,44.06951484431571,250,76,23.71542360608255,5
Category_Wikipedia_sockpuppets_of_Thewolfstar.csv,5133,18712632.0,1813,3320,500,1313,0,31.903175530878627,200,85,19.678940190921487,4
Category_Wikipedia_sockpuppets_of_Humphreys_eli.csv,15,333947.0,8,7,7,1,3,40.0,108,59,38.86666666666667,20
Category_Wikipedia_sockpuppets_of_Kushalawatarsing.csv,184,26543709.0,75,109,35,40,0,59.04891304347826,250,36,17.380434782608695,5
Category_Wikipedia_sockpuppets_of_Socoolgp.csv,255,28449318.0,97,158,83,14,0,35.02745098039216,496,61,27.698039215686276,11
Category_Wikipedia_sockpuppets_of_BalboaTheatre.csv,5,9951.0,3,2,3,0,0,51.0,145,23,21.6,18
Category_Wikipedia_sockpuppets_of_OLoera.csv,89,2612169.0,77,12,69,8,0,18.01123595505618,161,16,10.202247191011235,10
Category_Wikipedia_sockpuppets_of_Huppafa.csv,33,2778376.0,7,26,3,4,0,70.03030303030303,165,19,6.545454545454546,4
Category_Wikipedia_sockpuppets_of_Eddiej15.csv,1,0.0,1,0,1,0,23,23.0,23,19,19.0,19
Category_Wikipedia_sockpuppets_of_Ventura488.csv,498,163323071.0,150,348,147,3,0,41.234939759036145,233,54,15.090361445783133,5
Category_Wikipedia_sockpuppets_of_Georgeko.csv,948,511560505.0,392,556,389,3,0,46.24789029535865,373,53,18.16561181434599,9
Category_Wikipedia_sockpuppets_of_Eightcirclestheorem.csv,1137,23056992.0,538,599,477,61,0,36.682497801231314,255,66,30.58311345646438,12
Category_Wikipedia_sockpuppets_of_Lobstobar.csv,948,2777498.0,282,666,132,150,0,40.81012658227848,290,48,23.477848101265824,4
Category_Wikipedia_sockpuppets_of_Siddsg.csv,1832,19702476.0,557,1275,500,57,0,57.86572052401747,499,58,18.12991266375546,4
Category_Wikipedia_sockpuppets_of_PRProgRock.csv,2223,14541723.0,657,1566,500,157,0,48.29194781826361,261,75,17.786324786324787,3
Category_Wikipedia_sockpuppets_of_Partha_frnd.csv,24,108674.0,11,13,11,0,0,58.791666666666664,167,22,19.291666666666668,15
Category_Wikipedia_sockpuppets_of_Wahwahpedal.csv,7490,159040073.0,2589,4901,500,2089,0,41.42456608811749,264,92,22.09906542056075,3
Category_Wikipedia_sockpuppets_of_DanielLee555.csv,153,1237168.0,45,108,24,21,0,58.02614379084967,226,45,21.026143790849673,5
Category_Wikipedia_sockpuppets_of_Cs12operator.csv,198,5069721.0,59,139,20,39,0,65.08585858585859,232,31,12.803030303030303,6
Category_Wikipedia_sockpuppets_of_Ebcidic.csv,207,5073777.0,107,100,68,39,0,45.072463768115945,247,61,22.565217391304348,12
Category_Wikipedia_sockpuppets_of_TD44444444.csv,5,170966.0,5,0,4,1,0,0.0,0,16,16.0,16
Category_Wikipedia_sockpuppets_of_Isupportkimilsung.csv,789,49237357.0,213,576,29,184,0,47.41571609632446,324,47,26.803548795944234,4
Category_Wikipedia_sockpuppets_of_Euexperttime.csv,2441,82235808.0,923,1518,500,423,0,44.009832036050796,479,87,22.941827120032773,5
Category_Wikipedia_sockpuppets_of_21hbcm4zvk3iqxqaacuzhgd5i.csv,83,113282.0,28,55,21,7,0,74.0,291,36,20.879518072289155,7
Category_Wikipedia_sockpuppets_of_Jagdeep_singh_bittu.csv,6383,111926224.0,2022,4361,177,1845,0,41.00924330252232,500,60,14.106689644367853,5
Category_Wikipedia_sockpuppets_of_EH_EleVids_Productions.csv,1,0.0,1,0,1,0,85,85.0,85,12,12.0,12
Category_Wikipedia_sockpuppets_of_Ehpitcher.csv,58,93402372.0,16,42,8,8,0,45.63793103448276,175,21,15.551724137931034,13
Category_Wikipedia_sockpuppets_of_Crocodile_Dundee.csv,6,231.0,3,3,3,0,0,42.333333333333336,146,18,18.0,18
Category_Wikipedia_sockpuppets_of_Woerayraiyan7.csv,974,14375547.0,377,597,363,14,0,28.775154004106778,255,40,16.745379876796715,4
Category_Wikipedia_sockpuppets_of_John_Jeffery_Robinson.csv,62,29343355.0,13,49,9,4,0,43.016129032258064,186,65,17.032258064516128,5
Category_Wikipedia_sockpuppets_of_Zahidul_Is_Chowdhury.csv,665,253360003.0,255,410,250,5,0,38.08872180451128,272,48,20.66015037593985,8
Category_Wikipedia_sockpuppets_of_Thantsil.csv,115,18160784.0,56,59,56,0,0,35.97391304347826,220,27,16.191304347826087,7
Category_Wikipedia_sockpuppets_of_Bob_the_constructor.csv,7,371.0,4,3,4,0,11,50.857142857142854,149,19,19.0,19
Category_Wikipedia_sockpuppets_of_TruthorDuty.csv,7,3165.0,5,2,3,2,0,40.0,162,32,21.714285714285715,15
Category_Wikipedia_sockpuppets_of_Tag6u0.csv,39,5395.0,20,19,7,13,0,72.17948717948718,232,31,23.871794871794872,14
Category_Wikipedia_sockpuppets_of_Nick.mon.csv,1536,353979430.0,511,1025,500,11,0,44.210286458333336,496,58,23.985677083333332,5
Category_Wikipedia_sockpuppets_of_Mono_obono.csv,50,26502581.0,12,38,6,6,0,66.54,252,24,11.1,6
Category_Wikipedia_sockpuppets_of_NewsagentEU.csv,146,28321388.0,90,56,89,1,0,34.67123287671233,517,53,19.534246575342465,11
Category_Wikipedia_sockpuppets_of_Shoot_for_the_Stars.csv,1676,91682852.0,564,1112,500,64,0,51.630071599045344,515,52,18.897971360381863,5
Category_Wikipedia_sockpuppets_of_White_Tyson.csv,105,1537866.0,58,47,58,0,0,36.87619047619047,213,25,14.038095238095238,10
Category_Wikipedia_sockpuppets_of_Tianwei124.csv,26,954002.0,14,12,7,7,0,35.92307692307692,116,49,38.65384615384615,20
Category_Wikipedia_sockpuppets_of_Ka12345678.csv,33,3483770.0,9,24,5,4,0,59.57575757575758,219,35,15.515151515151516,9
Category_Wikipedia_sockpuppets_of_Tnd900.csv,771,92608798.0,304,467,289,15,0,33.56031128404669,255,57,17.68093385214008,8
Category_Wikipedia_sockpuppets_of_CelciusHasNoTalent.csv,17,442913.0,12,5,8,4,0,35.470588235294116,215,12,7.882352941176471,5
Category_Wikipedia_sockpuppets_of_MRandhwana.csv,26,1378766.0,11,15,5,6,0,39.30769230769231,208,58,22.346153846153847,8
Category_Wikipedia_sockpuppets_of_Stho002.csv,2724,290840988.0,1031,1693,500,531,0,50.26908957415565,314,52,15.604992657856094,4
Category_Wikipedia_sockpuppets_of_Farooqahmadbhat.csv,1764,59794254.0,622,1142,500,122,0,55.09126984126984,376,92,23.335600907029477,4
Category_Wikipedia_sockpuppets_of_Rws_killer.csv,1275,29047309.0,501,774,441,60,0,35.39686274509804,220,60,22.431372549019606,5
Category_Wikipedia_sockpuppets_of_USAismisunderstood.csv,79,540946.0,40,39,18,22,0,62.392405063291136,255,25,18.50632911392405,10
Category_Wikipedia_sockpuppets_of_Cheenarman.csv,958,37237871.0,213,745,117,96,0,47.01356993736952,454,57,14.789144050104385,5
Category_Wikipedia_sockpuppets_of_Arglebargle79.csv,2632,62578624.0,1000,1632,500,500,0,50.28913373860183,472,96,42.5790273556231,6
Category_Wikipedia_sockpuppets_of_Pitcroft.csv,845,206492197.0,225,620,181,44,0,51.29822485207101,255,47,19.881656804733726,3
Category_Wikipedia_sockpuppets_of_AndrewCrebar.csv,105,97680165.0,21,84,12,9,0,54.838095238095235,224,31,15.495238095238095,10
Category_Wikipedia_sockpuppets_of_Creepy_Crawler.csv,8795,47033359.0,1934,6861,500,1434,0,28.60386583285958,255,63,16.148266060261513,4
Category_Wikipedia_sockpuppets_of_Luuuuuka.csv,270,10566324.0,122,148,34,88,0,37.0,214,49,18.64074074074074,5
Category_Wikipedia_sockpuppets_of_Simple_Lang_Ako.csv,1020,8160933.0,256,764,92,164,0,43.24901960784314,500,54,14.057843137254903,8
Category_Wikipedia_sockpuppets_of_Dumbarse1229.csv,5,14886.0,3,2,2,1,0,44.0,138,14,14.0,14
Category_Wikipedia_sockpuppets_of_Montreux69.csv,125,59458700.0,26,99,16,10,0,41.824,191,63,26.384,8
Category_Wikipedia_sockpuppets_of_Jwalia012.csv,645,5250634.0,195,450,86,109,0,41.38294573643411,253,40,16.28062015503876,4
Category_Wikipedia_sockpuppets_of_Ihj2021.csv,40,114227.0,12,28,7,5,0,83.55,500,30,22.475,8
Category_Wikipedia_sockpuppets_of_Ars3nal311.csv,263,955729.0,97,166,19,78,0,53.80228136882129,242,60,27.05703422053232,8
Category_Wikipedia_sockpuppets_of_Mdismailali.02.csv,15,7519074.0,13,2,8,5,0,26.066666666666666,154,27,23.8,23
Category_Wikipedia_sockpuppets_of_Rayrayzone.csv,2413,20125853.0,1000,1413,500,500,0,32.076253626191466,255,62,17.670534604227104,4
Category_Wikipedia_sockpuppets_of_Paulmorphy900.csv,82,72850231.0,22,60,20,2,0,46.81707317073171,218,29,13.951219512195122,5
Category_Wikipedia_sockpuppets_of_Cormeo.csv,639,14069567.0,422,217,407,15,0,26.80438184663537,196,64,32.87793427230047,4
Category_Wikipedia_sockpuppets_of_Specialkjamie.csv,13,3717792.0,10,3,7,3,0,28.0,199,22,22.0,22
Category_Wikipedia_sockpuppets_of_FEFCO.csv,8,11526.0,5,3,3,2,45,82.125,158,21,13.875,10
Category_Wikipedia_sockpuppets_of_Bopomofo.csv,511,20911777.0,217,294,169,48,0,50.84344422700587,237,34,17.250489236790607,7
Category_Wikipedia_sockpuppets_of_Sharyf299.csv,17,28563094.0,4,13,3,1,0,40.529411764705884,95,26,18.647058823529413,13
Category_Wikipedia_sockpuppets_of_Paul_Bedson.csv,5941,206249061.0,2511,3430,500,2011,0,50.02726813667733,288,101,23.41390338326881,4
Category_Wikipedia_sockpuppets_of_Roshan950130.csv,41,5515097.0,29,12,11,18,0,59.75609756097561,219,29,19.878048780487806,16
Category_Wikipedia_sockpuppets_of_Wpdiamonds.csv,20,14617316.0,20,0,12,8,0,19.15,128,16,11.5,11
Category_Wikipedia_sockpuppets_of_Armayle_salari.csv,12,106856.0,7,5,3,4,0,38.333333333333336,157,22,8.083333333333334,5
Category_Wikipedia_sockpuppets_of_Secretupdater.csv,22,2170806.0,6,16,6,0,0,31.454545454545453,84,33,29.818181818181817,18
Category_Wikipedia_sockpuppets_of_Name_Defend_IPA.csv,91,1869548.0,39,52,16,23,0,57.0,251,65,31.043956043956044,12
Category_Wikipedia_sockpuppets_of_Nediyakala_Vasavan.csv,2554,28065852.0,980,1574,500,480,0,35.50195771339076,508,77,17.141346906812842,5
Category_Wikipedia_sockpuppets_of_Grabyton.csv,393,100287853.0,172,221,161,11,0,50.42493638676845,246,40,16.709923664122137,3
Category_Wikipedia_sockpuppets_of_Igaalbania.csv,1951,204013311.0,624,1327,500,124,0,40.76114812916453,414,41,11.69502819067145,4
Category_Wikipedia_sockpuppets_of_Goldiggah.csv,6,3320.0,5,1,2,3,4,60.166666666666664,86,25,17.166666666666668,11
Category_Wikipedia_sockpuppets_of_Hammad_Chaudhry.csv,1124,21281587.0,388,736,121,267,0,42.069395017793596,500,61,18.852313167259787,4
Category_Wikipedia_sockpuppets_of_Goldheart.Jewelry.csv,16,3541355.0,7,9,5,2,0,53.875,192,17,8.3125,4
Category_Wikipedia_sockpuppets_of_ICQ_ASSISTANT.csv,70,2332021.0,37,33,19,18,0,46.77142857142857,201,53,18.442857142857143,10
Category_Wikipedia_sockpuppets_of_Todineshmathur.csv,7,306731.0,5,2,3,2,0,0.0,0,58,37.857142857142854,23
Category_Wikipedia_sockpuppets_of_Slogadog.csv,89,7728938.0,19,70,8,11,0,89.1685393258427,255,23,18.292134831460675,12
Category_Wikipedia_sockpuppets_of_Jena_Amiya_Kumar.csv,337,172372054.0,122,215,63,59,0,43.08605341246291,296,51,19.652818991097924,7
Category_Wikipedia_sockpuppets_of_John_Jex_Asif.csv,180,11603571.0,49,131,18,31,0,62.09444444444444,211,82,25.594444444444445,6
Category_Wikipedia_sockpuppets_of_Cornelius_Keagon.csv,3672,112570746.0,1235,2437,500,735,0,41.016067538126364,483,63,16.983115468409586,4
Category_Wikipedia_sockpuppets_of_Exztnz.csv,36,1212234.0,16,20,10,6,0,45.19444444444444,235,53,24.916666666666668,11
Category_Wikipedia_sockpuppets_of_WikiAssistance.csv,92,1029556.0,42,50,25,17,0,63.43478260869565,226,50,20.152173913043477,11
Category_Wikipedia_sockpuppets_of_Miguel_√Ålvarez_Jim√©nez.csv,180,293928359.0,56,124,21,35,0,56.80555555555556,386,32,13.266666666666667,5
Category_Wikipedia_sockpuppets_of_Bra1nwashin.csv,595,11497938.0,145,450,112,33,0,44.44033613445378,405,45,13.685714285714285,4
Category_Wikipedia_sockpuppets_of_Scarbear1122.csv,17,2158552.0,6,11,3,3,0,35.35294117647059,144,24,16.41176470588235,11
Category_Wikipedia_sockpuppets_of_Rami_Neudorfer.csv,496,656067462.0,112,384,77,35,0,48.47379032258065,349,49,17.098790322580644,5
Category_Wikipedia_sockpuppets_of_Mir_Adil_Ali_Rizvi.csv,408,14444704.0,128,280,82,46,0,51.64950980392157,439,28,12.696078431372548,3
Category_Wikipedia_sockpuppets_of_Farazdctm.csv,80,148836910.0,26,54,21,5,0,64.6125,241,38,22.375,9
Category_Wikipedia_sockpuppets_of_Untrammeled.csv,1235,2233091.0,515,720,500,15,0,57.03967611336032,500,47,28.354655870445345,5
Category_Wikipedia_sockpuppets_of_Hannibear55.csv,5,504.0,3,2,2,1,0,98.6,183,18,18.0,18
Category_Wikipedia_sockpuppets_of_HitchP.csv,415,3039611.0,164,251,103,61,0,60.89879518072289,488,32,16.951807228915662,5
Category_Wikipedia_sockpuppets_of_Wikii128.csv,38,1123297.0,30,8,11,19,0,36.89473684210526,161,23,18.526315789473685,10
Category_Wikipedia_sockpuppets_of_Braveheart5050.csv,614,2914393.0,207,407,165,42,0,33.8957654723127,253,43,21.34527687296417,7
Category_Wikipedia_sockpuppets_of_Swati097gupta.csv,116,122620414.0,27,89,26,1,0,63.439655172413794,381,30,15.387931034482758,7
Category_Wikipedia_sockpuppets_of_Primetime.csv,10678,85289907.0,3383,7295,500,2883,0,43.40812886308297,250,90,19.481644502715863,1
Category_Wikipedia_sockpuppets_of_Wat_is_7_+_15.csv,40,575809.0,15,25,13,2,0,32.55,154,46,18.925,6
Category_Wikipedia_sockpuppets_of_RobinHoodThePatriot.csv,106,102921.0,30,76,26,4,0,44.160377358490564,312,25,13.80188679245283,6
Category_Wikipedia_sockpuppets_of_Reverend_Dr._Ulas_Hayes.csv,265,155474588.0,148,117,111,37,0,28.57358490566038,199,37,29.649056603773584,20
Category_Wikipedia_sockpuppets_of_J_Man_Fire.csv,6,251577.0,3,3,3,0,0,48.0,136,25,25.0,25
Category_Wikipedia_sockpuppets_of_Baxter17.csv,207,5260063.0,111,96,104,7,0,29.32850241545894,220,43,18.26086956521739,4
Category_Wikipedia_sockpuppets_of_Adigabrek.csv,1338,44004313.0,500,838,500,0,0,44.51793721973094,496,64,18.32511210762332,5
Category_Wikipedia_sockpuppets_of_Brianyau323.csv,1686,23928978.0,474,1212,239,235,0,30.373665480427047,221,76,25.08956109134045,2
Category_Wikipedia_sockpuppets_of_NikolaKrajnc11.csv,19,71192.0,13,6,12,1,0,31.57894736842105,193,27,14.368421052631579,6
Category_Wikipedia_sockpuppets_of_Historyk_IPN.csv,43,82225.0,14,29,8,6,0,79.11627906976744,380,51,30.13953488372093,18
Category_Wikipedia_sockpuppets_of_Dylanpizza358.csv,72,15940094.0,26,46,18,8,0,43.19444444444444,201,57,36.68055555555556,12
Category_Wikipedia_sockpuppets_of_Pacnews.csv,9,148925210.0,3,6,3,0,0,35.55555555555556,145,17,12.333333333333334,10
Category_Wikipedia_sockpuppets_of_Smoothestaashu007.csv,6,4591.0,3,3,3,0,0,26.833333333333332,60,24,23.833333333333332,23
Category_Wikipedia_sockpuppets_of_Bluecord.csv,800,66156362.0,239,561,166,73,0,44.115,250,85,28.14375,3
Category_Wikipedia_sockpuppets_of_Perperof31.csv,1077,78628137.0,437,640,430,7,0,31.688022284122564,253,47,16.020427112349118,3
Category_Wikipedia_sockpuppets_of_Helen_roundme.csv,68,1166114.0,20,48,19,1,0,43.35294117647059,177,26,20.676470588235293,17
Category_Wikipedia_sockpuppets_of_Info2012.csv,742,91456259.0,196,546,190,6,0,50.96495956873316,255,51,18.82075471698113,5
Category_Wikipedia_sockpuppets_of_Master12112wp.csv,272,53530484.0,72,200,26,46,0,48.88235294117647,266,22,14.610294117647058,10
Category_Wikipedia_sockpuppets_of_Runta.csv,10,51054.0,4,6,4,0,2,50.0,146,17,12.5,8
Category_Wikipedia_sockpuppets_of_Tea1212.csv,1548,13392905.0,715,833,500,215,0,26.27777777777778,255,49,26.58139534883721,4
Category_Wikipedia_sockpuppets_of_Bridge70002.csv,33,6480668.0,18,15,8,10,0,50.36363636363637,162,24,22.12121212121212,15
Category_Wikipedia_sockpuppets_of_Bun39.csv,3479,61692808.0,1158,2321,394,764,0,32.772348375970104,250,76,17.045415349238286,3
Category_Wikipedia_sockpuppets_of_Vandhi100.csv,1267,152853452.0,536,731,499,37,0,36.913180741910026,247,53,21.03314917127072,5
Category_Wikipedia_sockpuppets_of_Mil_Mi-888.csv,100,5895232.0,41,59,37,4,0,40.19,496,63,34.52,8
Category_Wikipedia_sockpuppets_of_Plyjacks.csv,2069,445933296.0,629,1440,500,129,0,48.23827936201063,500,91,21.500241662638956,5
Category_Wikipedia_sockpuppets_of_Ptah2010.csv,255,41277497.0,74,181,19,55,0,70.8156862745098,239,54,15.137254901960784,5
Category_Wikipedia_sockpuppets_of_Shezfrez62.csv,1988,37223771.0,705,1283,401,304,0,41.84909456740443,496,74,17.665995975855132,6
Category_Wikipedia_sockpuppets_of_Mandyadashiradisaibaba.csv,231,24031949.0,66,165,60,6,0,47.22943722943723,247,30,18.623376623376622,6
Category_Wikipedia_sockpuppets_of_Turnbull35.csv,360,18488787.0,138,222,106,32,0,43.50277777777778,250,34,18.958333333333332,6
Category_Wikipedia_sockpuppets_of_Anthonyjmel.csv,86,3246541.0,46,40,22,24,0,45.627906976744185,206,66,30.25581395348837,13
Category_Wikipedia_sockpuppets_of_Lovesugar.csv,55,7212.0,19,36,12,7,0,47.836363636363636,155,42,15.290909090909091,8
Category_Wikipedia_sockpuppets_of_Pritamjha7711.csv,17,375469.0,7,10,4,3,0,67.76470588235294,210,15,9.705882352941176,1
Category_Wikipedia_sockpuppets_of_Poofdragon.csv,298,66289947.0,90,208,54,36,0,93.09060402684564,311,51,22.459731543624162,12
Category_Wikipedia_sockpuppets_of_Patryk777pt.csv,2128,133828352.0,894,1234,500,394,0,30.632518796992482,337,49,22.69078947368421,7
Category_Wikipedia_sockpuppets_of_AniceMathew.csv,5074,44940017.0,1850,3224,500,1350,0,39.958415451320455,255,60,15.685849428458809,3
Category_Wikipedia_sockpuppets_of_Cyber.Eyes.2005.csv,4093,64501047.0,1080,3013,152,928,0,59.317615440996825,485,67,14.818470559491816,4
Category_Wikipedia_sockpuppets_of_JonGordon07.csv,24,619795.0,9,15,5,4,2,48.583333333333336,123,25,17.666666666666668,3
Category_Wikipedia_sockpuppets_of_Leoesb1032.csv,1895,328911482.0,516,1379,500,16,0,66.74511873350923,395,70,19.953034300791558,3
Category_Wikipedia_sockpuppets_of_Games_Slots1.csv,10,2503.0,6,4,5,1,15,31.3,131,7,7.0,7
Category_Wikipedia_sockpuppets_of_The_one_online.csv,561,7263732.0,173,388,157,16,0,31.89483065953654,235,60,21.607843137254903,8
Category_Wikipedia_sockpuppets_of_Raulseixas.csv,5144,44590322.0,1335,3809,500,835,0,33.49727838258165,255,49,16.450233281493002,4
Category_Wikipedia_sockpuppets_of_Forces77.csv,322,233190828.0,84,238,52,32,0,44.630434782608695,233,44,16.816770186335404,6
Category_Wikipedia_sockpuppets_of_Shannon2000.csv,3,2384.0,2,1,2,0,9,47.333333333333336,120,27,27.0,27
Category_Wikipedia_sockpuppets_of_James_Tucton.csv,163,270220.0,59,104,12,47,0,42.29447852760736,146,47,24.20245398773006,10
Category_Wikipedia_sockpuppets_of_Sir_Bronx.csv,228,96788473.0,63,165,49,14,0,59.94298245614035,255,47,15.350877192982455,6
Category_Wikipedia_sockpuppets_of_Trumpet_Morning.csv,37,1517916.0,9,28,3,6,0,44.972972972972975,271,70,45.75675675675676,18
Category_Wikipedia_sockpuppets_of_BabbarJatt.csv,1834,3304843.0,727,1107,307,420,0,59.06379498364231,500,105,23.991821155943292,6
Category_Wikipedia_sockpuppets_of_George_SJ_XXI.csv,260,3826274.0,104,156,104,0,0,43.246153846153845,229,49,29.965384615384615,6
Category_Wikipedia_sockpuppets_of_Phines0001.csv,282,81328425.0,73,209,30,43,0,41.308510638297875,238,43,19.361702127659573,6
Category_Wikipedia_sockpuppets_of_Raliegofficial22.csv,59,18701061.0,17,42,8,9,0,43.88135593220339,220,53,33.271186440677965,7
Category_Wikipedia_sockpuppets_of_Janasommer.csv,1429,40775757.0,696,733,500,196,0,40.09867039888034,255,63,27.345696291112667,4
Category_Wikipedia_sockpuppets_of_Timmy_the_peterson.csv,24,119182651.0,6,18,4,2,0,47.125,165,14,12.0,11
Category_Wikipedia_sockpuppets_of_Fiduproperty.csv,3,66.0,3,0,3,0,20,20.333333333333332,21,17,17.0,17
Category_Wikipedia_sockpuppets_of_Emedia86.csv,14,19981324.0,5,9,3,2,0,51.714285714285715,132,50,36.714285714285715,17
Category_Wikipedia_sockpuppets_of_Kanabekobaton.csv,4281,113784772.0,1000,3281,500,500,0,36.321887409483764,255,73,22.692828778322824,3
Category_Wikipedia_sockpuppets_of_Bradjonesmusic.csv,10,2903.0,10,0,10,0,0,19.6,196,27,27.0,27
Category_Wikipedia_sockpuppets_of_Dek0001.csv,593,14482126.0,250,343,177,73,0,57.24789207419899,255,43,19.15008431703204,6
Category_Wikipedia_sockpuppets_of_Lilyanrose.csv,39,103759534.0,10,29,8,2,0,61.92307692307692,254,20,9.23076923076923,8
Category_Wikipedia_sockpuppets_of_Krurangwa.csv,57,3812942.0,20,37,15,5,0,50.26315789473684,208,33,22.07017543859649,13
Category_Wikipedia_sockpuppets_of_Agavtouch.csv,130,602677.0,56,74,32,24,0,51.03846153846154,213,63,32.246153846153845,4
Category_Wikipedia_sockpuppets_of_Flyhead.csv,736,12865263.0,251,485,153,98,0,28.671195652173914,207,62,23.980978260869566,8
Category_Wikipedia_sockpuppets_of_Hogroast92.csv,55,5413786.0,33,22,13,20,0,23.236363636363638,279,34,11.818181818181818,8
Category_Wikipedia_sockpuppets_of_Dr._Shauna_Springer.csv,2,0.0,1,1,1,0,30,30.0,30,29,29.0,29
Category_Wikipedia_sockpuppets_of_Indiggo77.csv,849,252249031.0,364,485,330,34,0,41.14369846878681,255,27,10.83510011778563,6
Category_Wikipedia_sockpuppets_of_Normaraga.csv,200,41859215.0,69,131,64,5,0,46.38,351,62,19.815,7
Category_Wikipedia_sockpuppets_of_Ddog6999.csv,20,6044188.0,5,15,5,0,0,47.1,190,18,10.3,6
Category_Wikipedia_sockpuppets_of_MX_player.csv,180,965827.0,52,128,52,0,0,52.37777777777778,212,41,20.033333333333335,9
Category_Wikipedia_sockpuppets_of_Combo_Panda.csv,526,72745805.0,207,319,110,97,0,41.99239543726236,292,44,21.524714828897338,8
Category_Wikipedia_sockpuppets_of_DuplixD.csv,2985,44205941.0,1210,1775,500,710,0,35.35443886097153,264,85,18.24422110552764,5
Category_Wikipedia_sockpuppets_of_Commandernavy.csv,747,18650309.0,256,491,248,8,0,40.2289156626506,255,50,21.720214190093706,7
Category_Wikipedia_sockpuppets_of_Baba1031.csv,91,2583348.0,35,56,22,13,0,46.582417582417584,168,45,20.714285714285715,10
Category_Wikipedia_sockpuppets_of_W_EXPRESS_TRAIN.csv,1068,25415022.0,289,779,254,35,0,44.41385767790262,417,57,22.05805243445693,5
Category_Wikipedia_sockpuppets_of_Bsharvy.csv,2020,22131471.0,615,1405,500,115,0,44.36732673267327,212,67,24.236633663366337,5
Category_Wikipedia_sockpuppets_of_A_Great_Catholic_Person.csv,8319,59165985.0,2268,6051,500,1768,0,70.49188604399568,500,75,19.78122370477221,1
Category_Wikipedia_sockpuppets_of_Muhammad_Ali_008.csv,8,9642471.0,5,3,4,1,0,32.625,116,14,14.0,14
Category_Wikipedia_sockpuppets_of_Zach.vega1.csv,65,10548367.0,22,43,22,0,0,49.69230769230769,261,41,20.384615384615383,7
Category_Wikipedia_sockpuppets_of_Pankaj_Bora_ji.csv,22,3358134.0,16,6,16,0,0,15.681818181818182,169,11,11.0,11
Category_Wikipedia_sockpuppets_of_TyDwiki.csv,1559,9077241.0,547,1012,500,47,0,37.769082745349586,259,65,23.515073765234124,6
Category_Wikipedia_sockpuppets_of_Pethmakhama.csv,609,5362260.0,311,298,295,16,0,40.6863711001642,253,38,16.561576354679804,5
Category_Wikipedia_sockpuppets_of_Technoquacker.csv,514,2876677.0,160,354,148,12,0,45.27237354085603,269,75,18.29377431906615,5
Category_Wikipedia_sockpuppets_of_Radiopathy.csv,4516,445800597.0,1000,3516,500,500,0,61.284986713906115,475,61,18.928697962798935,3
Category_Wikipedia_sockpuppets_of_Tamburellista.csv,542,56167016.0,140,402,58,82,0,44.632841328413285,252,65,27.780442804428045,6
Category_Wikipedia_sockpuppets_of_Urten5384.csv,27,235075.0,9,18,4,5,0,67.74074074074075,263,31,13.0,8
Category_Wikipedia_sockpuppets_of_BirminghamAV.csv,94,666766.0,51,43,37,14,0,30.117021276595743,199,67,33.38297872340426,10
Category_Wikipedia_sockpuppets_of_Sauood07.csv,1582,269839802.0,549,1033,500,49,0,44.12452591656132,292,49,14.166877370417193,4
Category_Wikipedia_sockpuppets_of_Access_Denied.csv,3156,181133152.0,940,2216,500,440,0,52.5415082382763,250,84,26.572243346007603,3
Category_Wikipedia_sockpuppets_of_Jojoplaut.csv,359,115877059.0,104,255,94,10,0,32.88857938718663,215,32,16.409470752089135,4
Category_Wikipedia_sockpuppets_of_Xxx_anon.csv,1717,12509774.0,641,1076,492,149,0,40.22714036109493,362,73,27.728013977868375,6
Category_Wikipedia_sockpuppets_of_Asr99.0979.csv,1083,11376267.0,301,782,259,42,0,55.60018467220683,504,44,15.71191135734072,5
Category_Wikipedia_sockpuppets_of_Jbuffkin.csv,128,31903394.0,75,53,36,39,0,56.2421875,226,35,22.8671875,11
Category_Wikipedia_sockpuppets_of_WritingPro1234.csv,1103,5191900.0,619,484,349,270,0,31.620126926563916,334,57,27.954669084315505,12
Category_Wikipedia_sockpuppets_of_Korruski.csv,1904,264373143.0,549,1355,500,49,0,59.19485294117647,493,103,24.46376050420168,3
Category_Wikipedia_sockpuppets_of_Johnclarencevelasco.csv,107,15074587.0,35,72,17,18,0,46.299065420560744,359,53,21.429906542056074,12
Category_Wikipedia_sockpuppets_of_ReifWinery.csv,9,10857.0,7,2,4,3,0,1.7777777777777777,16,18,18.0,18
Category_Wikipedia_sockpuppets_of_LidaSlv.csv,3,202492.0,2,1,2,0,74,86.66666666666667,111,17,17.0,17
Category_Wikipedia_sockpuppets_of_JackNassar.csv,232,12441892.0,102,130,81,21,0,46.47844827586207,222,38,15.150862068965518,5
Category_Wikipedia_sockpuppets_of_Praveen77777.csv,444,87286416.0,156,288,47,109,0,34.82432432432432,336,61,21.36936936936937,5
Category_Wikipedia_sockpuppets_of_Sweethavxn.csv,2527,29568375.0,863,1664,500,363,0,41.91056588840522,496,57,18.66481994459834,5
Category_Wikipedia_sockpuppets_of_Ulasbrdkci40.csv,902,77808.0,461,441,398,63,0,31.556541019955652,285,46,15.60310421286031,5
Category_Wikipedia_sockpuppets_of_Arashtitan.csv,362,166761598.0,101,261,97,4,0,43.16298342541437,227,89,29.91988950276243,5
Category_Wikipedia_sockpuppets_of_RevitDazio.csv,8,1027.0,4,4,4,0,19,47.875,85,54,25.875,13
Category_Wikipedia_sockpuppets_of_Hempbilly.csv,1135,24906878.0,373,762,284,89,0,43.77533039647577,250,84,23.12863436123348,5
Category_Wikipedia_sockpuppets_of_Hispanapsih.csv,61,142231.0,35,26,33,2,0,47.31147540983606,229,17,5.868852459016393,4
Category_Wikipedia_sockpuppets_of_Jan_Blanicky.csv,3057,395212541.0,1053,2004,500,553,0,39.07392868825646,255,77,20.21099116781158,5
Category_Wikipedia_sockpuppets_of_Depressed_Desi.csv,1727,49535407.0,535,1192,253,282,0,50.919513607411695,496,73,25.17486971627099,6
Category_Wikipedia_sockpuppets_of_Wagonron.csv,177,284718217.0,40,137,30,10,0,84.92090395480226,613,12,11.734463276836157,5
Category_Wikipedia_sockpuppets_of_Rickwas99.csv,351,8340872.0,111,240,57,54,0,46.401709401709404,462,57,21.897435897435898,3
Category_Wikipedia_sockpuppets_of_Mary_Eleanor_de_Normandy.csv,2000,278067175.0,531,1469,500,31,0,53.7415,412,62,20.0915,4
Category_Wikipedia_sockpuppets_of_Lllopqqp.csv,8857,18266857.0,3098,5759,500,2598,0,42.170825335892516,500,114,18.10511459862256,3
Category_Wikipedia_sockpuppets_of_Justlife1.csv,4,110.0,3,1,3,0,0,11.5,20,15,12.5,10
Category_Wikipedia_sockpuppets_of_The_Iron_Warrior.csv,2776,121934318.0,796,1980,500,296,0,48.64481268011527,500,250,23.15922190201729,2
Category_Wikipedia_sockpuppets_of_Nicknam4.csv,120,148443396.0,24,96,20,4,0,48.666666666666664,211,62,20.833333333333332,4
Category_Wikipedia_sockpuppets_of_Phillip_Pham.csv,52,15806191.0,19,33,15,4,0,54.36538461538461,250,67,35.51923076923077,15
Category_Wikipedia_sockpuppets_of_Alexandradddd.csv,3,291.0,3,0,3,0,0,11.333333333333334,21,18,18.0,18
Category_Wikipedia_sockpuppets_of_Naveed_attari.csv,9,520478.0,5,4,3,2,0,32.666666666666664,74,26,22.333333333333332,17
Category_Wikipedia_sockpuppets_of_Everlearningonline.csv,60,38034496.0,20,40,18,2,0,66.1,249,41,18.65,8
Category_Wikipedia_sockpuppets_of_Stavgard.csv,515,93636239.0,210,305,207,3,0,45.64271844660194,250,45,19.06601941747573,5
Category_Wikipedia_sockpuppets_of_MinunBoo.csv,297,23998339.0,105,192,46,59,0,67.13468013468014,278,54,23.84175084175084,14
Category_Wikipedia_sockpuppets_of_Ryan_HoganBruen's_life.csv,41,4934805.0,22,19,19,3,0,31.146341463414632,156,40,21.390243902439025,9
Category_Wikipedia_sockpuppets_of_Hack54about33.csv,73,5229214.0,27,46,4,23,0,47.47945205479452,215,26,12.767123287671232,4
Category_Wikipedia_sockpuppets_of_Adamiiijr.csv,25,15884394.0,10,15,9,1,0,29.8,119,18,15.8,13
Category_Wikipedia_sockpuppets_of_MateusFreiitass.csv,40,596928.0,21,19,15,6,0,34.825,181,31,12.225,5
Category_Wikipedia_sockpuppets_of_Ricard_wells.csv,17,101629.0,13,4,9,4,0,32.1764705882353,160,27,18.823529411764707,15
Category_Wikipedia_sockpuppets_of_Qehciojcvjliokvf.csv,14,809.0,10,4,6,4,0,57.57142857142857,163,10,10.0,10
Category_Wikipedia_sockpuppets_of_N8triez.csv,7,1292.0,6,1,6,0,0,31.857142857142858,117,17,16.285714285714285,12
Category_Wikipedia_sockpuppets_of_TelGonzie.csv,281,35254408.0,81,200,44,37,0,71.86832740213524,403,80,26.07829181494662,4
Category_Wikipedia_sockpuppets_of_Tanzirvai1.csv,486,15640661.0,157,329,96,61,0,42.05761316872428,279,34,17.866255144032923,5
Category_Wikipedia_sockpuppets_of_Leelawadee_UI.csv,354,1690702.0,95,259,32,63,0,51.48587570621469,275,41,14.254237288135593,5
Category_Wikipedia_sockpuppets_of_Sugar_Bear.csv,5753,320987849.0,1559,4194,500,1059,0,45.08604206500956,395,72,18.540239874847906,4
Category_Wikipedia_sockpuppets_of_Southernyoungin.csv,131,3097995.0,83,48,74,9,0,39.282442748091604,243,46,19.709923664122137,10
Category_Wikipedia_sockpuppets_of_Breast999A.csv,549,1824226.0,170,379,37,133,0,53.44444444444444,496,52,24.963570127504553,7
Category_Wikipedia_sockpuppets_of_LRP19PT.csv,1578,38088380.0,435,1143,428,7,0,42.57794676806083,460,56,21.160329531051964,4
Category_Wikipedia_sockpuppets_of_The_Micronesian-Corsican_Revolution.csv,1264,139629708.0,391,873,340,51,0,52.22863924050633,496,61,17.09018987341772,4
Category_Wikipedia_sockpuppets_of_Splatomier.csv,89,84111983.0,18,71,14,4,0,69.86516853932584,254,24,15.101123595505618,5
Category_Wikipedia_sockpuppets_of_Chie_one.csv,28799,78640757.0,7371,21428,500,6871,0,50.80634744261953,446,61,15.141532692107365,2
Category_Wikipedia_sockpuppets_of_Sussyfist69.csv,186,36374865.0,58,128,55,3,0,50.77956989247312,499,46,30.822580645161292,15
Category_Wikipedia_sockpuppets_of_PostPunkPete.csv,21,2073935.0,7,14,4,3,0,87.52380952380952,256,19,9.80952380952381,4
Category_Wikipedia_sockpuppets_of_Sscp3241.csv,125,4187453.0,75,50,42,33,0,36.32,231,44,28.168,10
Category_Wikipedia_sockpuppets_of_Ballcadeias.csv,308,191186396.0,62,246,39,23,0,72.65259740259741,479,50,23.211038961038962,9
Category_Wikipedia_sockpuppets_of_Peter.hantz.csv,398,479705352.0,91,307,27,64,0,49.15075376884422,499,38,16.766331658291456,6
Category_Wikipedia_sockpuppets_of_Tuf75527.csv,20,152018.0,13,7,8,5,0,59.05,345,40,31.55,13
Category_Wikipedia_sockpuppets_of_KhetiGaadi01.csv,61,1289854.0,20,41,17,3,0,67.45901639344262,222,27,16.672131147540984,7
Category_Wikipedia_sockpuppets_of_Jakehergz.csv,21,1936129.0,8,13,7,1,0,39.04761904761905,216,14,12.0,8
Category_Wikipedia_sockpuppets_of_Liist.csv,1268,61577545.0,292,976,215,77,0,33.079652996845425,250,52,17.472397476340696,4
Category_Wikipedia_sockpuppets_of_Attenuasis.csv,4,1328.0,2,2,2,0,15,117.75,251,20,14.5,9
Category_Wikipedia_sockpuppets_of_Lu3ke.csv,543,269704312.0,130,413,66,64,0,45.729281767955804,248,70,17.257826887661142,4
Category_Wikipedia_sockpuppets_of_Shjjose.csv,31,1339.0,18,13,18,0,0,47.0,196,37,37.0,37
Category_Wikipedia_sockpuppets_of_TheoDaviesLewis.csv,198,358740.0,75,123,46,29,0,54.76767676767677,255,51,24.80808080808081,13
Category_Wikipedia_sockpuppets_of_Marufkhanoviofficial.csv,2,206.0,2,0,2,0,0,39.0,78,30,30.0,30
Category_Wikipedia_sockpuppets_of_Kswikiaccount.csv,403,3908367.0,125,278,105,20,0,53.89081885856079,255,68,35.72208436724566,12
Category_Wikipedia_sockpuppets_of_Fovean_Author.csv,1115,44383949.0,223,892,212,11,0,63.34977578475336,250,66,17.777578475336323,10
Category_Wikipedia_sockpuppets_of_Standage.csv,286,6940557.0,102,184,45,57,0,47.05244755244755,245,57,26.055944055944057,12
Category_Wikipedia_sockpuppets_of_Kyle.sivvenxo.csv,3204,124174316.0,1195,2009,500,695,0,37.34893882646691,496,67,28.41541822721598,7
Category_Wikipedia_sockpuppets_of_LFAF.csv,835,18324323.0,271,564,230,41,0,41.808383233532936,276,47,18.095808383233532,6
Category_Wikipedia_sockpuppets_of_KameBusted.csv,62,83043.0,23,39,20,3,0,49.20967741935484,192,34,20.56451612903226,11
Category_Wikipedia_sockpuppets_of_Case_edu.csv,136,5557644.0,45,91,45,0,0,29.816176470588236,234,48,19.044117647058822,6
Category_Wikipedia_sockpuppets_of_Chaconaut.csv,31,22231082.0,12,19,12,0,0,52.806451612903224,171,19,13.451612903225806,9
Category_Wikipedia_sockpuppets_of_Pascack.csv,983,15057559.0,312,671,249,63,0,37.92980671414038,210,47,15.6205493387589,8
Category_Wikipedia_sockpuppets_of_Nenpog.csv,1254,2988637.0,447,807,441,6,0,44.34290271132377,250,54,27.650717703349283,7
Category_Wikipedia_sockpuppets_of_Alessandro.camanini.csv,26,2944524.0,21,5,13,8,0,23.73076923076923,196,30,26.46153846153846,26
Category_Wikipedia_sockpuppets_of_ItHysteria.csv,4543,105071861.0,1287,3256,500,787,0,41.07373981950253,262,105,21.091789566365836,2
Category_Wikipedia_sockpuppets_of_TheBishopAndHolyPrince.csv,2771,16714777.0,1001,1770,500,501,0,58.71093468062072,500,82,29.853482497293395,10
Category_Wikipedia_sockpuppets_of_Archprateek.csv,8,627315.0,4,4,4,0,0,14.625,60,45,45.0,45
Category_Wikipedia_sockpuppets_of_Booshakla.csv,2524,179484599.0,506,2018,500,6,0,36.76307448494453,244,103,19.826862123613314,4
Category_Wikipedia_sockpuppets_of_Caden_randall.csv,13,1208.0,7,6,3,4,0,23.46153846153846,111,18,16.76923076923077,14
Category_Wikipedia_sockpuppets_of_Zubac97.csv,475,33948121.0,145,330,63,82,0,44.351578947368424,292,30,17.28,4
Category_Wikipedia_sockpuppets_of_Khalid_Alkhudair.csv,43,28962555.0,17,26,7,10,0,52.906976744186046,255,53,23.488372093023255,5
Category_Wikipedia_sockpuppets_of_Muhammad_Ali_Khalid.csv,1876,52124448.0,1083,793,500,583,0,27.81449893390192,255,47,23.36087420042644,7
Category_Wikipedia_sockpuppets_of_Voice4People.csv,758,4048846.0,269,489,234,35,0,49.11873350923483,489,54,14.308707124010555,6
Category_Wikipedia_sockpuppets_of_Crazychink.csv,81,163465.0,68,13,65,3,0,19.82716049382716,199,21,9.246913580246913,4
Category_Wikipedia_sockpuppets_of_RahullThakur.csv,1,0.0,1,0,1,0,11,11.0,11,17,17.0,17
Category_Wikipedia_sockpuppets_of_Grinding_Slicker.csv,48,1375251.0,38,10,7,31,0,89.0,243,31,25.854166666666668,11
Category_Wikipedia_sockpuppets_of_Bristolbottom.csv,180,5537949.0,82,98,71,11,0,39.41111111111111,214,77,40.25,9
Category_Wikipedia_sockpuppets_of_Frock~trwiki.csv,211,143248962.0,71,140,61,10,0,45.691943127962084,271,47,21.13270142180095,7
Category_Wikipedia_sockpuppets_of_Grant23.csv,427,4019335.0,182,245,164,18,0,48.20843091334895,200,58,33.70257611241218,11
Category_Wikipedia_sockpuppets_of_Lavalizard101.csv,1905,231025119.0,576,1329,500,76,0,67.34803149606299,458,65,21.155905511811024,3
Category_Wikipedia_sockpuppets_of_Plastiquedoll12.csv,61,5865775.0,21,40,20,1,0,55.967213114754095,283,37,27.065573770491802,20
Category_Wikipedia_sockpuppets_of_Œ£œÖŒΩœÑŒ¨Œ∫œÑŒ∑œÇ.csv,1000,5522547.0,404,596,231,173,0,50.603,255,49,20.054,1
Category_Wikipedia_sockpuppets_of_MrJigjag9.csv,73,3215182.0,50,23,43,7,0,56.76712328767123,496,27,17.493150684931507,7
Category_Wikipedia_sockpuppets_of_Vinonyi3.csv,173,147036399.0,68,105,40,28,0,41.86705202312139,265,44,15.791907514450868,5
Category_Wikipedia_sockpuppets_of_Sazmancrpo.csv,910,52367735.0,338,572,37,301,0,45.003296703296705,500,61,18.31208791208791,5
Category_Wikipedia_sockpuppets_of_EvanS.csv,1,0.0,1,0,1,0,60,60.0,60,21,21.0,21
Category_Wikipedia_sockpuppets_of_C√¶sey.csv,2538,32922580.0,744,1794,500,244,0,56.29984239558708,500,67,20.519700551615447,1
Category_Wikipedia_sockpuppets_of_Dariusdaman.csv,57,746417.0,24,33,19,5,0,42.333333333333336,184,37,20.017543859649123,9
Category_Wikipedia_sockpuppets_of_Businessbond.csv,18,2467.0,7,11,4,3,0,75.94444444444444,194,34,28.22222222222222,22
Category_Wikipedia_sockpuppets_of_Chiranjeevivenkatesh1s.csv,32,1135555.0,15,17,9,6,0,69.65625,496,38,23.9375,8
Category_Wikipedia_sockpuppets_of_Anujror.csv,1840,56624035.0,769,1071,449,320,0,41.27608695652174,494,105,14.207608695652175,2
Category_Wikipedia_sockpuppets_of_Point_by_point.csv,1187,6810862.0,383,804,353,30,0,50.50716090985678,255,108,25.207245155855098,5
Category_Wikipedia_sockpuppets_of_BeastAttitude.csv,39,4398135.0,11,28,9,2,0,36.8974358974359,197,20,12.538461538461538,6
Category_Wikipedia_sockpuppets_of_GBAlph4.csv,2399,79815889.0,858,1541,500,358,0,35.54230929553981,496,60,23.436015006252607,4
Category_Wikipedia_sockpuppets_of_Sladeakakevin.csv,136,1902226.0,85,51,79,6,0,33.10294117647059,207,27,18.360294117647058,10
Category_Wikipedia_sockpuppets_of_Jordvnd.csv,52,79727685.0,22,30,11,11,0,33.03846153846154,201,27,16.423076923076923,11
Category_Wikipedia_sockpuppets_of_Prodigy012.csv,304,4854516.0,102,202,36,66,0,49.92763157894737,496,59,21.73355263157895,5
Category_Wikipedia_sockpuppets_of_Toto_38389030.csv,25,95698.0,8,17,6,2,0,49.72,166,42,22.48,8
Category_Wikipedia_sockpuppets_of_Alma_Fordy.csv,3160,11910569.0,973,2187,397,576,0,34.68227848101266,241,77,20.300949367088606,4
Category_Wikipedia_sockpuppets_of_√Ü-202.csv,639,190477498.0,128,511,78,50,0,46.406885758998435,254,39,17.22222222222222,5
Category_Wikipedia_sockpuppets_of_Shame_on_PJ_Santos.csv,299,32385830.0,78,221,13,65,0,48.71571906354515,424,60,15.454849498327759,4
Category_Wikipedia_sockpuppets_of_Sicarioxy.csv,73,20306453.0,27,46,16,11,0,43.602739726027394,210,23,17.65753424657534,10
Category_Wikipedia_sockpuppets_of_KoMontEW.csv,61,92788.0,28,33,15,13,0,67.62295081967213,151,47,37.459016393442624,13
Category_Wikipedia_sockpuppets_of_Junepar65.csv,74,1910028.0,21,53,3,18,0,63.16216216216216,221,23,12.513513513513514,6
Category_Wikipedia_sockpuppets_of_Johnsaavn.csv,3752,225917106.0,1331,2421,500,831,0,45.980277185501066,490,134,16.538379530916846,4
Category_Wikipedia_sockpuppets_of_Jeremiah_Caquias.csv,1949,101453765.0,722,1227,45,677,0,41.84556182657773,496,58,25.467932272960493,7
Category_Wikipedia_sockpuppets_of_Swissfishpool.csv,157,1884601.0,54,103,16,38,0,59.560509554140125,254,65,23.089171974522294,8
Category_Wikipedia_sockpuppets_of_Gatorbearratica.csv,2024,44974930.0,790,1234,443,347,0,38.92588932806324,382,71,28.08102766798419,6
Category_Wikipedia_sockpuppets_of_Kils.csv,2143,340064402.0,748,1395,500,248,0,44.565095660289316,250,62,17.52449836677555,4
Category_Wikipedia_sockpuppets_of_Icecold1.csv,506,25399396.0,203,303,200,3,0,28.887351778656125,249,38,21.134387351778656,7
Category_Wikipedia_sockpuppets_of_Axl_Reisdorff.csv,134,1961218.0,57,77,19,38,0,26.350746268656717,184,31,19.029850746268657,6
Category_Wikipedia_sockpuppets_of_Bmwz3hm.csv,1521,80194438.0,528,993,350,178,0,44.87639710716634,255,62,18.932938856015777,5
Category_Wikipedia_sockpuppets_of_Vaibhavpomal123.csv,2758,12443206.0,807,1951,500,307,0,44.336113125453224,500,56,15.502900652646845,4
Category_Wikipedia_sockpuppets_of_The_Lord's_Prayer.csv,40,1612.0,14,26,12,2,0,67.9,221,27,14.4,6
Category_Wikipedia_sockpuppets_of_OnceASpy.csv,3315,46017382.0,1032,2283,352,680,0,57.87963800904977,448,56,17.86606334841629,3
Category_Wikipedia_sockpuppets_of_Oasis5Bridge.csv,13,5431.0,8,5,7,1,16,103.84615384615384,307,22,15.076923076923077,13
Category_Wikipedia_sockpuppets_of_Gi22account.csv,2661,65894375.0,938,1723,500,438,0,52.27358136039083,485,94,19.97707628711011,3
Category_Wikipedia_sockpuppets_of_Mynglestine.csv,329,41901496.0,120,209,29,91,0,32.15501519756839,199,62,22.376899696048632,2
Category_Wikipedia_sockpuppets_of_Lui2021.csv,1778,38110574.0,697,1081,500,197,0,35.177727784027,247,75,25.582114735658042,10
Category_Wikipedia_sockpuppets_of_The_Walking_Dead_DE.csv,90,43387700.0,30,60,11,19,0,49.87777777777778,196,53,28.5,15
Category_Wikipedia_sockpuppets_of_Nicnagel1.csv,221,17180058.0,55,166,55,0,0,42.737556561085974,255,39,20.013574660633484,6
Category_Wikipedia_sockpuppets_of_Chickennuggets75.csv,9,245.0,6,3,6,0,0,22.555555555555557,203,16,16.0,16
Category_Wikipedia_sockpuppets_of_Harrisonpardoe.csv,10,59549.0,6,4,5,1,11,51.9,196,24,20.4,16
Category_Wikipedia_sockpuppets_of_TwitterBo.csv,114,3360300.0,36,78,5,31,0,53.79824561403509,267,34,15.605263157894736,6
Category_Wikipedia_sockpuppets_of_Muskit333.csv,300,5156193.0,93,207,68,25,0,55.236666666666665,483,67,21.403333333333332,8
Category_Wikipedia_sockpuppets_of_RikePirado.csv,29,21764887.0,7,22,6,1,0,48.172413793103445,231,50,21.17241379310345,12
Category_Wikipedia_sockpuppets_of_Milktaco.csv,10394,222581417.0,2883,7511,500,2383,0,50.42139695978449,500,56,17.609871079468924,3
Category_Wikipedia_sockpuppets_of_Talentforfilm.csv,793,3166758.0,338,455,336,2,0,43.41361916771753,255,62,16.55233291298865,5
Category_Wikipedia_sockpuppets_of_Intare_con.csv,1,0.0,1,0,1,0,18,18.0,18,19,19.0,19
Category_Wikipedia_sockpuppets_of_Jsjofficial.csv,2,0.0,1,1,1,0,0,0.0,0,19,19.0,19
Category_Wikipedia_sockpuppets_of_Brizzleman.csv,19,4236575.0,16,3,6,10,0,26.473684210526315,123,22,18.473684210526315,16
Category_Wikipedia_sockpuppets_of_Etvindia.csv,356,7174799.0,120,236,44,76,0,30.53370786516854,217,29,11.724719101123595,3
Category_Wikipedia_sockpuppets_of_Ahmad5.farah.csv,659,42271544.0,277,382,212,65,0,40.628224582701066,235,50,22.555386949924127,5
Category_Wikipedia_sockpuppets_of_Poopernutt.csv,16,1947157.0,12,4,7,5,0,49.125,191,39,35.8125,22
Category_Wikipedia_sockpuppets_of_Raryel.csv,2279,454248979.0,514,1765,500,14,0,54.225976305397104,364,62,18.093023255813954,5
Category_Wikipedia_sockpuppets_of_James_buddrige.csv,2,0.0,1,1,1,0,23,23.0,23,17,17.0,17
Category_Wikipedia_sockpuppets_of_Rajpaj.csv,1476,149333645.0,352,1124,326,26,0,48.363143631436316,232,55,13.975609756097562,2
Category_Wikipedia_sockpuppets_of_Shaifaligupta.csv,221,280650271.0,56,165,52,4,0,49.171945701357465,236,54,12.963800904977376,7
Category_Wikipedia_sockpuppets_of_OfficeMax.csv,26,1388970.0,12,14,7,5,0,33.65384615384615,137,17,12.0,9
Category_Wikipedia_sockpuppets_of_Nukedestroy.csv,1,0.0,1,0,1,0,196,196.0,196,52,52.0,52
Category_Wikipedia_sockpuppets_of_Nartur.csv,84,4581237.0,31,53,21,10,0,26.404761904761905,157,35,27.30952380952381,9
Category_Wikipedia_sockpuppets_of_MaysonMage009.csv,357,16027554.0,161,196,82,79,0,43.34453781512605,255,68,19.15406162464986,8
Category_Wikipedia_sockpuppets_of_Maxikelley62063.csv,550,74757114.0,133,417,74,59,0,52.78909090909091,300,47,18.12727272727273,9
Category_Wikipedia_sockpuppets_of_Reggieplata.csv,246,88666900.0,52,194,50,2,0,42.49186991869919,345,52,18.878048780487806,5
Category_Wikipedia_sockpuppets_of_Harryishere.csv,898,149267255.0,361,537,199,162,0,49.95879732739421,496,64,21.309576837416483,3
Category_Wikipedia_sockpuppets_of_Grenoble_jojo.csv,22,6665.0,10,12,10,0,0,30.772727272727273,157,26,15.181818181818182,5
Category_Wikipedia_sockpuppets_of_DerekHammel123.csv,14,2458.0,9,5,7,2,13,62.785714285714285,140,18,18.0,18
Category_Wikipedia_sockpuppets_of_Hamish_Ross.csv,5897,571803664.0,1798,4099,500,1298,0,64.83652704765134,464,149,22.182126505002543,2
Category_Wikipedia_sockpuppets_of_Justahelpfulguy574.csv,4,296458.0,2,2,1,1,0,82.75,179,27,27.0,27
Category_Wikipedia_sockpuppets_of_Hydropout.csv,95,5785429.0,30,65,21,9,0,35.85263157894737,196,52,22.33684210526316,11
Category_Wikipedia_sockpuppets_of_Ekolot.csv,1739,2593413.0,618,1121,500,118,0,47.6693502012651,255,76,25.412880966072457,4
Category_Wikipedia_sockpuppets_of_Sandra_Pereira_-_Castilho.csv,48,52907777.0,15,33,12,3,0,45.1875,145,35,21.6875,9
Category_Wikipedia_sockpuppets_of_Chenqing1025.csv,1417,3283170.0,779,638,345,434,0,31.285109386026818,249,49,9.671136203246295,5
Category_Wikipedia_sockpuppets_of_Parabellum101.csv,1019,19158222.0,276,743,257,19,0,35.309126594700686,222,67,23.015701668302256,3
Category_Wikipedia_sockpuppets_of_Woodylogan.csv,835,32324838.0,229,606,83,146,0,27.234730538922157,199,54,27.58802395209581,7
Category_Wikipedia_sockpuppets_of_MukeshMahe.csv,616,47230126.0,173,443,52,121,0,49.31655844155844,275,54,16.878246753246753,4
Category_Wikipedia_sockpuppets_of_Mohammad_Zahid_Hossain.csv,103,1855878.0,26,77,14,12,0,65.93203883495146,277,28,10.970873786407767,4
Category_Wikipedia_sockpuppets_of_Bensebgli.csv,1448,9982802.0,612,836,500,112,0,48.261740331491715,500,54,14.969613259668508,4
Category_Wikipedia_sockpuppets_of_Doug_Coldwell.csv,2950,394351799.0,1095,1855,500,595,0,50.92677966101695,286,72,28.158983050847457,5
Category_Wikipedia_sockpuppets_of_JeffRambo.csv,148,12237829.0,30,118,29,1,0,54.817567567567565,205,51,20.986486486486488,4
Category_Wikipedia_sockpuppets_of_3dconversion3d.csv,302,171206841.0,105,197,102,3,0,46.02317880794702,237,31,14.798013245033113,7
Category_Wikipedia_sockpuppets_of_Mustaqbal.csv,1392,62179667.0,373,1019,337,36,0,30.899425287356323,202,63,17.349137931034484,3
Category_Wikipedia_sockpuppets_of_The_Bloodhound.csv,271,19724475.0,80,191,20,60,0,55.91143911439114,427,47,17.74538745387454,7
Category_Wikipedia_sockpuppets_of_Mrsdietz19.csv,16,19768.0,12,4,8,4,0,21.375,161,19,18.25,18
Category_Wikipedia_sockpuppets_of_Krisvstudios.csv,18,17768384.0,7,11,7,0,0,28.055555555555557,116,20,13.166666666666666,11
Category_Wikipedia_sockpuppets_of_Orokrstas.csv,16,1745018.0,9,7,7,2,0,45.25,249,23,12.5,11
Category_Wikipedia_sockpuppets_of_John_Dhar.csv,42,15652133.0,22,20,9,13,0,46.857142857142854,236,21,13.69047619047619,8
Category_Wikipedia_sockpuppets_of_GoatLordServant.csv,2499,113693738.0,836,1663,500,336,0,58.06602641056423,337,93,23.396158463385355,1
Category_Wikipedia_sockpuppets_of_Guineapulaaro.csv,45,96666.0,21,24,19,2,0,38.422222222222224,227,16,13.11111111111111,11
Category_Wikipedia_sockpuppets_of_Atlantic12.csv,5424,118550829.0,1444,3980,500,944,0,50.03982300884956,255,68,20.079646017699115,4
Category_Wikipedia_sockpuppets_of_K0nkaz.csv,1,0.0,1,0,1,0,32,32.0,32,17,17.0,17
Category_Wikipedia_sockpuppets_of_Mickonewell.csv,17,51160619.0,16,1,12,4,0,26.941176470588236,194,24,16.823529411764707,16
Category_Wikipedia_sockpuppets_of_Ciaran.london.csv,3600,13720261.0,1000,2600,500,500,0,56.10666666666667,499,75,22.637777777777778,6
Category_Wikipedia_sockpuppets_of_Chingjog.csv,8,47992.0,6,2,6,0,13,47.25,114,54,24.5,14
Category_Wikipedia_sockpuppets_of_Cantosys783.csv,5,261616.0,3,2,2,1,0,82.0,196,22,21.4,19
Category_Wikipedia_sockpuppets_of_Exacrion.csv,1894,28353567.0,742,1152,500,242,0,36.25501583949313,255,61,15.993136219640972,3
Category_Wikipedia_sockpuppets_of_Solomon7968.csv,2018,344345998.0,516,1502,500,16,0,51.344895936570865,364,84,23.129335976214072,4
Category_Wikipedia_sockpuppets_of_Akgideens.csv,868,27182560.0,350,518,299,51,0,41.79032258064516,329,69,18.82488479262673,5
Category_Wikipedia_sockpuppets_of_AbdulRehman_sattar.csv,243,2574476.0,72,171,70,2,0,68.08641975308642,500,46,15.292181069958847,4
Category_Wikipedia_sockpuppets_of_CanadianHistorian(MMA_&_History).csv,2188,45671543.0,1095,1093,500,595,0,40.212979890310784,500,55,23.61197440585009,7
Category_Wikipedia_sockpuppets_of_Curse_of_Fenric.csv,4887,301432416.0,1471,3416,500,971,0,51.73255576018007,323,89,29.578678125639453,3
Category_Wikipedia_sockpuppets_of_Grumpyrob.csv,355,75274505.0,153,202,60,93,0,34.4112676056338,216,78,22.864788732394366,3
Category_Wikipedia_sockpuppets_of_AlohnUsers.csv,21,864547.0,6,15,5,1,0,75.04761904761905,304,41,24.047619047619047,12
Category_Wikipedia_sockpuppets_of_Crotchety_Old_Man.csv,2175,4780979.0,564,1611,500,64,0,57.86666666666667,255,58,23.10896551724138,4
Category_Wikipedia_sockpuppets_of_Tbenzinger.csv,7782,347831982.0,2095,5687,385,1710,0,42.40208172706245,255,111,16.598303777949113,3
Category_Wikipedia_sockpuppets_of_Romello_Brooks.csv,2618,23945506.0,972,1646,500,472,0,46.28800611153552,376,77,21.094728800611154,3
Category_Wikipedia_sockpuppets_of_Pastykcutup.csv,593,22480204.0,237,356,56,181,0,45.231028667790895,255,65,20.952782462057336,5
Category_Wikipedia_sockpuppets_of_20spokesperson.csv,1904,168588221.0,664,1240,500,164,0,33.49422268907563,255,48,21.359768907563026,5
Category_Wikipedia_sockpuppets_of_Zerochanger.csv,258,7686937.0,73,185,18,55,0,58.35658914728682,214,35,12.988372093023257,4
Category_Wikipedia_sockpuppets_of_Brandon5015.csv,1972,135013990.0,781,1191,500,281,0,47.89756592292089,395,81,12.426977687626774,1
Category_Wikipedia_sockpuppets_of_Kutebuy.csv,175,6486061.0,40,135,32,8,0,70.09142857142857,255,50,15.851428571428572,5
Category_Wikipedia_sockpuppets_of_Yasin_ali1970.csv,39,10351629.0,12,27,12,0,0,60.84615384615385,217,15,10.205128205128204,4
Category_Wikipedia_sockpuppets_of_Arcang7.csv,148,193050841.0,58,90,42,16,0,40.5,228,43,16.925675675675677,4
Category_Wikipedia_sockpuppets_of_Pianist321.csv,1,0.0,1,0,1,0,0,0.0,0,17,17.0,17
Category_Wikipedia_sockpuppets_of_0001.csv,325,67094718.0,96,229,94,2,0,35.90461538461538,199,70,26.833846153846153,4
Category_Wikipedia_sockpuppets_of_Hinduism018.csv,192,1474879.0,105,87,75,30,0,55.9375,500,24,8.1875,7
Category_Wikipedia_sockpuppets_of_Pubcomp101.csv,14,139604.0,9,5,6,3,0,49.785714285714285,131,26,22.142857142857142,20
Category_Wikipedia_sockpuppets_of_Arman_ad60.csv,1380,40487035.0,562,818,500,62,0,48.358695652173914,255,47,20.58550724637681,4
Category_Wikipedia_sockpuppets_of_Bazadais.csv,59,1093940.0,24,35,17,7,0,52.23728813559322,337,42,31.322033898305083,17
Category_Wikipedia_sockpuppets_of_Jobieh.csv,306,121049715.0,86,220,32,54,0,40.19281045751634,233,47,16.38235294117647,9
Category_Wikipedia_sockpuppets_of_Gsnguy.csv,4172,381412414.0,1058,3114,500,558,0,36.49520613614573,286,68,13.759827420901246,3
Category_Wikipedia_sockpuppets_of_Alyaww.csv,9,10827356.0,6,3,3,3,0,45.77777777777778,195,43,30.22222222222222,20
Category_Wikipedia_sockpuppets_of_GameCritic.csv,11,53810.0,8,3,7,1,0,51.54545454545455,196,20,16.181818181818183,12
Category_Wikipedia_sockpuppets_of_L'grand_Anonim.csv,1434,35095343.0,474,960,340,134,0,54.86331938633194,498,50,30.27754532775453,5
Category_Wikipedia_sockpuppets_of_MetricMaster.csv,101,2766651.0,63,38,47,16,0,28.465346534653467,217,71,39.67326732673267,9
Category_Wikipedia_sockpuppets_of_Polaron.csv,1757,250981142.0,527,1230,500,27,0,58.178144564598746,250,87,27.815594763801936,7
Category_Wikipedia_sockpuppets_of_Greier.csv,3645,31468008.0,1218,2427,500,718,0,32.99615912208505,200,57,18.273251028806584,3
Category_Wikipedia_sockpuppets_of_Ps_Saifi_M.csv,88,187595744.0,28,60,10,18,0,55.81818181818182,237,27,11.670454545454545,5
Category_Wikipedia_sockpuppets_of_Art_Lover.csv,824,325821915.0,247,577,139,108,0,49.21116504854369,456,86,20.196601941747574,4
Category_Wikipedia_sockpuppets_of_Tercessuinotlim.csv,744,4173289.0,230,514,213,17,0,43.16263440860215,254,51,19.981182795698924,5
Category_Wikipedia_sockpuppets_of_Mohariz.csv,4,54729.0,4,0,4,0,0,36.5,60,20,15.25,12
Category_Wikipedia_sockpuppets_of_Djkoushik.csv,13,150359.0,10,3,7,3,0,27.76923076923077,94,42,30.615384615384617,9
Category_Wikipedia_sockpuppets_of_Musaddiq_indikar.csv,14,22542430.0,8,6,6,2,0,57.714285714285715,163,29,25.571428571428573,21
Category_Wikipedia_sockpuppets_of_Sayyid_Mir_Israfil.csv,689,88174219.0,227,462,103,124,0,53.92017416545718,510,58,18.04499274310595,3
Category_Wikipedia_sockpuppets_of_Thepoliticsexpert.csv,3355,200185589.0,976,2379,450,526,0,49.915946348733236,500,70,18.64053651266766,3
Category_Wikipedia_sockpuppets_of_Gun23man.csv,1870,52337758.0,591,1279,189,402,0,48.61336898395722,500,51,19.413903743315508,3
Category_Wikipedia_sockpuppets_of_Donbrandoni.csv,227,1927785.0,67,160,37,30,0,51.096916299559474,233,58,21.31718061674009,7
Category_Wikipedia_sockpuppets_of_Zmarcel32.csv,308,6680273.0,127,181,56,71,0,34.74025974025974,325,56,32.69155844155844,17
Category_Wikipedia_sockpuppets_of_Sileebo.csv,455,145461078.0,91,364,89,2,0,53.081318681318685,266,45,15.448351648351649,4
Category_Wikipedia_sockpuppets_of_Adam_Chacko.csv,253,7058732.0,68,185,58,10,0,56.58498023715415,274,54,20.91699604743083,7
Category_Wikipedia_sockpuppets_of_TheREALCableGuy.csv,2292,104230442.0,595,1697,500,95,0,37.93804537521815,255,57,16.597731239092496,3
Category_Wikipedia_sockpuppets_of_Bablu_Baghel.csv,1638,186029719.0,705,933,500,205,0,36.52014652014652,358,53,14.898656898656899,4
Category_Wikipedia_sockpuppets_of_Outdoorsmen2000.csv,1161,258859631.0,364,797,100,264,0,48.56330749354005,500,62,20.00344530577089,4
Category_Wikipedia_sockpuppets_of_Spiderpig449.csv,19,324175.0,14,5,13,1,0,65.36842105263158,215,11,8.789473684210526,5
Category_Wikipedia_sockpuppets_of_JARIAN.csv,790,54282750.0,187,603,187,0,0,30.20379746835443,208,49,16.52278481012658,3
Category_Wikipedia_sockpuppets_of_IslamForEver1.csv,432,38389149.0,166,266,36,130,0,43.282407407407405,228,29,16.88888888888889,12
Category_Wikipedia_sockpuppets_of_RonaldRon.csv,18,3684891.0,10,8,6,4,0,34.611111111111114,182,17,13.666666666666666,13
Category_Wikipedia_sockpuppets_of_Latin_Wolf.csv,1599,10354741.0,505,1094,500,5,0,40.41588492808005,255,50,13.752970606629143,4
Category_Wikipedia_sockpuppets_of_Aristotele1982.csv,1207,194979192.0,300,907,291,9,0,62.59983429991715,499,69,18.569179784589892,3
Category_Wikipedia_sockpuppets_of_Sheriff_Leader_908.csv,81,243262.0,33,48,20,13,0,66.06172839506173,270,38,33.23456790123457,23
Category_Wikipedia_sockpuppets_of_Speak23.csv,163,277989883.0,83,80,79,4,0,38.83435582822086,315,34,14.042944785276074,10
Category_Wikipedia_sockpuppets_of_FFS19.csv,1358,1737317.0,519,839,437,82,0,47.40500736377025,500,52,19.739322533136967,4
Category_Wikipedia_sockpuppets_of_ChrisfromHouston.csv,4813,171503886.0,1164,3649,500,664,0,63.7567006025348,255,84,19.431955121545812,3
Category_Wikipedia_sockpuppets_of_Superfast1111.csv,1573,194673951.0,508,1065,500,8,0,43.446280991735534,451,57,27.322949777495232,6
Category_Wikipedia_sockpuppets_of_Tyler_Ricks.csv,1674,105754366.0,727,947,500,227,0,41.80406212664277,255,61,18.38888888888889,5
Category_Wikipedia_sockpuppets_of_TheLegend27t.csv,15,1329.0,10,5,5,5,0,50.46666666666667,191,12,11.266666666666667,11
Category_Wikipedia_sockpuppets_of_MrTallBoy.csv,152,35896404.0,58,94,34,24,0,43.30921052631579,231,73,15.506578947368421,7
Category_Wikipedia_sockpuppets_of_Pahareo.csv,76,64096437.0,28,48,15,13,0,51.55263157894737,220,21,19.18421052631579,19
Category_Wikipedia_sockpuppets_of_Yui_Ponyo.csv,748,1369004.0,245,503,184,61,0,36.27272727272727,230,33,13.004010695187166,3
Category_Wikipedia_sockpuppets_of_Bonnie_Nagy.csv,14,192049.0,8,6,5,3,0,37.714285714285715,107,28,22.571428571428573,15
Category_Wikipedia_sockpuppets_of_Secord150.csv,233,14555598.0,68,165,51,17,0,58.09012875536481,255,69,26.330472103004293,11
Category_Wikipedia_sockpuppets_of_Mridul_varma_tharakan.csv,2490,4633299.0,915,1575,500,415,0,32.30120481927711,306,59,17.225301204819278,4
Category_Wikipedia_sockpuppets_of_MNB9911.csv,5689,26606644.0,1935,3754,500,1435,0,56.53401300755844,467,79,17.11197046932677,3
Category_Wikipedia_sockpuppets_of_Divineabraham.csv,2179,42856486.0,794,1385,435,359,0,50.11335474988527,249,72,22.773290500229464,5
Category_Wikipedia_sockpuppets_of_MAB1970.csv,10,2682391.0,3,7,3,0,6,42.2,90,47,34.3,13
Category_Wikipedia_sockpuppets_of_Infonerd2216.csv,41,135728.0,19,22,19,0,0,29.365853658536587,113,35,22.29268292682927,12
Category_Wikipedia_sockpuppets_of_Cumanche.csv,323,356879874.0,151,172,141,10,0,46.4891640866873,255,56,16.28482972136223,8
Category_Wikipedia_sockpuppets_of_M4th5.csv,535,307872146.0,171,364,168,3,0,43.8803738317757,249,47,18.829906542056076,7
Category_Wikipedia_sockpuppets_of_Adam_patsey.csv,311,51849186.0,111,200,98,13,0,41.20900321543408,314,22,13.813504823151126,5
Category_Wikipedia_sockpuppets_of_Johnsydney123.csv,221,41490459.0,113,108,39,74,0,38.94570135746606,240,48,16.407239819004523,6
Category_Wikipedia_sockpuppets_of_Taqi_Inalessa_Sany.csv,168,8737464.0,45,123,22,23,0,57.99404761904762,494,33,18.011904761904763,5
Category_Wikipedia_sockpuppets_of_Twinkelvi.csv,41,57522.0,16,25,6,10,0,37.4390243902439,192,52,32.48780487804878,13
Category_Wikipedia_sockpuppets_of_Mark.matthews1234.csv,18,146696.0,10,8,5,5,15,48.888888888888886,138,20,13.277777777777779,9
Category_Wikipedia_sockpuppets_of_Lelemera.csv,125,6792415.0,47,78,28,19,0,57.2,283,51,24.68,4
Category_Wikipedia_sockpuppets_of_Mr.sahota.csv,355,90882562.0,135,220,72,63,0,45.23380281690141,226,52,18.70985915492958,6
Category_Wikipedia_sockpuppets_of_Jungan_Pratama.csv,113,15412863.0,39,74,21,18,0,47.902654867256636,325,31,18.168141592920353,5
Category_Wikipedia_sockpuppets_of_Dr_Claudio.csv,1291,14764504.0,449,842,423,26,0,33.72347017815647,221,83,29.727343144848955,6
Category_Wikipedia_sockpuppets_of_Michael_182.csv,887,14591519.0,223,664,207,16,0,44.49492671927847,255,97,48.51860202931229,9
Category_Wikipedia_sockpuppets_of_Rashidhosseini3.csv,54,7574464.0,21,33,20,1,0,58.24074074074074,239,53,31.833333333333332,17
Category_Wikipedia_sockpuppets_of_Richardaldinho.csv,283,75224273.0,99,184,52,47,0,42.293286219081274,325,45,17.406360424028268,8
Category_Wikipedia_sockpuppets_of_Parsnipdude.csv,104,384571591.0,30,74,19,11,0,53.5,229,43,22.625,10
Category_Wikipedia_sockpuppets_of_A1Houseboy.csv,4579,54112828.0,1391,3188,439,952,0,46.32627211181481,255,83,23.525223848001747,4
Category_Wikipedia_sockpuppets_of_Andyscotlandlewis.csv,386,8823540.0,180,206,102,78,0,48.170984455958546,240,27,18.803108808290155,8
Category_Wikipedia_sockpuppets_of_LiberalReformer.csv,17,36507.0,13,4,12,1,25,86.52941176470588,288,20,14.294117647058824,13
Category_Wikipedia_sockpuppets_of_37KZ.csv,1361,55813477.0,505,856,500,5,0,48.370315944158705,292,55,19.575312270389418,4
Category_Wikipedia_sockpuppets_of_Ruzgar.csv,294,11673186.0,70,224,70,0,0,27.510204081632654,242,50,18.714285714285715,5
Category_Wikipedia_sockpuppets_of_JeSuisBilly.csv,616,21271770.0,207,409,207,0,0,31.70616883116883,255,70,31.54383116883117,7
Category_Wikipedia_sockpuppets_of_Sahil193319.csv,1268,9766063.0,564,704,500,64,0,33.25078864353312,500,73,24.08832807570978,9
Category_Wikipedia_sockpuppets_of_PatPeter.csv,2870,192249008.0,1000,1870,500,500,0,39.59163763066202,255,81,21.990592334494774,1
Category_Wikipedia_sockpuppets_of_Motodragon2044.csv,343,57709340.0,127,216,64,63,0,43.71137026239067,309,60,26.685131195335277,14
Category_Wikipedia_sockpuppets_of_Pradeepkumarxplorer.csv,18,116929.0,10,8,7,3,0,66.94444444444444,252,26,16.77777777777778,14
Category_Wikipedia_sockpuppets_of_Enjois.csv,5271,226411553.0,1542,3729,102,1440,0,48.50787326882944,500,75,19.024852969076075,4
Category_Wikipedia_sockpuppets_of_Kelmaa.csv,1420,61017905.0,458,962,420,38,0,48.86408450704225,496,53,17.319014084507042,4
Category_Wikipedia_sockpuppets_of_JackSarfatti.csv,374,7022539.0,216,158,215,1,0,30.772727272727273,141,28,22.446524064171122,7
Category_Wikipedia_sockpuppets_of_Sabuj_Tapos.csv,75,4078875.0,30,45,15,15,0,42.56,187,47,22.253333333333334,8
Category_Wikipedia_sockpuppets_of_-dantbh.csv,5810,216974237.0,1984,3826,500,1484,0,31.883993115318418,255,75,22.714629948364887,2
Category_Wikipedia_sockpuppets_of_Anuj_Choudhary_Ror.csv,5129,12854826.0,2104,3025,500,1604,0,42.20530317800741,500,64,14.760772080327548,3
Category_Wikipedia_sockpuppets_of_BlackBear279.csv,6,3756206.0,5,1,3,2,0,83.5,197,52,33.666666666666664,17
Category_Wikipedia_sockpuppets_of_Anti4ITCELL.csv,149,779515.0,83,66,80,3,0,57.2751677852349,463,29,14.006711409395972,5
Category_Wikipedia_sockpuppets_of_Braaad.csv,492,6567711.0,230,262,230,0,0,22.67479674796748,175,45,19.96747967479675,11
Category_Wikipedia_sockpuppets_of_EvilAlex.csv,1367,34713713.0,594,773,500,94,0,41.986832479882956,235,86,17.211411850768105,7
Category_Wikipedia_sockpuppets_of_ToiletBot_McDick.csv,184,90186.0,56,128,37,19,0,40.83152173913044,279,41,27.902173913043477,5
Category_Wikipedia_sockpuppets_of_Dcelano.csv,1348,98313030.0,529,819,500,29,0,45.49183976261128,255,77,18.48887240356083,4
Category_Wikipedia_sockpuppets_of_Mateus_Televisa.csv,752,9252201.0,254,498,214,40,0,26.61037234042553,255,53,20.852393617021278,7
Category_Wikipedia_sockpuppets_of_DjMlindos.csv,244,66695491.0,101,143,17,84,0,42.55327868852459,244,53,20.74590163934426,6
Category_Wikipedia_sockpuppets_of_Wongmisgoingdown.csv,15,524307.0,7,8,3,4,0,39.2,128,36,25.666666666666668,11
Category_Wikipedia_sockpuppets_of_Sofiamar.csv,372,40414129.0,146,226,70,76,0,44.60752688172043,255,65,22.00537634408602,6
Category_Wikipedia_sockpuppets_of_Thelintos.csv,27,240794.0,15,12,11,4,0,39.333333333333336,163,37,21.296296296296298,12
Category_Wikipedia_sockpuppets_of_Majolat2000.csv,75,57189.0,27,48,15,12,0,39.586666666666666,195,36,16.706666666666667,9
Category_Wikipedia_sockpuppets_of_Arie»ôeni.csv,3,5753.0,3,0,2,1,0,69.0,194,14,11.333333333333334,6
Category_Wikipedia_sockpuppets_of_Sridhar1000.csv,1319,31980632.0,462,857,266,196,0,42.37452615617892,253,51,16.411675511751326,2
Category_Wikipedia_sockpuppets_of_MorenaReka.csv,1769,8564142.0,633,1136,500,133,0,41.19276427360091,251,57,20.75240248728095,5
Category_Wikipedia_sockpuppets_of_Mckhoii.csv,31,342569.0,14,17,11,3,0,39.096774193548384,84,55,32.41935483870968,17
Category_Wikipedia_sockpuppets_of_Sunenergy1.csv,197,144280434.0,87,110,36,51,0,45.76142131979695,221,17,12.609137055837563,11
Category_Wikipedia_sockpuppets_of_Grkbkny69.csv,1426,4439138.0,435,991,367,68,0,26.85413744740533,200,48,16.56591865357644,3
Category_Wikipedia_sockpuppets_of_Chasidy.csv,41,180802140.0,11,30,11,0,0,53.292682926829265,251,22,19.195121951219512,14
Category_Wikipedia_sockpuppets_of_Sumeroduo.csv,19,339486.0,9,10,8,1,0,26.210526315789473,186,44,28.42105263157895,10
Category_Wikipedia_sockpuppets_of_Toppergun.csv,5,1250080.0,4,1,2,2,0,53.6,113,11,11.0,11
Category_Wikipedia_sockpuppets_of_Bowser2500.csv,4159,32704486.0,1268,2891,500,768,0,35.48569367636451,255,68,21.163500841548448,2
Category_Wikipedia_sockpuppets_of_Hohanyao.csv,91,1208116.0,26,65,21,5,0,41.10989010989011,184,21,14.384615384615385,7
Category_Wikipedia_sockpuppets_of_Comet_Egypt.csv,2086,301711974.0,609,1477,492,117,0,49.61313518696069,395,64,29.656759348034516,8
Category_Wikipedia_sockpuppets_of_Cjbraves.csv,98,179361041.0,31,67,18,13,0,30.53061224489796,219,38,22.459183673469386,10
Category_Wikipedia_sockpuppets_of_Epictrex.csv,1158,18240940.0,405,753,379,26,0,56.49654576856649,438,47,20.253022452504318,4
Category_Wikipedia_sockpuppets_of_AALIYAH2014.csv,1243,20054883.0,317,926,315,2,0,29.724859211584874,272,49,16.032180209171358,3
Category_Wikipedia_sockpuppets_of_Sonic_Shadow_Silver.csv,376,13961062.0,140,236,59,81,0,20.502659574468087,199,60,21.784574468085108,4
Category_Wikipedia_sockpuppets_of_Group21)ss.csv,10,1566.0,7,3,4,3,0,32.5,108,17,13.2,11
Category_Wikipedia_sockpuppets_of_Awliya.csv,744,28341377.0,251,493,126,125,0,47.18682795698925,255,44,15.768817204301076,5
Category_Wikipedia_sockpuppets_of_Jacket729.csv,1,0.0,1,0,1,0,13,13.0,13,14,14.0,14
Category_Wikipedia_sockpuppets_of_Malaiya.csv,6989,539685209.0,2173,4816,500,1673,0,44.385176706252686,493,58,16.006152525397052,3
Category_Wikipedia_sockpuppets_of_Coach_wears_a_skirt.csv,2993,243129313.0,608,2385,176,432,0,42.39592382225192,245,57,14.211493484797861,3
Category_Wikipedia_sockpuppets_of_Thebyzantineman.csv,1,0.0,1,0,1,0,39,39.0,39,25,25.0,25
Category_Wikipedia_sockpuppets_of_Acyd101.csv,188,163839993.0,73,115,37,36,0,42.01063829787234,232,53,22.76063829787234,3
Category_Wikipedia_sockpuppets_of_Jackp.csv,2184,34294657.0,543,1641,500,43,0,33.8974358974359,200,51,15.446886446886447,4
Category_Wikipedia_sockpuppets_of_Reverb100.csv,1409,287917511.0,526,883,500,26,0,47.217885024840314,498,43,18.364088005677786,6
Category_Wikipedia_sockpuppets_of_Fourlaxers.csv,6247,204552505.0,1425,4822,500,925,0,42.07619657435569,424,81,21.271170161677606,5
Category_Wikipedia_sockpuppets_of_SSH_remoteserver.csv,1325,60717571.0,459,866,193,266,0,57.64679245283019,499,54,15.868679245283019,4
Category_Wikipedia_sockpuppets_of_Martytanaki.csv,164,247619504.0,50,114,29,21,0,44.8719512195122,362,47,21.378048780487806,9
Category_Wikipedia_sockpuppets_of_KOinfinite.csv,660,78710508.0,213,447,92,121,0,55.10151515151515,386,29,10.77878787878788,2
Category_Wikipedia_sockpuppets_of_DragonKing22.csv,3985,107806738.0,1084,2901,500,584,0,39.813048933500625,339,76,24.141530740276036,4
Category_Wikipedia_sockpuppets_of_Estnot.csv,2084,25991322.0,763,1321,500,263,0,70.72024952015354,500,70,26.687619961612285,6
Category_Wikipedia_sockpuppets_of_WikiKing626.csv,61,4687105.0,20,41,8,12,0,58.557377049180324,212,22,15.327868852459016,11
Category_Wikipedia_sockpuppets_of_Someone_who_likes_train_writing.csv,1674,39665950.0,664,1010,500,164,0,31.36200716845878,494,51,23.97610513739546,5
Category_Wikipedia_sockpuppets_of_Tkcmgl12.csv,1558,2709960.0,550,1008,500,50,0,35.28177150192555,339,59,18.171373555840823,3
Category_Wikipedia_sockpuppets_of_Billelaggab.csv,153,15812508.0,47,106,39,8,0,56.50326797385621,298,44,17.725490196078432,7
Category_Wikipedia_sockpuppets_of_MoroccanEd.csv,263,18634448.0,111,152,98,13,0,46.09885931558935,496,70,17.00380228136882,5
Category_Wikipedia_sockpuppets_of_Arnon_Chaffin.csv,1965,24091763.0,500,1465,500,0,0,50.59236641221374,255,59,18.971501272264632,1
Category_Wikipedia_sockpuppets_of_GothGrrrl.csv,585,167446117.0,117,468,104,13,0,53.76068376068376,254,45,13.271794871794873,4
Category_Wikipedia_sockpuppets_of_Roadsidemultimedia.csv,15,4755.0,7,8,7,0,0,42.06666666666667,149,30,22.2,10
Category_Wikipedia_sockpuppets_of_Jakecash1.csv,78,70567883.0,28,50,18,10,0,48.42307692307692,253,51,22.692307692307693,13
Category_Wikipedia_sockpuppets_of_The_Callipygian.csv,44,82155.0,28,16,26,2,0,46.04545454545455,192,45,29.113636363636363,24
Category_Wikipedia_sockpuppets_of_Sakincalimimar.csv,327,186214186.0,105,222,96,9,0,52.039755351681954,297,32,16.856269113149846,5
Category_Wikipedia_sockpuppets_of_Roobit.csv,689,66374062.0,263,426,258,5,0,32.97968069666183,213,69,18.88388969521045,3
Category_Wikipedia_sockpuppets_of_Hispanicfilmmaker.csv,425,1506789.0,130,295,93,37,0,51.65176470588235,314,44,20.416470588235295,7
Category_Wikipedia_sockpuppets_of_AmberleyChristmas.csv,232,29229149.0,64,168,12,52,0,47.75431034482759,496,43,22.663793103448278,8
Category_Wikipedia_sockpuppets_of_Mona_merry_Blue.csv,22,254309.0,13,9,10,3,0,83.9090909090909,386,23,20.045454545454547,10
Category_Wikipedia_sockpuppets_of_Mr_ArticleEditor.csv,113,82497.0,49,64,49,0,0,41.91150442477876,199,26,17.761061946902654,4
Category_Wikipedia_sockpuppets_of_AmCap-Marketing.csv,16,12065.0,9,7,8,1,0,39.25,208,26,25.25,23
Category_Wikipedia_sockpuppets_of_KCWikiEdits.csv,70,8646902.0,33,37,22,11,0,66.88571428571429,218,43,22.37142857142857,11
Category_Wikipedia_sockpuppets_of_Yogesh_Khandke.csv,1487,322960518.0,501,986,500,1,0,47.54741089441829,399,68,19.37525218560861,3
Category_Wikipedia_sockpuppets_of_Salaiken.csv,102,23002970.0,28,74,9,19,0,86.19607843137256,369,23,20.80392156862745,13
Category_Wikipedia_sockpuppets_of_BulgariaSources.csv,802,22809471.0,306,496,301,5,0,41.28304239401496,255,51,25.345386533665835,6
Category_Wikipedia_sockpuppets_of_Jjmruwka.csv,564,19697426.0,282,282,223,59,0,28.902482269503547,255,45,17.851063829787233,11
Category_Wikipedia_sockpuppets_of_Rohan19952009.csv,47,11083156.0,27,20,18,9,0,47.191489361702125,207,26,17.574468085106382,11
Category_Wikipedia_sockpuppets_of_Weird_gloop.csv,218,1499450.0,80,138,58,22,0,43.591743119266056,353,37,20.94495412844037,4
Category_Wikipedia_sockpuppets_of_Miallup_Nahte.csv,85,17617704.0,25,60,16,9,0,46.4,210,43,19.235294117647058,4
Category_Wikipedia_sockpuppets_of_Nicecorrector.csv,80,1812860.0,37,43,12,25,0,34.5125,263,28,14.8625,7
Category_Wikipedia_sockpuppets_of_Xotheusedguyox.csv,3069,15350773.0,1295,1774,500,795,0,29.488758553274682,217,81,16.97165200391007,6
Category_Wikipedia_sockpuppets_of_Levelingup2023.csv,48,17391315.0,18,30,8,10,0,48.958333333333336,141,25,21.8125,17
Category_Wikipedia_sockpuppets_of_Brancekahle.csv,14,1396372.0,9,5,4,5,0,29.214285714285715,143,15,11.285714285714286,7
Category_Wikipedia_sockpuppets_of_Zdawg1029.csv,2226,189094007.0,505,1721,500,5,0,55.27403414195867,327,79,19.259209344115003,3
Category_Wikipedia_sockpuppets_of_Wikiuser999111.csv,41,187753.0,26,15,26,0,0,35.73170731707317,164,35,31.21951219512195,30
Category_Wikipedia_sockpuppets_of_Leol12.csv,79,7433642.0,30,49,27,3,0,48.164556962025316,216,42,16.569620253164558,6
Category_Wikipedia_sockpuppets_of_Malcolmrevere.csv,1212,150137880.0,503,709,500,3,0,37.834158415841586,254,61,15.182343234323433,2
Category_Wikipedia_sockpuppets_of_7oceans.csv,325,6299101.0,112,213,72,40,0,48.47076923076923,250,46,18.138461538461538,8
Category_Wikipedia_sockpuppets_of_HaiNH1993.csv,75,164540737.0,15,60,14,1,0,43.08,254,19,8.08,3
Category_Wikipedia_sockpuppets_of_Pullbasket.csv,675,5063337.0,135,540,135,0,0,61.727407407407405,499,50,24.62074074074074,7
Category_Wikipedia_sockpuppets_of_Tfyugihoj.csv,85,78183661.0,60,25,50,10,0,45.6,439,54,25.870588235294118,19
Category_Wikipedia_sockpuppets_of_TwentytwoAug.csv,2158,24195398.0,736,1422,321,415,0,58.96895273401297,496,66,22.992585727525487,5
Category_Wikipedia_sockpuppets_of_RG654321.csv,4576,24768052.0,1698,2878,500,1198,0,40.91083916083916,255,74,15.363854895104895,3
Category_Wikipedia_sockpuppets_of_Shashanksinghvi334.csv,1111,186995177.0,562,549,500,62,0,59.063006300630065,263,95,25.622862286228624,4
Category_Wikipedia_sockpuppets_of_AltWhite.csv,1,0.0,1,0,1,0,19,19.0,19,14,14.0,14
Category_Wikipedia_sockpuppets_of_Luisa_Pisani.csv,66,117105.0,27,39,19,8,0,38.43939393939394,250,70,30.303030303030305,14
Category_Wikipedia_sockpuppets_of_Pcoo1898.csv,60,21540516.0,18,42,5,13,0,54.733333333333334,225,40,30.533333333333335,8
Category_Wikipedia_sockpuppets_of_Supreme_Elite_Commander.csv,51,4242995.0,14,37,5,9,0,54.549019607843135,187,59,29.50980392156863,14
Category_Wikipedia_sockpuppets_of_Garusha9.csv,17,2878952.0,6,11,5,1,0,54.470588235294116,202,26,16.235294117647058,9
Category_Wikipedia_sockpuppets_of_Plimonov.csv,51,272065498.0,11,40,11,0,0,50.3921568627451,188,25,10.901960784313726,3
Category_Wikipedia_sockpuppets_of_Utkarsh_Pandey.csv,2677,162097375.0,981,1696,500,481,0,45.20171834142697,500,86,29.70974971983564,4
Category_Wikipedia_sockpuppets_of_Viviocon.csv,15,1289.0,6,9,1,5,13,41.0,98,25,21.6,16
Category_Wikipedia_sockpuppets_of_Psr1427.csv,1,0.0,1,0,1,0,0,0.0,0,22,22.0,22
Category_Wikipedia_sockpuppets_of_TomTof.csv,24,9726414.0,9,15,5,4,0,40.0,154,29,27.083333333333332,13
Category_Wikipedia_sockpuppets_of_Patriotic1.csv,14,64908.0,9,5,8,1,0,42.714285714285715,151,14,14.0,14
Category_Wikipedia_sockpuppets_of_JarOfCrystals04.csv,53,4761052.0,17,36,12,5,0,46.075471698113205,222,31,15.641509433962264,9
Category_Wikipedia_sockpuppets_of_Sivanathsilly.csv,127,13752786.0,37,90,16,21,0,58.63779527559055,327,31,17.35433070866142,6
Category_Wikipedia_sockpuppets_of_Donnieo7357.csv,44,4507530.0,17,27,13,4,0,58.13636363636363,255,37,21.818181818181817,15
Category_Wikipedia_sockpuppets_of_Mushroom9.csv,9826,147133567.0,3577,6249,500,3077,0,36.6355587217586,255,85,23.51323020557704,3
Category_Wikipedia_sockpuppets_of_Kielcerin.csv,2602,17375529.0,739,1863,500,239,0,40.80822444273635,500,68,22.459262106072252,4
Category_Wikipedia_sockpuppets_of_KyokuTGM.csv,127,136333692.0,27,100,26,1,0,61.37795275590551,290,37,14.929133858267717,9
Category_Wikipedia_sockpuppets_of_Riley_cagle.csv,3,143.0,2,1,2,0,13,18.0,28,16,16.0,16
Category_Wikipedia_sockpuppets_of_Vishwachander.csv,61,170528285.0,15,46,14,1,0,37.42622950819672,150,18,14.770491803278688,5
Category_Wikipedia_sockpuppets_of_Nyaytyhyaynyiyeylyluytyeysy.csv,2381,43488937.0,705,1676,482,223,0,49.19277614447711,496,69,20.584628307433853,4
Category_Wikipedia_sockpuppets_of_Mc1150a.csv,10,7869706.0,7,3,3,4,3,34.9,177,11,11.0,11
Category_Wikipedia_sockpuppets_of_Manacpowers.csv,1787,19416207.0,623,1164,500,123,0,44.74538332400672,226,50,23.612758813654168,5
Category_Wikipedia_sockpuppets_of_Cohler.csv,1571,342498059.0,603,968,500,103,0,59.973901973265434,292,50,23.23360916613622,10
Category_Wikipedia_sockpuppets_of_Ssouperg.csv,8,804483.0,4,4,2,2,0,29.125,161,22,20.0,18
Category_Wikipedia_sockpuppets_of_Nickjames0423.csv,63,12315600.0,19,44,8,11,0,58.857142857142854,232,49,7.031746031746032,4
Category_Wikipedia_sockpuppets_of_Victor_Giarola.csv,377,16848423.0,123,254,107,16,0,52.63129973474801,495,53,13.188328912466844,4
Category_Wikipedia_sockpuppets_of_MinorityEqualizer.csv,35,691514.0,12,23,11,1,14,56.4,234,42,36.2,18
Category_Wikipedia_sockpuppets_of_Wliiam¬∑Shakespeare.csv,703,29604018.0,214,489,192,22,0,47.62588904694168,250,19,10.318634423897581,6
Category_Wikipedia_sockpuppets_of_Netgainmay.csv,13,2502324.0,8,5,6,2,0,53.0,181,40,30.46153846153846,22
Category_Wikipedia_sockpuppets_of_Factcitation.csv,98,792107.0,33,65,19,14,0,61.88775510204081,383,45,22.142857142857142,2
Category_Wikipedia_sockpuppets_of_LightFromABrightStar.csv,1787,242956954.0,424,1363,121,303,0,61.58477895914941,499,62,18.651371012870733,3
Category_Wikipedia_sockpuppets_of_Bomabenjy2.csv,95,5210248.0,40,55,35,5,0,45.36842105263158,196,41,21.073684210526316,15
Category_Wikipedia_sockpuppets_of_Appalachianhistory.csv,118,765373.0,38,80,19,19,0,65.45762711864407,494,34,17.906779661016948,9
Category_Wikipedia_sockpuppets_of_Kalyankokila.csv,49,4242257.0,27,22,14,13,0,37.97959183673469,196,22,18.306122448979593,15
Category_Wikipedia_sockpuppets_of_Rickymosslee.csv,19,527881.0,11,8,11,0,0,36.10526315789474,145,31,24.526315789473685,19
Category_Wikipedia_sockpuppets_of_John_adwic.csv,219,4325238.0,81,138,24,57,0,37.242009132420094,269,46,13.821917808219178,4
Category_Wikipedia_sockpuppets_of_Soccer980331.csv,2080,252027672.0,589,1491,500,89,0,39.79038461538462,311,55,20.54951923076923,4
Category_Wikipedia_sockpuppets_of_EGL1234.csv,2671,29441153.0,1004,1667,500,504,0,52.09509546986148,500,59,21.897416697865967,2
Category_Wikipedia_sockpuppets_of_Jageshwar.csv,1138,188424453.0,364,774,342,22,0,37.7311072056239,234,67,18.259226713532513,6
Category_Wikipedia_sockpuppets_of_PhilthyBear.csv,4060,26674006.0,1212,2848,500,712,0,44.853940886699505,250,67,18.80862068965517,3
Category_Wikipedia_sockpuppets_of_CrestvilIe.csv,83,334017.0,28,55,13,15,0,31.42168674698795,129,47,26.650602409638555,4
Category_Wikipedia_sockpuppets_of_Naius.csv,8,67482.0,6,2,6,0,0,47.25,116,15,15.0,15
Category_Wikipedia_sockpuppets_of_Legiallity.csv,1956,86008338.0,630,1326,294,336,0,44.897750511247445,255,61,18.236196319018404,3
Category_Wikipedia_sockpuppets_of_Grammeteo818.csv,91,7397343.0,45,46,18,27,0,37.010989010989015,196,38,19.571428571428573,12
Category_Wikipedia_sockpuppets_of_Me2000.csv,13,1214827.0,6,7,6,0,0,33.23076923076923,122,25,19.0,13
Category_Wikipedia_sockpuppets_of_TIAN_YOSI.csv,3,366.0,2,1,1,1,196,196.0,196,19,18.333333333333332,17
Category_Wikipedia_sockpuppets_of_Correctinfo86.csv,184,35530858.0,90,94,46,44,0,62.80978260869565,355,23,16.23913043478261,11
Category_Wikipedia_sockpuppets_of_D-MacDermott.csv,141,29430239.0,55,86,42,13,0,56.4113475177305,198,46,18.354609929078013,6
Category_Wikipedia_sockpuppets_of_Jasonrushworth.csv,42,463950.0,24,18,15,9,0,41.142857142857146,161,28,23.452380952380953,10
Category_Wikipedia_sockpuppets_of_Gala19000.csv,4238,169006519.0,1498,2740,500,998,0,59.16163284568193,502,74,30.02878716375649,6
Category_Wikipedia_sockpuppets_of_Wik.csv,4942,65613759.0,1523,3419,500,1023,0,20.1671388101983,202,72,18.80433023067584,2
Category_Wikipedia_sockpuppets_of_Isaburo.csv,5,806.0,4,1,2,2,18,35.6,82,56,45.6,30
Category_Wikipedia_sockpuppets_of_MihaiTheScienceGuy.csv,46,5804311.0,27,19,25,2,0,54.41304347826087,235,31,17.82608695652174,7
Category_Wikipedia_sockpuppets_of_Tony.dirks3.csv,564,38119887.0,196,368,126,70,0,29.47340425531915,255,47,15.73049645390071,4
Category_Wikipedia_sockpuppets_of_Facto.csv,1693,110411913.0,391,1302,370,21,0,39.78913171884229,249,74,24.141169521559362,5
Category_Wikipedia_sockpuppets_of_Dataice.csv,608,244585452.0,196,412,196,0,0,35.99671052631579,230,43,23.598684210526315,6
Category_Wikipedia_sockpuppets_of_Dmartinaus.csv,430,11225291.0,151,279,77,74,0,40.71395348837209,216,59,26.048837209302327,9
Category_Wikipedia_sockpuppets_of_Rindlams0.csv,42,5955.0,14,28,2,12,0,36.095238095238095,163,35,21.833333333333332,9
Category_Wikipedia_sockpuppets_of_Mohit_Bajgain.csv,426,26606916.0,153,273,82,71,0,41.39906103286385,280,53,21.561032863849764,7
Category_Wikipedia_sockpuppets_of_Georgivac.csv,185,152046607.0,70,115,65,5,0,42.47027027027027,247,47,25.32972972972973,14
Category_Wikipedia_sockpuppets_of_Sofiyulah.csv,36,9171028.0,16,20,12,4,12,61.5,143,29,23.02777777777778,14
Category_Wikipedia_sockpuppets_of_James_Cantor.csv,2304,271202134.0,753,1551,500,253,0,62.01649305555556,436,76,24.08550347222222,4
Category_Wikipedia_sockpuppets_of_Vimraj_Wilfred.csv,1030,6860731.0,295,735,199,96,0,30.73106796116505,302,74,24.780582524271846,8
Category_Wikipedia_sockpuppets_of_Super_Ito_Fan.csv,139,717583.0,41,98,22,19,0,60.32374100719424,373,36,18.705035971223023,7
Category_Wikipedia_sockpuppets_of_Emperordarius.csv,1656,48906238.0,486,1170,241,245,0,37.74335748792271,245,50,16.79649758454106,4
Category_Wikipedia_sockpuppets_of_Attaturk_is_Greek.csv,57,18757.0,18,39,12,6,0,39.63157894736842,181,40,16.140350877192983,5
Category_Wikipedia_sockpuppets_of_TimmyTurner1573.csv,407,106162378.0,137,270,41,96,0,45.54545454545455,254,44,21.835380835380835,9
Category_Wikipedia_sockpuppets_of_Jurijus_Pacalovas.csv,133,9775234.0,69,64,17,52,0,52.43609022556391,268,28,15.894736842105264,7
Category_Wikipedia_sockpuppets_of_Vishnugoyallive.csv,128,129216790.0,26,102,17,9,0,57.6328125,284,54,25.875,3
Category_Wikipedia_sockpuppets_of_MuhammetFurkan1.csv,362,38728538.0,74,288,59,15,0,47.61878453038674,481,34,15.403314917127071,4
Category_Wikipedia_sockpuppets_of_Prioryman.csv,2171,424405713.0,715,1456,500,215,0,55.76646706586826,494,63,18.37125748502994,3
Category_Wikipedia_sockpuppets_of_Vybr8.csv,7674,258152954.0,1740,5934,500,1240,0,67.50886108939275,499,70,19.111284857961948,2
Category_Wikipedia_sockpuppets_of_Infopage100.csv,1121,22713003.0,557,564,500,57,0,42.570026761819804,258,73,18.856378233719894,4
Category_Wikipedia_sockpuppets_of_Jacobariel91.csv,404,2899096.0,120,284,88,32,0,55.87871287128713,223,54,38.74752475247525,12
Category_Wikipedia_sockpuppets_of_Morgananderson82.csv,32,2445339.0,22,10,14,8,0,27.53125,122,39,33.40625,19
Category_Wikipedia_sockpuppets_of_Sudafedfiend8.csv,10934,55823560.0,4085,6849,443,3642,0,40.31854764953356,264,83,17.91009694530821,3
Category_Wikipedia_sockpuppets_of_Mostafa130868.csv,663,18921897.0,183,480,41,142,0,50.328808446455504,303,66,19.182503770739064,5
Category_Wikipedia_sockpuppets_of_Abbasshaikh124.csv,14159,125399196.0,4169,9990,500,3669,0,46.414436047743486,499,93,18.728370647644606,3
Category_Wikipedia_sockpuppets_of_Marcomarati.csv,69,6153848.0,23,46,16,7,0,45.7536231884058,202,31,17.115942028985508,9
Category_Wikipedia_sockpuppets_of_M_Cedric_Pimenta.csv,219,52240300.0,84,135,27,57,0,59.26027397260274,496,53,19.8675799086758,3
Category_Wikipedia_sockpuppets_of_Immaeditdis.csv,11,59801.0,8,3,4,4,0,49.54545454545455,128,27,13.909090909090908,11
Category_Wikipedia_sockpuppets_of_MagdelenaDiArco.csv,1784,7099637.0,726,1058,392,334,0,34.028587443946186,213,57,18.293721973094172,3
Category_Wikipedia_sockpuppets_of_Unifiedmagazine.csv,9,2557369.0,4,5,1,3,0,63.888888888888886,145,47,25.666666666666668,21
Category_Wikipedia_sockpuppets_of_Avoided.csv,1941,132290544.0,501,1440,500,1,0,71.01957753735188,255,67,18.16486347243689,1
Category_Wikipedia_sockpuppets_of_The_Mystery_Man.csv,14067,31389820.0,3826,10241,500,3326,0,31.99317551716784,250,82,17.285277600056872,6
Category_Wikipedia_sockpuppets_of_Mokezhilao.csv,332,27162461.0,116,216,52,64,0,40.6144578313253,253,56,13.108433734939759,5
Category_Wikipedia_sockpuppets_of_AnonTroller.csv,34,90806004.0,9,25,9,0,0,85.32352941176471,399,34,18.235294117647058,12
Category_Wikipedia_sockpuppets_of_M3diaguide.csv,455,96274431.0,168,287,119,49,0,47.32747252747253,247,61,15.793406593406594,4
Category_Wikipedia_sockpuppets_of_Ladispeaks.csv,298,116807907.0,100,198,77,23,0,47.98322147651007,255,62,20.110738255033556,4
Category_Wikipedia_sockpuppets_of_RDivya55.csv,232,3802431.0,56,176,55,1,0,27.810344827586206,151,30,17.051724137931036,8
Category_Wikipedia_sockpuppets_of_Sschaal2.csv,44,17576576.0,33,11,23,10,0,17.727272727272727,179,18,13.454545454545455,13
Category_Wikipedia_sockpuppets_of_Rashedul_Lion.csv,2,0.0,1,1,1,0,20,20.0,20,30,30.0,30
Category_Wikipedia_sockpuppets_of_Eowbotm.csv,44,1217901.0,14,30,12,2,0,42.97727272727273,168,25,10.0,5
Category_Wikipedia_sockpuppets_of_Mudassariqbal59.csv,81,6041117.0,37,44,23,14,0,53.32098765432099,438,51,16.308641975308642,11
Category_Wikipedia_sockpuppets_of_MasterBait.csv,10,5549.0,6,4,6,0,0,73.3,134,22,15.2,12
Category_Wikipedia_sockpuppets_of_F1F2F2.csv,4146,63939397.0,1500,2646,450,1050,0,45.39845634346358,255,74,16.364206464061745,3
Category_Wikipedia_sockpuppets_of_Cjwright79.csv,3714,18943876.0,1243,2471,500,743,0,30.91357027463651,250,66,22.992460958535272,4
Category_Wikipedia_sockpuppets_of_Hungrygyhhbgftygv.csv,161,21143344.0,54,107,32,22,0,38.36645962732919,242,37,31.180124223602483,22
Category_Wikipedia_sockpuppets_of_Worldometers.csv,987,24300709.0,613,374,500,113,0,25.541033434650455,496,40,22.149949341438703,4
Category_Wikipedia_sockpuppets_of_Aglrochisat.csv,2535,41780208.0,928,1607,500,428,0,48.748717948717946,444,85,20.514792899408285,2
Category_Wikipedia_sockpuppets_of_Humor_Editori.csv,1927,99388112.0,487,1440,236,251,0,50.956408925791386,394,91,19.077841203943954,3
Category_Wikipedia_sockpuppets_of_Yobtar1.csv,576,29497524.0,210,366,120,90,0,45.942708333333336,249,47,17.31423611111111,7
Category_Wikipedia_sockpuppets_of_Brandify_Global_Services.csv,2,0.0,1,1,1,0,78,78.0,78,34,34.0,34
Category_Wikipedia_sockpuppets_of_IeBariRM.csv,26,378456.0,11,15,5,6,0,45.19230769230769,184,36,22.23076923076923,13
Category_Wikipedia_sockpuppets_of_Bech86.csv,1557,460338759.0,476,1081,464,12,0,44.86962106615286,261,69,17.432883750802826,4
Category_Wikipedia_sockpuppets_of_Er._Nishant_Saxena__AAHAAN_.csv,2,0.0,1,1,1,0,36,36.0,36,31,31.0,31
Category_Wikipedia_sockpuppets_of_Hernando.cortez.csv,1,0.0,1,0,1,0,14,14.0,14,35,35.0,35
Category_Wikipedia_sockpuppets_of_Infomanager.csv,1072,28339429.0,419,653,173,246,0,28.379664179104477,200,74,29.56063432835821,8
Category_Wikipedia_sockpuppets_of_George134.csv,73,112838.0,38,35,37,1,0,59.54794520547945,242,48,22.465753424657535,14
Category_Wikipedia_sockpuppets_of_Mihic3.csv,33,147317275.0,11,22,8,3,0,26.848484848484848,149,35,21.818181818181817,6
Category_Wikipedia_sockpuppets_of_Dpgame.csv,50,2500824.0,18,32,17,1,0,36.08,163,75,30.32,14
Category_Wikipedia_sockpuppets_of_Ledenierhomme.csv,6464,130559608.0,1827,4637,500,1327,0,49.054146039603964,255,63,19.715191831683168,3
Category_Wikipedia_sockpuppets_of_Financeexpert331.csv,130,15533557.0,30,100,25,5,0,71.75384615384615,363,35,15.246153846153845,7
Category_Wikipedia_sockpuppets_of_Charlesquebec.csv,3041,28039302.0,1248,1793,500,748,0,36.524827359421245,250,71,25.64419598816179,6
Category_Wikipedia_sockpuppets_of_Renuka_sarkar.csv,919,256756057.0,336,583,318,18,0,47.2557127312296,500,52,18.11969532100109,5
Category_Wikipedia_sockpuppets_of_Quidysquidypedia.csv,1,0.0,1,0,1,0,0,0.0,0,15,15.0,15
Category_Wikipedia_sockpuppets_of_AS92813.csv,422,12684199.0,155,267,82,73,0,47.50473933649289,232,62,26.37440758293839,8
Category_Wikipedia_sockpuppets_of_Green_Fashion_Week.csv,7,6145684.0,4,3,3,1,0,77.28571428571429,166,24,21.142857142857142,19
Category_Wikipedia_sockpuppets_of_Godusisasassada.csv,14,2173093.0,6,8,4,2,0,75.78571428571429,183,27,18.928571428571427,14
Category_Wikipedia_sockpuppets_of_Bermsalot.csv,495,303717703.0,150,345,138,12,0,52.836363636363636,319,46,17.161616161616163,5
Category_Wikipedia_sockpuppets_of_Maniyababaee.csv,69,12598025.0,29,40,19,10,0,40.73913043478261,152,53,32.608695652173914,14
Category_Wikipedia_sockpuppets_of_Asdfghjkl9658.csv,2378,66806633.0,525,1853,500,25,0,46.100504625735915,384,62,20.357863751051305,4
Category_Wikipedia_sockpuppets_of_ToQ100gou.csv,1515,295152067.0,507,1008,500,7,0,44.86402640264026,496,70,21.963036303630364,8
Category_Wikipedia_sockpuppets_of_Smethport.csv,1590,58238250.0,480,1110,307,173,0,53.78050314465409,496,82,19.069811320754717,3
Category_Wikipedia_sockpuppets_of_CraftedRL.csv,17,1830.0,11,6,8,3,0,85.0,217,19,16.352941176470587,16
Category_Wikipedia_sockpuppets_of_Thetruewikiguy.csv,6,1168.0,5,1,4,1,0,5.5,33,49,33.0,17
Category_Wikipedia_sockpuppets_of_ChinaKnowledge2001.csv,1,0.0,1,0,1,0,18,18.0,18,28,28.0,28
Category_Wikipedia_sockpuppets_of_Wanderer123.csv,826,113959488.0,344,482,279,65,0,28.812348668280872,217,34,19.216707021791766,6
Category_Wikipedia_sockpuppets_of_Encoreameya.csv,456,72259142.0,165,291,152,13,0,61.14473684210526,255,54,21.037280701754387,6
Category_Wikipedia_sockpuppets_of_AnnLivinova.csv,11087,76153132.0,3630,7457,500,3130,0,31.056282132226933,255,70,17.750518625417154,4
Category_Wikipedia_sockpuppets_of_FrozenFan2.csv,4061,181853226.0,1130,2931,500,630,0,42.36419601083477,395,84,17.389559221866534,5
Category_Wikipedia_sockpuppets_of_DrCoolio3.csv,172,35617554.0,41,131,34,7,0,46.22093023255814,254,36,16.325581395348838,5
Category_Wikipedia_sockpuppets_of_Ge0ffrey_de_smet.csv,181,418985886.0,49,132,49,0,0,51.0828729281768,221,47,25.574585635359117,11
Category_Wikipedia_sockpuppets_of_Papisjap.csv,110,125937751.0,28,82,23,5,0,49.17272727272727,219,41,17.454545454545453,2
Category_Wikipedia_sockpuppets_of_Mopterhlaf.csv,14,898.0,9,5,6,3,0,59.0,153,5,5.0,5
Category_Wikipedia_sockpuppets_of_IntermezzoMan.csv,988,106042389.0,367,621,90,277,0,53.13157894736842,496,71,20.445344129554655,4
Category_Wikipedia_sockpuppets_of_Por_Por_2.csv,583,12966347.0,211,372,82,129,0,36.313893653516296,249,47,19.900514579759864,5
Category_Wikipedia_sockpuppets_of_Hellow34.csv,1210,67620338.0,396,814,384,12,0,41.57685950413223,359,55,19.517355371900827,4
Category_Wikipedia_sockpuppets_of_Alinss4.csv,129,23701162.0,36,93,15,21,0,55.031007751937985,302,20,13.666666666666666,6
Category_Wikipedia_sockpuppets_of_SnehaBanik.csv,85,22797254.0,26,59,16,10,0,52.10588235294118,234,49,18.788235294117648,7
Category_Wikipedia_sockpuppets_of_Googlekerala.csv,68,24979130.0,30,38,30,0,0,39.661764705882355,228,35,24.514705882352942,12
Category_Wikipedia_sockpuppets_of_DollDunn03.csv,70,8044882.0,52,18,19,33,0,56.18571428571428,312,24,12.571428571428571,10
Category_Wikipedia_sockpuppets_of_Benabeleda26.csv,246,24873971.0,60,186,15,45,0,44.296747967479675,331,44,21.617886178861788,9
Category_Wikipedia_sockpuppets_of_DidYouDoIt.csv,12,513397.0,5,7,1,4,0,44.25,213,46,33.25,11
Category_Wikipedia_sockpuppets_of_Pankajclub12.csv,788,22632919.0,273,515,254,19,0,37.505076142131976,255,50,16.543147208121827,3
Category_Wikipedia_sockpuppets_of_Virtualizer.csv,324,437861277.0,101,223,67,34,0,54.28395061728395,258,45,20.145061728395063,8
Category_Wikipedia_sockpuppets_of_Randomname341351.csv,3,537152.0,2,1,1,1,43,116.33333333333333,188,16,16.0,16
Category_Wikipedia_sockpuppets_of_Scallywag787.csv,5003,35429134.0,1674,3329,500,1174,0,40.33699780131921,255,66,14.696781930841496,3
Category_Wikipedia_sockpuppets_of_Jaryed_Hagerty_173031.csv,127,10012275.0,39,88,35,4,0,40.74015748031496,249,57,26.58267716535433,12
Category_Wikipedia_sockpuppets_of_Jirachi.csv,27,1323476.0,9,18,8,1,0,35.77777777777778,134,26,12.88888888888889,7
Category_Wikipedia_sockpuppets_of_Zack9764.csv,21,131141722.0,5,16,4,1,0,58.523809523809526,154,31,19.714285714285715,11
Category_Wikipedia_sockpuppets_of_Bitafarhadi.csv,645,31025925.0,129,516,57,72,0,47.648062015503875,255,34,13.068217054263567,4
Category_Wikipedia_sockpuppets_of_Wilkinsonp.csv,21,80565.0,8,13,5,3,0,83.61904761904762,178,29,22.523809523809526,19
Category_Wikipedia_sockpuppets_of_Goutamkumar_Oinam.csv,3292,67218830.0,1542,1750,500,1042,0,31.309538274605103,331,47,16.920716889428917,2
Category_Wikipedia_sockpuppets_of_Sheela_Charitable_Foundation.csv,4,106.0,2,2,2,0,23,28.5,34,38,38.0,38
Category_Wikipedia_sockpuppets_of_Smmithers54894.csv,65,66166.0,22,43,15,7,0,48.246153846153845,237,31,14.061538461538461,6
Category_Wikipedia_sockpuppets_of_ÿπŸÑ€å_ÿÆÿ≥ÿ±Ÿà€å_€±€µ.csv,153,45469385.0,53,100,13,40,0,43.33986928104575,200,30,15.764705882352942,5
Category_Wikipedia_sockpuppets_of_Stevieboii.csv,20,1649647.0,7,13,4,3,0,67.75,195,18,14.0,10
Category_Wikipedia_sockpuppets_of_Deepal66.csv,110,8739916.0,48,62,31,17,0,49.78181818181818,252,31,17.59090909090909,11
Category_Wikipedia_sockpuppets_of_AugustinBeyArticle.csv,14,1974275.0,8,6,4,4,0,32.642857142857146,151,35,13.642857142857142,12
Category_Wikipedia_sockpuppets_of_FilmMakers00023.csv,508,45894365.0,191,317,181,10,0,33.42913385826772,255,30,16.415354330708663,6
Category_Wikipedia_sockpuppets_of_HelmandAGoGo.csv,685,12657709.0,157,528,27,130,0,46.56788321167883,223,38,14.545985401459854,3
Category_Wikipedia_sockpuppets_of_Bristyomor861.csv,5,5259.0,5,0,5,0,0,22.2,59,26,26.0,26
Category_Wikipedia_sockpuppets_of_WhatsUpWorld.csv,15647,76404854.0,3912,11735,500,3412,0,42.91896210136128,500,87,19.827698600370677,3
Category_Wikipedia_sockpuppets_of_Tanya09.csv,281,26400104.0,68,213,5,63,0,47.07473309608541,220,51,16.80782918149466,6
Category_Wikipedia_sockpuppets_of_BNJ_Nilam.csv,1871,85538643.0,580,1291,414,166,0,41.553180117584176,496,78,21.195082843399252,4
Category_Wikipedia_sockpuppets_of_Christinacz.csv,13,27560444.0,3,10,2,1,0,62.0,231,17,10.307692307692308,4
Category_Wikipedia_sockpuppets_of_Thisistheworst.csv,437,76501662.0,133,304,86,47,0,50.97711670480549,343,45,16.988558352402745,4
Category_Wikipedia_sockpuppets_of_Aravono.csv,14,16920485.0,10,4,5,5,0,20.928571428571427,123,17,14.142857142857142,12
Category_Wikipedia_sockpuppets_of_CalEditerILikeTrain.csv,1479,91058067.0,490,989,487,3,0,46.26504394861393,399,211,20.30764029749831,4
Category_Wikipedia_sockpuppets_of_Honesty_Best.csv,104,326905.0,30,74,20,10,0,55.22115384615385,310,22,14.596153846153847,10
Category_Wikipedia_sockpuppets_of_TrackSparks.csv,9,1934009.0,7,2,4,3,0,82.22222222222223,251,18,18.0,18
Category_Wikipedia_sockpuppets_of_AlphaHero21.csv,282,78368911.0,91,191,48,43,0,36.290780141843975,220,41,13.47163120567376,5
Category_Wikipedia_sockpuppets_of_Chiefeditor001.csv,121,162828.0,47,74,31,16,0,48.48760330578512,231,58,22.735537190082646,7
Category_Wikipedia_sockpuppets_of_Thomaschilds1998.csv,8,33433620.0,2,6,2,0,0,38.75,171,26,17.0,14
Category_Wikipedia_sockpuppets_of_Allknowingroger.csv,1115,14154948.0,502,613,500,2,0,46.22780269058296,259,33,14.170403587443946,5
Category_Wikipedia_sockpuppets_of_Jaqalig.csv,16,1738010.0,10,6,8,2,0,42.9375,177,28,15.8125,13
Category_Wikipedia_sockpuppets_of_Authorgaurav.csv,107,11389838.0,35,72,23,12,0,38.4392523364486,207,62,34.3177570093458,13
Category_Wikipedia_sockpuppets_of_Firoz6767.csv,184,8333779.0,51,133,42,9,0,46.755434782608695,221,56,21.092391304347824,9
Category_Wikipedia_sockpuppets_of_BonheurFDS.csv,4330,205299056.0,1116,3214,500,616,0,66.25196304849885,255,70,17.618706697459583,3
Category_Wikipedia_sockpuppets_of_Ricatayakahusta.csv,106,2809254.0,54,52,45,9,0,78.32075471698113,496,54,26.169811320754718,20
Category_Wikipedia_sockpuppets_of_Kuswaha.csv,340,309192.0,173,167,83,90,0,35.96470588235294,493,63,16.241176470588236,5
Category_Wikipedia_sockpuppets_of_Catface1965.csv,240,81788552.0,76,164,42,34,0,63.979166666666664,219,47,21.85,12
Category_Wikipedia_sockpuppets_of_Johnjames2.csv,175,141716834.0,46,129,37,9,0,36.285714285714285,241,43,23.577142857142857,7
Category_Wikipedia_sockpuppets_of_Jasons99Contour.csv,531,8464597.0,166,365,60,106,0,59.03201506591337,255,47,20.001883239171374,3
Category_Wikipedia_sockpuppets_of_Prester_John.csv,6149,52456771.0,1930,4219,500,1430,0,44.883720930232556,239,76,21.846153846153847,2
Category_Wikipedia_sockpuppets_of_Hain9.csv,3883,8329114.0,2000,1883,500,1500,0,29.23821787277878,496,60,23.16945660571723,4
Category_Wikipedia_sockpuppets_of_Jennifer_Shame.csv,147,5789682.0,93,54,37,56,0,46.97278911564626,250,50,25.891156462585034,9
Category_Wikipedia_sockpuppets_of_Liliylo.csv,250,8687378.0,124,126,84,40,0,90.564,502,39,16.572,4
Category_Wikipedia_sockpuppets_of_Tracypoise.csv,11,165133.0,5,6,3,2,0,66.54545454545455,201,27,17.454545454545453,9
Category_Wikipedia_sockpuppets_of_Whalestate.csv,11118,181786992.0,4383,6735,500,3883,0,54.552257600287824,424,126,21.32415902140673,1
Category_Wikipedia_sockpuppets_of_Kielz86.csv,586,22712265.0,153,433,57,96,0,38.16723549488054,232,50,20.098976109215016,7
Category_Wikipedia_sockpuppets_of_DinoBambinoNFS.csv,3982,81583340.0,1622,2360,500,1122,0,51.18206931190357,496,56,23.401305876444,4
Category_Wikipedia_sockpuppets_of_Antony1103.csv,424,125078648.0,115,309,84,31,0,46.06603773584906,217,59,18.066037735849058,5
Category_Wikipedia_sockpuppets_of_Usfsocial.csv,12,3730295.0,7,5,3,4,0,44.916666666666664,135,13,13.0,13
Category_Wikipedia_sockpuppets_of_Gazakhordarsonik.csv,404,10461306.0,137,267,31,106,0,44.62623762376238,466,62,16.28960396039604,5
Category_Wikipedia_sockpuppets_of_Sumerophile.csv,6758,40781943.0,2666,4092,500,2166,0,40.344332642793724,250,88,18.16498964190589,1
Category_Wikipedia_sockpuppets_of_Selena+simmer.csv,508,68831141.0,155,353,23,132,0,48.511811023622045,258,54,21.51771653543307,4
Category_Wikipedia_sockpuppets_of_Ahbullo.csv,87,513379.0,62,25,60,2,0,45.08045977011494,397,32,27.344827586206897,13
Category_Wikipedia_sockpuppets_of_Mohammad_Hifzan.csv,87,68125542.0,30,57,29,1,0,57.71264367816092,238,45,17.344827586206897,4
Category_Wikipedia_sockpuppets_of_Aeremin.csv,556,284323788.0,176,380,131,45,0,56.7931654676259,480,46,18.31654676258993,4
Category_Wikipedia_sockpuppets_of_Baladna_CEO.csv,39,3718968.0,20,19,14,6,0,79.0,315,23,19.41025641025641,17
Category_Wikipedia_sockpuppets_of_Dinomarek.csv,463,37023889.0,163,300,126,37,0,56.30021598272138,500,70,18.876889848812095,7
Category_Wikipedia_sockpuppets_of_Coolnes99.csv,33,715558.0,15,18,11,4,0,32.121212121212125,197,31,16.606060606060606,10
Category_Wikipedia_sockpuppets_of_AHSApacheStudent.csv,3630,62832073.0,1063,2567,469,594,0,38.87382920110193,255,72,28.58374655647383,4
Category_Wikipedia_sockpuppets_of_Bomball.csv,38,77066186.0,12,26,8,4,0,44.921052631578945,219,36,22.5,17
Category_Wikipedia_sockpuppets_of_Armanvakili09.csv,3,6353.0,2,1,1,1,0,19.0,57,6,6.0,6
Category_Wikipedia_sockpuppets_of_DCarltonsm@msn.com.csv,282,17038358.0,107,175,31,76,0,36.5,172,44,29.397163120567377,6
Category_Wikipedia_sockpuppets_of_Mahmoud_Fayed.csv,249,264756023.0,76,173,45,31,0,42.92369477911647,232,81,29.132530120481928,7
Category_Wikipedia_sockpuppets_of_Christianmclark.csv,49,25890186.0,10,39,9,1,0,59.734693877551024,214,23,16.959183673469386,10
Category_Wikipedia_sockpuppets_of_Destiel7777777.csv,128,82979057.0,43,85,9,34,0,63.875,252,7,7.0,7
Category_Wikipedia_sockpuppets_of_Rars07.csv,1026,18108205.0,434,592,419,15,0,33.698830409356724,256,42,17.52046783625731,10
Category_Wikipedia_sockpuppets_of_Pearljambandaid.csv,205,22845422.0,79,126,35,44,0,35.98048780487805,226,75,24.482926829268294,9
Category_Wikipedia_sockpuppets_of_Smoore95GAGA.csv,4224,36453373.0,1614,2610,500,1114,0,46.34493371212121,255,55,23.31368371212121,3
Category_Wikipedia_sockpuppets_of_KhaledKetata.csv,1023,47479001.0,277,746,116,161,0,46.52785923753666,322,44,20.577712609970675,3
Category_Wikipedia_sockpuppets_of_Lanternix.csv,3441,188575039.0,1099,2342,500,599,0,34.13658820110433,255,52,18.35251380412671,3
Category_Wikipedia_sockpuppets_of_Juzhong.csv,2055,7119610.0,815,1240,500,315,0,38.91970802919708,250,103,33.020924574209246,2
Category_Wikipedia_sockpuppets_of_–û—Ä–∞–∑–±–∞–µ–≤_–ö–∞—Å—ã–º–±–µ–∫.csv,773,86411545.0,320,453,90,230,0,40.08796895213454,351,48,16.22509702457956,3
Category_Wikipedia_sockpuppets_of_Mrdhimas.csv,1545,19316258.0,744,801,500,244,0,27.092556634304206,258,53,16.642718446601943,10
Category_Wikipedia_sockpuppets_of_Macromonkey.csv,1516,65247616.0,515,1001,497,18,0,55.517150395778366,250,65,18.863456464379947,3
Category_Wikipedia_sockpuppets_of_Awengjuan.csv,1,0.0,1,0,1,0,0,0.0,0,35,35.0,35
Category_Wikipedia_sockpuppets_of_SCD_Fan.csv,1853,15109413.0,785,1068,409,376,0,33.18186724230977,255,56,29.64490016189962,10
Category_Wikipedia_sockpuppets_of_Fluffyboy15.csv,29,34126.0,13,16,4,9,0,55.93103448275862,218,15,11.551724137931034,10
Category_Wikipedia_sockpuppets_of_SimoooIX.csv,2038,9412555.0,589,1449,500,89,0,60.39793915603533,496,54,25.019136408243376,4
Category_Wikipedia_sockpuppets_of_Codo2411.csv,835,100957396.0,255,580,102,153,0,44.707784431137725,363,56,17.38682634730539,3
Category_Wikipedia_sockpuppets_of_Muhafiz-e-Pakistan.csv,1761,15662552.0,606,1155,500,106,0,52.0442930153322,500,55,21.35434412265758,4
Category_Wikipedia_sockpuppets_of_Debayanmukherjee12112002.csv,141,19118411.0,38,103,28,10,0,46.290780141843975,256,67,26.46099290780142,9
Category_Wikipedia_sockpuppets_of_Anacostia_River_Realty.csv,24,7162.0,15,9,10,5,7,18.291666666666668,41,9,9.0,9
Category_Wikipedia_sockpuppets_of_Febin96.csv,75,6191268.0,29,46,19,10,0,34.29333333333334,173,40,25.253333333333334,16
Category_Wikipedia_sockpuppets_of_Bonpetin.csv,136,24628338.0,33,103,20,13,0,66.76470588235294,275,61,17.25735294117647,5
Category_Wikipedia_sockpuppets_of_Shabaloobavengers.csv,528,3377733.0,193,335,168,25,0,31.119318181818183,231,40,21.126893939393938,7
Category_Wikipedia_sockpuppets_of_TheShadowCrow.csv,1443,44000251.0,511,932,500,11,0,40.31046431046431,255,62,23.33887733887734,6
Category_Wikipedia_sockpuppets_of_Janaa22.csv,19,1580990.0,11,8,8,3,0,39.1578947368421,134,46,21.526315789473685,14
Category_Wikipedia_sockpuppets_of_AndyWillis111.csv,147,36202070.0,79,68,42,37,0,44.69387755102041,178,29,21.551020408163264,18
Category_Wikipedia_sockpuppets_of_Accostapp.csv,401,39737959.0,154,247,112,42,0,38.88279301745636,249,96,21.294264339152118,5
Category_Wikipedia_sockpuppets_of_AnthonyFernando5.csv,267,36499701.0,90,177,20,70,0,37.81273408239701,255,31,21.674157303370787,10
Category_Wikipedia_sockpuppets_of_Michaeldavisxoxo.csv,322,13580513.0,149,173,75,74,0,31.658385093167702,395,58,23.763975155279503,8
Category_Wikipedia_sockpuppets_of_JasonHaddad.csv,279,145004068.0,63,216,43,20,0,52.61290322580645,235,54,33.46594982078853,13
Category_Wikipedia_sockpuppets_of_Vertexgodblessing.csv,486,13200462.0,273,213,160,113,0,30.77777777777778,262,45,35.129629629629626,8
Category_Wikipedia_sockpuppets_of_Sarkarsanju.csv,29,2751661.0,18,11,18,0,0,52.3448275862069,196,13,12.724137931034482,9
Category_Wikipedia_sockpuppets_of_NairaKairav.csv,24,247892.0,12,12,7,5,0,27.583333333333332,274,30,11.041666666666666,5
Category_Wikipedia_sockpuppets_of_Malan_Lucio.csv,34,344316.0,26,8,18,8,0,201.2058823529412,504,26,14.0,11
Category_Wikipedia_sockpuppets_of_CarolinaPete.csv,150,6896473.0,44,106,13,31,0,63.1,233,50,17.346666666666668,5
Category_Wikipedia_sockpuppets_of_Iam2tushar.csv,81,738821.0,56,25,28,28,0,33.77777777777778,255,36,30.555555555555557,12
Category_Wikipedia_sockpuppets_of_Macechap.csv,1255,38293253.0,615,640,242,373,0,34.41673306772908,255,74,16.682868525896414,4
Category_Wikipedia_sockpuppets_of_Arifbehapiee.csv,790,11411756.0,318,472,247,71,0,36.50126582278481,255,59,23.637974683544304,5
Category_Wikipedia_sockpuppets_of_Likhon123.csv,2693,47362127.0,1028,1665,500,528,0,34.58782027478648,255,44,16.961010025993318,4
Category_Wikipedia_sockpuppets_of_Sapvdjksfsqd.csv,259,19016109.0,107,152,25,82,0,39.67567567567568,238,18,11.822393822393822,9
Category_Wikipedia_sockpuppets_of_Xebulon.csv,2660,30729964.0,964,1696,245,719,0,42.157518796992484,253,50,19.56203007518797,3
Category_Wikipedia_sockpuppets_of_Citybuild122.csv,1374,129204590.0,502,872,500,2,0,39.9919941775837,397,63,21.58296943231441,5
Category_Wikipedia_sockpuppets_of_Agljones.csv,2149,408958106.0,680,1469,500,180,0,51.783620288506285,499,135,24.041879944160076,4
Category_Wikipedia_sockpuppets_of_Rocketpower123.csv,58,2169472.0,22,36,22,0,0,51.48275862068966,494,33,16.517241379310345,6
Category_Wikipedia_sockpuppets_of_Lyndasim.csv,173,13631076.0,80,93,44,36,0,51.76878612716763,255,59,15.352601156069364,6
Category_Wikipedia_sockpuppets_of_Peacepal1.csv,130,8211933.0,104,26,102,2,0,33.761538461538464,187,14,14.0,14
Category_Wikipedia_sockpuppets_of_Charlie.rodricks.csv,166,69537904.0,48,118,26,22,0,56.30120481927711,245,49,16.295180722891565,7
Category_Wikipedia_sockpuppets_of_Drrump69_698--.csv,18,14462.0,8,10,6,2,0,55.22222222222222,201,21,15.277777777777779,12
Category_Wikipedia_sockpuppets_of_Engjihere.csv,97,99618914.0,28,69,16,12,0,47.08247422680412,219,53,20.24742268041237,5
Category_Wikipedia_sockpuppets_of_Bloggersam.csv,18,798048.0,6,12,6,0,0,41.888888888888886,128,42,24.333333333333332,16
Category_Wikipedia_sockpuppets_of_Kid_in_ox_cart.csv,53,240141.0,30,23,19,11,0,18.92452830188679,199,28,20.09433962264151,10
Category_Wikipedia_sockpuppets_of_Chahar007.csv,658,3154585.0,188,470,144,44,0,76.69300911854103,305,75,17.05775075987842,4
Category_Wikipedia_sockpuppets_of_Sutyarashi.csv,2380,86775186.0,746,1634,500,246,0,56.891596638655464,500,72,15.578991596638655,3
Category_Wikipedia_sockpuppets_of_Debora_Mugica.csv,154,6142839.0,92,62,29,63,0,25.441558441558442,238,22,13.318181818181818,12
Category_Wikipedia_sockpuppets_of_John_Cena_Fan_2002.csv,2298,46900439.0,616,1682,148,468,0,45.45517841601392,495,60,20.290687554395127,4
Category_Wikipedia_sockpuppets_of_FriendlyFront.csv,10,2095521.0,3,7,3,0,0,32.9,120,74,37.6,25
Category_Wikipedia_sockpuppets_of_Wilnews.csv,1,0.0,1,0,1,0,0,0.0,0,53,53.0,53
Category_Wikipedia_sockpuppets_of_Mgwari.csv,79,7563587.0,30,49,17,13,0,42.45569620253165,203,41,23.126582278481013,3
Category_Wikipedia_sockpuppets_of_Spiros_13.csv,34,83438.0,10,24,10,0,0,49.5,199,55,33.970588235294116,19
Category_Wikipedia_sockpuppets_of_Bombshell.csv,1799,165148523.0,543,1256,405,138,0,37.97832128960533,242,69,19.57254030016676,2
Category_Wikipedia_sockpuppets_of_Mattwags32.csv,62,10031050.0,21,41,18,3,0,41.24193548387097,176,20,12.306451612903226,9
Category_Wikipedia_sockpuppets_of_Danieljohnson478.csv,188,3893598.0,69,119,31,38,0,46.973404255319146,330,50,26.122340425531913,8
Category_Wikipedia_sockpuppets_of_Biblestudyprof.csv,93,194962.0,48,45,15,33,0,82.09677419354838,252,50,27.78494623655914,14
Category_Wikipedia_sockpuppets_of_Zoe_Lorraine.csv,22,8196079.0,12,10,5,7,0,51.0,129,16,12.590909090909092,11
Category_Wikipedia_sockpuppets_of_Pehie_Herrver.csv,25,16237758.0,20,5,17,3,0,28.32,131,26,19.32,11
Category_Wikipedia_sockpuppets_of_HJ72JH.csv,2085,30801142.0,538,1547,285,253,0,60.152997601918464,484,58,19.054196642685852,4
Category_Wikipedia_sockpuppets_of_Phil2334.csv,868,3780259.0,299,569,154,145,0,35.80069124423963,200,43,16.820276497695854,5
"Category_Wikipedia_sockpuppets_of_Oh_Sh_t,_Astros_Suck.csv",5,821.0,3,2,1,2,96,137.4,194,18,18.0,18
Category_Wikipedia_sockpuppets_of_Bluesatellite.csv,3171,479781573.0,968,2203,500,468,0,52.53926206244087,495,77,20.830968148848942,4
Category_Wikipedia_sockpuppets_of_JBsupreme.csv,1902,56571303.0,502,1400,500,2,0,47.83964248159832,235,97,17.49421661409043,3
Category_Wikipedia_sockpuppets_of_Saadahcar.csv,53,54065018.0,19,34,6,13,0,61.132075471698116,238,57,22.09433962264151,9
Category_Wikipedia_sockpuppets_of_Srinivas_Bangalore.csv,104,161588296.0,29,75,24,5,0,70.75,294,48,20.057692307692307,8
Category_Wikipedia_sockpuppets_of_Rasmus_Paludan_Creative_Commons.csv,23,20983486.0,14,9,10,4,0,54.65217391304348,481,41,26.26086956521739,14
Category_Wikipedia_sockpuppets_of_Omni_Maximum.csv,58,615686.0,28,30,22,6,0,47.310344827586206,230,49,33.810344827586206,17
Category_Wikipedia_sockpuppets_of_DishingMachine.csv,435,3671531.0,137,298,62,75,0,61.49885057471264,400,43,19.448275862068964,7
Category_Wikipedia_sockpuppets_of_Assefme.csv,262,49664057.0,83,179,66,17,0,45.79389312977099,234,51,21.935114503816795,7
Category_Wikipedia_sockpuppets_of_Fipplet.csv,1606,151636185.0,531,1075,500,31,0,43.0,255,62,19.272727272727273,5
Category_Wikipedia_sockpuppets_of_HB_Arif.csv,25,21549542.0,11,14,10,1,0,38.84,132,20,16.48,15
Category_Wikipedia_sockpuppets_of_Waveofcoldair.csv,30,10491.0,17,13,6,11,0,41.3,156,14,14.0,14
Category_Wikipedia_sockpuppets_of_Stump1990.csv,283,92435561.0,77,206,67,10,0,62.46996466431096,255,45,15.183745583038869,6
Category_Wikipedia_sockpuppets_of_Masud_rana505.csv,41,9825448.0,12,29,4,8,0,45.390243902439025,240,43,24.536585365853657,9
Category_Wikipedia_sockpuppets_of_Rehman_Bahadur.csv,26,828845.0,23,3,5,18,0,23.03846153846154,153,42,42.0,42
Category_Wikipedia_sockpuppets_of_Atrihemtn.csv,33,291473.0,9,24,9,0,0,52.93939393939394,239,27,13.121212121212121,5
Category_Wikipedia_sockpuppets_of_8yd.csv,156,27019078.0,51,105,25,26,0,40.083333333333336,210,25,19.94871794871795,13
Category_Wikipedia_sockpuppets_of_Hocimi.csv,3745,102049490.0,1000,2745,500,500,0,58.502269692923896,500,60,19.800801068090788,3
Category_Wikipedia_sockpuppets_of_Dave_the_silly_peter.csv,11,534.0,5,6,5,0,0,49.54545454545455,200,11,11.0,11
Category_Wikipedia_sockpuppets_of_Trooper1131.csv,27,11656747.0,10,17,5,5,0,61.81481481481482,255,22,19.333333333333332,15
Category_Wikipedia_sockpuppets_of_Frank8188.csv,110,764970.0,43,67,9,34,0,49.39090909090909,249,54,20.845454545454544,4
Category_Wikipedia_sockpuppets_of_Wickedangry.csv,497,70207184.0,166,331,130,36,0,45.17102615694165,251,40,20.708249496981892,7
Category_Wikipedia_sockpuppets_of_Epcotguy.csv,285,20595156.0,63,222,46,17,0,51.04912280701755,240,54,23.270175438596493,8
Category_Wikipedia_sockpuppets_of_OmniousOK.csv,79,41318011.0,31,48,17,14,0,53.48101265822785,164,59,38.151898734177216,4
Category_Wikipedia_sockpuppets_of_Bershya.csv,43,6832191.0,15,28,13,2,0,92.72093023255815,500,20,16.302325581395348,13
Category_Wikipedia_sockpuppets_of_MrNewWritter.csv,169,30019690.0,44,125,28,16,0,48.946745562130175,263,96,24.319526627218934,2
Category_Wikipedia_sockpuppets_of_LaylaShyu.csv,78,25050740.0,26,52,16,10,0,42.34615384615385,180,46,17.82051282051282,8
Category_Wikipedia_sockpuppets_of_NSK_Pandan.csv,20,254041.0,7,13,4,3,0,63.55,202,28,14.4,8
Category_Wikipedia_sockpuppets_of_HenryRobins.csv,6,957334.0,4,2,2,2,11,21.333333333333332,28,17,16.333333333333332,16
Category_Wikipedia_sockpuppets_of_Borderenity.csv,35,187155.0,28,7,21,7,0,72.28571428571429,298,47,21.857142857142858,15
Category_Wikipedia_sockpuppets_of_Ks64q2.csv,1524,255554472.0,504,1020,500,4,0,39.120734908136484,255,78,23.05971128608924,4
Category_Wikipedia_sockpuppets_of_Shark310.csv,314,31927880.0,98,216,92,6,0,47.27707006369427,247,57,25.821656050955415,11
Category_Wikipedia_sockpuppets_of_Anonmoi.csv,147,4344952.0,43,104,6,37,0,51.08843537414966,199,34,16.517006802721088,9
Category_Wikipedia_sockpuppets_of_Cquest.csv,12,201048655.0,4,8,2,2,20,75.83333333333333,208,21,18.0,13
Category_Wikipedia_sockpuppets_of_Abhijit038.csv,120,16265151.0,32,88,21,11,0,66.43333333333334,189,32,17.441666666666666,6
Category_Wikipedia_sockpuppets_of_Lilifh.csv,26,3964.0,12,14,5,7,0,31.53846153846154,172,31,26.576923076923077,17
Category_Wikipedia_sockpuppets_of_Deathismetal14.csv,286,167298643.0,71,215,12,59,0,45.62587412587413,268,35,21.51048951048951,9
Category_Wikipedia_sockpuppets_of_Salman1492.csv,124,78943640.0,31,93,21,10,0,56.064516129032256,302,35,18.193548387096776,4
Category_Wikipedia_sockpuppets_of_Robert32439.csv,120,4344316.0,89,31,86,3,0,44.225,198,23,13.566666666666666,3
Category_Wikipedia_sockpuppets_of_Mrbrklyn.csv,1513,333318578.0,498,1015,334,164,0,49.8235294117647,255,58,20.397224058162593,4
Category_Wikipedia_sockpuppets_of_Eskimo2016.csv,115,7897050.0,39,76,23,16,0,49.11304347826087,215,98,33.30434782608695,3
Category_Wikipedia_sockpuppets_of_Uddinkabir.csv,75,87195276.0,22,53,20,2,0,63.78666666666667,197,56,21.72,10
Category_Wikipedia_sockpuppets_of_Reece_Leonard.csv,69,3065678.0,25,44,22,3,0,55.333333333333336,253,49,17.956521739130434,6
Category_Wikipedia_sockpuppets_of_Planetarg.csv,3,71283.0,3,0,2,1,25,51.333333333333336,104,22,22.0,22
Category_Wikipedia_sockpuppets_of_Pyrodude7172.csv,839,4057724.0,262,577,228,34,0,57.06912991656734,503,51,21.30274135876043,4
Category_Wikipedia_sockpuppets_of_Ahmed_Ghazi.csv,1444,31177906.0,546,898,479,67,0,42.96952908587257,250,55,14.855263157894736,5
Category_Wikipedia_sockpuppets_of_Lisa_Dawn_Hannaford.csv,11,151963.0,6,5,4,2,0,57.54545454545455,228,41,17.09090909090909,7
Category_Wikipedia_sockpuppets_of_Ozilogy.csv,254,8841779.0,77,177,72,5,0,42.71259842519685,376,52,20.783464566929133,4
Category_Wikipedia_sockpuppets_of_SDSandecki.csv,531,2835186.0,206,325,199,7,0,59.51035781544256,212,35,13.858757062146893,4
Category_Wikipedia_sockpuppets_of_Ariyashirzaee.csv,650,547839.0,198,452,99,99,0,33.63076923076923,274,62,20.704615384615384,4
Category_Wikipedia_sockpuppets_of_Haroldcovington.csv,151,164993182.0,56,95,18,38,0,36.88741721854305,165,47,18.602649006622517,11
Category_Wikipedia_sockpuppets_of_Lastsoundofdefense.csv,1858,4750119.0,518,1340,500,18,0,55.29332615715823,451,64,21.502691065662003,3
Category_Wikipedia_sockpuppets_of_Saizul_99.csv,60,3082848.0,30,30,27,3,0,32.05,164,63,34.85,14
Category_Wikipedia_sockpuppets_of_98.5%_Chimpanzee.csv,206,2241883.0,83,123,37,46,0,63.76699029126213,255,56,21.296116504854368,7
Category_Wikipedia_sockpuppets_of_Ïó∞Ïù∏_(2023ÎÖÑ_ÎìúÎùºÎßà).csv,108,5397544.0,56,52,20,36,0,48.398148148148145,235,35,19.22222222222222,6
Category_Wikipedia_sockpuppets_of_JackBludd.csv,7,169548.0,4,3,3,1,0,26.714285714285715,111,22,15.0,11
Category_Wikipedia_sockpuppets_of_Amityville1992fan.csv,505,443415780.0,193,312,192,1,0,32.16831683168317,254,40,23.815841584158417,9
Category_Wikipedia_sockpuppets_of_Josh_Woolstenhulme.csv,860,34051031.0,294,566,174,120,0,26.95,250,65,15.373255813953488,3
Category_Wikipedia_sockpuppets_of_Kairos604.csv,19,10217.0,13,6,10,3,12,180.78947368421052,492,45,14.68421052631579,13
Category_Wikipedia_sockpuppets_of_Sophia49.csv,122,46975401.0,39,83,27,12,0,41.08196721311475,231,51,17.69672131147541,7
Category_Wikipedia_sockpuppets_of_Esd7211.csv,131,93832103.0,28,103,26,2,0,52.274809160305345,275,30,18.916030534351144,6
Category_Wikipedia_sockpuppets_of_Alex_Buchet.csv,98,1071509.0,43,55,41,2,0,25.897959183673468,200,47,19.663265306122447,5
Category_Wikipedia_sockpuppets_of_Bentley9020.csv,29,4962.0,16,13,16,0,3,61.827586206896555,200,33,18.344827586206897,12
Category_Wikipedia_sockpuppets_of_Getharis.csv,91,328542595.0,23,68,23,0,0,42.252747252747255,212,26,20.824175824175825,11
Category_Wikipedia_sockpuppets_of_Zenkymunda.csv,11,174025.0,8,3,6,2,0,71.27272727272727,196,20,19.181818181818183,13
Category_Wikipedia_sockpuppets_of_Choccobkk.csv,1084,11191318.0,529,555,500,29,0,41.2260147601476,255,37,23.366236162361623,7
Category_Wikipedia_sockpuppets_of_Bricknfleeks.csv,63,33735031.0,30,33,26,4,0,56.3968253968254,336,22,16.428571428571427,6
Category_Wikipedia_sockpuppets_of_Rogers_Park_Chamber_of_Commerce.csv,55,125202.0,33,22,26,7,0,49.54545454545455,198,67,33.32727272727273,17
Category_Wikipedia_sockpuppets_of_HarshThk9644.csv,31,46134864.0,27,4,17,10,0,51.96774193548387,240,25,21.838709677419356,17
Category_Wikipedia_sockpuppets_of_„Ñè„Ñ®„Ñ§„Ñâ„Ñß.csv,2552,20076125.0,830,1722,500,330,0,40.83385579937304,255,86,20.014890282131663,1
Category_Wikipedia_sockpuppets_of_Mokshanine.csv,854,199912995.0,230,624,71,159,0,43.7423887587822,255,44,21.22365339578454,5
Category_Wikipedia_sockpuppets_of_Pakistan01.csv,1451,19497769.0,618,833,500,118,0,32.7815299793246,255,41,25.20606478290834,4
Category_Wikipedia_sockpuppets_of_Colonel_Chaos.csv,289,50665192.0,80,209,26,54,0,47.6159169550173,211,44,20.231833910034602,6
Category_Wikipedia_sockpuppets_of_Nobody_Too.csv,38,1713631.0,26,12,18,8,0,26.710526315789473,196,26,22.263157894736842,13
Category_Wikipedia_sockpuppets_of_Michael_Holland_Shepard.csv,32,3364704.0,9,23,7,2,0,52.90625,184,22,19.15625,9
Category_Wikipedia_sockpuppets_of_Jrs5000.csv,91,319748.0,47,44,31,16,0,32.45054945054945,220,42,13.56043956043956,6
Category_Wikipedia_sockpuppets_of_EucalyptusLancome.csv,68,1161311.0,21,47,6,15,0,65.67647058823529,228,18,12.544117647058824,9
Category_Wikipedia_sockpuppets_of_Apphistorian.csv,260,528969712.0,88,172,86,2,0,61.9,256,66,14.311538461538461,8
Category_Wikipedia_sockpuppets_of_Zachary12345Pogson.csv,1038,15910187.0,270,768,268,2,0,35.24181117533719,253,53,24.189788053949904,4
Category_Wikipedia_sockpuppets_of_RomanGladiator2000.csv,1841,155647186.0,575,1266,500,75,0,71.82183595871808,499,110,20.740901683867463,2
Category_Wikipedia_sockpuppets_of_Dudeimhere.csv,239,1209641.0,67,172,23,44,0,58.66108786610879,292,37,18.84518828451883,4
Category_Wikipedia_sockpuppets_of_Force101.csv,1114,1808538.0,442,672,148,294,0,37.14003590664273,250,48,20.392280071813286,3
Category_Wikipedia_sockpuppets_of_The_kyle_3.csv,809,42598863.0,353,456,301,52,0,55.05809641532756,255,80,33.414091470951796,13
Category_Wikipedia_sockpuppets_of_Luckycat092710.csv,696,62904985.0,163,533,101,62,0,49.09770114942529,346,47,24.29597701149425,9
Category_Wikipedia_sockpuppets_of_Americanpie1996.csv,697,132463548.0,249,448,46,203,0,53.744619799139166,499,47,17.73457675753228,6
Category_Wikipedia_sockpuppets_of_Jang_Ja_Yeon.csv,11,388893.0,6,5,2,4,0,117.63636363636364,196,34,21.272727272727273,12
Category_Wikipedia_sockpuppets_of_Himanshushukla433.csv,173,8912813.0,61,112,39,22,0,49.15028901734104,396,53,21.653179190751445,6
Category_Wikipedia_sockpuppets_of_BumCrack1092.csv,1,0.0,1,0,1,0,87,87.0,87,4,4.0,4
Category_Wikipedia_sockpuppets_of_Yung1001.csv,29,1024465.0,12,17,11,1,0,143.10344827586206,452,54,18.551724137931036,10
Category_Wikipedia_sockpuppets_of_Dmboatis.csv,14,40387.0,7,7,4,3,10,37.0,89,43,38.857142857142854,36
Category_Wikipedia_sockpuppets_of_Lee_sibley.csv,133,35753680.0,50,83,22,28,0,44.203007518796994,223,22,14.609022556390977,6
Category_Wikipedia_sockpuppets_of_FFA_P-16.csv,1833,224170760.0,734,1099,500,234,0,45.97435897435897,355,81,24.45390070921986,4
Category_Wikipedia_sockpuppets_of_Kalki.csv,2196,576202367.0,530,1666,500,30,0,50.649817850637525,500,67,17.06830601092896,2
Category_Wikipedia_sockpuppets_of_Indiasummer95.csv,6691,9163478.0,1901,4790,500,1401,0,36.48617545957256,255,63,18.0040352712599,1
Category_Wikipedia_sockpuppets_of_Grundle2600.csv,14857,445086264.0,5108,9749,500,4608,0,61.657669785286394,500,104,22.55334185905634,3
Category_Wikipedia_sockpuppets_of_Niazification10.csv,182,876478.0,68,114,54,14,0,42.31318681318681,196,35,20.873626373626372,7
Category_Wikipedia_sockpuppets_of_BQ20_RBellostas.csv,20,262072.0,13,7,9,4,0,34.3,229,25,6.1,4
Category_Wikipedia_sockpuppets_of_Internetwikier.csv,586,73348752.0,211,375,177,34,0,59.39249146757679,255,50,25.0,11
Category_Wikipedia_sockpuppets_of_Piggy_Wiki_InterHunt.csv,91,5797415.0,65,26,24,41,0,40.56043956043956,282,28,14.241758241758241,5
Category_Wikipedia_sockpuppets_of_Otolorin123.csv,83,1425549.0,30,53,10,20,0,61.78313253012048,241,52,14.337349397590362,5
Category_Wikipedia_sockpuppets_of_Tbone49.csv,4674,53291204.0,1360,3314,500,860,0,37.732777064612755,443,60,18.280701754385966,4
Category_Wikipedia_sockpuppets_of_Andres_Jonathan_Balingit_Fajardo.csv,627,8229847.0,363,264,101,262,0,25.762360446570973,327,47,23.379585326953748,8
Category_Wikipedia_sockpuppets_of_Abote2.csv,2091,30844300.0,529,1562,500,29,0,58.3739837398374,460,75,24.016738402678143,2
Category_Wikipedia_sockpuppets_of_Cjmonit.csv,229,1538356.0,95,134,95,0,0,35.70305676855895,218,40,27.14410480349345,13
Category_Wikipedia_sockpuppets_of_HCAmidwest12.csv,73,24911.0,32,41,28,4,0,42.47945205479452,213,23,18.89041095890411,18
Category_Wikipedia_sockpuppets_of_Walter_Eugene_Wood.csv,34,6942346.0,21,13,11,10,0,37.705882352941174,94,28,21.852941176470587,18
Category_Wikipedia_sockpuppets_of_M_naeem22.csv,15,230836.0,9,6,8,1,0,48.266666666666666,69,20,13.933333333333334,13
Category_Wikipedia_sockpuppets_of_Dwaro.csv,2267,44844877.0,732,1535,500,232,0,48.397882664314075,502,100,20.5037494486105,4
Category_Wikipedia_sockpuppets_of_New_Yawk.csv,46,318886.0,19,27,7,12,0,45.34782608695652,332,32,19.73913043478261,13
Category_Wikipedia_sockpuppets_of_Maxpayne69.csv,26,948783.0,12,14,7,5,0,46.11538461538461,196,25,15.615384615384615,9
Category_Wikipedia_sockpuppets_of_Exaadadon2.csv,125,13399805.0,38,87,17,21,0,46.536,500,33,14.672,4
Category_Wikipedia_sockpuppets_of_Olonia.csv,1510,37749119.0,592,918,500,92,0,46.29006622516556,255,54,26.019867549668874,5
Category_Wikipedia_sockpuppets_of_Yorkshirian_Forever.csv,11,182144.0,7,4,5,2,0,31.0,117,55,24.90909090909091,16
Category_Wikipedia_sockpuppets_of_GoldDragon.csv,7473,216860714.0,1666,5807,500,1166,0,38.825103706677375,254,76,17.154021142780678,3
Category_Wikipedia_sockpuppets_of_Adam2893.csv,256,41285980.0,74,182,55,19,0,45.16796875,208,52,16.59375,5
Category_Wikipedia_sockpuppets_of_Honduras200010.csv,3747,407857085.0,882,2865,136,746,0,57.27942353883107,500,53,16.14598345342941,4
Category_Wikipedia_sockpuppets_of_Yylecaksberri.csv,85,30283968.0,17,68,17,0,0,65.50588235294117,368,37,16.847058823529412,7
Category_Wikipedia_sockpuppets_of_Hkdesigner.csv,13,34676.0,5,8,5,0,0,93.15384615384616,249,13,11.384615384615385,10
Category_Wikipedia_sockpuppets_of_RJII.csv,4954,115743487.0,1745,3209,500,1245,0,48.0347194186516,243,56,18.47981429148163,7
Category_Wikipedia_sockpuppets_of_Natalieraum.csv,9,2340962.0,2,7,1,1,0,82.88888888888889,235,15,15.0,15
Category_Wikipedia_sockpuppets_of_Serena_Berman.csv,108,8182750.0,37,71,18,19,0,61.19444444444444,298,54,20.64814814814815,5
Category_Wikipedia_sockpuppets_of_Bengali_Mapper.csv,177,3706586.0,71,106,65,6,0,42.932203389830505,331,32,19.129943502824858,12
Category_Wikipedia_sockpuppets_of_NedFausa.csv,2767,30577301.0,1033,1734,500,533,0,66.08059269967474,496,81,20.82905674015179,5
Category_Wikipedia_sockpuppets_of_Taniaferrero.csv,98,14522712.0,36,62,15,21,0,36.42857142857143,245,36,17.56122448979592,8
Category_Wikipedia_sockpuppets_of_2023Bharat.csv,297,14872999.0,80,217,41,39,0,62.21212121212121,500,47,23.373737373737374,8
Category_Wikipedia_sockpuppets_of_Flyer322.csv,183,890308.0,61,122,37,24,0,60.77049180327869,251,25,16.311475409836067,7
Category_Wikipedia_sockpuppets_of_Lerdall.csv,80,1011939.0,34,46,13,21,0,28.6125,131,68,24.925,9
Category_Wikipedia_sockpuppets_of_80.134.csv,1149,27485818.0,405,744,253,152,0,23.19060052219321,200,65,15.568320278503046,3
Category_Wikipedia_sockpuppets_of_AresXV.csv,97,365438.0,41,56,21,20,0,82.41237113402062,213,51,26.20618556701031,13
Category_Wikipedia_sockpuppets_of_Ashesh_Shah.csv,32,11214701.0,13,19,10,3,0,64.34375,198,47,22.4375,8
Category_Wikipedia_sockpuppets_of_Scalabrineformvp.csv,95,30775888.0,45,50,40,5,0,46.31578947368421,199,44,24.389473684210525,13
Category_Wikipedia_sockpuppets_of_Shirley_Chan1.csv,6,1534554.0,3,3,2,1,0,61.0,196,26,14.0,4
Category_Wikipedia_sockpuppets_of_TrevorBryan95.csv,1642,53983744.0,416,1226,381,35,0,44.24847746650426,267,49,13.982338611449451,4
Category_Wikipedia_sockpuppets_of_The_Duckworth_Project.csv,100,505014.0,27,73,7,20,0,55.23,295,46,17.73,7
Category_Wikipedia_sockpuppets_of_DanielSeabolt.csv,18,31555.0,9,9,8,1,0,37.72222222222222,196,32,25.666666666666668,13
Category_Wikipedia_sockpuppets_of_Samhalliday69.csv,19,1587.0,7,12,4,3,0,73.57894736842105,231,29,19.736842105263158,13
Category_Wikipedia_sockpuppets_of_Trampton.csv,6589,350690195.0,2181,4408,500,1681,0,45.24586431932008,255,68,20.998785855213235,3
Category_Wikipedia_sockpuppets_of_Mountain157.csv,2657,31781170.0,784,1873,500,284,0,47.218291305984195,465,60,23.64283025969138,3
Category_Wikipedia_sockpuppets_of_ThecentreCZ.csv,2905,253145617.0,727,2178,500,227,0,50.577280550774525,496,78,26.09776247848537,3
Category_Wikipedia_sockpuppets_of_Cartoon_Classics_Master.csv,435,321431.0,121,314,17,104,0,40.60919540229885,231,33,7.096551724137931,4
Category_Wikipedia_sockpuppets_of_Gandharraj.csv,268,216165462.0,68,200,36,32,0,58.53731343283582,285,52,15.623134328358208,4
Category_Wikipedia_sockpuppets_of_Hurricane_boy_50.csv,458,12508395.0,217,241,108,109,0,40.277292576419214,272,55,30.351528384279476,11
Category_Wikipedia_sockpuppets_of_Manavatha.csv,3477,119136899.0,1265,2212,500,765,0,39.15329306873742,516,45,15.251941328731665,4
Category_Wikipedia_sockpuppets_of_Sky0000.csv,669,17808308.0,227,442,87,140,0,46.14050822122571,240,50,28.523168908819134,9
Category_Wikipedia_sockpuppets_of_Gagoy.csv,583,2475303.0,175,408,137,38,0,37.480274442538594,229,47,21.456260720411663,3
Category_Wikipedia_sockpuppets_of_MSMRHurricane.csv,1712,185579482.0,503,1209,500,3,0,56.73831775700935,333,50,23.577102803738317,10
Category_Wikipedia_sockpuppets_of_Issac77.csv,4,82988.0,3,1,3,0,0,73.5,196,17,17.0,17
Category_Wikipedia_sockpuppets_of_APCBasketball.csv,28,123027.0,16,12,10,6,0,31.107142857142858,164,30,22.785714285714285,19
Category_Wikipedia_sockpuppets_of_Olurteilanru.csv,781,98459016.0,276,505,156,120,0,44.50320102432779,376,51,15.683738796414852,7
Category_Wikipedia_sockpuppets_of_Scarletspeedster7.csv,676,99612211.0,174,502,103,71,0,43.60207100591716,214,37,16.715976331360945,3
Category_Wikipedia_sockpuppets_of_Vadjihoudine.csv,2068,144711858.0,522,1546,500,22,0,35.38684719535783,255,39,14.713249516441007,4
Category_Wikipedia_sockpuppets_of_Muhammad_Omar_18.csv,9,649.0,3,6,3,0,0,46.22222222222222,117,27,25.444444444444443,20
Category_Wikipedia_sockpuppets_of_Diegotoreto.csv,67,1056051.0,35,32,25,10,0,34.134328358208954,195,23,17.26865671641791,16
Category_Wikipedia_sockpuppets_of_Anglopatriot.csv,54,3520419.0,19,35,9,10,0,76.20370370370371,400,22,15.5,5
Category_Wikipedia_sockpuppets_of_Abbobo.csv,13,2358.0,5,8,4,1,0,42.30769230769231,159,15,12.307692307692308,4
Category_Wikipedia_sockpuppets_of_Pocoyohasan8.csv,315,108281800.0,64,251,37,27,0,64.97777777777777,500,58,27.533333333333335,6
Category_Wikipedia_sockpuppets_of_RIGHT_UP_THE_WALL!.csv,222,522422.0,64,158,10,54,0,35.68018018018018,206,63,23.396396396396398,6
Category_Wikipedia_sockpuppets_of_Ppslimited.csv,257,89773278.0,73,184,39,34,0,37.038910505836576,225,45,16.07782101167315,8
Category_Wikipedia_sockpuppets_of_Muhammad_Jahidul_Islam.csv,14,8971122.0,11,3,4,7,0,85.5,384,30,19.928571428571427,13
Category_Wikipedia_sockpuppets_of_Arnuvtandon.csv,64,8975392.0,22,42,10,12,0,64.734375,310,43,21.234375,7
Category_Wikipedia_sockpuppets_of_Sirfmovie.csv,274,6884827.0,101,173,71,30,0,41.784671532846716,243,50,20.645985401459853,6
Category_Wikipedia_sockpuppets_of_Jonah_PR_Musto.csv,101,1631860.0,31,70,18,13,0,30.455445544554454,180,58,17.792079207920793,8
Category_Wikipedia_sockpuppets_of_MrBakar.csv,1909,8963263.0,829,1080,500,329,0,52.16081718177056,500,55,21.672603457307492,6
Category_Wikipedia_sockpuppets_of_OSUHEY.csv,9470,260754361.0,4649,4821,500,4149,0,35.23189017951425,255,56,18.503590285110878,4
Category_Wikipedia_sockpuppets_of_Aongchan.csv,44,1139048.0,34,10,22,12,0,19.272727272727273,178,35,11.295454545454545,8
Category_Wikipedia_sockpuppets_of_Sreeja_Addala.csv,48,24613367.0,12,36,9,3,0,64.52083333333333,207,23,16.625,12
Category_Wikipedia_sockpuppets_of_Dreamerlight00.csv,111,7795914.0,83,28,73,10,0,26.774774774774773,174,24,13.801801801801801,12
Category_Wikipedia_sockpuppets_of_Leisterman.csv,127,1779804.0,55,72,20,35,0,40.173228346456696,206,31,16.73228346456693,6
Category_Wikipedia_sockpuppets_of_DARKXRAV3N.csv,280,39299499.0,85,195,45,40,0,77.01785714285714,500,50,23.178571428571427,4
Category_Wikipedia_sockpuppets_of_Kinsky2020.csv,16,79438.0,10,6,9,1,0,39.8125,143,37,25.1875,20
Category_Wikipedia_sockpuppets_of_Kingofmann.csv,659,40408532.0,227,432,90,137,0,42.68588770864947,200,72,27.365705614567528,10
Category_Wikipedia_sockpuppets_of_Vicky12333.csv,1166,12979348.0,459,707,197,262,0,29.475128644939964,255,53,17.40222984562607,9
Category_Wikipedia_sockpuppets_of_Digitalravan.csv,567,33789709.0,182,385,21,161,0,41.0352733686067,254,77,37.192239858906525,4
Category_Wikipedia_sockpuppets_of_Mukit1234.csv,1,0.0,1,0,1,0,20,20.0,20,25,25.0,25
Category_Wikipedia_sockpuppets_of_Gculegalit.csv,76,60433.0,24,52,17,7,0,31.81578947368421,215,26,15.855263157894736,8
Category_Wikipedia_sockpuppets_of_Kelvin_Martinez.csv,249,1005871.0,77,172,62,15,0,43.373493975903614,255,90,22.759036144578314,7
Category_Wikipedia_sockpuppets_of_Jenne_josp.csv,253,28941636.0,74,179,26,48,0,48.73913043478261,500,38,15.727272727272727,5
Category_Wikipedia_sockpuppets_of_Astrologerneeraj.csv,3,190.0,2,1,2,0,0,130.0,195,34,34.0,34
Category_Wikipedia_sockpuppets_of_Musicbyac.csv,11511,57461469.0,3024,8487,464,2560,0,39.7901138041873,255,66,17.04491356094171,3
Category_Wikipedia_sockpuppets_of_UnknownMan~enwiki.csv,931,44953451.0,288,643,288,0,0,35.58216970998926,206,72,17.1031149301826,4
Category_Wikipedia_sockpuppets_of_Yyang_Sr._GakupoKaito.csv,1579,18218770.0,616,963,500,116,0,34.46991766941102,496,84,25.520582647245092,8
Category_Wikipedia_sockpuppets_of_ComedyYes_HorrorNo.csv,1018,115033538.0,249,769,161,88,0,50.30451866404715,366,56,22.5049115913556,4
Category_Wikipedia_sockpuppets_of_Alymacq11.csv,84,5357234.0,31,53,20,11,0,48.48809523809524,227,53,21.488095238095237,9
Category_Wikipedia_sockpuppets_of_Scgcreations.csv,65,306986497.0,16,49,14,2,0,46.95384615384615,194,49,34.13846153846154,21
Category_Wikipedia_sockpuppets_of_Cpurcellartwork.csv,503,21624937.0,185,318,128,57,0,64.40755467196819,869,50,21.178926441351887,5
Category_Wikipedia_sockpuppets_of_Akhiljaxxn.csv,17,2071.0,8,9,8,0,0,45.23529411764706,202,60,32.411764705882355,11
"Category_Wikipedia_sockpuppets_of_HarryPotter1,000,000.csv",1,0.0,1,0,1,0,24,24.0,24,30,30.0,30
Category_Wikipedia_sockpuppets_of_Ert141.csv,77,4765744.0,38,39,35,3,0,33.44155844155844,213,30,13.831168831168831,10
Category_Wikipedia_sockpuppets_of_Harmonia1.csv,1090,4827502.0,549,541,500,49,0,44.726605504587155,214,53,19.958715596330276,6
Category_Wikipedia_sockpuppets_of_Adith_Balan.csv,290,96273014.0,94,196,86,8,0,41.41379310344828,240,43,24.989655172413794,10
Category_Wikipedia_sockpuppets_of_MileyCyrusLover.csv,5151,314217292.0,1738,3413,500,1238,0,43.61289070083479,450,67,23.367889730149486,5
Category_Wikipedia_sockpuppets_of_RebeccaTheAwesomeXD.csv,1246,24438166.0,523,723,500,23,0,37.976725521669344,255,54,24.25601926163724,5
Category_Wikipedia_sockpuppets_of_Dasith_Gamage.csv,240,6055013.0,83,157,52,31,0,55.2625,278,61,25.991666666666667,7
Category_Wikipedia_sockpuppets_of_Redking7.csv,3765,120045136.0,1102,2663,500,602,0,45.5875166002656,253,79,26.556440903054447,3
Category_Wikipedia_sockpuppets_of_River10.csv,621,256989027.0,148,473,112,36,0,41.91626409017714,255,47,17.317230273752013,6
Category_Wikipedia_sockpuppets_of_Orubel.csv,312,215622009.0,113,199,106,7,0,45.65064102564103,320,47,26.432692307692307,11
Category_Wikipedia_sockpuppets_of_Sweetkind5.csv,721,6320640.0,215,506,194,21,0,66.8876560332871,500,65,29.606102635228847,6
Category_Wikipedia_sockpuppets_of_Wowgeezmate.csv,11,62659.0,8,3,6,2,0,45.90909090909091,191,28,25.454545454545453,21
Category_Wikipedia_sockpuppets_of_Absconcier.csv,43,451274.0,25,18,25,0,0,51.46511627906977,204,44,19.209302325581394,12
Category_Wikipedia_sockpuppets_of_Xiaomichel.csv,570,59095845.0,150,420,119,31,0,53.47719298245614,496,54,12.821052631578947,2
Category_Wikipedia_sockpuppets_of_KissmeKate.csv,2219,129092870.0,860,1359,500,360,0,31.994592158630013,208,77,21.2798557908968,4
Category_Wikipedia_sockpuppets_of_Sahilchemist.abbas.csv,186,136011420.0,58,128,47,11,0,48.24193548387097,255,50,33.86021505376344,14
Category_Wikipedia_sockpuppets_of_Creative2world.csv,1,0.0,1,0,1,0,4,4.0,4,15,15.0,15
Category_Wikipedia_sockpuppets_of_Teletadka.csv,799,3417503.0,217,582,130,87,0,37.74217772215269,255,40,15.271589486858574,6
Category_Wikipedia_sockpuppets_of_Makxsiq.csv,288,38508788.0,91,197,33,58,0,78.98958333333333,362,49,24.12847222222222,6
Category_Wikipedia_sockpuppets_of_Iistal.csv,2483,115336179.0,739,1744,500,239,0,49.42891663310512,350,51,17.61498187676198,4
Category_Wikipedia_sockpuppets_of_Bishangarh.csv,300,9511972.0,86,214,29,57,0,65.49666666666667,402,47,18.28,5
Category_Wikipedia_sockpuppets_of_Bugnot.csv,2092,94801322.0,537,1555,500,37,0,48.00430210325048,255,63,18.1065965583174,4
Category_Wikipedia_sockpuppets_of_Roitr.csv,4101,80461443.0,1493,2608,500,993,0,31.38332114118508,255,86,28.543769812240917,4
Category_Wikipedia_sockpuppets_of_Hstakast.csv,49,10099463.0,39,10,24,15,0,31.346938775510203,239,28,17.142857142857142,9
Category_Wikipedia_sockpuppets_of_Sun_Sunris.csv,844,162615039.0,251,593,249,2,0,49.88388625592417,303,61,21.120853080568722,3
Category_Wikipedia_sockpuppets_of_Martianpelli.csv,42,181134.0,19,23,8,11,0,67.54761904761905,223,23,17.357142857142858,11
Category_Wikipedia_sockpuppets_of_Patiparmeshwar.csv,1024,36358330.0,248,776,103,145,0,49.3310546875,500,53,14.36328125,5
Category_Wikipedia_sockpuppets_of_Johnwangxun.csv,944,114039821.0,230,714,85,145,0,35.920550847457626,250,54,23.658898305084747,4
Category_Wikipedia_sockpuppets_of_Chanakyathegreat.csv,7655,321605620.0,2132,5523,500,1632,0,48.10097975179621,426,63,20.89758327890268,3
Category_Wikipedia_sockpuppets_of_Littlemixfan!.csv,2176,51170642.0,864,1312,165,699,0,42.034007352941174,339,83,20.326286764705884,2
Category_Wikipedia_sockpuppets_of_WOverstreet.csv,1120,12044509.0,426,694,426,0,0,40.325892857142854,213,51,22.132142857142856,7
Category_Wikipedia_sockpuppets_of_Fayninja.csv,1389,23546822.0,467,922,447,20,0,59.91144708423326,482,59,19.165586753059756,2
Category_Wikipedia_sockpuppets_of_Sophiamichelle314.csv,62,4790215.0,19,43,5,14,0,62.83870967741935,270,26,16.903225806451612,10
Category_Wikipedia_sockpuppets_of_Alienus.csv,1354,7306217.0,501,853,500,1,0,37.818316100443134,200,59,19.946085672082717,6
Category_Wikipedia_sockpuppets_of_ZachFarnum.csv,15,1560678.0,5,10,5,0,0,46.733333333333334,150,55,30.0,20
Category_Wikipedia_sockpuppets_of_ItsLassieTime.csv,25244,355318176.0,9854,15390,500,9354,0,43.78165108540643,888,108,21.136903818729202,3
Category_Wikipedia_sockpuppets_of_RAHULRAIGUPTA.csv,10,76400.0,9,1,8,1,4,30.9,181,25,10.6,9
Category_Wikipedia_sockpuppets_of_Faniel.dontaine.csv,42,1302520.0,33,9,16,17,0,65.19047619047619,204,34,29.238095238095237,24
Category_Wikipedia_sockpuppets_of_Colon-el-Nuevo.csv,1255,113484516.0,504,751,500,4,0,53.692430278884466,254,56,30.775298804780878,8
Category_Wikipedia_sockpuppets_of_Ems_27_03.csv,2182,32918166.0,922,1260,500,422,0,33.66086159486709,496,49,26.565994500458295,7
Category_Wikipedia_sockpuppets_of_Chooser546.csv,239,60926524.0,78,161,31,47,0,48.40585774058577,378,45,19.723849372384937,4
Category_Wikipedia_sockpuppets_of_Raymondskie99.csv,5874,157481551.0,2128,3746,500,1628,0,48.56094654409261,494,64,18.271195097037793,3
Category_Wikipedia_sockpuppets_of_53harishkv.csv,280,3091948.0,100,180,50,50,0,46.607142857142854,234,54,22.692857142857143,5
Category_Wikipedia_sockpuppets_of_DaveyPASCOE.csv,85,1191959.0,32,53,32,0,0,46.15294117647059,196,27,18.694117647058825,9
Category_Wikipedia_sockpuppets_of_Amy._Firehoof..csv,513,27226045.0,161,352,65,96,0,49.512670565302145,257,59,19.432748538011698,4
Category_Wikipedia_sockpuppets_of_Ramsham12345.csv,35,2126775.0,11,24,4,7,0,41.25714285714286,148,27,18.542857142857144,14
Category_Wikipedia_sockpuppets_of_Wnnse.csv,2054,17305435.0,877,1177,500,377,0,35.97224926971762,250,49,21.917721518987342,6
Category_Wikipedia_sockpuppets_of_Lordsweat.csv,22,74092.0,16,6,8,8,0,14.272727272727273,39,43,25.545454545454547,19
Category_Wikipedia_sockpuppets_of_SMG055.csv,621,7417971.0,194,427,137,57,0,32.16747181964573,220,43,18.943639291465377,8
Category_Wikipedia_sockpuppets_of_Walidou47.csv,3286,25921659.0,1082,2204,500,582,0,62.911746804625686,475,110,14.29123554473524,3
Category_Wikipedia_sockpuppets_of_Haiyenslna.csv,6225,184313137.0,1810,4415,192,1618,0,42.723534136546185,496,64,20.00289156626506,5
Category_Wikipedia_sockpuppets_of_Hugpetfood.csv,14,1814749.0,8,6,5,3,0,41.92857142857143,194,15,9.5,8
Category_Wikipedia_sockpuppets_of_Tianjone02.csv,98,260506.0,31,67,9,22,0,38.48979591836735,184,26,17.183673469387756,4
Category_Wikipedia_sockpuppets_of_WellspringHealthAccess.csv,3,2334061.0,2,1,2,0,0,84.0,189,32,30.333333333333332,27
Category_Wikipedia_sockpuppets_of_Valleryking.csv,595,1577554.0,203,392,199,4,0,41.07731092436975,255,59,20.181512605042016,10
Category_Wikipedia_sockpuppets_of_Tokyo_Oz.csv,2764,265689258.0,1036,1728,500,536,0,40.96852387843705,498,52,16.095151953690305,3
Category_Wikipedia_sockpuppets_of_L.Halifax001.csv,1086,342716536.0,508,578,500,8,0,31.243093922651934,234,34,23.54696132596685,4
Category_Wikipedia_sockpuppets_of_Mike_maroon.csv,255,9655323.0,108,147,67,41,0,42.96078431372549,226,38,16.737254901960785,11
Category_Wikipedia_sockpuppets_of_Dearmky.csv,122,48619271.0,45,77,36,9,0,57.28688524590164,230,25,8.975409836065573,4
Category_Wikipedia_sockpuppets_of_PawandeepSinghOnline.csv,5,17541859.0,2,3,2,0,0,110.8,335,20,19.6,19
Category_Wikipedia_sockpuppets_of_Amansharma111.csv,2584,126358972.0,1077,1507,97,980,0,41.80379256965944,496,76,19.095201238390093,5
Category_Wikipedia_sockpuppets_of_Vr.csv,1926,125930386.0,765,1161,500,265,0,29.240913811007267,216,110,20.23208722741433,4
Category_Wikipedia_sockpuppets_of_Daddy_Kindsoul.csv,5657,50735867.0,2077,3580,500,1577,0,35.82782393494785,264,66,17.896411525543574,3
Category_Wikipedia_sockpuppets_of_MaxPrem.csv,582,21232066.0,151,431,64,87,0,58.6958762886598,255,46,16.352233676975946,5
Category_Wikipedia_sockpuppets_of_Cstemhouston.csv,5,898.0,5,0,5,0,0,44.6,195,14,14.0,14
Category_Wikipedia_sockpuppets_of_Barbaric.csv,221,2821240.0,62,159,56,6,0,42.339366515837106,200,41,14.819004524886878,5
Category_Wikipedia_sockpuppets_of_Ahussam.csv,251,419983820.0,71,180,67,4,0,47.44621513944223,494,53,22.382470119521912,4
Category_Wikipedia_sockpuppets_of_Nucleargeek.csv,150,6188962.0,54,96,17,37,0,56.11333333333334,227,60,24.786666666666665,8
Category_Wikipedia_sockpuppets_of_Abutsagem.csv,20,2294536.0,10,10,10,0,0,62.85,194,26,18.0,6
Category_Wikipedia_sockpuppets_of_JuanNicolas04.csv,266,5432292.0,88,178,50,38,0,51.95864661654135,478,50,20.330827067669173,7
Category_Wikipedia_sockpuppets_of_Kannada123.csv,2710,53138242.0,986,1724,500,486,0,36.62361623616236,260,64,18.09778597785978,5
Category_Wikipedia_sockpuppets_of_Shapiros10.csv,117,38441018.0,34,83,15,19,0,45.30769230769231,217,50,24.76923076923077,4
Category_Wikipedia_sockpuppets_of_Armoboy323.csv,229,17667767.0,70,159,33,37,0,41.26637554585153,199,43,13.969432314410481,5
Category_Wikipedia_sockpuppets_of_Okmrman.csv,1082,2158649.0,503,579,500,3,0,56.56099815157116,430,111,33.733826247689464,5
Category_Wikipedia_sockpuppets_of_Jenevip.csv,189,18245488.0,107,82,90,17,0,25.402116402116402,199,32,19.25925925925926,11
Category_Wikipedia_sockpuppets_of_Jmjocson62.csv,953,8837444.0,404,549,380,24,0,26.942287513116476,255,70,27.54354669464848,5
Category_Wikipedia_sockpuppets_of_Raptorama.csv,18,86253.0,7,11,4,3,1,42.27777777777778,151,41,28.77777777777778,11
Category_Wikipedia_sockpuppets_of_Rock_soul_of_christ.csv,8,90753.0,4,4,4,0,0,45.375,119,37,27.0,19
Category_Wikipedia_sockpuppets_of_JaneDoobyJench.csv,1102,731765.0,379,723,239,140,0,51.33575317604356,438,34,15.996370235934664,7
Category_Wikipedia_sockpuppets_of_Jcornu.csv,122,8556197.0,39,83,28,11,0,46.36065573770492,207,34,14.418032786885245,7
Category_Wikipedia_sockpuppets_of_Aariya_rafi.csv,46,5379707.0,15,31,14,1,0,43.58695652173913,214,34,19.043478260869566,6
Category_Wikipedia_sockpuppets_of_LunaVick79.csv,718,5274097.0,286,432,202,84,0,37.94568245125348,348,31,14.784122562674094,9
Category_Wikipedia_sockpuppets_of_Tumbleman.csv,2647,278116091.0,992,1655,490,502,0,46.60445787684171,244,60,24.64374763883642,4
Category_Wikipedia_sockpuppets_of_BreakingDexter.csv,804,2432938.0,237,567,184,53,0,36.86194029850746,250,50,21.80597014925373,6
Category_Wikipedia_sockpuppets_of_Remyleduc.csv,14,1288.0,6,8,6,0,0,24.357142857142858,159,33,22.928571428571427,9
Category_Wikipedia_sockpuppets_of_Crampus46.csv,277,290997854.0,78,199,40,38,0,36.85920577617328,230,27,13.31768953068592,4
Category_Wikipedia_sockpuppets_of_Darkcover21.csv,1318,5959038.0,558,760,500,58,0,34.96737481031867,247,53,15.15402124430956,6
Category_Wikipedia_sockpuppets_of_Keepfaithintruths.csv,12,83310.0,6,6,4,2,0,105.0,249,20,19.583333333333332,19
Category_Wikipedia_sockpuppets_of_Njoidjer.csv,16,194275.0,5,11,3,2,0,54.25,127,47,30.625,13
Category_Wikipedia_sockpuppets_of_E_Pluribus_Anthony.csv,10300,369801022.0,2703,7597,500,2203,0,51.39174757281553,255,83,17.71650485436893,3
Category_Wikipedia_sockpuppets_of_Stewaj7.csv,829,120711375.0,299,530,297,2,0,52.56453558504222,236,51,23.16887816646562,9
Category_Wikipedia_sockpuppets_of_Avineshjose.csv,1772,6862968.0,518,1254,480,38,0,46.37641083521445,212,77,21.975733634311513,3
Category_Wikipedia_sockpuppets_of_AichiWikiFixer.csv,2647,31599722.0,750,1897,500,250,0,51.34756327918398,414,102,12.751794484321874,3
Category_Wikipedia_sockpuppets_of_Percy_Pissnose.csv,589,25969949.0,174,415,17,157,0,55.29202037351443,255,58,17.419354838709676,4
Category_Wikipedia_sockpuppets_of_Posestrade.csv,10,588.0,6,4,4,2,0,86.3,131,16,11.8,10
Category_Wikipedia_sockpuppets_of_Happycats58.csv,252,44151098.0,106,146,88,18,0,45.36507936507937,275,50,35.38095238095238,16
Category_Wikipedia_sockpuppets_of_Wik09wik.csv,66,1215563.0,25,41,15,10,0,44.25757575757576,160,24,17.257575757575758,8
Category_Wikipedia_sockpuppets_of_Tanisha_priyadarshini.csv,795,3047178.0,324,471,289,35,0,38.0314465408805,249,56,24.349685534591195,5
Category_Wikipedia_sockpuppets_of_Jwb23.csv,917,57588820.0,312,605,63,249,0,50.355507088331514,417,48,18.17557251908397,7
Category_Wikipedia_sockpuppets_of_SuaveArt.csv,1645,7542607.0,530,1115,500,30,0,51.054103343465044,250,78,28.561702127659576,1
Category_Wikipedia_sockpuppets_of_Camila_Pastorelli.csv,104,244922591.0,29,75,19,10,0,44.54807692307692,196,53,27.942307692307693,11
Category_Wikipedia_sockpuppets_of_Ronald_Galope_Barniso.csv,1749,15639692.0,765,984,500,265,0,34.724985706117785,254,66,24.61520869068039,6
Category_Wikipedia_sockpuppets_of_Alessandro573.csv,128,8918.0,43,85,11,32,0,66.265625,242,54,29.4296875,6
Category_Wikipedia_sockpuppets_of_Blake24.csv,1778,216137191.0,456,1322,357,99,0,47.70472440944882,250,59,9.70978627671541,4
Category_Wikipedia_sockpuppets_of_Sirspinzalot.csv,85,8059610.0,35,50,26,9,0,47.72941176470588,270,69,21.211764705882352,8
Category_Wikipedia_sockpuppets_of_Nstm.csv,112,7415772.0,43,69,27,16,0,42.38392857142857,199,51,25.526785714285715,7
Category_Wikipedia_sockpuppets_of_Doyleisafag.csv,1,0.0,1,0,1,0,0,0.0,0,11,11.0,11
Category_Wikipedia_sockpuppets_of_Entuziazm.csv,1571,40702866.0,527,1044,266,261,0,50.22278803309994,500,51,17.870146403564608,4
Category_Wikipedia_sockpuppets_of_Revenues-expense=netincome.csv,30,2756991.0,9,21,9,0,0,52.666666666666664,250,47,35.8,17
Category_Wikipedia_sockpuppets_of_Lishowronsakura.csv,798,6050172.0,237,561,149,88,0,43.95864661654135,214,32,13.547619047619047,6
Category_Wikipedia_sockpuppets_of_TRATTOOO.csv,4918,56920283.0,1764,3154,388,1376,0,38.019520130134204,255,107,23.52155347702318,3
Category_Wikipedia_sockpuppets_of_Lewis_Nottingham.csv,331,38985656.0,96,235,59,37,0,78.82175226586102,500,37,16.241691842900302,8
Category_Wikipedia_sockpuppets_of_Planum.csv,6,3067.0,5,1,5,0,7,21.166666666666668,24,23,23.0,23
Category_Wikipedia_sockpuppets_of_Alethea2019.csv,9,94461.0,6,3,4,2,0,33.0,116,21,10.333333333333334,9
Category_Wikipedia_sockpuppets_of_Pear-Jack.csv,81,23528418.0,39,42,20,19,0,37.839506172839506,243,31,27.432098765432098,17
Category_Wikipedia_sockpuppets_of_BIKASHING.csv,47,62604.0,17,30,8,9,0,37.59574468085106,130,19,13.574468085106384,6
Category_Wikipedia_sockpuppets_of_Aloke_Singh12.csv,2,0.0,1,1,1,0,0,0.0,0,26,26.0,26
Category_Wikipedia_sockpuppets_of_Amr.elmowaled.csv,649,9573412.0,208,441,98,110,0,69.18489984591679,500,66,18.699537750385208,6
Category_Wikipedia_sockpuppets_of_Electronicoutcome.csv,56,6394414.0,29,27,17,12,0,60.19642857142857,300,39,22.267857142857142,11
Category_Wikipedia_sockpuppets_of_SmalforaGiant.csv,2102,54711342.0,588,1514,180,408,0,72.15794481446241,503,86,20.746907706945766,5
Category_Wikipedia_sockpuppets_of_Photon2322.csv,204,8121368.0,68,136,63,5,0,47.0735294117647,253,40,19.16176470588235,7
Category_Wikipedia_sockpuppets_of_Sonic_the_Hedgehog_Boy.csv,567,33135460.0,168,399,73,95,0,44.18165784832451,307,41,15.567901234567902,3
Category_Wikipedia_sockpuppets_of_TheBestBandInTheInternet.csv,403,17722855.0,124,279,58,66,0,39.84367245657568,255,47,21.10421836228288,5
Category_Wikipedia_sockpuppets_of_Oldmansaturn.csv,54,18839113.0,15,39,5,10,0,82.9074074074074,496,51,16.75925925925926,4
Category_Wikipedia_sockpuppets_of_Kee1992.csv,1976,41002890.0,1000,976,500,500,0,36.03593117408907,520,69,16.416497975708502,3
Category_Wikipedia_sockpuppets_of_Gogdygody.csv,68,960494.0,26,42,21,5,0,52.85294117647059,222,28,13.558823529411764,11
Category_Wikipedia_sockpuppets_of_Frank_marine.csv,1589,41915911.0,659,930,500,159,0,27.61799874134676,362,60,26.414726242920075,7
Category_Wikipedia_sockpuppets_of_SUVRAT_RAJ.csv,104,53310343.0,27,77,10,17,0,47.88461538461539,255,44,19.85576923076923,3
Category_Wikipedia_sockpuppets_of_M._Richa_Mehul.csv,8,21939366.0,4,4,2,2,0,37.5,219,31,19.75,14
Category_Wikipedia_sockpuppets_of_Thelostwolf194.csv,16,447290.0,10,6,5,5,0,62.5,196,38,26.75,23
Category_Wikipedia_sockpuppets_of_ChronicalUsual.csv,5921,75791011.0,2533,3388,500,2033,0,43.433372741091034,255,87,26.20486404323594,3
Category_Wikipedia_sockpuppets_of_Mattsbigbrother.csv,67,236635.0,41,26,22,19,0,29.149253731343283,183,48,19.71641791044776,10
Category_Wikipedia_sockpuppets_of_Gene_Poole.csv,3319,149295579.0,1000,2319,500,500,0,42.16872551973486,259,93,21.442000602591143,6
Category_Wikipedia_sockpuppets_of_Kes√§lauantait.csv,2271,45740098.0,568,1703,53,515,0,35.92778511668868,226,74,16.026860413914576,4
Category_Wikipedia_sockpuppets_of_Mynose2.csv,12,896.0,4,8,4,0,9,68.41666666666667,187,17,11.416666666666666,9
Category_Wikipedia_sockpuppets_of_Itskumudhk.csv,944,35226799.0,301,643,182,119,0,37.380296610169495,255,49,27.8135593220339,7
Category_Wikipedia_sockpuppets_of_Quantum_or_not.csv,103,809087.0,58,45,39,19,0,31.631067961165048,199,34,20.718446601941746,14
Category_Wikipedia_sockpuppets_of_YaR_GnitS.csv,119,20395278.0,33,86,29,4,0,31.445378151260503,161,39,12.882352941176471,3
Category_Wikipedia_sockpuppets_of_WhiteReaperPM.csv,853,1986611.0,555,298,500,55,0,38.889800703399764,496,56,25.582649472450175,7
Category_Wikipedia_sockpuppets_of_Gingie11.csv,204,10106016.0,64,140,23,41,0,60.490196078431374,500,62,17.401960784313726,10
Category_Wikipedia_sockpuppets_of_Csdestiner09.csv,449,157897215.0,124,325,57,67,0,47.05345211581292,255,44,20.476614699331847,6
Category_Wikipedia_sockpuppets_of_Muazam_Ali_Bhatti.csv,8,313925.0,6,2,5,1,8,17.0,20,18,18.0,18
Category_Wikipedia_sockpuppets_of_Mintoo44.csv,2315,78674035.0,734,1581,483,251,0,41.83844492440605,255,53,11.608207343412527,3
Category_Wikipedia_sockpuppets_of_Bader_Bloshi.csv,544,4819159.0,197,347,58,139,0,47.96875,244,43,24.604779411764707,8
Category_Wikipedia_sockpuppets_of_Swarlzy.csv,95,66446272.0,33,62,33,0,0,78.10526315789474,496,27,14.505263157894737,7
Category_Wikipedia_sockpuppets_of_Turkeybutt_JC.csv,1776,1608404.0,513,1263,500,13,0,52.225788288288285,255,79,20.95608108108108,4
Category_Wikipedia_sockpuppets_of_G-Zay.csv,4337,175641863.0,1386,2951,500,886,0,45.62693105833525,262,67,19.617938667281532,4
Category_Wikipedia_sockpuppets_of_Dcfctippy.csv,285,230258842.0,69,216,42,27,0,38.656140350877195,229,63,19.55438596491228,10
Category_Wikipedia_sockpuppets_of_Cricket_Butterfly.csv,4818,38824509.0,1710,3108,500,1210,0,34.2656704026567,496,76,17.12079701120797,3
Category_Wikipedia_sockpuppets_of_Elick_txu.csv,366,19462392.0,121,245,34,87,0,59.97540983606557,255,54,19.060109289617486,4
Category_Wikipedia_sockpuppets_of_Shailendrarinku.csv,52,25345667.0,16,36,12,4,0,52.86538461538461,172,38,27.884615384615383,12
Category_Wikipedia_sockpuppets_of_Immirzakhan.csv,827,31169319.0,308,519,90,218,0,38.05320435308344,254,47,16.422007255139057,4
Category_Wikipedia_sockpuppets_of_Packistani.csv,4457,379505451.0,1420,3037,182,1238,0,39.24837334529953,495,70,15.693515817814674,4
Category_Wikipedia_sockpuppets_of_Opfinland.csv,232,65406.0,153,79,149,4,0,38.1551724137931,221,54,22.780172413793103,9
Category_Wikipedia_sockpuppets_of_DawedalRaqqa.csv,1312,10028882.0,410,902,324,86,0,51.48704268292683,255,54,16.554878048780488,3
Category_Wikipedia_sockpuppets_of_LaruaWA11.csv,965,50320104.0,354,611,105,249,0,43.48497409326425,216,51,21.00621761658031,4
Category_Wikipedia_sockpuppets_of_Claire.Poggi.csv,139,19264122.0,71,68,27,44,0,69.29496402877697,249,21,18.302158273381295,10
Category_Wikipedia_sockpuppets_of_Irianto06.csv,44,917996.0,17,27,4,13,0,64.36363636363636,297,44,15.454545454545455,6
Category_Wikipedia_sockpuppets_of_Saeedkhanbozdar786.csv,158,45585253.0,136,22,60,76,0,30.89240506329114,196,36,22.61392405063291,11
Category_Wikipedia_sockpuppets_of_Swirlgirl_m.csv,11,2076962.0,6,5,3,3,0,52.45454545454545,204,14,14.0,14
Category_Wikipedia_sockpuppets_of_Musiclover_john.csv,64,18555629.0,27,37,9,18,0,42.25,194,60,27.546875,12
Category_Wikipedia_sockpuppets_of_Craffael.09.csv,685,7366769.0,218,467,218,0,0,45.315328467153286,283,64,26.46131386861314,4
Category_Wikipedia_sockpuppets_of_USSRHydra.csv,1,0.0,1,0,1,0,27,27.0,27,28,28.0,28
Category_Wikipedia_sockpuppets_of_ÿ£ŸÑŸäŸÉÿ≥.csv,1824,85416701.0,468,1356,115,353,0,52.053179824561404,515,48,16.39857456140351,2
Category_Wikipedia_sockpuppets_of_31stash.csv,828,39484752.0,256,572,132,124,0,35.17270531400966,243,39,13.472222222222221,4
Category_Wikipedia_sockpuppets_of_Magnonimous.csv,2576,116276280.0,823,1753,500,323,0,45.631211180124225,253,99,27.68633540372671,5
Category_Wikipedia_sockpuppets_of_Tennis_expert.csv,5998,160203562.0,2064,3934,500,1564,0,63.159053017672555,255,106,26.690563521173726,6
Category_Wikipedia_sockpuppets_of_PeterSwensen.csv,406,41200404.0,143,263,89,54,0,40.99261083743843,306,56,30.448275862068964,6
Category_Wikipedia_sockpuppets_of_Yukhei25.csv,19,3636455.0,17,2,11,6,0,46.94736842105263,273,8,8.0,8
Category_Wikipedia_sockpuppets_of_Whitebunny_558.csv,79,23579995.0,22,57,19,3,0,64.87341772151899,245,31,16.88607594936709,5
Category_Wikipedia_sockpuppets_of_Mujeeb_Rahman_Chandio.csv,595,15488549.0,222,373,74,148,0,42.272268907563024,255,56,21.853781512605043,5
Category_Wikipedia_sockpuppets_of_White-Black-Kitten.csv,267,453299.0,153,114,118,35,0,36.95880149812734,254,45,17.411985018726593,5
Category_Wikipedia_sockpuppets_of_Wolves0000.csv,3441,20032484.0,1460,1981,500,960,0,28.13949433304272,491,48,25.804126707352513,8
Category_Wikipedia_sockpuppets_of_ArthurRead1234.csv,1256,57748590.0,614,642,500,114,0,30.779458598726116,255,42,15.587579617834395,5
Category_Wikipedia_sockpuppets_of_Devasthali.csv,208,128831732.0,58,150,6,52,0,44.625,196,54,16.048076923076923,3
Category_Wikipedia_sockpuppets_of_J_hamilton.csv,50,30587564.0,22,28,12,10,0,42.5,196,48,16.98,9
Category_Wikipedia_sockpuppets_of_Fingeekz.csv,12,19440.0,9,3,3,6,0,78.5,146,18,18.0,18
Category_Wikipedia_sockpuppets_of_Taztouzi.csv,218,11830594.0,61,157,25,36,0,53.11009174311926,248,46,13.160550458715596,4
Category_Wikipedia_sockpuppets_of_Alrahimofficial.csv,3,10323.0,2,1,1,1,0,0.0,0,25,12.333333333333334,6
Category_Wikipedia_sockpuppets_of_Tommystar.csv,1216,19063737.0,328,888,254,74,0,38.43996710526316,250,55,26.54111842105263,6
Category_Wikipedia_sockpuppets_of_Neelix.csv,3612,187409590.0,1273,2339,500,773,0,48.44656699889258,465,159,23.854097452934663,4
Category_Wikipedia_sockpuppets_of_Deepashaun.csv,12,9949917.0,7,5,6,1,0,39.25,196,23,16.0,11
Category_Wikipedia_sockpuppets_of_PooPaLoose.csv,9,3773.0,7,2,6,1,0,29.0,163,20,12.88888888888889,12
Category_Wikipedia_sockpuppets_of_Jemesouviens32.csv,1382,435563074.0,501,881,500,1,0,50.72069464544139,287,95,19.69464544138929,4
Category_Wikipedia_sockpuppets_of_ŒìŒΩ·ø∂Œ∏Œπ_œÉŒµŒ±œÖœÑœåŒΩ.csv,2042,18699198.0,719,1323,500,219,0,47.48139079333986,255,66,20.146914789422134,4
Category_Wikipedia_sockpuppets_of_Eightcubed.csv,428,49815008.0,160,268,126,34,0,39.64018691588785,232,49,22.764018691588785,6
Category_Wikipedia_sockpuppets_of_Zahratallah.csv,49,55896554.0,17,32,9,8,0,55.755102040816325,257,42,21.551020408163264,16
Category_Wikipedia_sockpuppets_of_Mr_Beans_Backside.csv,538,695872.0,124,414,117,7,0,39.24163568773234,200,47,35.45353159851301,16
Category_Wikipedia_sockpuppets_of_Goncbaisreal.csv,25,1347.0,12,13,8,4,0,56.4,209,16,8.8,4
Category_Wikipedia_sockpuppets_of_BlaccCrab.csv,2313,38342810.0,713,1600,500,213,0,45.188932122784266,476,59,20.562040639861653,4
Category_Wikipedia_sockpuppets_of_Compressedair83.csv,41,74816.0,16,25,15,1,0,30.170731707317074,112,52,44.63414634146341,30
Category_Wikipedia_sockpuppets_of_Rafael.reta31.csv,45,3197944.0,14,31,11,3,0,40.24444444444445,138,22,22.0,22
Category_Wikipedia_sockpuppets_of_Anil_2196.csv,142,2587456.0,49,93,37,12,0,43.098591549295776,261,27,14.147887323943662,6
Category_Wikipedia_sockpuppets_of_Ak131001.csv,3701,64518904.0,1413,2288,500,913,0,43.18454471764388,496,79,20.85517427722237,3
Category_Wikipedia_sockpuppets_of_Sublinamani.csv,721,72226643.0,198,523,71,127,0,48.45353675450763,388,43,13.79889042995839,3
Category_Wikipedia_sockpuppets_of_Anshuman001.csv,7,25526.0,4,3,2,2,0,19.142857142857142,134,27,27.0,27
Category_Wikipedia_sockpuppets_of_ŒùŒπŒ∫œåŒªŒ±ŒøŒöŒ±ŒªŒªŒπœÅœÅœåŒ∑.csv,202,4436260.0,73,129,48,25,0,53.054455445544555,494,53,20.876237623762375,6
Category_Wikipedia_sockpuppets_of_Talkoffact_Fact.csv,2,0.0,1,1,1,0,72,72.0,72,25,25.0,25
Category_Wikipedia_sockpuppets_of_Jack_turnip.csv,920,276880751.0,184,736,76,108,0,39.005434782608695,255,46,19.745652173913044,3
Category_Wikipedia_sockpuppets_of_Hiishi.csv,21,1571.0,11,10,8,3,0,53.666666666666664,200,21,13.857142857142858,8
Category_Wikipedia_sockpuppets_of_Melodica_Music_&_Dance_School.csv,97,39644276.0,34,63,27,7,0,51.618556701030926,255,46,21.051546391752577,14
Category_Wikipedia_sockpuppets_of_Priyanku.Phukan.csv,487,110367094.0,202,285,202,0,0,40.383983572895275,255,96,28.08829568788501,3
Category_Wikipedia_sockpuppets_of_NORTHCLICK.csv,356,52594617.0,144,212,73,71,0,46.77808988764045,255,52,20.365168539325843,6
Category_Wikipedia_sockpuppets_of_Mr.Election.csv,217,2298926.0,67,150,67,0,0,49.483870967741936,246,44,19.723502304147466,4
Category_Wikipedia_sockpuppets_of_Hums4r.csv,1258,278428580.0,421,837,385,36,0,50.588235294117645,261,53,22.329093799682035,4
Category_Wikipedia_sockpuppets_of_Clemper.csv,839,10018123.0,401,438,216,185,0,55.43742550655542,500,51,38.00953516090584,9
Category_Wikipedia_sockpuppets_of_Film2pro.csv,41,1396297.0,16,25,15,1,0,51.80487804878049,219,43,20.634146341463413,6
Category_Wikipedia_sockpuppets_of_Tyresem2k7.csv,2822,121207134.0,850,1972,460,390,0,41.01700921332388,494,50,20.935152374202694,3
Category_Wikipedia_sockpuppets_of_Kashmiri_musician.csv,10,112636168.0,4,6,2,2,0,22.2,67,53,25.9,18
Category_Wikipedia_sockpuppets_of_Youssefsameh5665.csv,16,3686.0,16,0,16,0,0,6.0,96,25,25.0,25
Category_Wikipedia_sockpuppets_of_Rugby_666.csv,1368,3371232.0,483,885,396,87,0,25.166666666666668,255,61,20.694444444444443,3
Category_Wikipedia_sockpuppets_of_Akagunduzsa01.csv,50,188340.0,29,21,18,11,0,25.1,121,26,17.56,11
Category_Wikipedia_sockpuppets_of_Zombiesnyder.csv,3568,21003941.0,847,2721,500,347,0,42.05773542600897,421,63,15.748318385650224,3
Category_Wikipedia_sockpuppets_of_Somaliland_sun.csv,103,48459821.0,36,67,12,24,0,57.56310679611651,210,37,20.339805825242717,7
Category_Wikipedia_sockpuppets_of_Vaishal.csv,8278,252982631.0,3524,4754,500,3024,0,39.578762986228554,255,62,15.327856970282676,3
Category_Wikipedia_sockpuppets_of_Aubmn.csv,2708,72152525.0,931,1777,500,431,0,64.86299852289513,255,57,20.93205317577548,5
Category_Wikipedia_sockpuppets_of_Wenfeiwu.csv,45,371300.0,28,17,22,6,0,29.066666666666666,196,62,16.755555555555556,10
Category_Wikipedia_sockpuppets_of_Belugajdm.csv,4519,65460760.0,1511,3008,500,1011,0,48.198495242310244,501,76,18.439256472670944,3
Category_Wikipedia_sockpuppets_of_Yevoc4.csv,21,363956.0,10,11,5,5,0,48.95238095238095,139,43,25.238095238095237,12
Category_Wikipedia_sockpuppets_of_ERGP.csv,108,124032819.0,38,70,19,19,0,67.46296296296296,252,25,13.49074074074074,8
Category_Wikipedia_sockpuppets_of_Harshasimha.csv,847,138862993.0,294,553,275,19,0,37.36599763872491,247,58,16.257378984651712,5
Category_Wikipedia_sockpuppets_of_SpeedAdron.csv,141,1802603.0,52,89,38,14,0,41.744680851063826,232,50,17.375886524822697,8
Category_Wikipedia_sockpuppets_of_Saqlainify.csv,879,35100356.0,286,593,141,145,0,46.901023890784984,494,60,16.0,4
Category_Wikipedia_sockpuppets_of_Aarem.csv,2709,456019415.0,703,2006,500,203,0,53.18456995201181,380,77,15.412698412698413,2
Category_Wikipedia_sockpuppets_of_Cmoibenlepro.csv,1449,2422495.0,586,863,500,86,0,44.99654934437543,255,64,32.869565217391305,6
Category_Wikipedia_sockpuppets_of_Maryank3.csv,613,8260943.0,184,429,40,144,0,30.756933115823816,196,56,23.784665579119086,9
Category_Wikipedia_sockpuppets_of_Tempest2552.csv,163,199761.0,74,89,42,32,0,51.59509202453988,275,75,34.828220858895705,5
Category_Wikipedia_sockpuppets_of_Tetra_quark.csv,8877,48035749.0,2430,6447,500,1930,0,59.953925875858964,255,71,17.960121662723893,1
Category_Wikipedia_sockpuppets_of_Shahidgee07.csv,4451,177995418.0,1762,2689,286,1476,0,47.0168501460346,255,109,22.79083352055718,3
Category_Wikipedia_sockpuppets_of_Composerhouse.csv,64,154258977.0,17,47,9,8,0,40.125,194,43,22.28125,12
Category_Wikipedia_sockpuppets_of_Nagendra_NJ.csv,6934,70594910.0,2480,4454,500,1980,0,34.89558696279204,260,54,16.333285261032593,4
Category_Wikipedia_sockpuppets_of_Robert_S._Barlow.csv,119,2249377.0,35,84,11,24,0,71.0672268907563,196,48,18.73109243697479,6
Category_Wikipedia_sockpuppets_of_Kashniyal.csv,13,9651.0,12,1,11,1,20,20.53846153846154,24,11,11.0,11
Category_Wikipedia_sockpuppets_of_Shagadelicbasil23.csv,1083,6700393.0,528,555,500,28,0,21.04247460757156,255,50,24.63157894736842,6
Category_Wikipedia_sockpuppets_of_Awesomedjh.csv,146,4830140.0,61,85,52,9,0,49.35616438356164,206,71,22.773972602739725,4
Category_Wikipedia_sockpuppets_of_Mashhood316.csv,150,140892458.0,30,120,30,0,0,45.4,231,15,11.36,4
Category_Wikipedia_sockpuppets_of_Wiki_Historian_N_OH.csv,1924,25663386.0,651,1273,500,151,0,44.79261954261954,224,64,15.321725571725572,4
Category_Wikipedia_sockpuppets_of_Sidd90.csv,34,33980197.0,12,22,8,4,0,54.14705882352941,285,26,16.735294117647058,11
Category_Wikipedia_sockpuppets_of_Bhattarai1237.csv,459,1969172.0,160,299,88,72,0,47.89542483660131,281,52,17.880174291939,6
Category_Wikipedia_sockpuppets_of_Tranngocnhatminh.csv,1161,18025651.0,374,787,143,231,0,40.8776916451335,255,45,15.956072351421188,3
Category_Wikipedia_sockpuppets_of_FQ20FanVimtojuice.csv,485,4689186.0,225,260,219,6,0,36.42061855670103,285,36,20.554639175257734,4
Category_Wikipedia_sockpuppets_of_Silar.csv,1838,210311841.0,506,1332,500,6,0,37.17845484221981,249,73,13.848748639825898,3
Category_Wikipedia_sockpuppets_of_Sav_Love_MT.csv,51,16692602.0,18,33,13,5,0,40.294117647058826,164,14,11.411764705882353,11
Category_Wikipedia_sockpuppets_of_Surbhipatel.csv,1,0.0,1,0,1,0,15,15.0,15,68,68.0,68
Category_Wikipedia_sockpuppets_of_Griot.csv,5306,383526736.0,1234,4072,354,880,0,47.067093856012065,376,77,18.213908782510366,3
Category_Wikipedia_sockpuppets_of_AdityaNakul.csv,4111,19650767.0,1391,2720,500,891,0,51.92045730965702,500,61,19.754804183896862,5
Category_Wikipedia_sockpuppets_of_Lemonsunited.csv,106,460175.0,45,61,11,34,0,70.24528301886792,220,30,15.179245283018869,7
Category_Wikipedia_sockpuppets_of_TrueLicense909.csv,7396,339180678.0,2032,5364,500,1532,0,37.77082206598161,516,64,16.546241211465656,2
Category_Wikipedia_sockpuppets_of_OwDOnimEDGENiORmyTErentea.csv,103,11586222.0,80,23,29,51,0,60.33009708737864,285,25,18.009708737864077,5
Category_Wikipedia_sockpuppets_of_Firefox09101.csv,13,97670.0,11,2,5,6,14,42.61538461538461,77,70,65.76923076923077,15
Category_Wikipedia_sockpuppets_of_Alessandr79.csv,40,2135016.0,17,23,16,1,0,92.8,169,15,11.0,8
Category_Wikipedia_sockpuppets_of_Benjaminzyg9402.csv,120,2530133.0,35,85,17,18,0,60.38333333333333,238,32,18.641666666666666,11
Category_Wikipedia_sockpuppets_of_DyslexicNerd_01.csv,76,1132456.0,40,36,40,0,0,65.97368421052632,330,50,29.342105263157894,11
Category_Wikipedia_sockpuppets_of_Hizubiki25.csv,319,33997527.0,113,206,113,0,0,31.608150470219435,327,34,16.598746081504704,7
Category_Wikipedia_sockpuppets_of_Paolonephotoreporter.csv,7,593986.0,3,4,2,1,0,32.857142857142854,180,20,14.857142857142858,8
Category_Wikipedia_sockpuppets_of_Cosmic_Disturbance.csv,81,1601206.0,26,55,12,14,0,62.5679012345679,254,52,17.48148148148148,8
Category_Wikipedia_sockpuppets_of_Dwai1986.csv,97,2108212.0,27,70,14,13,0,81.45360824742268,255,50,34.72164948453608,9
Category_Wikipedia_sockpuppets_of_Cinemawaali.csv,146,31720618.0,52,94,40,12,0,45.178082191780824,255,32,12.849315068493151,5
Category_Wikipedia_sockpuppets_of_Filmfan1964.csv,16,679828.0,8,8,6,2,12,110.0625,248,23,18.1875,12
Category_Wikipedia_sockpuppets_of_‡§≤‡•ã‡§ï‡•á‡§Ç‡§¶‡•ç‡§∞_‡§∏‡§ø‡§Ç‡§π.csv,12,454667.0,9,3,5,4,0,34.083333333333336,176,28,27.583333333333332,27
Category_Wikipedia_sockpuppets_of_Madhav_Eleswarapu.csv,15,360641.0,12,3,8,4,0,42.733333333333334,196,31,23.533333333333335,14
Category_Wikipedia_sockpuppets_of_Purplelitchi.csv,1,0.0,1,0,1,0,60,60.0,60,25,25.0,25
Category_Wikipedia_sockpuppets_of_Abignofromme.csv,12,187314.0,11,1,5,6,0,31.833333333333332,159,23,13.833333333333334,13
Category_Wikipedia_sockpuppets_of_Dilpreet_Singh01.csv,151,1726355.0,43,108,19,24,0,54.211920529801326,319,53,21.225165562913908,8
Category_Wikipedia_sockpuppets_of_Papakis1.csv,398,36320755.0,147,251,90,57,0,30.168341708542712,250,44,20.587939698492463,10
Category_Wikipedia_sockpuppets_of_Etyler22.csv,27,67233.0,16,11,10,6,0,35.55555555555556,130,42,27.62962962962963,7
Category_Wikipedia_sockpuppets_of_Sribalajivideo.csv,74,1312374.0,26,48,23,3,0,74.97297297297297,496,31,16.27027027027027,6
Category_Wikipedia_sockpuppets_of_Kosi_Onochie.csv,388,13142197.0,148,240,130,18,0,46.22422680412371,233,64,31.827319587628867,4
Category_Wikipedia_sockpuppets_of_Rishabh7009.csv,1,0.0,1,0,1,0,24,24.0,24,17,17.0,17
Category_Wikipedia_sockpuppets_of_Priscilla_223.csv,966,94852729.0,262,704,80,182,0,45.81780538302277,500,52,18.781573498964804,4
Category_Wikipedia_sockpuppets_of_Alizulfikarzahedi.csv,2946,434713566.0,1072,1874,256,816,0,42.57976917854718,499,89,22.081466395112017,4
Category_Wikipedia_sockpuppets_of_Poojajainhr.csv,322,3675000.0,129,193,37,92,0,54.993788819875775,319,80,26.400621118012424,4
Category_Wikipedia_sockpuppets_of_WhyJesus.csv,77,274535150.0,19,58,18,1,0,52.05194805194805,202,30,16.545454545454547,9
Category_Wikipedia_sockpuppets_of_Medhi89.csv,175,1800767.0,109,66,104,5,0,32.01714285714286,250,43,16.365714285714287,9
Category_Wikipedia_sockpuppets_of_MrAmberGold.csv,609,18048089.0,195,414,185,10,0,51.11330049261084,235,45,16.97208538587849,5
Category_Wikipedia_sockpuppets_of_Orugoro.csv,103,116800358.0,25,78,17,8,0,54.679611650485434,227,53,20.864077669902912,15
Category_Wikipedia_sockpuppets_of_Mart_Waterizz.csv,151,7396970.0,43,108,25,18,0,62.205298013245034,253,49,23.7682119205298,11
Category_Wikipedia_sockpuppets_of_Thubgb.csv,53,2458165.0,13,40,12,1,0,55.660377358490564,209,24,18.169811320754718,11
Category_Wikipedia_sockpuppets_of_SingWale.csv,133,7912803.0,37,96,27,10,0,52.984962406015036,214,54,24.593984962406015,10
Category_Wikipedia_sockpuppets_of_Vinayvinyill.csv,321,2880610.0,122,199,67,55,0,67.24610591900311,358,53,14.04361370716511,5
Category_Wikipedia_sockpuppets_of_Jr_abad.csv,1829,68736175.0,500,1329,103,397,0,29.948059048660472,252,44,16.41880809185347,5
Category_Wikipedia_sockpuppets_of_Dylnmr.csv,38,13888519.0,16,22,9,7,0,35.73684210526316,174,20,16.05263157894737,10
Category_Wikipedia_sockpuppets_of_SahabAliwadia.csv,2305,186275041.0,757,1548,500,257,0,48.85162689804772,445,68,22.937527114967462,4
Category_Wikipedia_sockpuppets_of_Jakehurst10.csv,170,64455076.0,34,136,28,6,0,57.39411764705882,255,39,27.935294117647057,10
Category_Wikipedia_sockpuppets_of_RockNRollWiki.csv,2575,122273299.0,1000,1575,500,500,0,51.984466019417475,469,60,21.673009708737865,3
Category_Wikipedia_sockpuppets_of_I69yomom.csv,3,216.0,2,1,2,0,17,22.333333333333332,25,23,12.333333333333334,7
Category_Wikipedia_sockpuppets_of_Wasraw.csv,1425,40028361.0,450,975,248,202,0,54.18456140350877,499,84,20.482105263157894,4
Category_Wikipedia_sockpuppets_of_Nisheshbhattarai.csv,109,41113133.0,32,77,21,11,0,44.56880733944954,277,29,18.146788990825687,6
Category_Wikipedia_sockpuppets_of_OneInAMillion96.csv,1761,34291083.0,596,1165,500,96,0,36.80863145939807,241,51,20.98182850653038,5
Category_Wikipedia_sockpuppets_of_Rage476.csv,1541,43852610.0,473,1068,148,325,0,45.31278390655419,422,44,15.80986372485399,3
Category_Wikipedia_sockpuppets_of_Lorenzo_Cappiello.csv,66,1914729.0,40,26,39,1,0,16.40909090909091,199,40,22.575757575757574,12
Category_Wikipedia_sockpuppets_of_Synthelabobabe21.csv,5203,28795688.0,1502,3701,285,1217,0,42.42667691716318,255,59,16.94407072842591,1
Category_Wikipedia_sockpuppets_of_Tumbleweed6536.csv,46,1380272.0,15,31,10,5,0,56.0,228,30,20.17391304347826,13
Category_Wikipedia_sockpuppets_of_Jerryzrli.csv,76,63763681.0,22,54,9,13,0,54.223684210526315,232,37,17.43421052631579,8
Category_Wikipedia_sockpuppets_of_Bro_no_go.csv,23,4839.0,10,13,8,2,0,65.17391304347827,196,20,17.304347826086957,13
Category_Wikipedia_sockpuppets_of_JosephDann.csv,275,232517173.0,68,207,35,33,0,37.32727272727273,190,51,20.723636363636363,4
Category_Wikipedia_sockpuppets_of_RSR2003.csv,1805,29792975.0,615,1190,500,115,0,57.19390581717452,495,44,21.966759002770083,7
Category_Wikipedia_sockpuppets_of_Another_Wiki_User_the_2nd.csv,1549,116118658.0,460,1089,429,31,0,53.45900581020013,500,85,28.569399612653324,5
Category_Wikipedia_sockpuppets_of_Phuntsok2000.csv,1966,62217976.0,620,1346,141,479,0,35.24059003051882,211,89,23.545778229908443,2
Category_Wikipedia_sockpuppets_of_Imabookreader.csv,59,12536007.0,17,42,14,3,0,56.101694915254235,227,34,20.796610169491526,13
Category_Wikipedia_sockpuppets_of_Booze_broads_and_bullets.csv,907,29013110.0,317,590,317,0,0,25.144432194046306,193,56,29.163175303197352,6
Category_Wikipedia_sockpuppets_of_King_Shadzar.csv,210,36899379.0,45,165,7,38,0,48.74285714285714,210,35,11.128571428571428,6
Category_Wikipedia_sockpuppets_of_AlfredHitchcockFromMeTV.csv,472,6759387.0,329,143,135,194,0,25.133474576271187,322,53,21.108050847457626,6
Category_Wikipedia_sockpuppets_of_North_Atlanticist_Usonian.csv,3268,25135398.0,852,2416,500,352,0,46.2906976744186,255,75,20.71358629130967,3
Category_Wikipedia_sockpuppets_of_Ejrjrrrie.csv,6,314.0,4,2,4,0,0,49.5,119,30,30.0,30
Category_Wikipedia_sockpuppets_of_Marlia555786.csv,87,12955842.0,35,52,17,18,0,43.52873563218391,342,53,21.011494252873565,9
Category_Wikipedia_sockpuppets_of_Karemia.csv,46,14150737.0,10,36,8,2,0,60.91304347826087,286,27,17.782608695652176,6
Category_Wikipedia_sockpuppets_of_MEXXS.csv,22,6039464.0,8,14,5,3,0,48.54545454545455,139,52,14.181818181818182,3
Category_Wikipedia_sockpuppets_of_SMART_NewsPaper.csv,9,412380.0,4,5,2,2,0,34.55555555555556,115,19,13.555555555555555,5
Category_Wikipedia_sockpuppets_of_Filucz2004.csv,1136,30218414.0,295,841,272,23,0,46.86619718309859,255,46,14.471830985915492,4
Category_Wikipedia_sockpuppets_of_Nobel_X300.csv,3520,3855809.0,778,2742,500,278,0,49.03011363636364,442,66,15.35625,3
Category_Wikipedia_sockpuppets_of_Hatem_Mohammed_Al-Shamea.csv,9,84576.0,6,3,3,3,15,22.0,46,37,30.666666666666668,26
Category_Wikipedia_sockpuppets_of_Blackjack1812.csv,19,443660.0,15,4,14,1,10,29.526315789473685,129,14,14.0,14
Category_Wikipedia_sockpuppets_of_Mike_Babic.csv,2451,11050150.0,925,1526,500,425,0,35.8078335373317,255,73,19.432068543451653,4
Category_Wikipedia_sockpuppets_of_Inoxent_AR.csv,7643,26233741.0,2295,5348,500,1795,0,73.08229752714902,496,67,25.034672249116838,3
Category_Wikipedia_sockpuppets_of_Amino-protecting-groups.csv,25,20137001.0,12,13,6,6,0,60.12,208,44,37.92,15
Category_Wikipedia_sockpuppets_of_FAIZGUEVARRA.csv,653,5880677.0,283,370,94,189,0,52.98162327718224,249,48,23.306278713629403,3
Category_Wikipedia_sockpuppets_of_Stoubora.csv,1330,276567518.0,372,958,133,239,0,45.77067669172932,255,95,15.182706766917294,5
Category_Wikipedia_sockpuppets_of_Ronaldolobscoca.csv,38,609236.0,29,9,27,2,0,19.55263157894737,280,28,23.05263157894737,11
Category_Wikipedia_sockpuppets_of_Wikiblanks.csv,121,1699179.0,57,64,45,12,0,65.1900826446281,250,50,21.52892561983471,11
Category_Wikipedia_sockpuppets_of_Mahek_faldu.csv,61,5052678.0,22,39,12,10,0,39.47540983606557,196,53,22.737704918032787,9
Category_Wikipedia_sockpuppets_of_Countryball.csv,316,5698862.0,103,213,58,45,0,55.7626582278481,255,34,15.996835443037975,3
Category_Wikipedia_sockpuppets_of_Larry_Hanes_of_Raleigh.csv,2,0.0,1,1,1,0,0,0.0,0,6,6.0,6
Category_Wikipedia_sockpuppets_of_Kiri_Chafr.csv,638,1197997.0,206,432,154,52,0,41.38557993730407,255,64,24.78526645768025,4
Category_Wikipedia_sockpuppets_of_Samet_Y√ºcel.csv,2,39.0,2,0,2,0,0,48.0,96,18,18.0,18
Category_Wikipedia_sockpuppets_of_ImmortalKaine.csv,1759,57224304.0,575,1184,500,75,0,33.37350767481524,201,69,25.86753837407618,7
Category_Wikipedia_sockpuppets_of_Kidilamfiroz.csv,68,625230.0,54,14,35,19,0,26.058823529411764,205,39,34.411764705882355,22
Category_Wikipedia_sockpuppets_of_Nipponese_Dog_Calvero.csv,20702,530074221.0,6693,14009,500,6193,0,43.68418510288861,500,73,17.75103854700029,2
Category_Wikipedia_sockpuppets_of_Vernonheng.csv,12,3349158.0,11,1,11,0,0,14.5,174,20,20.0,20
Category_Wikipedia_sockpuppets_of_GlowingCommando66.csv,106,792138.0,40,66,20,20,0,37.29245283018868,152,34,23.830188679245282,14
Category_Wikipedia_sockpuppets_of_SuperNepoznat.csv,1012,111279424.0,301,711,135,166,0,42.819169960474305,255,108,21.984189723320156,5
Category_Wikipedia_sockpuppets_of_Warmpuppy.csv,140,46842772.0,44,96,36,8,0,46.00714285714286,218,42,18.307142857142857,4
Category_Wikipedia_sockpuppets_of_Iloveandrea.csv,9074,50279214.0,3124,5950,500,2624,0,47.74366321357726,255,81,20.76239806039233,4
Category_Wikipedia_sockpuppets_of_Uscdl.csv,2,159.0,2,0,2,0,0,98.0,196,15,15.0,15
Category_Wikipedia_sockpuppets_of_BlablablaQ1.csv,4,52551.0,3,1,3,0,0,47.5,190,21,16.5,12
Category_Wikipedia_sockpuppets_of_ABIElectronics.csv,8,8289.0,3,5,2,1,0,9.25,42,17,17.0,17
Category_Wikipedia_sockpuppets_of_Mason_snyder.csv,6,398.0,3,3,2,1,0,61.666666666666664,227,13,13.0,13
Category_Wikipedia_sockpuppets_of_Sauraved.csv,5279,23551240.0,1549,3730,500,1049,0,43.36124265959462,412,42,16.733282818715665,5
Category_Wikipedia_sockpuppets_of_GooberGorbachev83.csv,99,3474729.0,34,65,26,8,0,61.535353535353536,228,53,25.747474747474747,10
Category_Wikipedia_sockpuppets_of_Somi60bay.csv,105,24137752.0,34,71,22,12,0,38.61904761904762,172,45,22.238095238095237,14
Category_Wikipedia_sockpuppets_of_Sadiqahmad122.csv,111,6823683.0,62,49,30,32,0,46.4954954954955,201,23,13.864864864864865,4
Category_Wikipedia_sockpuppets_of_Maus-78.csv,1040,451082567.0,226,814,170,56,0,43.308653846153845,330,43,15.691346153846155,4
Category_Wikipedia_sockpuppets_of_Crowkid555.csv,1594,58285924.0,335,1259,150,185,0,70.49686323713927,442,55,21.737139272271015,5
Category_Wikipedia_sockpuppets_of_Algebraical.csv,984,177631972.0,387,597,121,266,0,51.4380081300813,498,53,17.95528455284553,9
Category_Wikipedia_sockpuppets_of_Nievsky.csv,192,9118350.0,76,116,71,5,0,51.75,255,52,29.723958333333332,10
Category_Wikipedia_sockpuppets_of_Dantherocker1.csv,3230,176088571.0,1026,2204,462,564,0,41.371826625386994,251,63,18.04891640866873,1
Category_Wikipedia_sockpuppets_of_FetcherFetcherHoH.csv,50,2653016.0,18,32,11,7,0,49.12,196,38,31.5,13
Category_Wikipedia_sockpuppets_of_YoungQuan3yZ.csv,64,15482152.0,15,49,9,6,0,43.046875,169,53,47.515625,17
Category_Wikipedia_sockpuppets_of_Chaudary_Nabeel.csv,43,2629787.0,14,29,8,6,0,50.674418604651166,140,41,23.976744186046513,14
Category_Wikipedia_sockpuppets_of_Md_iet.csv,2615,297133891.0,934,1681,500,434,0,50.56749521988528,496,64,19.409177820267686,3
Category_Wikipedia_sockpuppets_of_Touchablemantis.csv,92,11081016.0,43,49,41,2,0,31.043478260869566,173,28,24.347826086956523,17
Category_Wikipedia_sockpuppets_of_Stevegrtz.csv,219,178726784.0,67,152,42,25,0,46.305936073059364,227,45,13.949771689497718,5
Category_Wikipedia_sockpuppets_of_Amaan_Ul_Hasan99.csv,95,4410247.0,32,63,30,2,0,25.557894736842105,184,61,22.789473684210527,12
Category_Wikipedia_sockpuppets_of_MichaelPhelpsFoundation.csv,10,1190467.0,5,5,4,1,0,60.3,199,44,22.9,17
Category_Wikipedia_sockpuppets_of_Nrwairport.csv,2314,14697130.0,766,1548,500,266,0,49.87121866897148,255,65,26.42999135695765,4
Category_Wikipedia_sockpuppets_of_Itshayfevertime.csv,1040,46839098.0,333,707,290,43,0,40.70096153846154,261,70,26.089423076923076,5
Category_Wikipedia_sockpuppets_of_Amysaggu.csv,107,27524289.0,63,44,31,32,0,38.80373831775701,255,24,13.532710280373832,6
Category_Wikipedia_sockpuppets_of_PumpkinSky.csv,3298,158909870.0,1063,2235,500,563,0,44.31716191631292,255,86,21.842935112189206,3
Category_Wikipedia_sockpuppets_of_Vaalee.csv,1626,136402561.0,671,955,500,171,0,35.10393603936039,257,59,17.56088560885609,8
Category_Wikipedia_sockpuppets_of_Totocugno.csv,1574,3918099.0,486,1088,439,47,0,55.44790343074968,406,73,19.346886912325285,4
Category_Wikipedia_sockpuppets_of_Bmunir.pak.csv,169,30841641.0,43,126,17,26,0,38.59171597633136,225,23,12.775147928994082,6
Category_Wikipedia_sockpuppets_of_Rahul0500.csv,69,369263.0,39,30,20,19,0,33.84057971014493,197,52,29.28985507246377,10
Category_Wikipedia_sockpuppets_of_Desperadomgmt.csv,14,9674.0,11,3,8,3,0,34.714285714285715,185,9,9.0,9
Category_Wikipedia_sockpuppets_of_SuperblySpiffingPerson.csv,2787,39986302.0,906,1881,165,741,0,52.941872981700755,253,93,29.826695371367062,2
Category_Wikipedia_sockpuppets_of_Swanlaje29.csv,53,758934.0,21,32,11,10,0,32.83018867924528,208,40,31.30188679245283,16
Category_Wikipedia_sockpuppets_of_Deliciousgrapefruit.csv,1177,6351463.0,513,664,342,171,0,40.85471537807987,237,64,25.661002548853016,10
Category_Wikipedia_sockpuppets_of_DzzD.csv,74,625962.0,30,44,24,6,0,35.33783783783784,199,21,14.554054054054054,5
Category_Wikipedia_sockpuppets_of_TomPhan.csv,483,155351954.0,152,331,32,120,0,43.625258799171846,227,55,21.67287784679089,2
Category_Wikipedia_sockpuppets_of_Opute_promise.csv,42,4490994.0,12,30,12,0,0,61.285714285714285,223,44,41.523809523809526,18
Category_Wikipedia_sockpuppets_of_MakaveliReed.csv,4544,159568168.0,1171,3373,351,820,0,45.76958626760563,429,60,18.17363556338028,4
Category_Wikipedia_sockpuppets_of_BeingFaridKhan.csv,84,89691.0,41,43,31,10,0,40.80952380952381,196,30,21.69047619047619,13
Category_Wikipedia_sockpuppets_of_Rwneill.csv,302,368731679.0,90,212,81,9,0,39.02980132450331,253,45,18.887417218543046,8
Category_Wikipedia_sockpuppets_of_Spoondivy.csv,568,71807000.0,224,344,224,0,0,55.49295774647887,460,53,26.14788732394366,9
Category_Wikipedia_sockpuppets_of_Theodore_Larson_1962.csv,502,111621245.0,149,353,71,78,0,60.11155378486056,496,60,18.13545816733068,4
Category_Wikipedia_sockpuppets_of_Nooberchooss.csv,132,28428369.0,74,58,19,55,0,39.833333333333336,313,45,21.204545454545453,7
Category_Wikipedia_sockpuppets_of_Chris_H_of_New_York.csv,1656,55987404.0,608,1048,181,427,0,47.697463768115945,248,79,22.42330917874396,5
Category_Wikipedia_sockpuppets_of_JohnEventide.csv,5,5901.0,2,3,1,1,30,39.6,73,50,50.0,50
Category_Wikipedia_sockpuppets_of_MrJoshThehawk.csv,358,66967162.0,172,186,46,126,0,42.03631284916201,235,44,27.237430167597765,15
Category_Wikipedia_sockpuppets_of_Tidder.csv,30,385.0,14,16,14,0,44,56.2,65,31,22.233333333333334,19
Category_Wikipedia_sockpuppets_of_Warrior4just.csv,207,104891197.0,78,129,61,17,0,65.8743961352657,309,27,16.96135265700483,7
Category_Wikipedia_sockpuppets_of_Woobwoobwoob.csv,25,214498.0,10,15,9,1,0,36.0,164,20,16.8,13
Category_Wikipedia_sockpuppets_of_Openbluesky.csv,16,105119.0,6,10,2,4,0,91.6875,248,19,13.25,11
Category_Wikipedia_sockpuppets_of_Hound1330.csv,75,75096128.0,28,47,25,3,0,69.24,256,33,19.96,12
Category_Wikipedia_sockpuppets_of_Thealameda.csv,54,34531766.0,21,33,9,12,0,61.22222222222222,236,23,18.074074074074073,9
Category_Wikipedia_sockpuppets_of_Icequeen666.csv,21,332402.0,13,8,7,6,0,28.80952380952381,185,27,16.428571428571427,8
Category_Wikipedia_sockpuppets_of_Toad4707.csv,85,59885745.0,27,58,22,5,0,42.10588235294118,175,33,16.611764705882354,4
Category_Wikipedia_sockpuppets_of_Tfoxworth.csv,1516,69729229.0,497,1019,241,256,0,41.178759894459105,250,80,27.355540897097626,7
Category_Wikipedia_sockpuppets_of_Dancert12.csv,73,2394019.0,19,54,19,0,0,46.75342465753425,206,37,20.164383561643834,11
Category_Wikipedia_sockpuppets_of_Sunilseth15.csv,186,65126209.0,61,125,11,50,0,46.913978494623656,239,37,14.505376344086022,5
Category_Wikipedia_sockpuppets_of_Dragon_Emperor.csv,562,103787049.0,194,368,106,88,0,31.729537366548044,210,58,19.51423487544484,5
Category_Wikipedia_sockpuppets_of_Gardenstatelaw.csv,119,595848.0,47,72,34,13,0,58.403361344537814,358,27,19.10924369747899,13
Category_Wikipedia_sockpuppets_of_Nithya.rahul.csv,678,6682089.0,309,369,245,64,0,22.261061946902654,379,47,18.94542772861357,9
Category_Wikipedia_sockpuppets_of_Aimulti.csv,1433,5785755.0,500,933,500,0,0,35.74808094905792,225,58,23.26866713189114,5
Category_Wikipedia_sockpuppets_of_Random_Haste.csv,2538,38145053.0,666,1872,500,166,0,56.5531914893617,496,54,29.131205673758867,9
Category_Wikipedia_sockpuppets_of_SOUTHWEST_AIRLINES_IS_THE_BEST.csv,24,1199870.0,14,10,8,6,0,69.16666666666667,223,58,45.0,35
Category_Wikipedia_sockpuppets_of_‡¶®‡¶¨‡¶¶‡ßç‡¶¨‡ßÄ‡¶™.csv,788,13217816.0,272,516,160,112,0,51.34517766497462,496,53,17.911167512690355,5
Category_Wikipedia_sockpuppets_of_Devilmusic_2021.csv,9,1076.0,4,5,4,0,0,51.55555555555556,300,22,18.333333333333332,15
Category_Wikipedia_sockpuppets_of_Amrairin.csv,272,250332937.0,77,195,42,35,0,40.205882352941174,248,54,14.441176470588236,7
Category_Wikipedia_sockpuppets_of_Journalist492.csv,802,472169051.0,185,617,175,10,0,58.22693266832918,297,57,18.209476309226932,5
Category_Wikipedia_sockpuppets_of_HorseSnack.csv,47,2188555.0,16,31,13,3,0,44.148936170212764,208,48,24.70212765957447,7
Category_Wikipedia_sockpuppets_of_Klaus_Bells.csv,1555,412840528.0,456,1099,236,220,0,50.812861736334405,355,96,19.614790996784567,4
Category_Wikipedia_sockpuppets_of_Dierikon.csv,9,188333.0,5,4,4,1,7,27.11111111111111,110,19,18.77777777777778,18
Category_Wikipedia_sockpuppets_of_Mortaylor26.csv,2117,8313437.0,559,1558,500,59,0,40.02881435994332,419,70,25.59754369390647,4
Category_Wikipedia_sockpuppets_of_ÿ£ÿ≥ÿßŸÖÿ©_ÿ®ŸÜ_ÿπÿ®ÿØ_ÿßŸÑŸÑŸá_ŸàŸÑŸäÿØ.csv,1169,2238603.0,513,656,500,13,0,48.23866552609068,496,54,15.037639007698887,4
Category_Wikipedia_sockpuppets_of_Eminence_innovation.csv,20,72776972.0,4,16,4,0,0,76.6,180,20,16.5,11
Category_Wikipedia_sockpuppets_of_Ceoil.csv,1419,515669736.0,517,902,500,17,0,42.44256518675123,383,65,18.840028188865396,6
Category_Wikipedia_sockpuppets_of_Canelo225.csv,251,25723360.0,80,171,26,54,0,46.79681274900398,234,52,14.07569721115538,5
Category_Wikipedia_sockpuppets_of_Sadyboy333.csv,19,678362.0,9,10,9,0,0,73.94736842105263,212,56,28.05263157894737,18
Category_Wikipedia_sockpuppets_of_Sharkey45.csv,3112,186376699.0,1143,1969,192,951,0,44.60057840616967,255,74,19.517994858611825,3
Category_Wikipedia_sockpuppets_of_Ann_Cane.csv,733,129954095.0,287,446,217,70,0,41.0,225,67,20.117326057298772,4
Category_Wikipedia_sockpuppets_of_Smfhs_photographer.csv,2694,62894386.0,1046,1648,478,568,0,37.32776540460282,220,60,23.93132887899035,3
Category_Wikipedia_sockpuppets_of_Arowesy0206.csv,63,124239782.0,16,47,15,1,0,56.523809523809526,249,34,33.82539682539682,23
Category_Wikipedia_sockpuppets_of_Gabcol.csv,221,26109544.0,102,119,83,19,0,41.57918552036199,238,41,18.579185520361992,8
Category_Wikipedia_sockpuppets_of_Theshitman.csv,1092,9708853.0,399,693,97,302,0,45.354395604395606,241,54,22.12912087912088,5
Category_Wikipedia_sockpuppets_of_Cicely_of_Sicily.csv,113,447553.0,38,75,20,18,0,43.150442477876105,197,71,36.34513274336283,11
Category_Wikipedia_sockpuppets_of_Martineejames.csv,455,2584077.0,148,307,148,0,0,38.03736263736264,217,40,15.868131868131869,5
Category_Wikipedia_sockpuppets_of_Stephen70.csv,7301,232175282.0,3473,3828,500,2973,0,44.55827968771401,499,55,23.71949048075606,8
Category_Wikipedia_sockpuppets_of_Jageracog2020.csv,65,3816670.0,26,39,16,10,0,70.98461538461538,446,33,19.215384615384615,10
Category_Wikipedia_sockpuppets_of_Trandanganh10092003.csv,405,7062373.0,124,281,45,79,0,43.21975308641975,274,29,15.466666666666667,4
Category_Wikipedia_sockpuppets_of_Huttlingermusic.csv,16,4250.0,12,4,10,2,0,44.1875,154,15,15.0,15
Category_Wikipedia_sockpuppets_of_Varun_Pradip_Dave_Powerlifter.csv,116,38448.0,31,85,31,0,0,45.93103448275862,226,47,22.586206896551722,6
Category_Wikipedia_sockpuppets_of_Nugo20299.csv,465,18225185.0,176,289,121,55,0,43.582795698924734,500,74,29.843010752688173,10
Category_Wikipedia_sockpuppets_of_Khwajablessed.csv,61,31841382.0,25,36,20,5,0,36.52459016393443,222,82,23.950819672131146,10
Category_Wikipedia_sockpuppets_of_Wamthomo.csv,4,327.0,2,2,2,0,26,39.0,78,23,23.0,23
Category_Wikipedia_sockpuppets_of_Lovinghimmler.csv,47,1638257.0,15,32,4,11,0,74.38297872340425,227,27,15.361702127659575,11
Category_Wikipedia_sockpuppets_of_Zakthejesuschristgod.csv,7,85138.0,5,2,2,3,0,37.285714285714285,218,12,9.714285714285714,4
Category_Wikipedia_sockpuppets_of_Chichochow.csv,213,177133.0,65,148,29,36,0,35.882629107981224,240,41,19.206572769953052,7
Category_Wikipedia_sockpuppets_of_Gordom53.csv,38,1138129.0,25,13,11,14,0,86.86842105263158,410,20,14.289473684210526,11
Category_Wikipedia_sockpuppets_of_Loser-1987.csv,12,91517.0,8,4,4,4,0,2.8333333333333335,22,27,18.0,6
Category_Wikipedia_sockpuppets_of_AletheaJavon.csv,17,42566.0,10,7,6,4,0,34.23529411764706,85,45,40.23529411764706,24
Category_Wikipedia_sockpuppets_of_Milkmen437.csv,22,2066751.0,9,13,5,4,0,46.86363636363637,185,22,20.727272727272727,20
Category_Wikipedia_sockpuppets_of_I'mOfSwedishDescent.csv,66,3196772.0,22,44,20,2,0,61.75757575757576,205,33,14.93939393939394,5
Category_Wikipedia_sockpuppets_of_Juwel_Rana.csv,44,31717921.0,16,28,11,5,0,30.795454545454547,255,29,17.25,8
Category_Wikipedia_sockpuppets_of_Pastorwayne.csv,3067,107217541.0,1177,1890,500,677,0,30.7378545810238,250,74,27.183240952070427,7
Category_Wikipedia_sockpuppets_of_CentralTiger74.csv,347,7999399.0,135,212,124,11,0,41.429394812680115,212,47,22.605187319884728,8
Category_Wikipedia_sockpuppets_of_JohnDoe134.csv,16,64399.0,6,10,2,4,0,55.4375,145,21,9.9375,4
Category_Wikipedia_sockpuppets_of_JIM_ME_BOY_2.csv,62,280867.0,22,40,19,3,0,44.29032258064516,186,25,17.677419354838708,12
Category_Wikipedia_sockpuppets_of_Jinfnff.csv,328,7719115.0,126,202,112,14,0,42.59451219512195,319,46,12.414634146341463,4
Category_Wikipedia_sockpuppets_of_Markus1463.csv,419,50263566.0,156,263,62,94,0,52.51551312649165,236,59,20.353221957040574,6
Category_Wikipedia_sockpuppets_of_Will_McG.csv,58,606352.0,20,38,7,13,0,41.724137931034484,212,27,13.862068965517242,6
Category_Wikipedia_sockpuppets_of_Niloy229.csv,287,6070648.0,119,168,71,48,0,39.21602787456446,230,24,13.02787456445993,5
Category_Wikipedia_sockpuppets_of_Adventurous_City.csv,121,34772415.0,38,83,19,19,0,50.68595041322314,208,28,17.702479338842974,3
Category_Wikipedia_sockpuppets_of_Josepolivares.csv,4007,78563978.0,1295,2712,500,795,0,38.724232592962316,334,54,16.45245819815323,4
Category_Wikipedia_sockpuppets_of_Smackbott2.csv,17,544.0,6,11,3,3,0,74.94117647058823,222,25,15.705882352941176,4
Category_Wikipedia_sockpuppets_of_Natashiansunite.csv,53,264294.0,24,29,7,17,0,31.849056603773583,207,27,20.77358490566038,17
Category_Wikipedia_sockpuppets_of_Lil_Bow_Wow.csv,46,91.0,12,34,12,0,0,31.26086956521739,144,30,16.217391304347824,7
Category_Wikipedia_sockpuppets_of_Akanns.csv,101,3601130.0,54,47,31,23,0,17.277227722772277,194,29,19.396039603960396,15
Category_Wikipedia_sockpuppets_of_Justpp.csv,7762,162246413.0,2890,4872,500,2390,0,49.12342179850554,429,85,22.624967791806235,3
Category_Wikipedia_sockpuppets_of_Gullucum1956.csv,264,104097324.0,53,211,30,23,0,58.97348484848485,233,54,15.996212121212121,4
Category_Wikipedia_sockpuppets_of_Lilzaddytz.csv,10,1904.0,7,3,6,1,0,110.2,500,15,11.0,10
Category_Wikipedia_sockpuppets_of_Goblin_Face.csv,3545,51058812.0,1456,2089,500,956,0,44.80197461212976,255,78,19.414104372355432,4
Category_Wikipedia_sockpuppets_of_AngelaVidal.csv,2674,41588171.0,826,1848,500,326,0,41.448391922213915,255,47,20.270381451009722,3
Category_Wikipedia_sockpuppets_of_1981Laura.csv,180,181346499.0,77,103,42,35,0,45.91111111111111,178,31,16.022222222222222,3
Category_Wikipedia_sockpuppets_of_HubxTrux.csv,3,12.0,2,1,2,0,47,53.0,60,13,9.666666666666666,8
Category_Wikipedia_sockpuppets_of_MarkFlemish.csv,260,276248564.0,52,208,40,12,0,53.026923076923076,243,54,19.073076923076922,9
Category_Wikipedia_sockpuppets_of_DinduMcMuffins.csv,5,49993.0,2,3,1,1,22,73.6,218,9,9.0,9
Category_Wikipedia_sockpuppets_of_Hjkk_ssjdn.csv,467,1832592.0,154,313,77,77,0,46.55032119914347,500,54,20.670235546038544,5
Category_Wikipedia_sockpuppets_of_Samswik.csv,457,13107235.0,137,320,106,31,0,53.67833698030635,255,42,16.599562363238512,9
Category_Wikipedia_sockpuppets_of_Banjardar.csv,244,34458714.0,63,181,26,37,0,59.56147540983606,481,60,21.860655737704917,5
Category_Wikipedia_sockpuppets_of_Jacobssteph.csv,436,137303734.0,162,274,145,17,0,51.81880733944954,255,61,22.621559633027523,9
Category_Wikipedia_sockpuppets_of_ComoMagna.csv,19,29684.0,17,2,16,1,0,8.789473684210526,134,19,12.368421052631579,10
Category_Wikipedia_sockpuppets_of_GrandBotBoi.csv,1821,11559295.0,560,1261,272,288,0,42.57386051619989,393,65,24.1444261394838,4
Category_Wikipedia_sockpuppets_of_AshyLarryMarcySon.csv,114,6064810.0,41,73,22,19,0,29.473684210526315,178,30,16.25438596491228,6
Category_Wikipedia_sockpuppets_of_PeakTime.csv,15,202883.0,12,3,8,4,0,26.733333333333334,196,48,37.6,13
Category_Wikipedia_sockpuppets_of_Aryavams.csv,144,1742019.0,52,92,27,25,0,39.44444444444444,227,40,20.84027777777778,10
Category_Wikipedia_sockpuppets_of_WisdomSideKick.csv,32,3024113.0,25,7,10,15,0,67.28125,222,28,13.0,12
Category_Wikipedia_sockpuppets_of_Meechim.csv,29,2658139.0,20,9,8,12,7,37.10344827586207,190,12,12.0,12
Category_Wikipedia_sockpuppets_of_Turgeis.csv,2115,10396879.0,542,1573,392,150,0,47.68936170212766,255,57,19.609456264775414,4
Category_Wikipedia_sockpuppets_of_Geromasis.csv,891,10636288.0,376,515,257,119,0,38.16273849607183,248,54,23.6307519640853,9
Category_Wikipedia_sockpuppets_of_Ericjcarrmiddletownde.csv,629,349889336.0,160,469,138,22,0,52.691573926868045,300,106,23.395866454689983,7
Category_Wikipedia_sockpuppets_of_Iphone8fan.csv,56,469601.0,29,27,14,15,0,46.892857142857146,171,59,30.232142857142858,14
Category_Wikipedia_sockpuppets_of_Iamjudee.csv,5,1808.0,4,1,2,2,12,47.2,178,16,16.0,16
Category_Wikipedia_sockpuppets_of_SamB135.csv,1756,303288860.0,502,1254,500,2,0,52.10535307517084,267,104,21.804669703872438,4
Category_Wikipedia_sockpuppets_of_Sclgva.csv,4,9705.0,3,1,2,1,0,40.75,163,3,3.0,3
Category_Wikipedia_sockpuppets_of_The_highest_authority.csv,539,32576112.0,201,338,77,124,0,57.7569573283859,255,64,22.46938775510204,4
Category_Wikipedia_sockpuppets_of_LegolasRoyale.csv,65,2187636.0,29,36,22,7,0,34.49230769230769,191,28,17.123076923076923,5
Category_Wikipedia_sockpuppets_of_The_Fresh_Beat_Band.csv,944,15527695.0,248,696,18,230,0,38.22457627118644,236,63,18.81885593220339,3
Category_Wikipedia_sockpuppets_of_King_Shedrack_the_First.csv,5,6766.0,3,2,2,1,118,356.8,495,33,26.2,16
Category_Wikipedia_sockpuppets_of_AmYisroelChai.csv,2695,10863687.0,729,1966,500,229,0,58.199628942486086,389,88,32.03525046382189,5
Category_Wikipedia_sockpuppets_of_EZW.csv,59,40475782.0,21,38,11,10,0,55.11864406779661,222,53,21.050847457627118,13
Category_Wikipedia_sockpuppets_of_Kkktpkirij.csv,516,7278041.0,223,293,142,81,0,41.10271317829457,350,57,22.8953488372093,7
Category_Wikipedia_sockpuppets_of_Alisan.csv,26,455.0,11,15,9,2,0,57.19230769230769,211,31,19.615384615384617,11
Category_Wikipedia_sockpuppets_of_Ararat_arev.csv,3532,558711831.0,1194,2338,500,694,0,46.59229898074745,438,49,15.173556058890147,2
Category_Wikipedia_sockpuppets_of_Taung_Tan.csv,2113,51466510.0,1000,1113,500,500,0,45.672030288689065,496,96,22.960246095598674,6
Category_Wikipedia_sockpuppets_of_Ritikgoyali.csv,10,2006006.0,8,2,5,3,0,57.7,196,29,26.2,11
Category_Wikipedia_sockpuppets_of_Flatoncsi.csv,991,8770996.0,332,659,107,225,0,59.64278506559031,255,51,18.646821392532797,5
Category_Wikipedia_sockpuppets_of_Jesusman8.csv,50,78424348.0,10,40,10,0,0,54.66,253,28,12.92,8
Category_Wikipedia_sockpuppets_of_TheMetallican.csv,9230,70395982.0,2306,6924,500,1806,0,43.98580715059588,255,82,18.405092091007585,3
Category_Wikipedia_sockpuppets_of_Johnheneghan.csv,11,2567106.0,9,2,6,3,0,45.09090909090909,169,12,12.0,12
Category_Wikipedia_sockpuppets_of_Idaz09_wikipedia.csv,5,15342.0,3,2,2,1,0,116.2,196,26,24.2,23
Category_Wikipedia_sockpuppets_of_Aleksnadra2006daa.csv,8,530625.0,4,4,4,0,0,33.25,192,12,10.25,5
Category_Wikipedia_sockpuppets_of_Manofknowledge69.csv,167,14968099.0,48,119,33,15,0,65.40718562874251,327,49,18.395209580838323,6
Category_Wikipedia_sockpuppets_of_AMILTON_DE_CRISTO.csv,285,185576979.0,98,187,24,74,0,55.91228070175438,255,55,20.33684210526316,7
Category_Wikipedia_sockpuppets_of_David_Redmond.csv,7,11583.0,5,2,4,1,0,9.428571428571429,65,27,27.0,27
Category_Wikipedia_sockpuppets_of_Indianathlete2016.csv,57,36713849.0,30,27,19,11,0,37.280701754385966,196,43,31.982456140350877,22
Category_Wikipedia_sockpuppets_of_Thecelebrityeditor31.csv,44,2345689.0,21,23,20,1,0,29.204545454545453,240,18,17.545454545454547,16
Category_Wikipedia_sockpuppets_of_Cipspic.csv,193,3979996.0,60,133,17,43,0,40.18652849740933,166,79,22.191709844559586,9
Category_Wikipedia_sockpuppets_of_Bishopsmg.csv,100,38964344.0,33,67,22,11,0,52.34,346,35,20.54,17
Category_Wikipedia_sockpuppets_of_Blendar33.csv,139,17038841.0,47,92,31,16,0,46.67625899280576,160,53,20.755395683453237,7
Category_Wikipedia_sockpuppets_of_Kendall2232.csv,46,3328116.0,36,10,26,10,17,66.54347826086956,249,29,26.195652173913043,21
Category_Wikipedia_sockpuppets_of_Mrelving.csv,210,7679293.0,128,82,115,13,0,54.05714285714286,226,29,17.895238095238096,12
Category_Wikipedia_sockpuppets_of_Some4real.csv,178,6663203.0,54,124,43,11,0,46.39325842696629,309,46,15.719101123595506,4
Category_Wikipedia_sockpuppets_of_SimoneBilesStan.csv,478,39410427.0,121,357,119,2,0,64.5460251046025,312,53,23.42050209205021,9
Category_Wikipedia_sockpuppets_of_CharlieJS13.csv,2472,34856896.0,917,1555,500,417,0,33.45145631067961,250,54,18.164644012944983,4
Category_Wikipedia_sockpuppets_of_Gboyeaig11.csv,46,1139290.0,28,18,23,5,0,44.34782608695652,118,47,28.41304347826087,17
Category_Wikipedia_sockpuppets_of_Dr_boothe_surgeon.csv,5,249501.0,4,1,2,2,0,32.4,72,29,26.2,22
Category_Wikipedia_sockpuppets_of_Avento55.csv,56,1127434.0,25,31,19,6,0,28.785714285714285,150,50,24.892857142857142,9
Category_Wikipedia_sockpuppets_of_BosniakDefender001.csv,19,223687.0,9,10,6,3,5,59.78947368421053,299,28,18.31578947368421,12
Category_Wikipedia_sockpuppets_of_FDMD04.csv,1078,30925291.0,393,685,140,253,0,37.26901669758813,492,41,18.145640074211503,7
Category_Wikipedia_sockpuppets_of_Ramkripalyadavgeo.csv,94,35816386.0,29,65,9,20,0,45.5531914893617,348,41,18.393617021276597,3
Category_Wikipedia_sockpuppets_of_Vem_vinay_Reddy.csv,31,227129.0,17,14,9,8,0,44.645161290322584,141,28,22.677419354838708,18
Category_Wikipedia_sockpuppets_of_Giovani.ernesto.csv,1,0.0,1,0,1,0,0,0.0,0,8,8.0,8
Category_Wikipedia_sockpuppets_of_Pursuinginquiry.csv,312,1520701.0,139,173,55,84,0,58.169871794871796,254,48,17.07371794871795,10
Category_Wikipedia_sockpuppets_of_Technoto.csv,137,26203106.0,40,97,30,10,0,46.160583941605836,248,34,18.138686131386862,13
Category_Wikipedia_sockpuppets_of_David_Nelson.csv,1064,239640507.0,367,697,327,40,0,44.27913533834587,246,91,26.014097744360903,8
Category_Wikipedia_sockpuppets_of_BorisGunn.csv,66,52514328.0,22,44,20,2,0,49.06060606060606,178,45,14.409090909090908,12
Category_Wikipedia_sockpuppets_of_Wildhartlivie.csv,4109,41953160.0,1002,3107,500,502,0,45.05913847651497,247,75,17.317108785592602,4
Category_Wikipedia_sockpuppets_of_Fila3466757.csv,5877,43734943.0,2020,3857,500,1520,0,35.364982133741705,224,77,19.960353922069082,2
Category_Wikipedia_sockpuppets_of_FrancestBlanc.csv,122,5953648.0,30,92,18,12,0,65.4672131147541,245,45,13.385245901639344,5
Category_Wikipedia_sockpuppets_of_Jason_Gastrich.csv,2666,556663136.0,883,1783,238,645,0,47.846961740435106,468,95,22.843585896474117,4
Category_Wikipedia_sockpuppets_of_FlowerBay718.csv,29,5510240.0,12,17,7,5,0,76.65517241379311,403,27,18.896551724137932,13
Category_Wikipedia_sockpuppets_of_The_Editor_of_All_Things_Wikipedia.csv,2418,548469.0,874,1544,500,374,0,51.435483870967744,255,73,29.47477253928867,6
Category_Wikipedia_sockpuppets_of_LittleNirvana.csv,515,25612834.0,166,349,78,88,0,52.768932038834954,430,60,17.12621359223301,3
Category_Wikipedia_sockpuppets_of_Zoidberg262.csv,159,102386065.0,97,62,93,4,0,47.264150943396224,230,52,33.698113207547166,13
Category_Wikipedia_sockpuppets_of_GentlePuff.csv,118,3567.0,56,62,21,35,0,102.15254237288136,177,53,21.152542372881356,11
Category_Wikipedia_sockpuppets_of_BlueMoon65625.csv,356,21236409.0,130,226,75,55,0,42.94662921348315,301,88,22.73876404494382,7
Category_Wikipedia_sockpuppets_of_Jackie786.csv,391,2557240.0,122,269,118,4,0,53.10485933503836,379,47,13.797953964194374,5
Category_Wikipedia_sockpuppets_of_Miggy72.csv,5460,126602160.0,1959,3501,500,1459,0,46.885347985347984,496,84,24.91996336996337,2
Category_Wikipedia_sockpuppets_of_Nair_Saheb.csv,438,45663875.0,155,283,70,85,0,45.78310502283105,421,39,16.17351598173516,6
Category_Wikipedia_sockpuppets_of_Glitch_glitch11.csv,19,171274.0,9,10,6,3,0,27.63157894736842,74,60,46.21052631578947,7
Category_Wikipedia_sockpuppets_of_90Xray.csv,187,23177308.0,76,111,54,22,0,50.32085561497326,252,55,35.101604278074866,18
Category_Wikipedia_sockpuppets_of_Slaveloverandowner.csv,15,537.0,9,6,5,4,0,55.93333333333333,192,6,5.2,5
Category_Wikipedia_sockpuppets_of_Sock_of_Rodhullandemu.csv,18,5907.0,6,12,4,2,0,59.77777777777778,175,32,18.444444444444443,11
Category_Wikipedia_sockpuppets_of_‡¶∞‡¶æ‡¶ï‡¶ø‡¶¨‡ßÅ‡¶≤_‡¶π‡¶æ‡¶∏‡¶æ‡¶®_‡¶Æ‡¶æ‡¶π‡¶Æ‡ßÅ‡¶¶.csv,42,6493656.0,15,27,9,6,0,29.214285714285715,127,30,16.428571428571427,7
Category_Wikipedia_sockpuppets_of_Helooo201.csv,204,61510859.0,61,143,45,16,0,50.43627450980392,211,45,19.941176470588236,8
Category_Wikipedia_sockpuppets_of_Gweilo60.csv,2577,52947974.0,1038,1539,500,538,0,42.922778424524644,498,38,15.797438882421421,6
Category_Wikipedia_sockpuppets_of_Sanderskko9.csv,15,11115.0,11,4,5,6,11,41.2,152,47,34.333333333333336,16
Category_Wikipedia_sockpuppets_of_Zgolik5757.csv,25,74833.0,8,17,8,0,0,60.88,192,22,10.4,3
Category_Wikipedia_sockpuppets_of_OpinionsAreLikeAHoles.csv,549,4664301.0,174,375,78,96,0,53.94535519125683,250,95,24.183970856102004,3
Category_Wikipedia_sockpuppets_of_Er._Avinash_Singh.csv,441,166063725.0,149,292,146,3,0,40.600907029478456,247,69,21.662131519274375,8
Category_Wikipedia_sockpuppets_of_PPP.csv,2090,461905693.0,548,1542,500,48,0,50.56555023923445,368,79,19.370813397129186,3
Category_Wikipedia_sockpuppets_of_Paraiso_Pal.csv,76,57399628.0,25,51,15,10,0,41.828947368421055,155,53,38.44736842105263,9
Category_Wikipedia_sockpuppets_of_Altowiki.csv,3218,32393131.0,1207,2011,500,707,0,47.49160969546302,255,56,15.548477315102549,3
Category_Wikipedia_sockpuppets_of_Cognition.csv,4400,588857375.0,1075,3325,500,575,0,51.41136363636364,495,95,18.70977272727273,4
Category_Wikipedia_sockpuppets_of_Farnavaz.csv,367,122377286.0,98,269,84,14,0,49.095367847411445,495,60,14.365122615803815,4
Category_Wikipedia_sockpuppets_of_√áelebicihan.csv,997,193747341.0,485,512,81,404,0,35.864593781344034,514,48,16.980942828485457,5
Category_Wikipedia_sockpuppets_of_Bellieflop.csv,128,427317.0,36,92,10,26,0,82.1484375,227,56,24.8203125,10
Category_Wikipedia_sockpuppets_of_ÿßÿßŸÖŸÖ€å€åÿ±ÿ±.csv,1000,5174546.0,342,658,179,163,0,38.615,250,51,18.633,3
Category_Wikipedia_sockpuppets_of_Opentruth4you.csv,34,4040430.0,21,13,13,8,11,112.41176470588235,272,17,10.176470588235293,9
Category_Wikipedia_sockpuppets_of_Ashlyzand.csv,1,0.0,1,0,1,0,0,0.0,0,5,5.0,5
Category_Wikipedia_sockpuppets_of_Gift_of_ELOOHIM.csv,6,203704.0,3,3,2,1,15,116.66666666666667,255,16,16.0,16
Category_Wikipedia_sockpuppets_of_Bossdog123.csv,53,12286.0,30,23,29,1,0,44.735849056603776,222,92,87.75471698113208,20
Category_Wikipedia_sockpuppets_of_Safee.adnan.csv,6,1096939.0,2,4,2,0,0,84.16666666666667,196,27,25.0,21
Category_Wikipedia_sockpuppets_of_Fuku76.csv,271,49081036.0,86,185,11,75,0,48.55350553505535,234,50,18.19188191881919,6
Category_Wikipedia_sockpuppets_of_Prussian0791.csv,4,941280.0,4,0,2,2,0,0.0,0,28,28.0,28
Category_Wikipedia_sockpuppets_of_Reeeeeetarded.csv,10,296.0,4,6,3,1,0,33.0,178,25,16.4,7
Category_Wikipedia_sockpuppets_of_Shockmetric.csv,976,1033926.0,414,562,409,5,0,59.64754098360656,212,74,31.390368852459016,5
Category_Wikipedia_sockpuppets_of_Smithzv31.csv,296,13392491.0,219,77,173,46,0,36.652027027027025,255,49,18.875,13
Category_Wikipedia_sockpuppets_of_Arabelle36.csv,7,846038.0,4,3,4,0,12,41.42857142857143,127,20,13.571428571428571,11
Category_Wikipedia_sockpuppets_of_Zifran_Islam.csv,105,39596984.0,35,70,32,3,0,47.55238095238095,274,38,15.038095238095238,9
Category_Wikipedia_sockpuppets_of_Gaganpreet_Singh_Sokhi.csv,67,30592516.0,20,47,13,7,0,27.65671641791045,226,27,13.313432835820896,5
Category_Wikipedia_sockpuppets_of_NuclearUmpf.csv,13667,557089022.0,4479,9188,500,3979,0,45.16689836833248,479,99,25.611253384063804,2
Category_Wikipedia_sockpuppets_of_Supervox2113.csv,1187,24880883.0,369,818,99,270,0,38.97135636057287,215,64,20.761583824768323,4
Category_Wikipedia_sockpuppets_of_ClaimJumperPete.csv,10916,157459936.0,2820,8096,174,2646,0,32.37019054598754,250,76,18.555423231953096,1
Category_Wikipedia_sockpuppets_of_Gogglebum.csv,147,20766561.0,54,93,51,3,0,41.625850340136054,199,23,13.537414965986395,5
Category_Wikipedia_sockpuppets_of_‰æùÈ†º‰∫∫.csv,1684,246919601.0,715,969,500,215,0,35.07304038004751,249,56,19.71496437054632,8
Category_Wikipedia_sockpuppets_of_Abijitark.csv,150,14255595.0,64,86,40,24,0,36.973333333333336,493,34,20.513333333333332,12
Category_Wikipedia_sockpuppets_of_Youngbabushka.csv,94,21638422.0,40,54,23,17,0,50.234042553191486,372,50,30.882978723404257,7
Category_Wikipedia_sockpuppets_of_Waenceslaus.csv,576,139686151.0,187,389,155,32,0,52.99305555555556,255,91,35.24131944444444,11
Category_Wikipedia_sockpuppets_of_Johnjoshua1.csv,2084,28460174.0,876,1208,500,376,0,40.010556621881,500,65,28.710652591170824,4
Category_Wikipedia_sockpuppets_of_GamenLewis.csv,77,63656.0,26,51,17,9,0,40.857142857142854,254,72,24.324675324675326,4
Category_Wikipedia_sockpuppets_of_Hazel028.csv,27,1568543.0,16,11,9,7,0,52.77777777777778,248,24,18.962962962962962,9
Category_Wikipedia_sockpuppets_of_Umarbux123.csv,27,1789142.0,11,16,9,2,0,55.592592592592595,203,11,7.7407407407407405,7
Category_Wikipedia_sockpuppets_of_Tyangarin.csv,426,11674552.0,135,291,81,54,0,42.39201877934272,209,56,10.48356807511737,4
Category_Wikipedia_sockpuppets_of_SWASTIK_25.csv,5186,37790206.0,1791,3395,500,1291,0,35.83089086000771,255,100,26.994408021596605,2
Category_Wikipedia_sockpuppets_of_Paulioetc.csv,2157,113355425.0,776,1381,500,276,0,37.93509503940658,250,73,22.196105702364395,8
Category_Wikipedia_sockpuppets_of_HeyRaphael.csv,3115,181680156.0,928,2187,478,450,0,45.78747993579454,496,68,17.02343499197432,4
Category_Wikipedia_sockpuppets_of_Thoriq_Azka_Rahmat.csv,639,56434687.0,255,384,132,123,0,29.848200312989047,254,44,27.417840375586856,14
Category_Wikipedia_sockpuppets_of_Humanidk.csv,1778,8301850.0,602,1176,192,410,0,52.27952755905512,255,38,14.15466816647919,4
Category_Wikipedia_sockpuppets_of_Apalaria.csv,2700,393951121.0,692,2008,500,192,0,52.02037037037037,330,39,10.561851851851852,4
Category_Wikipedia_sockpuppets_of_Arianajarvis.csv,151,209852193.0,49,102,28,21,0,47.50993377483444,223,62,26.94039735099338,9
Category_Wikipedia_sockpuppets_of_Gumfold33.csv,233,6009807.0,64,169,37,27,0,40.94849785407725,245,72,21.811158798283262,6
Category_Wikipedia_sockpuppets_of_Zespinosa5.csv,19,160693.0,16,3,5,11,0,22.473684210526315,204,4,4.0,4
Category_Wikipedia_sockpuppets_of_Fairfax17.csv,138,5539382.0,43,95,17,26,0,42.65217391304348,204,43,18.485507246376812,7
Category_Wikipedia_sockpuppets_of_CHU33_Z.csv,90,27917936.0,24,66,17,7,0,59.91111111111111,255,18,14.266666666666667,9
Category_Wikipedia_sockpuppets_of_Ilovelanguage123.csv,5,50431.0,4,1,2,2,0,100.6,255,16,16.0,16
Category_Wikipedia_sockpuppets_of_Angelworld7.csv,83,4826884.0,52,31,26,26,0,36.30120481927711,196,61,20.53012048192771,5
Category_Wikipedia_sockpuppets_of_LeedsBloke10.csv,647,6993637.0,192,455,40,152,0,44.88408037094281,223,39,18.323029366306027,8
Category_Wikipedia_sockpuppets_of_Alohato.csv,77,5946544.0,33,44,14,19,0,47.15584415584416,226,39,26.649350649350648,9
Category_Wikipedia_sockpuppets_of_Jlind0.csv,219,225180032.0,49,170,40,9,0,52.89954337899543,251,31,20.141552511415526,12
Category_Wikipedia_sockpuppets_of_Irishbastard88.csv,40,442987.0,9,31,6,3,0,62.0,173,16,8.75,5
Category_Wikipedia_sockpuppets_of_Robert_James_Logan.csv,63,756572.0,36,27,27,9,0,73.31746031746032,445,36,22.41269841269841,14
Category_Wikipedia_sockpuppets_of_Yahalladubai.csv,50,50173546.0,22,28,6,16,0,52.66,196,37,24.5,13
Category_Wikipedia_sockpuppets_of_Niezwmxa_Boro.csv,502,20689032.0,191,311,129,62,0,41.99601593625498,249,57,20.91434262948207,7
Category_Wikipedia_sockpuppets_of_Knowlesadam.csv,66,89997711.0,22,44,21,1,0,59.18181818181818,212,31,20.242424242424242,7
Category_Wikipedia_sockpuppets_of_Mahir6219.csv,539,345944999.0,206,333,152,54,0,48.41558441558441,291,56,19.19851576994434,5
Category_Wikipedia_sockpuppets_of_Tasisengland.csv,45,155407.0,40,5,33,7,0,13.71111111111111,194,13,13.0,13
Category_Wikipedia_sockpuppets_of_Duqsene.csv,1218,47774866.0,421,797,356,65,0,56.58784893267652,264,51,18.251231527093594,5
Category_Wikipedia_sockpuppets_of_Chase2na.csv,3066,38084983.0,881,2185,500,381,0,36.52152641878669,255,54,20.965101108936725,4
Category_Wikipedia_sockpuppets_of_Crowingfortruth.csv,37,49495.0,27,10,13,14,0,54.62162162162162,167,51,15.432432432432432,7
Category_Wikipedia_sockpuppets_of_MaveT23.csv,67,866274.0,55,12,39,16,0,28.208955223880597,233,56,17.16417910447761,8
Category_Wikipedia_sockpuppets_of_Marcobetticarboncini1.csv,602,3965947.0,208,394,159,49,0,48.285714285714285,395,37,14.137873754152825,5
Category_Wikipedia_sockpuppets_of_Sm_mithun.csv,36,368865.0,18,18,12,6,0,47.69444444444444,182,47,22.11111111111111,9
Category_Wikipedia_sockpuppets_of_Alpoin117.csv,1800,410557360.0,557,1243,500,57,0,49.51111111111111,496,102,27.22111111111111,4
Category_Wikipedia_sockpuppets_of_Dhouston17.csv,1320,44616989.0,564,756,383,181,0,40.47348484848485,496,55,17.803030303030305,4
Category_Wikipedia_sockpuppets_of__The_Template_Vandal_.csv,333,3736453.0,93,240,25,68,0,41.3033033033033,200,35,17.40840840840841,2
Category_Wikipedia_sockpuppets_of_EdwardLeeFrampton.csv,72,5767344.0,46,26,44,2,0,33.90277777777778,199,23,17.069444444444443,15
Category_Wikipedia_sockpuppets_of_Badtoothfairy.csv,4587,360827209.0,969,3618,243,726,0,58.054501853063,412,81,17.780248528449967,3
Category_Wikipedia_sockpuppets_of_Jeniferliberman.csv,701,355247739.0,309,392,120,189,0,39.47075606276748,336,58,21.8188302425107,9
Category_Wikipedia_sockpuppets_of_Angel_of_Death_Xie.csv,80,1982641.0,29,51,20,9,0,45.6625,249,53,16.05,6
Category_Wikipedia_sockpuppets_of_MJB06.csv,26,5168220.0,12,14,10,2,0,108.65384615384616,235,34,16.23076923076923,12
Category_Wikipedia_sockpuppets_of_FabDab11.csv,1014,6380711.0,511,503,500,11,0,23.537475345167653,272,61,24.945759368836292,10
Category_Wikipedia_sockpuppets_of_Cosmology2.csv,276,25056205.0,99,177,77,22,0,50.166666666666664,322,47,32.55797101449275,13
Category_Wikipedia_sockpuppets_of_Oxycut.csv,901,4852458.0,283,618,236,47,0,50.10321864594894,255,67,20.965593784683684,3
Category_Wikipedia_sockpuppets_of_Rtk4420.csv,676,2347480.0,512,164,500,12,0,35.03698224852071,369,65,48.29289940828402,10
Category_Wikipedia_sockpuppets_of_Jaisingh.bm.csv,10,11185.0,5,5,3,2,16,54.0,154,20,20.0,20
Category_Wikipedia_sockpuppets_of_Totheread.csv,1147,4452333.0,392,755,382,10,0,45.015693112467304,301,47,15.19180470793374,2
Category_Wikipedia_sockpuppets_of_Shakib_Mama_Family.csv,979,90929607.0,223,756,111,112,0,48.94994892747702,474,45,15.729315628192033,3
Category_Wikipedia_sockpuppets_of_Bikrookanpurgangster.csv,899,72570346.0,239,660,48,191,0,46.65294771968854,496,61,15.847608453837598,5
Category_Wikipedia_sockpuppets_of_EmiliaAno.csv,50,4401116.0,21,29,9,12,0,74.74,302,22,15.62,7
Category_Wikipedia_sockpuppets_of_Moatassemakmal.csv,1258,322404540.0,370,888,164,206,0,53.37678855325914,500,58,28.0516693163752,10
Category_Wikipedia_sockpuppets_of_DKBRAO.csv,90,25256456.0,36,54,18,18,0,60.74444444444445,236,46,15.844444444444445,3
Category_Wikipedia_sockpuppets_of_ULTRASMACKDOWNGORE.csv,14,96406.0,7,7,7,0,0,64.21428571428571,166,27,20.0,13
Category_Wikipedia_sockpuppets_of_KwameJack.csv,26,4360992.0,13,13,7,6,0,23.23076923076923,75,21,17.26923076923077,13
Category_Wikipedia_sockpuppets_of_Victormeidas.csv,2,40.0,2,0,2,0,0,9.5,19,14,14.0,14
Category_Wikipedia_sockpuppets_of_Imkmls.csv,43,9591292.0,11,32,7,4,0,46.97674418604651,267,32,19.25581395348837,10
Category_Wikipedia_sockpuppets_of_Inetpup.csv,2867,132959537.0,737,2130,500,237,0,47.19079176839902,255,78,20.62295081967213,3
Category_Wikipedia_sockpuppets_of_Linas.csv,2560,58205018.0,1000,1560,500,500,0,44.65078125,255,72,22.206640625,4
Category_Wikipedia_sockpuppets_of_KondottySultan.csv,258,5009126.0,63,195,31,32,0,49.87596899224806,248,44,12.007751937984496,4
Category_Wikipedia_sockpuppets_of_Sergiokato1.csv,11,23811540.0,6,5,4,2,0,45.0,148,21,12.818181818181818,11
Category_Wikipedia_sockpuppets_of_Niftylettuce.csv,70,155421827.0,28,42,25,3,0,62.82857142857143,214,45,18.185714285714287,10
Category_Wikipedia_sockpuppets_of_JusticeBlack.csv,262,224654053.0,76,186,64,12,0,53.396946564885496,232,63,19.129770992366414,5
Category_Wikipedia_sockpuppets_of_Dmgnewmedia.csv,5,213045719.0,2,3,2,0,0,64.8,228,21,19.8,18
Category_Wikipedia_sockpuppets_of_Alandyept.csv,621,53765876.0,187,434,176,11,0,64.47826086956522,500,54,22.064412238325282,3
Category_Wikipedia_sockpuppets_of_Fvsegarra.csv,46,112424509.0,15,31,13,2,0,35.108695652173914,149,53,23.391304347826086,4
Category_Wikipedia_sockpuppets_of_Haste1066.csv,339,176011270.0,116,223,89,27,0,46.92330383480826,255,53,18.097345132743364,9
Category_Wikipedia_sockpuppets_of_Betteruser.csv,3464,83913519.0,1154,2310,155,999,0,52.416859122401846,499,57,18.657043879907622,3
Category_Wikipedia_sockpuppets_of_ErikWarmelink.csv,2164,104711799.0,518,1646,500,18,0,56.60166358595194,249,100,18.859981515711645,4
Category_Wikipedia_sockpuppets_of_Limbojazz.csv,360,77648912.0,117,243,35,82,0,44.71111111111111,255,36,17.22222222222222,6
Category_Wikipedia_sockpuppets_of_Dan9122.csv,2820,276671804.0,866,1954,500,366,0,51.016666666666666,494,67,20.66276595744681,3
Category_Wikipedia_sockpuppets_of_Barclayspremierleague1.csv,29,448045.0,20,9,16,4,0,53.206896551724135,187,32,30.03448275862069,20
Category_Wikipedia_sockpuppets_of_Wikiwiki84.csv,7,609772.0,7,0,6,1,0,30.571428571428573,47,19,19.0,19
Category_Wikipedia_sockpuppets_of_Alski31.csv,14,57973.0,10,4,10,0,0,32.42857142857143,132,28,17.142857142857142,15
Category_Wikipedia_sockpuppets_of_ScienceGolfFanatic.csv,5211,91135532.0,1830,3381,500,1330,0,38.94703511801957,250,99,19.813855306083287,2
Category_Wikipedia_sockpuppets_of_Bog5576.csv,608,12341947.0,267,341,191,76,0,52.37828947368421,246,54,24.967105263157894,10
Category_Wikipedia_sockpuppets_of_Andrewthorpeapps.csv,97,98733017.0,29,68,13,16,0,43.855670103092784,218,67,23.443298969072163,7
Category_Wikipedia_sockpuppets_of_Bokpasa.csv,2743,369951617.0,707,2036,500,207,0,40.84141450966096,255,50,19.039008384979947,4
Category_Wikipedia_sockpuppets_of_Kaykayjohnson1234.csv,617,60311434.0,163,454,83,80,0,59.07617504051864,497,50,20.291734197730957,4
Category_Wikipedia_sockpuppets_of_Tommy1933.csv,1617,103340021.0,606,1011,500,106,0,38.01113172541744,255,64,22.183673469387756,3
Category_Wikipedia_sockpuppets_of_GirlishDriver.csv,144,20901274.0,51,93,23,28,0,76.34722222222223,448,30,19.743055555555557,9
Category_Wikipedia_sockpuppets_of_√ñmer_Nasuhi_Bilmen.csv,419,8969614.0,124,295,67,57,0,62.02147971360382,307,51,20.2291169451074,3
Category_Wikipedia_sockpuppets_of_Retcon.csv,807,55472115.0,275,532,194,81,0,34.87732342007435,200,52,21.030978934324658,6
Category_Wikipedia_sockpuppets_of_Alivahedian.csv,36,9418739.0,9,27,7,2,0,62.80555555555556,210,29,22.02777777777778,4
Category_Wikipedia_sockpuppets_of_GordonHolmes7162.csv,28,80363.0,18,10,8,10,0,35.785714285714285,156,47,21.678571428571427,14
Category_Wikipedia_sockpuppets_of_Tony28tarun.csv,433,91906629.0,114,319,77,37,0,49.16397228637413,251,61,21.4364896073903,3
Category_Wikipedia_sockpuppets_of_Viktorpp.csv,577,156525011.0,187,390,101,86,0,52.719237435008665,500,70,20.51473136915078,8
Category_Wikipedia_sockpuppets_of_Randomstuff207_w.csv,603,3282909.0,225,378,217,8,0,40.14262023217247,255,66,23.051409618573796,5
Category_Wikipedia_sockpuppets_of_Dervish_Tsaddik.csv,1618,30131174.0,563,1055,321,242,0,36.834363411619286,200,81,20.205809641532756,3
Category_Wikipedia_sockpuppets_of_Rashidiyah.csv,1453,43303103.0,542,911,500,42,0,54.279421885753614,344,77,17.773571920165175,5
Category_Wikipedia_sockpuppets_of_Vucien.csv,1690,4828504.0,545,1145,500,45,0,22.253846153846155,444,48,16.787573964497042,5
Category_Wikipedia_sockpuppets_of_Kaivalyaskulkarni.csv,85,2024007.0,82,3,48,34,0,11.882352941176471,196,29,27.91764705882353,21
Category_Wikipedia_sockpuppets_of_Ajdkj.csv,59,1051653.0,21,38,11,10,0,57.40677966101695,231,31,18.033898305084747,4
Category_Wikipedia_sockpuppets_of_Emily_Yu1.csv,38,2178.0,20,18,18,2,0,17.473684210526315,119,20,20.0,20
Category_Wikipedia_sockpuppets_of_Sumitkumar1211.csv,72,597354.0,31,41,26,5,0,43.986111111111114,196,47,22.01388888888889,7
Category_Wikipedia_sockpuppets_of_Shivamguptacgasrtist.csv,14,5183524.0,11,3,8,3,0,51.714285714285715,196,30,27.857142857142858,25
Category_Wikipedia_sockpuppets_of_Graysonrpollard.csv,179,7949366.0,71,108,34,37,0,60.15642458100559,474,50,24.262569832402235,10
Category_Wikipedia_sockpuppets_of_Cut_Off_Their_Franks.csv,352,56737767.0,86,266,18,68,0,49.56534090909091,219,54,15.670454545454545,4
Category_Wikipedia_sockpuppets_of_ElcapitainFCP.csv,6778,39311809.0,1745,5033,500,1245,0,41.48819710829153,500,77,22.439362643847744,3
Category_Wikipedia_sockpuppets_of_HistoryWrite.csv,1626,11245958.0,699,927,500,199,0,38.431119311193115,255,71,20.415744157441573,6
Category_Wikipedia_sockpuppets_of_Undercovergals.csv,628,23527748.0,234,394,89,145,0,46.61942675159236,249,52,17.6656050955414,3
Category_Wikipedia_sockpuppets_of_Lazhar_Berkat.csv,5,96308.0,3,2,3,0,0,27.4,83,35,30.2,23
Category_Wikipedia_sockpuppets_of_Beh-nam.csv,23788,214666321.0,7683,16105,500,7183,0,42.912140575079874,255,66,16.467252396166135,3
Category_Wikipedia_sockpuppets_of_Lifnlsdlsdnf.csv,186,11482824.0,57,129,7,50,0,30.844086021505376,215,31,20.306451612903224,5
Category_Wikipedia_sockpuppets_of_Morganhxd.csv,9,806.0,5,4,3,2,0,43.888888888888886,196,45,28.444444444444443,19
Category_Wikipedia_sockpuppets_of_Fabimox.csv,10,3605453.0,3,7,2,1,17,61.3,163,43,30.8,17
Category_Wikipedia_sockpuppets_of_AmericaIsNumberOne.csv,3488,51012879.0,903,2585,500,403,0,48.5401376146789,244,77,17.68348623853211,2
Category_Wikipedia_sockpuppets_of_MFA_Uganda.csv,2,0.0,1,1,1,0,0,0.0,0,17,17.0,17
Category_Wikipedia_sockpuppets_of_Dewan_Architects_+_Engineers.csv,1,0.0,1,0,1,0,196,196.0,196,19,19.0,19
Category_Wikipedia_sockpuppets_of_Siljaye.csv,15,2462048.0,11,4,8,3,0,236.0,500,12,8.333333333333334,7
Category_Wikipedia_sockpuppets_of_‡ºÜ.csv,3420,410553905.0,1000,2420,500,500,0,46.91081871345029,468,103,25.67748538011696,5
Category_Wikipedia_sockpuppets_of_Randyjoel.csv,591,185624657.0,203,388,88,115,0,39.08967851099831,289,56,17.079526226734348,6
Category_Wikipedia_sockpuppets_of_RickColos78.csv,88,4681366.0,38,50,28,10,0,30.363636363636363,208,41,32.26136363636363,8
Category_Wikipedia_sockpuppets_of_Nickusa1.csv,62,36422630.0,19,43,19,0,0,51.016129032258064,257,18,14.419354838709678,12
Category_Wikipedia_sockpuppets_of_–û–∫—Å–∞–Ω–∞_–ß–æ–ø–∞–∫.csv,144,1704569.0,44,100,32,12,0,53.923611111111114,491,54,20.131944444444443,6
Category_Wikipedia_sockpuppets_of_DeveloperArifpay.csv,56,2329649.0,22,34,21,1,0,56.482142857142854,221,58,23.910714285714285,4
Category_Wikipedia_sockpuppets_of_Boneabone.csv,76,57549161.0,43,33,36,7,0,39.4078947368421,153,33,21.289473684210527,15
Category_Wikipedia_sockpuppets_of_Creatorpunjab19.csv,63,82970.0,54,9,40,14,0,29.857142857142858,194,51,18.873015873015873,13
Category_Wikipedia_sockpuppets_of_JimmyNeutron2016.csv,552,14696433.0,162,390,156,6,0,39.33876811594203,253,47,15.443840579710145,6
Category_Wikipedia_sockpuppets_of_Rajroy816.csv,279,39166364.0,97,182,85,12,0,34.437275985663085,223,47,23.189964157706093,9
Category_Wikipedia_sockpuppets_of_MAGAN_PATHANIA.csv,83,12024582.0,19,64,7,12,0,67.7710843373494,323,24,12.518072289156626,8
Category_Wikipedia_sockpuppets_of_Liirre.csv,11,474924.0,9,2,7,2,0,17.636363636363637,110,14,14.0,14
Category_Wikipedia_sockpuppets_of_BigCheese41.csv,191,34637088.0,73,118,54,19,0,55.24083769633508,255,59,33.07853403141361,3
Category_Wikipedia_sockpuppets_of_Jlomcc.csv,183,1626880.0,73,110,46,27,0,44.950819672131146,199,54,19.153005464480874,7
Category_Wikipedia_sockpuppets_of_Sadupatel.csv,6,1100495.0,2,4,2,0,0,44.833333333333336,102,19,16.666666666666668,12
Category_Wikipedia_sockpuppets_of_KO.2.csv,2120,263933455.0,694,1426,348,346,0,37.22924528301887,255,118,17.826415094339623,3
Category_Wikipedia_sockpuppets_of_AaronD'Costa.csv,1,0.0,1,0,1,0,84,84.0,84,10,10.0,10
Category_Wikipedia_sockpuppets_of_MEEMP4A.csv,62,9181147.0,15,47,5,10,0,66.46774193548387,234,53,43.45161290322581,12
Category_Wikipedia_sockpuppets_of_Aalaa324.csv,1166,15791416.0,314,852,307,7,0,54.98627787307033,500,82,18.08833619210978,3
Category_Wikipedia_sockpuppets_of_Jfmisha.csv,149,501882.0,77,72,47,30,0,56.48322147651007,255,50,27.57718120805369,13
Category_Wikipedia_sockpuppets_of_Ljekperic.csv,59,6182892.0,34,25,29,5,0,25.491525423728813,199,23,13.474576271186441,6
Category_Wikipedia_sockpuppets_of_Wikiaccount10.csv,96,34464136.0,38,58,28,10,0,35.53125,254,33,20.447916666666668,4
Category_Wikipedia_sockpuppets_of_Aarushthakkar153.csv,98,4952434.0,36,62,31,5,0,46.54081632653061,206,33,15.357142857142858,1
Category_Wikipedia_sockpuppets_of_Dillon_Ransom.csv,20,632990.0,5,15,2,3,0,64.4,201,43,30.0,18
Category_Wikipedia_sockpuppets_of_Replyentry.csv,371,17094864.0,126,245,32,94,0,41.25876010781671,248,36,16.30188679245283,3
Category_Wikipedia_sockpuppets_of_Carvoeiro.csv,29,1279003.0,22,7,10,12,0,52.827586206896555,185,23,10.89655172413793,10
Category_Wikipedia_sockpuppets_of_Eulalefty.csv,5644,87890750.0,1745,3899,500,1245,0,49.74060949681077,255,74,19.0012402551382,4
Category_Wikipedia_sockpuppets_of_Icbss_secretariat.csv,19,350709.0,15,4,11,4,0,22.526315789473685,98,42,42.0,42
Category_Wikipedia_sockpuppets_of_GENIUS(4th_power).csv,10305,299550900.0,3211,7094,500,2711,0,45.167394468704515,255,92,21.703153808830663,1
Category_Wikipedia_sockpuppets_of_Historicist.csv,4178,119060747.0,1568,2610,500,1068,0,42.667783628530394,252,101,22.93274293920536,4
Category_Wikipedia_sockpuppets_of_NeuroSex.csv,520,208578339.0,202,318,31,171,0,72.68461538461538,497,50,18.40576923076923,4
Category_Wikipedia_sockpuppets_of_Cyberhawk_5.csv,154,148676901.0,61,93,53,8,0,34.714285714285715,199,26,15.87012987012987,9
Category_Wikipedia_sockpuppets_of_Okuonzi.csv,69,246181642.0,27,42,24,3,0,32.95652173913044,196,21,13.782608695652174,5
Category_Wikipedia_sockpuppets_of_Modulor1.csv,91,15999429.0,29,62,8,21,0,42.45054945054945,157,35,19.75824175824176,14
Category_Wikipedia_sockpuppets_of_TerentiusNew.csv,4365,11966606.0,1728,2637,500,1228,0,51.3418098510882,430,96,20.119358533791523,4
Category_Wikipedia_sockpuppets_of_Jaylectricity.csv,211,295401828.0,55,156,55,0,0,47.507109004739334,236,63,19.10900473933649,8
Category_Wikipedia_sockpuppets_of_Tmvekmkvfhbjkliu.csv,1388,19328998.0,624,764,500,124,0,30.381844380403457,376,38,15.113832853025936,8
Category_Wikipedia_sockpuppets_of_Raj97700.csv,1,0.0,1,0,1,0,53,53.0,53,18,18.0,18
Category_Wikipedia_sockpuppets_of_Bttowadch.csv,10041,43820659.0,4011,6030,500,3511,0,43.09162434020516,501,68,16.402748730206156,4
Category_Wikipedia_sockpuppets_of_Rayloeb.csv,6,1286429.0,2,4,2,0,25,41.333333333333336,84,33,33.0,33
Category_Wikipedia_sockpuppets_of_Berry_stark.csv,239,1274357.0,134,105,57,77,0,51.57740585774059,296,35,16.694560669456067,10
Category_Wikipedia_sockpuppets_of_Joqool1237.csv,21,663518.0,16,5,13,3,0,20.0,97,14,14.0,14
Category_Wikipedia_sockpuppets_of_Grassroot76.csv,91,8418504.0,34,57,27,7,0,59.989010989010985,254,25,12.615384615384615,9
Category_Wikipedia_sockpuppets_of_Shoelejahan.csv,426,1403358.0,147,279,62,85,0,30.08450704225352,234,62,16.55399061032864,3
Category_Wikipedia_sockpuppets_of_Iriszuo.csv,70,5634483.0,14,56,3,11,13,42.42857142857143,99,38,34.57142857142857,34
Category_Wikipedia_sockpuppets_of_Janemillert.csv,184,157643279.0,67,117,41,26,0,45.54347826086956,200,50,23.66304347826087,10
Category_Wikipedia_sockpuppets_of_Denise_Sohn.csv,626,83214371.0,181,445,33,148,0,45.48242811501598,403,39,16.600638977635782,3
Category_Wikipedia_sockpuppets_of_XT_RedZone.csv,3942,99299419.0,1632,2310,500,1132,0,54.4974632166413,500,66,25.856925418569254,5
Category_Wikipedia_sockpuppets_of_Astudent0.csv,2861,199950015.0,1500,1361,500,1000,0,41.504019573575675,255,105,43.65955959454736,5
Category_Wikipedia_sockpuppets_of_RogerNiceEyes.csv,5517,18167808.0,1963,3554,500,1463,0,55.95903570781222,379,64,16.172557549392785,3
Category_Wikipedia_sockpuppets_of_Sorrow_of_Sophie.csv,734,48241039.0,511,223,500,11,0,42.950953678474114,425,51,21.704359673024523,12
Category_Wikipedia_sockpuppets_of_ChanComThemPho.csv,5338,118057264.0,2082,3256,500,1582,0,47.9986886474335,489,71,19.92375421506182,3
Category_Wikipedia_sockpuppets_of_Keith_McKenzie.csv,1150,10816510.0,502,648,500,2,0,30.828695652173913,500,59,18.210434782608697,3
Category_Wikipedia_sockpuppets_of_DanishBeast2.csv,3,280.0,2,1,1,1,0,82.0,223,7,7.0,7
Category_Wikipedia_sockpuppets_of_Abdulrehmanb8631.csv,82,16751146.0,41,41,33,8,0,43.8780487804878,246,58,25.548780487804876,6
Category_Wikipedia_sockpuppets_of_Khaliwarriors.csv,6991,25779806.0,1911,5080,500,1411,0,49.11271634959233,497,80,21.56315262480332,4
Category_Wikipedia_sockpuppets_of_Ronaldo_Performer.csv,48,17385219.0,29,19,19,10,0,44.979166666666664,241,39,28.5,11
Category_Wikipedia_sockpuppets_of_Jinnahpk.csv,1597,9210205.0,410,1187,401,9,0,49.13274890419537,434,66,18.453350031308705,5
Category_Wikipedia_sockpuppets_of_Rockjhon11.csv,238,8544529.0,72,166,20,52,0,60.69747899159664,500,39,16.991596638655462,8
Category_Wikipedia_sockpuppets_of_Morphin2020.csv,28,610325.0,8,20,8,0,0,43.17857142857143,126,30,17.142857142857142,13
Category_Wikipedia_sockpuppets_of_Yalexandrov.csv,118,70959330.0,47,71,17,30,0,33.483050847457626,226,21,13.576271186440678,9
Category_Wikipedia_sockpuppets_of_Kamilhrub.csv,1249,339908661.0,267,982,256,11,0,45.05284227381905,439,67,22.926341072858285,1
Category_Wikipedia_sockpuppets_of_GaritoSo.csv,2385,17836946.0,964,1421,340,624,0,30.248637316561844,353,39,20.254926624737944,8
Category_Wikipedia_sockpuppets_of_Sheldontechnology.csv,22,94248.0,17,5,14,3,0,21.90909090909091,117,30,25.272727272727273,16
Category_Wikipedia_sockpuppets_of_WhenDatHotlineBling.csv,5976,203362485.0,1453,4523,211,1242,0,51.09772423025435,500,63,17.770582329317268,3
Category_Wikipedia_sockpuppets_of_Dragonclaw690.csv,22,2531.0,10,12,4,6,0,114.5,255,22,11.636363636363637,10
Category_Wikipedia_sockpuppets_of_Biantez.csv,1304,112556519.0,505,799,500,5,0,41.16334355828221,458,62,24.821319018404907,4
Category_Wikipedia_sockpuppets_of_Ntjm1.csv,1,0.0,1,0,1,0,0,0.0,0,41,41.0,41
Category_Wikipedia_sockpuppets_of_Raymarcbadz.csv,2708,29390434.0,1184,1524,500,684,0,31.515140324963074,500,65,40.13847858197932,15
Category_Wikipedia_sockpuppets_of_Jeeny.csv,4361,15138824.0,1267,3094,500,767,0,49.17381334556294,226,115,19.510204081632654,3
Category_Wikipedia_sockpuppets_of_Jarred_Gaskins_III.csv,35,1118241.0,11,24,10,1,0,42.2,226,28,12.885714285714286,5
Category_Wikipedia_sockpuppets_of_SofiaPerezD.csv,84,4209.0,29,55,14,15,0,57.607142857142854,376,34,15.976190476190476,3
Category_Wikipedia_sockpuppets_of_SOULMMANAGMENT.csv,4,173249.0,2,2,1,1,0,60.0,113,13,13.0,13
Category_Wikipedia_sockpuppets_of_EminemEdger1972.csv,92,538756.0,32,60,18,14,0,50.81521739130435,257,57,19.206521739130434,9
Category_Wikipedia_sockpuppets_of_Ramiz5550.csv,1583,17355311.0,860,723,500,360,0,26.0056854074542,496,62,22.615919140871764,5
Category_Wikipedia_sockpuppets_of_ÿ£ÿ≠ŸÖÿØ_ÿßŸÑŸÖŸÜÿµŸàÿ±ÿ©.csv,588,151291485.0,161,427,95,66,0,55.96768707482993,255,50,14.687074829931973,4
Category_Wikipedia_sockpuppets_of_Noahqueen.csv,71,123729859.0,16,55,8,8,0,47.50704225352113,232,39,28.6056338028169,19
Category_Wikipedia_sockpuppets_of_Snowynina.csv,176,4238168.0,50,126,31,19,0,51.11931818181818,192,29,9.732954545454545,4
Category_Wikipedia_sockpuppets_of_Seize_the_means_of_production_and_hang_the_rich.csv,20,765.0,9,11,9,0,0,66.15,348,92,75.6,10
Category_Wikipedia_sockpuppets_of_Lin_Htet_Wah_Wah.csv,19,6302939.0,7,12,7,0,0,84.15789473684211,401,53,26.210526315789473,8
Category_Wikipedia_sockpuppets_of_Time_2_Check.csv,349,4722708.0,133,216,53,80,0,55.51002865329513,233,54,18.710601719197708,6
Category_Wikipedia_sockpuppets_of_LouisBrownstone.csv,319,269150776.0,89,230,48,41,0,47.73040752351097,250,59,19.981191222570533,5
Category_Wikipedia_sockpuppets_of_Aradicus77.csv,1359,23459984.0,556,803,500,56,0,48.698307579102284,393,69,22.300220750551876,7
Category_Wikipedia_sockpuppets_of_Ben1239randy.csv,404,16667403.0,145,259,141,4,0,37.883663366336634,250,64,25.26732673267327,6
Category_Wikipedia_sockpuppets_of_Carmine_dryer.csv,160,3966720.0,47,113,21,26,0,53.3125,254,25,16.91875,7
Category_Wikipedia_sockpuppets_of_Xd69x.csv,133,270153.0,79,54,73,6,0,37.338345864661655,187,39,17.789473684210527,10
Category_Wikipedia_sockpuppets_of_Hmercer1976.csv,79,23013546.0,23,56,20,3,0,68.48101265822785,379,48,26.430379746835442,11
Category_Wikipedia_sockpuppets_of_Kjae1994.csv,7,66314.0,4,3,2,2,3,54.285714285714285,156,23,18.428571428571427,13
Category_Wikipedia_sockpuppets_of_Quzeyli.csv,408,7313742.0,180,228,130,50,0,53.61029411764706,255,54,22.730392156862745,6
Category_Wikipedia_sockpuppets_of_Shravani_Chatterjee.csv,312,22075661.0,94,218,45,49,0,45.66346153846154,473,31,11.724358974358974,6
Category_Wikipedia_sockpuppets_of_Iamtrhino.csv,2863,6703332.0,1095,1768,288,807,0,44.09640237513098,250,56,16.38351379671673,4
Category_Wikipedia_sockpuppets_of_Daughter_Of_The_Malassa.csv,241,8981726.0,106,135,50,56,0,56.14522821576764,269,59,17.074688796680498,6
Category_Wikipedia_sockpuppets_of_Marek.kapicak.csv,852,300289719.0,321,531,24,297,0,49.436619718309856,494,59,17.119718309859156,7
Category_Wikipedia_sockpuppets_of_Foundationforjustice.csv,21,98752965.0,11,10,5,6,0,59.714285714285715,191,35,33.666666666666664,29
Category_Wikipedia_sockpuppets_of_Lakx300.csv,241,1965238.0,88,153,44,44,0,62.551867219917014,452,43,22.937759336099585,12
Category_Wikipedia_sockpuppets_of_Cenima.csv,486,14528624.0,186,300,127,59,0,34.17283950617284,227,38,19.93415637860082,6
Category_Wikipedia_sockpuppets_of_PhenomenalKev.csv,157,611296.0,141,16,81,60,0,26.9171974522293,199,26,23.484076433121018,16
Category_Wikipedia_sockpuppets_of_Xfalloutboyphanx.csv,31,61748.0,11,20,8,3,0,43.935483870967744,189,26,16.70967741935484,10
Category_Wikipedia_sockpuppets_of_An-Apple-A-NY-Day.csv,1212,134727395.0,407,805,120,287,0,42.98432343234323,243,51,17.402640264026402,5
Category_Wikipedia_sockpuppets_of_NyarangiF.csv,4,287.0,3,1,1,2,0,6.75,15,23,17.0,15
Category_Wikipedia_sockpuppets_of_Andrew_Flesher.csv,24,33946655.0,5,19,4,1,0,49.5,148,35,24.625,17
Category_Wikipedia_sockpuppets_of_Cklay09.csv,3,7187.0,2,1,1,1,10,17.0,29,12,8.666666666666666,7
Category_Wikipedia_sockpuppets_of_poojjan_ccresta.csv,177,41823100.0,44,133,21,23,0,50.87570621468927,255,37,15.192090395480227,5
Category_Wikipedia_sockpuppets_of_Ilyadante.csv,1221,3795377.0,362,859,270,92,0,49.85995085995086,496,60,16.934479934479935,4
Category_Wikipedia_sockpuppets_of_Wikikings.csv,281,11739108.0,108,173,57,51,0,32.60142348754449,228,76,21.80782918149466,6
Category_Wikipedia_sockpuppets_of_Birdsflyinghigh123.csv,362,98616812.0,126,236,21,105,0,51.21546961325967,406,54,22.12154696132597,6
Category_Wikipedia_sockpuppets_of_SaturdayNightMorons.csv,724,7413963.0,245,479,238,7,0,30.926795580110497,211,47,19.531767955801104,5
Category_Wikipedia_sockpuppets_of_SharonAnama.csv,233,102534191.0,49,184,34,15,0,60.17167381974249,326,46,16.266094420600858,4
Category_Wikipedia_sockpuppets_of_Jace833.csv,53,1815718.0,16,37,9,7,0,67.49056603773585,216,43,23.0188679245283,3
Category_Wikipedia_sockpuppets_of_Cowrampage.csv,78,80873361.0,16,62,12,4,0,61.73076923076923,253,20,10.282051282051283,4
Category_Wikipedia_sockpuppets_of_BitcoinFrance.csv,116,1512068.0,52,64,9,43,0,50.18103448275862,205,41,14.336206896551724,8
Category_Wikipedia_sockpuppets_of_Antoineishotnsexy1912.csv,85,4928191.0,41,44,22,19,0,41.50588235294118,196,49,24.011764705882353,9
Category_Wikipedia_sockpuppets_of_LIS_408_2023.csv,37,13523.0,30,7,29,1,0,41.729729729729726,496,26,23.216216216216218,22
Category_Wikipedia_sockpuppets_of_Melechha.csv,381,7308948.0,167,214,96,71,0,45.196850393700785,506,39,23.120734908136484,9
Category_Wikipedia_sockpuppets_of_Tfc_jagadesh.csv,42,14889.0,19,23,11,8,0,34.333333333333336,210,21,12.714285714285714,5
Category_Wikipedia_sockpuppets_of_Anuragjha17.csv,94,2740870.0,30,64,16,14,0,46.723404255319146,228,53,19.28723404255319,6
Category_Wikipedia_sockpuppets_of_Iliketumbleweeds.csv,596,20295708.0,173,423,152,21,0,49.630872483221474,252,69,18.69463087248322,8
Category_Wikipedia_sockpuppets_of_Rakxit_RapStaR.csv,4,1642443.0,2,2,1,1,28,80.75,117,37,24.5,12
Category_Wikipedia_sockpuppets_of_Gregoryat.csv,344,24733866.0,165,179,158,7,0,31.046511627906977,255,45,25.86627906976744,14
Category_Wikipedia_sockpuppets_of_Mountain_gora.csv,174,8251245.0,45,129,25,20,0,46.91379310344828,378,22,11.028735632183908,5
Category_Wikipedia_sockpuppets_of_Baramop.csv,261,13525546.0,88,173,78,10,0,46.111111111111114,255,47,22.9272030651341,9
Category_Wikipedia_sockpuppets_of_Sabarnaparishad.csv,34,447180.0,26,8,24,2,0,23.0,76,30,22.58823529411765,20
Category_Wikipedia_sockpuppets_of_Rajiv01014.csv,48,26350.0,30,18,30,0,0,20.916666666666668,417,14,14.0,14
Category_Wikipedia_sockpuppets_of_Ingrid_Rodrigues.csv,1368,149405468.0,437,931,327,110,0,37.35233918128655,252,58,20.149122807017545,4
Category_Wikipedia_sockpuppets_of_Joanna_Gunadi.csv,3460,85450245.0,1372,2088,500,872,0,32.9528901734104,255,73,26.88872832369942,4
Category_Wikipedia_sockpuppets_of_Charlesgasparino.csv,29,268347.0,15,14,14,1,15,100.62068965517241,352,51,29.517241379310345,17
Category_Wikipedia_sockpuppets_of_DontBiteTheNewcomer.csv,14,13188079.0,14,0,10,4,0,57.42857142857143,196,31,26.857142857142858,21
Category_Wikipedia_sockpuppets_of_GOKYEYAYEAHYUAFYAUH.csv,5,599.0,3,2,2,1,0,82.0,205,27,27.0,27
Category_Wikipedia_sockpuppets_of_Tana785yr.csv,2864,38485042.0,1091,1773,500,591,0,34.687150837988824,331,49,22.47835195530726,4
Category_Wikipedia_sockpuppets_of_Wallflowers98.csv,2270,101317072.0,463,1807,25,438,0,33.17180616740088,249,55,20.411894273127754,4
Category_Wikipedia_sockpuppets_of_Semaan806.csv,4,3487013.0,2,2,1,1,0,16.5,33,23,21.0,19
Category_Wikipedia_sockpuppets_of_AR.EBE.owo.csv,858,33492392.0,294,564,253,41,0,37.96969696969697,255,51,17.677156177156178,4
Category_Wikipedia_sockpuppets_of_Richard_Thoma.csv,132,141427.0,44,88,24,20,0,48.20454545454545,225,51,23.151515151515152,10
Category_Wikipedia_sockpuppets_of_Shubhanshu_kesharwani.csv,97,7555719.0,38,59,33,5,0,25.608247422680414,255,33,11.938144329896907,9
Category_Wikipedia_sockpuppets_of_Nimisha_singhania.csv,149,177809533.0,49,100,44,5,0,38.5503355704698,218,59,22.355704697986578,10
Category_Wikipedia_sockpuppets_of_Fountaindream.csv,105,6455112.0,69,36,44,25,0,50.03809523809524,246,54,15.923809523809524,3
Category_Wikipedia_sockpuppets_of_OWGNicholas.csv,3846,366610886.0,1257,2589,500,757,0,47.72256890275611,496,56,21.457358294331772,5
Category_Wikipedia_sockpuppets_of_Norenarif.csv,9,239128.0,7,2,4,3,0,44.22222222222222,126,21,21.0,21
Category_Wikipedia_sockpuppets_of_Haggforlife.csv,147,1893923.0,62,85,44,18,0,38.10204081632653,243,64,29.047619047619047,9
Category_Wikipedia_sockpuppets_of_Newyorkborn.csv,98,1875519.0,44,54,31,13,0,47.6530612244898,193,42,36.90816326530612,20
Category_Wikipedia_sockpuppets_of_Lake_of_Milk.csv,764,7750771.0,247,517,154,93,0,47.86387434554974,254,89,27.153141361256544,10
Category_Wikipedia_sockpuppets_of_Crashmart.csv,20,1340607.0,13,7,7,6,0,57.5,199,58,31.1,4
Category_Wikipedia_sockpuppets_of_0yia.csv,8,42441.0,5,3,3,2,0,24.875,73,19,18.5,18
Category_Wikipedia_sockpuppets_of_Paliku.csv,5510,169703232.0,1354,4156,456,898,0,44.04936479128857,261,75,18.1994555353902,2
Category_Wikipedia_sockpuppets_of_Panditejashri.csv,446,57471904.0,204,242,81,123,0,29.97982062780269,235,50,13.68609865470852,6
Category_Wikipedia_sockpuppets_of_Altai_Khan.csv,265,17811057.0,100,165,38,62,0,30.70188679245283,199,46,15.079245283018867,6
Category_Wikipedia_sockpuppets_of_Scheheryar.csv,74,211090353.0,26,48,26,0,0,59.810810810810814,196,52,32.432432432432435,5
Category_Wikipedia_sockpuppets_of_Camoka4.csv,1724,115095137.0,551,1173,500,51,0,44.01624129930394,251,54,21.8631090487239,4
Category_Wikipedia_sockpuppets_of_Liveradvil.csv,98,6366.0,58,40,37,21,0,48.59183673469388,193,46,21.6734693877551,4
Category_Wikipedia_sockpuppets_of_Mutantofficial.csv,128,1921489.0,63,65,41,22,0,32.390625,488,47,25.8125,7
Category_Wikipedia_sockpuppets_of_Shuvuhikovsky.csv,99,305295.0,31,68,17,14,0,51.75757575757576,187,68,24.666666666666668,9
Category_Wikipedia_sockpuppets_of_Liallis.csv,189,98075797.0,53,136,44,9,0,49.01058201058201,224,43,16.06878306878307,8
Category_Wikipedia_sockpuppets_of_Speedy_King.csv,580,62753826.0,239,341,213,26,0,33.88275862068966,218,82,23.498275862068965,9
Category_Wikipedia_sockpuppets_of_Lizen543t4565y6.csv,90,2483983.0,35,55,5,30,0,58.51111111111111,356,26,11.3,4
Category_Wikipedia_sockpuppets_of_Lau_Cheng.csv,1314,21442379.0,319,995,70,249,0,45.94063926940639,478,67,20.477168949771688,4
Category_Wikipedia_sockpuppets_of_Ejanev.csv,486,90025701.0,160,326,144,16,0,58.99382716049383,226,53,18.909465020576132,4
Category_Wikipedia_sockpuppets_of_Xchrisblackx.csv,1504,27072863.0,500,1004,500,0,0,30.652925531914892,189,77,23.581117021276597,4
Category_Wikipedia_sockpuppets_of_Gurpartap_singh_kairon.csv,197,1785109.0,49,148,21,28,0,48.370558375634516,239,36,11.314720812182742,4
Category_Wikipedia_sockpuppets_of_Seguro64.csv,1766,28687537.0,522,1244,500,22,0,57.04303510758777,492,50,17.416194790486976,4
Category_Wikipedia_sockpuppets_of_GarryHenderson6.csv,194,4903013.0,142,52,113,29,0,32.97938144329897,339,67,19.47938144329897,8
Category_Wikipedia_sockpuppets_of_Terry535353tvdgd.csv,100,7357649.0,45,55,16,29,0,62.68,265,58,20.94,10
Category_Wikipedia_sockpuppets_of_Lucy990788478.csv,55,684287.0,32,23,25,7,0,40.67272727272727,225,31,23.09090909090909,2
Category_Wikipedia_sockpuppets_of_Amrapahal_Pahanswan.csv,12957,73487708.0,3336,9621,500,2836,0,52.15096087057189,500,77,17.80589642664197,2
Category_Wikipedia_sockpuppets_of_Wikiuser2090.csv,463,41331631.0,126,337,53,73,0,63.803455723542115,356,38,11.079913606911447,5
Category_Wikipedia_sockpuppets_of_Dharmendra_bansal.csv,133,21913941.0,41,92,14,27,0,67.15037593984962,213,39,29.31578947368421,15
Category_Wikipedia_sockpuppets_of_Pmd2013.csv,21,341169.0,9,12,8,1,0,34.714285714285715,121,20,18.523809523809526,15
Category_Wikipedia_sockpuppets_of_Tylerwade123.csv,1559,14510262.0,612,947,500,112,0,33.340602950609366,227,52,16.418858242463116,6
Category_Wikipedia_sockpuppets_of_YesOn8.csv,95,4157881.0,39,56,25,14,0,52.8421052631579,221,28,15.178947368421053,4
Category_Wikipedia_sockpuppets_of_Intelinsidehp.csv,233,64985203.0,71,162,70,1,0,45.69098712446352,229,78,20.042918454935624,4
Category_Wikipedia_sockpuppets_of_Kajal_Kali.csv,68,3136470.0,27,41,9,18,0,47.94117647058823,233,43,24.735294117647058,15
Category_Wikipedia_sockpuppets_of_Mono506672.csv,9,87568.0,5,4,2,3,31,64.77777777777777,120,27,20.0,18
Category_Wikipedia_sockpuppets_of_Nalbarian.csv,1774,195202468.0,680,1094,500,180,0,51.8032694475761,496,66,23.13021420518602,4
Category_Wikipedia_sockpuppets_of_N_R_Pavan_Kumar.csv,199,73960636.0,76,123,37,39,0,39.93969849246231,205,33,21.517587939698494,12
Category_Wikipedia_sockpuppets_of_Wearenotgermans.csv,28,505791.0,22,6,17,5,0,70.78571428571429,237,19,16.214285714285715,8
Category_Wikipedia_sockpuppets_of_80.133.45.209.csv,3,240.0,2,1,2,0,17,65.0,147,20,16.333333333333332,9
Category_Wikipedia_sockpuppets_of_Basedonfact.csv,199,1935241.0,99,100,70,29,0,52.321608040201006,259,32,11.110552763819095,5
Category_Wikipedia_sockpuppets_of_Hiwib38.csv,25,94074.0,18,7,2,16,20,92.68,189,49,30.0,17
Category_Wikipedia_sockpuppets_of_Oinkmachine.csv,198,9632752.0,66,132,47,19,0,44.676767676767675,249,42,26.28787878787879,6
Category_Wikipedia_sockpuppets_of_Heresthechill.csv,68,638103.0,45,23,40,5,0,64.3529411764706,467,23,12.882352941176471,9
Category_Wikipedia_sockpuppets_of_Abeerfarid.csv,204,7832337.0,89,115,52,37,0,38.3578431372549,255,66,24.13235294117647,15
Category_Wikipedia_sockpuppets_of_Sallysnail4.csv,415,57275481.0,269,146,112,157,0,35.513253012048196,272,45,27.257831325301204,11
Category_Wikipedia_sockpuppets_of_Nestor_8998.csv,4712,262136558.0,1328,3384,251,1077,0,52.37372665534805,388,66,19.54393039049236,5
Category_Wikipedia_sockpuppets_of_BrumBrum1.csv,18,4580336.0,5,13,2,3,0,52.333333333333336,233,22,17.27777777777778,13
Category_Wikipedia_sockpuppets_of_CorrectionEditBot.csv,4,72320.0,2,2,1,1,14,85.0,184,32,32.0,32
Category_Wikipedia_sockpuppets_of_The_Supermind.csv,1357,2623344.0,725,632,500,225,0,37.02873986735446,510,79,25.361827560795874,4
Category_Wikipedia_sockpuppets_of_The_love_pony.csv,3742,162665394.0,908,2834,176,732,0,43.84874398717263,500,59,17.08150721539284,4
Category_Wikipedia_sockpuppets_of_Stefanus_Purwanto.csv,67,108939.0,25,42,13,12,0,51.25373134328358,286,54,30.52238805970149,10
Category_Wikipedia_sockpuppets_of_Utc-100.csv,19553,71242901.0,8247,11306,500,7747,0,32.69124942464072,255,78,18.780698614023425,2
Category_Wikipedia_sockpuppets_of_BStudent0.csv,36,3984334.0,14,22,4,10,0,26.27777777777778,109,77,43.52777777777778,19
Category_Wikipedia_sockpuppets_of_Truthforever_1234.csv,12,1388313.0,7,5,3,4,0,30.333333333333332,223,34,34.0,34
Category_Wikipedia_sockpuppets_of_Jonathan_Mangum.csv,94,11138187.0,36,58,22,14,0,37.98936170212766,199,54,22.648936170212767,14
Category_Wikipedia_sockpuppets_of_Tg14673.csv,1,0.0,1,0,1,0,37,37.0,37,12,12.0,12
Category_Wikipedia_sockpuppets_of_Kozak4512.csv,918,205289866.0,201,717,130,71,0,63.16122004357298,521,40,15.485838779956428,3
Category_Wikipedia_sockpuppets_of_Eggbert6893.csv,35,4634573.0,10,25,6,4,0,55.68571428571428,194,18,13.714285714285714,5
Category_Wikipedia_sockpuppets_of_Politics_rule.csv,1490,5318642.0,501,989,500,1,0,37.22147651006711,233,78,30.397986577181207,9
Category_Wikipedia_sockpuppets_of_Flyingbeer.csv,69,144702.0,46,23,32,14,0,28.884057971014492,254,21,20.043478260869566,3
Category_Wikipedia_sockpuppets_of_Lala_migos.csv,1586,104966233.0,401,1185,66,335,0,45.48297604035309,388,45,16.474148802017655,4
Category_Wikipedia_sockpuppets_of_AngieWattsFan.csv,1652,42683423.0,503,1149,457,46,0,49.11138014527845,252,50,18.191888619854723,8
Category_Wikipedia_sockpuppets_of_Stupidcupid6.csv,450,5540199.0,135,315,114,21,0,48.215555555555554,297,63,20.164444444444445,7
Category_Wikipedia_sockpuppets_of_Jai_Prakash_Music.csv,37,62062904.0,17,20,13,4,0,35.7027027027027,206,30,17.89189189189189,11
Category_Wikipedia_sockpuppets_of_Britney901.csv,1729,457577298.0,366,1363,207,159,0,53.633314054366686,486,57,16.792365529207636,3
Category_Wikipedia_sockpuppets_of_Thetvcritic.csv,71,68916311.0,16,55,10,6,0,44.521126760563384,289,42,18.633802816901408,8
Category_Wikipedia_sockpuppets_of_Uss7777.csv,856,38106735.0,427,429,216,211,0,42.649532710280376,496,75,21.024532710280372,6
Category_Wikipedia_sockpuppets_of_Nefirious.csv,1685,251848806.0,574,1111,500,74,0,48.18041543026706,238,86,18.528783382789317,5
Category_Wikipedia_sockpuppets_of_Wikitime_Continuum.csv,1936,14164549.0,665,1271,130,535,0,41.548037190082646,255,58,16.672004132231404,7
Category_Wikipedia_sockpuppets_of_Daw-ruk.csv,11,150155.0,3,8,2,1,0,35.0,75,53,40.72727272727273,17
Category_Wikipedia_sockpuppets_of_Qaz102.csv,38,4167330.0,17,21,8,9,19,128.97368421052633,255,23,22.789473684210527,21
Category_Wikipedia_sockpuppets_of_GWFrog.csv,1326,344035007.0,596,730,500,96,0,42.125188536953246,495,87,34.64932126696833,3
Category_Wikipedia_sockpuppets_of_Samkeyta.csv,1169,63142247.0,568,601,500,68,0,36.96834901625321,314,72,24.264328485885372,10
Category_Wikipedia_sockpuppets_of_Petsfoodspro.csv,9,15673.0,3,6,1,2,0,43.0,104,31,21.666666666666668,13
Category_Wikipedia_sockpuppets_of_Saurabhgurgaon.csv,709,5258086.0,251,458,128,123,0,38.7277856135402,257,57,19.0,3
Category_Wikipedia_sockpuppets_of_Genuine_films.csv,184,1557509.0,56,128,46,10,0,45.91847826086956,252,55,19.119565217391305,8
Category_Wikipedia_sockpuppets_of_Linton_Quadros.csv,2,0.0,1,1,1,0,32,32.0,32,33,33.0,33
Category_Wikipedia_sockpuppets_of_Keditz.csv,3036,21845797.0,878,2158,500,378,0,57.08267457180501,608,59,15.627470355731225,3
Category_Wikipedia_sockpuppets_of_Cactus_Jack1966.csv,277,6814474.0,72,205,29,43,0,41.07581227436823,507,22,12.23826714801444,7
Category_Wikipedia_sockpuppets_of_JohnBambenek.csv,2773,125046661.0,790,1983,500,290,0,47.32708258204111,250,90,29.93508835196538,3
Category_Wikipedia_sockpuppets_of_DLindsley.csv,1817,33633763.0,618,1199,500,118,0,60.880572372041826,255,58,26.298293891029168,4
Category_Wikipedia_sockpuppets_of_TAG_speakers.csv,780,168842494.0,278,502,208,70,0,46.01923076923077,249,54,15.934615384615384,4
Category_Wikipedia_sockpuppets_of_Jamescoakley2121.csv,6,494.0,5,1,3,2,4,22.166666666666668,113,7,7.0,7
Category_Wikipedia_sockpuppets_of_Tabtab476.csv,150,43120149.0,45,105,28,17,0,42.44,214,39,16.953333333333333,5
Category_Wikipedia_sockpuppets_of_TheSyndromeOfaDown.csv,664,6302219.0,186,478,65,121,0,47.56325301204819,255,53,29.626506024096386,6
Category_Wikipedia_sockpuppets_of_Violetbonmua_Khong_nen_lam_BQV.csv,54,93675.0,41,13,35,6,0,19.14814814814815,168,40,26.87037037037037,21
Category_Wikipedia_sockpuppets_of_Dabossman1000000.csv,3027,165397765.0,744,2283,500,244,0,45.217046580773044,450,61,19.411298315163528,5
Category_Wikipedia_sockpuppets_of_TruthSeeker1234.csv,1326,14294169.0,516,810,491,25,0,31.30316742081448,253,103,30.795625942684765,15
Category_Wikipedia_sockpuppets_of_VicIlongo.csv,454,14364608.0,216,238,202,14,0,34.78193832599119,253,38,16.337004405286343,4
Category_Wikipedia_sockpuppets_of_Cfa_brother.csv,7,592.0,3,4,2,1,0,26.714285714285715,132,20,20.0,20
Category_Wikipedia_sockpuppets_of_TimiWikia2021.csv,1191,4754280.0,375,816,94,281,0,46.34760705289673,496,51,23.738035264483628,3
Category_Wikipedia_sockpuppets_of_TamCleanUp.csv,1266,10941384.0,401,865,186,215,0,33.41943127962085,395,62,17.076619273301738,4
Category_Wikipedia_sockpuppets_of_Yudhacahyo.csv,4012,169949797.0,1051,2961,500,551,0,34.2382851445663,438,53,24.720338983050848,6
Category_Wikipedia_sockpuppets_of_Spearmind.csv,1406,780613.0,506,900,500,6,0,56.21550497866287,255,50,32.8022759601707,10
Category_Wikipedia_sockpuppets_of_RichardKoshorek.csv,50,1808642.0,13,37,8,5,0,40.26,199,43,17.9,11
Category_Wikipedia_sockpuppets_of_Jesien1.csv,266,22821578.0,101,165,87,14,0,38.3421052631579,242,50,23.669172932330827,5
Category_Wikipedia_sockpuppets_of_Andranikpasha.csv,1394,63375805.0,500,894,500,0,0,44.91104734576758,243,55,20.86154949784792,6
Category_Wikipedia_sockpuppets_of_Dmzn8844.csv,88,1071781.0,27,61,13,14,0,67.76136363636364,255,36,15.965909090909092,9
Category_Wikipedia_sockpuppets_of_Mark_Williams_222254.csv,23,150281.0,8,15,7,1,0,36.69565217391305,110,65,30.391304347826086,7
Category_Wikipedia_sockpuppets_of_Vza.kurrodu.csv,125,46400559.0,25,100,12,13,0,39.456,178,21,12.72,11
Category_Wikipedia_sockpuppets_of_NotTechimo.csv,527,37919005.0,188,339,154,34,0,52.64326375711575,255,45,26.18216318785579,9
Category_Wikipedia_sockpuppets_of_ZAngami.csv,1110,10375176.0,417,693,223,194,0,37.43423423423423,255,59,15.72882882882883,5
Category_Wikipedia_sockpuppets_of_Culitrum1988.csv,232,6476622.0,90,142,47,43,0,47.043103448275865,494,21,11.40948275862069,3
Category_Wikipedia_sockpuppets_of_Dolove436.csv,40,23168741.0,14,26,10,4,0,56.375,233,24,18.5,5
Category_Wikipedia_sockpuppets_of_Skkajal.csv,32,19173235.0,11,21,11,0,16,85.34375,180,31,17.78125,14
Category_Wikipedia_sockpuppets_of_AFreshStart.csv,5751,32347924.0,2065,3686,500,1565,0,63.17962093548948,500,92,20.974613110763347,2
Category_Wikipedia_sockpuppets_of_Mystywave18.csv,434,18424161.0,201,233,137,64,0,35.91705069124424,253,80,24.016129032258064,11
Category_Wikipedia_sockpuppets_of_7AU1606.csv,3553,43527569.0,1039,2514,449,590,0,55.92879256965944,255,58,16.788066422741345,2
Category_Wikipedia_sockpuppets_of_Creditcamp.csv,129,6920034.0,53,76,45,8,0,36.8062015503876,173,46,24.62015503875969,4
Category_Wikipedia_sockpuppets_of_Justina1244567890d.csv,8,1200681.0,6,2,5,1,0,35.125,145,5,4.5,4
Category_Wikipedia_sockpuppets_of_Robert_Moore.csv,1617,174105511.0,558,1059,500,58,0,37.76623376623377,285,70,22.57204700061843,4
Category_Wikipedia_sockpuppets_of_Marlin1975.csv,1231,166056435.0,287,944,197,90,0,58.55645816409423,242,76,18.81153533712429,5
Category_Wikipedia_sockpuppets_of_Roverfan77.csv,725,412039571.0,156,569,119,37,0,43.19034482758621,253,50,16.69793103448276,3
Category_Wikipedia_sockpuppets_of_Happydaze1.csv,826,6427795.0,270,556,171,99,0,89.02905569007264,500,65,26.628329297820823,3
Category_Wikipedia_sockpuppets_of_Ijasm.csv,16,216866.0,8,8,5,3,0,86.0,494,20,16.9375,12
Category_Wikipedia_sockpuppets_of_Information_yes.csv,12279,11781378.0,3737,8542,500,3237,0,35.95708119553709,241,57,14.63026305073703,3
Category_Wikipedia_sockpuppets_of_Rvoskoboynikov.csv,34,5540965.0,12,22,8,4,0,80.11764705882354,318,65,23.676470588235293,9
Category_Wikipedia_sockpuppets_of_Shire‚Ä¶..77.csv,8,99457.0,7,1,4,3,0,51.375,398,10,10.0,10
Category_Wikipedia_sockpuppets_of_Kaylor2012.csv,684,97483472.0,175,509,148,27,0,34.22953216374269,235,64,24.830409356725145,4
Category_Wikipedia_sockpuppets_of_Cdg428.csv,232,17425410.0,71,161,57,14,0,47.69827586206897,255,41,18.530172413793103,6
Category_Wikipedia_sockpuppets_of_Naslechat.csv,311,29307751.0,101,210,83,18,0,48.72025723472669,496,54,16.774919614147908,4
Category_Wikipedia_sockpuppets_of_AmberPollic9444.csv,15,479331.0,10,5,6,4,0,96.93333333333334,500,28,28.0,28
Category_Wikipedia_sockpuppets_of_Ivygohnair.csv,1082,37578247.0,510,572,500,10,0,50.00554528650647,245,69,25.446395563770796,10
Category_Wikipedia_sockpuppets_of_Bulgames.csv,135,87810316.0,45,90,21,24,0,44.2,174,53,37.785185185185185,18
Category_Wikipedia_sockpuppets_of_Himesh_Kuttiyal.csv,1455,23651314.0,478,977,352,126,0,32.717525773195874,248,55,17.05979381443299,3
Category_Wikipedia_sockpuppets_of_Harvey54thf.csv,13,374292.0,7,6,4,3,10,50.07692307692308,169,18,16.384615384615383,15
Category_Wikipedia_sockpuppets_of_JJonathan.csv,6579,39566027.0,1635,4944,500,1135,0,29.68186654506764,227,65,16.588995288037697,4
Category_Wikipedia_sockpuppets_of_Jono2013.csv,1153,1595032.0,531,622,500,31,0,52.98785776235906,255,78,28.791847354726798,6
Category_Wikipedia_sockpuppets_of_Kbq430.csv,5169,141876690.0,1741,3428,500,1241,0,43.5703230798994,500,91,27.040626813697042,4
Category_Wikipedia_sockpuppets_of_KitchenDesignSolutionsLLC.csv,1,0.0,1,0,1,0,99,99.0,99,29,29.0,29
Category_Wikipedia_sockpuppets_of_Kalinindrag.csv,101,15482.0,49,52,45,4,0,57.851485148514854,129,37,17.168316831683168,11
Category_Wikipedia_sockpuppets_of_Raphael1234567.csv,101,2014201.0,39,62,26,13,0,47.633663366336634,279,56,14.881188118811881,3
Category_Wikipedia_sockpuppets_of_Epeefleche.csv,4865,186249588.0,1378,3487,500,878,0,44.713463514902365,255,89,19.10503597122302,2
Category_Wikipedia_sockpuppets_of_Hbb1994.csv,187,25607535.0,54,133,30,24,0,41.37967914438503,217,40,18.6524064171123,7
Category_Wikipedia_sockpuppets_of_Mjp2515.csv,194,18742378.0,59,135,26,33,0,42.56701030927835,189,51,22.778350515463917,5
Category_Wikipedia_sockpuppets_of_Beuhsskk.csv,12,34087.0,8,4,5,3,0,79.83333333333333,233,8,8.0,8
Category_Wikipedia_sockpuppets_of_Sanatany.csv,1240,382193597.0,344,896,290,54,0,54.12741935483871,417,40,12.754838709677419,3
Category_Wikipedia_sockpuppets_of_Plyhmrp.csv,1137,52347130.0,369,768,339,30,0,37.46437994722955,210,88,24.24538258575198,2
Category_Wikipedia_sockpuppets_of_‡¶π‡¶¨‡¶ø‡¶ó‡¶û‡ßç‡¶ú_‡¶â‡¶¶‡ßç‡¶≠‡¶æ‡¶¨‡¶®‡ßÄ_‡¶¨‡¶ø‡¶ú‡ßç‡¶û‡¶æ‡¶®_‡¶ï‡ßç‡¶≤‡¶æ‡¶¨.csv,17,244374.0,11,6,10,1,0,28.058823529411764,127,59,25.294117647058822,13
Category_Wikipedia_sockpuppets_of_Turquoisesummer.csv,321,53560086.0,109,212,51,58,0,47.18691588785047,255,66,18.3208722741433,7
Category_Wikipedia_sockpuppets_of_Shingling334.csv,9233,238897953.0,3223,6010,500,2723,0,45.835914653958625,496,60,16.46366294812087,4
Category_Wikipedia_sockpuppets_of_MarcEdelmanFan.csv,24,255605.0,13,11,8,5,5,44.875,241,50,43.916666666666664,24
Category_Wikipedia_sockpuppets_of_Oliver_H10.csv,49,7752558.0,14,35,14,0,0,45.714285714285715,231,41,23.73469387755102,10
Category_Wikipedia_sockpuppets_of_Scounder.csv,676,6847350.0,270,406,258,12,0,32.428994082840234,500,37,28.431952662721894,4
Category_Wikipedia_sockpuppets_of_CaptainHog.csv,549,37324287.0,236,313,138,98,0,32.3551912568306,254,44,10.848816029143897,4
Category_Wikipedia_sockpuppets_of_MathKeduor7.csv,2975,134694029.0,1026,1949,500,526,0,45.13949579831933,365,49,19.305546218487397,7
Category_Wikipedia_sockpuppets_of_YuRi_YuZi.csv,1913,17555919.0,552,1361,500,52,0,47.5363303711448,255,55,17.633559853633038,1
Category_Wikipedia_sockpuppets_of_Redban.csv,1044,10110314.0,354,690,250,104,0,47.6139846743295,255,69,23.477011494252874,6
Category_Wikipedia_sockpuppets_of_Bdyz.csv,92,6465719.0,29,63,23,6,0,45.130434782608695,181,44,26.391304347826086,15
Category_Wikipedia_sockpuppets_of_Nugget_biscuit_0.csv,29,258391.0,15,14,13,2,0,44.06896551724138,235,21,18.79310344827586,13
Category_Wikipedia_sockpuppets_of_Sanjeevkufh.csv,48,546658.0,17,31,16,1,0,93.60416666666667,500,43,25.104166666666668,13
Category_Wikipedia_sockpuppets_of_River_Stumpf.csv,2771,251791600.0,984,1787,500,484,0,33.36196319018405,255,55,18.96788163118008,4
Category_Wikipedia_sockpuppets_of_Biggy_P.csv,343,21792106.0,127,216,105,22,0,41.28862973760933,200,56,17.775510204081634,3
Category_Wikipedia_sockpuppets_of_Travelmania92.csv,94,4010690.0,56,38,48,8,0,55.840425531914896,209,25,16.340425531914892,14
Category_Wikipedia_sockpuppets_of_The_Good_Boy_Gone_Bad_Tour.csv,14,5888662.0,7,7,2,5,0,38.07142857142857,195,60,29.857142857142858,18
Category_Wikipedia_sockpuppets_of_Mdrealofficial.csv,4,2963.0,4,0,2,2,0,27.0,46,24,22.5,18
Category_Wikipedia_sockpuppets_of_Fredadams.csv,68,4344951.0,41,27,41,0,0,67.0,184,19,15.029411764705882,14
Category_Wikipedia_sockpuppets_of_Benpporter.csv,293,18189861.0,112,181,81,31,0,43.358361774744026,287,56,20.822525597269625,6
Category_Wikipedia_sockpuppets_of_Hilgerzick.csv,4,2481765.0,2,2,1,1,29,67.0,120,21,20.25,20
Category_Wikipedia_sockpuppets_of_What_am_you_are_2.csv,174,25930026.0,48,126,20,28,0,58.90229885057471,496,82,27.419540229885058,12
Category_Wikipedia_sockpuppets_of_Captbloodrock.csv,1642,166652672.0,526,1116,500,26,0,46.89890377588307,496,61,17.45919610231425,5
Category_Wikipedia_sockpuppets_of_Eswaran_Naveen.csv,7413,159475069.0,2237,5176,500,1737,0,35.715769593956566,500,56,17.69661405638743,3
Category_Wikipedia_sockpuppets_of_Noobletteowns.csv,23,22310.0,13,10,9,4,0,58.56521739130435,199,30,17.043478260869566,6
Category_Wikipedia_sockpuppets_of_Captain_Fearnought.csv,1455,117131803.0,451,1004,345,106,0,43.58213058419244,250,86,20.2,4
Category_Wikipedia_sockpuppets_of_Realbrownranger.csv,25,89563.0,14,11,14,0,0,39.92,297,40,35.2,25
Category_Wikipedia_sockpuppets_of_Deserved_Joy.csv,32,55836346.0,19,13,15,4,0,38.09375,197,20,12.5,10
Category_Wikipedia_sockpuppets_of_Factocop.csv,1512,78508679.0,550,962,500,50,0,40.51984126984127,250,69,26.097883597883598,7
Category_Wikipedia_sockpuppets_of_Mysure.csv,557,626745.0,249,308,83,166,0,46.29443447037702,250,56,24.662477558348293,7
Category_Wikipedia_sockpuppets_of_Salvio_Guilaino.csv,52,971510.0,21,31,14,7,0,40.76923076923077,249,41,36.5,14
Category_Wikipedia_sockpuppets_of_Bharatbhusannanda.csv,1,0.0,1,0,1,0,196,196.0,196,27,27.0,27
Category_Wikipedia_sockpuppets_of_Mohammedjaseem66.csv,1528,34982234.0,563,965,351,212,0,53.14921465968586,395,77,22.517670157068064,4
Category_Wikipedia_sockpuppets_of_GOAT7.csv,7096,30975234.0,2388,4708,473,1915,0,48.33751409244645,395,62,17.88768320180383,2
Category_Wikipedia_sockpuppets_of_Prof_Grey.csv,27,3922035.0,16,11,8,8,0,31.444444444444443,229,32,21.74074074074074,13
Category_Wikipedia_sockpuppets_of_Ayush_Pai.csv,32,1378486.0,14,18,12,2,0,43.78125,210,41,19.34375,8
Category_Wikipedia_sockpuppets_of_HeadMouse.csv,2086,170500565.0,865,1221,500,365,0,49.215244487056566,263,53,25.60882070949185,7
Category_Wikipedia_sockpuppets_of_Jack_Morales_Garcia.csv,893,61442016.0,223,670,222,1,0,59.81298992161254,496,50,17.625979843225085,6
Category_Wikipedia_sockpuppets_of_CoomerDeluxe.csv,45,35536958.0,17,28,10,7,0,41.37777777777778,183,34,14.0,8
Category_Wikipedia_sockpuppets_of_Mystery_island_4800.csv,6,602.0,3,3,2,1,0,44.0,128,4,4.0,4
Category_Wikipedia_sockpuppets_of_Medstudent213.csv,176,8994733.0,75,101,50,25,0,49.20454545454545,198,25,21.255681818181817,16
Category_Wikipedia_sockpuppets_of_Hypocritepedia.csv,3202,322351958.0,971,2231,500,471,0,43.49625234228607,255,82,20.66583385384135,2
Category_Wikipedia_sockpuppets_of_Wikinatz.csv,189,485892897.0,116,73,111,5,0,36.91005291005291,279,18,11.248677248677248,4
Category_Wikipedia_sockpuppets_of_Cyberanthropologist.csv,1234,9120267.0,486,748,390,96,0,68.55834683954619,502,49,16.562398703403566,6
Category_Wikipedia_sockpuppets_of_Woshinidema.csv,51,702029.0,20,31,12,8,0,49.294117647058826,192,28,16.11764705882353,9
Category_Wikipedia_sockpuppets_of_Lonlys.csv,49,432281.0,33,16,25,8,0,67.53061224489795,308,14,12.938775510204081,10
Category_Wikipedia_sockpuppets_of_Ginyattri.csv,105,155609833.0,31,74,21,10,0,40.819047619047616,202,53,20.295238095238094,7
Category_Wikipedia_sockpuppets_of_Jrmscpeople.csv,76,8534997.0,20,56,20,0,0,25.723684210526315,145,27,13.868421052631579,7
Category_Wikipedia_sockpuppets_of_Drift_king3.csv,3,2598.0,3,0,3,0,0,23.333333333333332,41,18,18.0,18
Category_Wikipedia_sockpuppets_of_Week7FNF.csv,213,5977872.0,59,154,39,20,0,51.244131455399064,496,31,12.291079812206572,2
Category_Wikipedia_sockpuppets_of_Tim96144.csv,2542,55851568.0,740,1802,500,240,0,44.87018095987411,515,54,20.865066876475215,5
Category_Wikipedia_sockpuppets_of_Middleamericajames.csv,810,221009369.0,267,543,69,198,0,46.92469135802469,407,73,33.544444444444444,9
Category_Wikipedia_sockpuppets_of_Leftregister.csv,998,17081816.0,301,697,301,0,0,55.61623246492986,495,50,18.904809619238478,5
Category_Wikipedia_sockpuppets_of_Bahironga.csv,806,34774130.0,210,596,51,159,0,53.473945409429284,478,89,22.574441687344912,4
Category_Wikipedia_sockpuppets_of_Aatt1-0.csv,226,7789971.0,70,156,42,28,0,45.97787610619469,166,53,29.61061946902655,10
Category_Wikipedia_sockpuppets_of_EAXAE.csv,159,38636376.0,58,101,8,50,0,49.17610062893082,415,41,18.654088050314467,8
Category_Wikipedia_sockpuppets_of_Khushig1011.csv,33,4063835.0,10,23,5,5,4,103.63636363636364,294,40,24.90909090909091,11
Category_Wikipedia_sockpuppets_of_Eleckill.csv,31,773865.0,29,2,13,16,0,51.74193548387097,134,21,21.0,21
Category_Wikipedia_sockpuppets_of_Realpeter_liu.csv,94,4493147.0,35,59,17,18,0,42.38297872340426,351,32,19.372340425531913,17
Category_Wikipedia_sockpuppets_of_Sn6054884.csv,83,58742281.0,21,62,18,3,0,61.66265060240964,264,27,17.397590361445783,5
Category_Wikipedia_sockpuppets_of_Guillen.csv,299,9619562.0,127,172,96,31,0,30.94314381270903,200,44,19.48160535117057,10
Category_Wikipedia_sockpuppets_of_K_Aquinz.csv,262,9934801.0,96,166,91,5,0,31.641221374045802,238,59,27.50763358778626,7
Category_Wikipedia_sockpuppets_of_Chloe81375.csv,4,26642.0,4,0,4,0,113,113.0,113,27,27.0,27
Category_Wikipedia_sockpuppets_of_Adeptzaire.csv,30,565196.0,18,12,12,6,0,16.2,120,43,24.1,20
Category_Wikipedia_sockpuppets_of_Pashto250.csv,298,30808398.0,108,190,92,16,0,50.17785234899329,389,37,12.909395973154362,4
Category_Wikipedia_sockpuppets_of_Russavia.csv,4189,51752722.0,1263,2926,500,763,0,51.83504416328479,255,73,18.360467892098352,4
Category_Wikipedia_sockpuppets_of_American_Brit.csv,3197,68699622.0,1130,2067,500,630,0,31.701908038786364,244,66,18.840162652486708,4
Category_Wikipedia_sockpuppets_of_Purbitaalipurduar.csv,69,160553381.0,17,52,14,3,0,57.10144927536232,296,53,14.246376811594203,7
Category_Wikipedia_sockpuppets_of_Annamargarita0.csv,2010,68401540.0,729,1281,500,229,0,37.801492537313436,494,57,21.65721393034826,4
Category_Wikipedia_sockpuppets_of_Undertrialryryr.csv,6440,181339647.0,2489,3951,500,1989,0,48.5666149068323,255,87,23.89798136645963,3
Category_Wikipedia_sockpuppets_of_Christopher_McBride.csv,5358,142053814.0,1900,3458,500,1400,0,48.76465098917507,386,63,25.728256812243373,3
Category_Wikipedia_sockpuppets_of_Breryl.csv,305,22685497.0,84,221,22,62,0,47.662295081967216,255,67,16.501639344262294,4
Category_Wikipedia_sockpuppets_of_Tyson_Turner.csv,114,100624572.0,43,71,24,19,0,34.31578947368421,209,48,30.63157894736842,17
Category_Wikipedia_sockpuppets_of_WFWW_.csv,47,7259424.0,11,36,5,6,0,42.191489361702125,178,24,16.25531914893617,10
Category_Wikipedia_sockpuppets_of_Maferolu.csv,5,233322.0,2,3,2,0,0,27.0,80,14,14.0,14
Category_Wikipedia_sockpuppets_of_Flowersforparis.csv,545,100572989.0,237,308,110,127,0,70.50275229357798,255,27,20.74678899082569,12
Category_Wikipedia_sockpuppets_of_NoCal100.csv,29831,500782011.0,10038,19793,500,9538,0,49.84076966913614,500,112,23.16301833662968,3
Category_Wikipedia_sockpuppets_of_Lauracerffer.csv,1427,265851184.0,500,927,269,231,0,49.82901191310442,281,42,17.303433777154872,5
Category_Wikipedia_sockpuppets_of_Lucasbishop.csv,40,13852900.0,31,9,30,1,0,36.225,389,43,39.55,20
Category_Wikipedia_sockpuppets_of_MadKingChucky.csv,129,7689941.0,48,81,43,5,0,57.689922480620154,224,37,17.294573643410853,6
Category_Wikipedia_sockpuppets_of_Bella922323.csv,74,6306199.0,24,50,19,5,0,49.95945945945946,255,53,28.7972972972973,11
Category_Wikipedia_sockpuppets_of_ZoeCroydon.csv,343,13213794.0,96,247,22,74,0,39.583090379008745,194,47,21.157434402332363,6
Category_Wikipedia_sockpuppets_of_Simbalillyoreo.csv,2035,46392382.0,783,1252,500,283,0,40.09041769041769,255,50,16.613759213759213,5
Category_Wikipedia_sockpuppets_of_RedDeadJohn.csv,2390,33823752.0,870,1520,422,448,0,38.99539748953975,255,48,20.515062761506275,5
Category_Wikipedia_sockpuppets_of_SaintOhrszy.csv,309,49496829.0,101,208,95,6,0,40.17799352750809,255,48,17.003236245954692,5
Category_Wikipedia_sockpuppets_of_SergeeIsBaws.csv,9,674.0,7,2,5,2,0,22.333333333333332,125,21,9.555555555555555,4
Category_Wikipedia_sockpuppets_of_Rs2586.csv,58,442815.0,23,35,12,11,0,40.39655172413793,181,26,17.96551724137931,13
Category_Wikipedia_sockpuppets_of_Darlingtontory123.csv,54,33326867.0,29,25,18,11,0,59.7962962962963,206,24,21.703703703703702,15
Category_Wikipedia_sockpuppets_of_Idmrks1.csv,658,193959548.0,160,498,44,116,0,45.98024316109422,248,54,14.465045592705167,5
Category_Wikipedia_sockpuppets_of_Jacobkennedy.csv,6183,367777921.0,1818,4365,500,1318,0,53.47064531780689,501,87,25.786673136018113,4
Category_Wikipedia_sockpuppets_of_Nwdcmarketing.csv,3,1273.0,3,0,2,1,0,37.0,68,39,31.0,18
Category_Wikipedia_sockpuppets_of_Iamamoron!.csv,676,21347358.0,252,424,248,4,0,26.014792899408285,255,71,17.28994082840237,5
Category_Wikipedia_sockpuppets_of_Bob_42315.csv,62,28663476.0,23,39,14,9,0,48.806451612903224,238,28,18.258064516129032,7
Category_Wikipedia_sockpuppets_of_Thebiggangwiki.csv,1427,6332447.0,522,905,500,22,0,46.87105816398038,499,81,19.314646110721792,4
Category_Wikipedia_sockpuppets_of_WikiFacts247.csv,26,8666701.0,15,11,8,7,0,29.653846153846153,192,26,13.5,13
Category_Wikipedia_sockpuppets_of_Zenzyyx.csv,3880,45868595.0,1073,2807,500,573,0,57.79123711340206,500,69,18.42835051546392,3
Category_Wikipedia_sockpuppets_of_Mirno.csv,1862,32290269.0,572,1290,500,72,0,41.92749731471536,255,56,26.155209452201934,4
Category_Wikipedia_sockpuppets_of_GucciBoi1002.csv,14,2286.0,8,6,8,0,0,82.28571428571429,187,38,38.0,38
Category_Wikipedia_sockpuppets_of_Bokan995.csv,1257,3682491.0,467,790,406,61,0,37.46062052505967,248,42,14.338106603023071,4
Category_Wikipedia_sockpuppets_of_AssadFin.csv,513,82416273.0,170,343,165,5,0,59.604288499025344,402,87,21.580896686159843,5
Category_Wikipedia_sockpuppets_of_AwesomeJEC.csv,174,46346688.0,41,133,35,6,0,45.03448275862069,423,58,20.022988505747126,4
Category_Wikipedia_sockpuppets_of_AuthorRk.csv,27,436847.0,7,20,6,1,0,42.666666666666664,127,27,20.555555555555557,16
Category_Wikipedia_sockpuppets_of_Donnetias23&.csv,72,621266.0,29,43,14,15,0,46.638888888888886,189,34,20.055555555555557,9
Category_Wikipedia_sockpuppets_of_Kleubay.csv,60,296984333.0,23,37,22,1,0,52.65,233,48,14.966666666666667,4
Category_Wikipedia_sockpuppets_of_Seemitfe.csv,894,16161055.0,247,647,112,135,0,49.63646532438479,500,80,17.002237136465325,4
Category_Wikipedia_sockpuppets_of_Haohaomyy.csv,99,15885820.0,44,55,38,6,0,43.35353535353536,236,48,27.747474747474747,8
Category_Wikipedia_sockpuppets_of_Rajesh_Munat.csv,22,154257.0,11,11,7,4,0,84.63636363636364,196,66,38.18181818181818,12
Category_Wikipedia_sockpuppets_of_Jake_Hayward.csv,45,7871285.0,23,22,21,2,0,34.48888888888889,273,22,8.11111111111111,5
Category_Wikipedia_sockpuppets_of_AgentPolkaDot.csv,333,7167210.0,124,209,29,95,0,50.825825825825824,235,53,17.41141141141141,7
Category_Wikipedia_sockpuppets_of_LogicLord.csv,123,12886590.0,64,59,40,24,0,39.146341463414636,341,50,17.48780487804878,8
Category_Wikipedia_sockpuppets_of_Engboy142.csv,4734,39842637.0,1514,3220,155,1359,0,35.330164765525986,255,57,21.920785804816223,6
Category_Wikipedia_sockpuppets_of_Bancaria.csv,14,292683.0,13,1,11,2,0,26.071428571428573,193,21,17.714285714285715,13
Category_Wikipedia_sockpuppets_of_AlborzTaha.csv,391,31624137.0,153,238,129,24,0,44.28132992327366,216,45,22.833759590792837,7
Category_Wikipedia_sockpuppets_of_Trufiness.csv,14,15004.0,6,8,3,3,14,86.21428571428571,175,21,14.142857142857142,5
Category_Wikipedia_sockpuppets_of_Victoria2Sander178.csv,224,4831228.0,60,164,16,44,0,56.892857142857146,274,47,18.754464285714285,8
Category_Wikipedia_sockpuppets_of_TardyMarmot.csv,1058,262902173.0,248,810,105,143,0,59.63421550094518,468,59,14.887523629489603,4
Category_Wikipedia_sockpuppets_of_Oon835.csv,1550,10801485.0,543,1007,500,43,0,38.163870967741936,255,64,29.44,6
Category_Wikipedia_sockpuppets_of_Nazim_Hussain_Pak.csv,1044,51881377.0,321,723,115,206,0,49.01724137931034,255,74,18.89750957854406,3
Category_Wikipedia_sockpuppets_of_BobbyBillyBob2.csv,450,6969135.0,139,311,38,101,0,60.5,348,54,16.824444444444445,5
Category_Wikipedia_sockpuppets_of_Bbtregervdfv.csv,1226,18042027.0,325,901,42,283,0,44.00815660685155,255,54,20.633768352365415,3
Category_Wikipedia_sockpuppets_of_Iamrajdeepdas.csv,1500,86153596.0,520,980,500,20,0,59.343333333333334,499,57,21.106,4
Category_Wikipedia_sockpuppets_of_Copyrightpower1337.csv,2218,166204165.0,501,1717,500,1,0,57.68935978358882,376,250,20.978809738503156,3
Category_Wikipedia_sockpuppets_of_Pleasureme23.csv,2882,45720911.0,852,2030,500,352,0,48.88896599583622,364,66,26.401804302567662,3
Category_Wikipedia_sockpuppets_of_Agesworthuser.csv,366,8385048.0,173,193,143,30,0,41.37158469945355,238,49,23.48087431693989,15
Category_Wikipedia_sockpuppets_of_Adityapowar.csv,216,8321688.0,81,135,60,21,0,39.324074074074076,247,46,22.98148148148148,9
Category_Wikipedia_sockpuppets_of_Thedamneditor.csv,1808,248631862.0,468,1340,467,1,0,50.4103982300885,331,50,19.190265486725664,6
Category_Wikipedia_sockpuppets_of_Smashitter2020.csv,21,5519906.0,13,8,9,4,15,72.57142857142857,139,24,18.857142857142858,12
Category_Wikipedia_sockpuppets_of_Renamed_user_sgjut467ggf.csv,1066,6723711.0,344,722,213,131,0,48.48780487804878,500,51,20.9906191369606,8
Category_Wikipedia_sockpuppets_of_XGustaX.csv,2176,336998595.0,684,1492,500,184,0,45.5813419117647,255,79,18.795955882352942,4
Category_Wikipedia_sockpuppets_of_Ufk_iitk.csv,1254,125673368.0,512,742,500,12,0,38.28947368421053,339,56,23.055821371610847,8
Category_Wikipedia_sockpuppets_of_GoldenGlory84.csv,2649,51930153.0,715,1934,500,215,0,51.384673461683654,241,98,21.023027557568895,4
Category_Wikipedia_sockpuppets_of_N_sahi.csv,1791,56160006.0,1000,791,500,500,0,46.17699609156895,255,58,15.27359017308766,6
Category_Wikipedia_sockpuppets_of_Punyaboy.csv,4256,4932201.0,1386,2870,500,886,0,42.496945488721806,255,95,23.904605263157894,3
Category_Wikipedia_sockpuppets_of_Snehadalvi87.csv,421,47174800.0,164,257,136,28,0,28.53206650831354,245,40,16.33729216152019,11
Category_Wikipedia_sockpuppets_of_Dmetric.csv,15529,127515733.0,5553,9976,500,5053,0,38.15075020928585,260,88,18.405177410007084,1
Category_Wikipedia_sockpuppets_of_Derek169.csv,32,548604.0,19,13,14,5,0,29.1875,287,18,14.15625,7
Category_Wikipedia_sockpuppets_of_Mccleskeygenius.csv,92,5003093.0,27,65,14,13,0,52.96739130434783,218,43,17.652173913043477,11
Category_Wikipedia_sockpuppets_of_Filmsleague.csv,86,43720791.0,25,61,14,11,0,60.58139534883721,272,30,13.709302325581396,7
Category_Wikipedia_sockpuppets_of_NameIsShaheer.csv,34,1891093.0,12,22,12,0,0,91.17647058823529,412,47,18.08823529411765,7
Category_Wikipedia_sockpuppets_of_Ettercamp.csv,15,15472716.0,8,7,7,1,0,147.6,250,20,17.2,13
Category_Wikipedia_sockpuppets_of_Gontlemang_General-Segolodi.csv,86,10146566.0,45,41,28,17,0,50.116279069767444,300,27,14.523255813953488,12
Category_Wikipedia_sockpuppets_of_Lapsed_Pacifist.csv,10479,370222251.0,2500,7979,500,2000,0,47.669052390495274,487,75,19.234946082641475,3
Category_Wikipedia_sockpuppets_of_DBAus2015.csv,59,8558.0,32,27,17,15,0,38.32203389830509,205,25,21.084745762711865,16
Category_Wikipedia_sockpuppets_of_WikiEdit386.csv,4,3945.0,3,1,2,1,14,25.5,32,21,19.5,15
Category_Wikipedia_sockpuppets_of_Troll001.csv,11,201.0,4,7,4,0,0,25.727272727272727,54,16,9.181818181818182,5
Category_Wikipedia_sockpuppets_of_Burt12345.csv,4,1658918.0,2,2,1,1,81,140.0,199,21,19.5,19
Category_Wikipedia_sockpuppets_of_Vannisher.csv,523,214348160.0,133,390,60,73,0,36.78585086042065,233,45,21.118546845124282,5
Category_Wikipedia_sockpuppets_of_Anovoula.csv,15,17587307.0,9,6,9,0,0,30.0,104,16,12.0,11
Category_Wikipedia_sockpuppets_of_Bull-Doser.csv,1681,34651109.0,526,1155,500,26,0,45.21534800713861,255,71,13.37239738251041,3
Category_Wikipedia_sockpuppets_of_Gulizcik.csv,254,60191239.0,196,58,156,40,0,38.57086614173228,199,80,32.42125984251968,18
Category_Wikipedia_sockpuppets_of_R0745976409.csv,101,43182857.0,60,41,27,33,0,19.742574257425744,189,33,18.22772277227723,11
Category_Wikipedia_sockpuppets_of_Onhdsu.csv,144,14836353.0,36,108,21,15,0,31.868055555555557,211,19,13.1875,7
Category_Wikipedia_sockpuppets_of_Highshines.csv,2912,46098438.0,1225,1687,500,725,0,26.228365384615383,227,54,20.077266483516482,4
Category_Wikipedia_sockpuppets_of_Spacer999.csv,78,1307876.0,51,27,22,29,0,39.5,220,50,27.03846153846154,11
Category_Wikipedia_sockpuppets_of_Pci_world.csv,18,614001.0,9,9,3,6,0,24.444444444444443,55,45,37.77777777777778,19
Category_Wikipedia_sockpuppets_of_Flamelai.csv,3495,537702491.0,1000,2495,500,500,0,38.089270386266094,314,76,18.923319027181687,3
Category_Wikipedia_sockpuppets_of_Leaky_gut_syndrome.csv,615,6865355.0,317,298,31,286,0,51.36910569105691,255,54,23.954471544715446,3
Category_Wikipedia_sockpuppets_of_Yaysmay15.csv,3104,243310023.0,1236,1868,500,736,0,33.100193298969074,476,45,22.86340206185567,4
Category_Wikipedia_sockpuppets_of_Zaidwani1.csv,158,27216931.0,50,108,33,17,0,50.575949367088604,273,50,20.59493670886076,6
Category_Wikipedia_sockpuppets_of_Souljaa.csv,368,4774060.0,153,215,124,29,0,32.94565217391305,231,41,18.154891304347824,5
Category_Wikipedia_sockpuppets_of_20kids.csv,59,3921549.0,21,38,5,16,0,49.03389830508475,230,80,30.593220338983052,5
Category_Wikipedia_sockpuppets_of_Natebrownmusic.csv,9,1212411.0,4,5,3,1,19,49.888888888888886,92,22,15.0,10
Category_Wikipedia_sockpuppets_of_Qwofhaioerhiooin.csv,43,535785.0,17,26,12,5,0,24.53488372093023,196,21,15.813953488372093,14
Category_Wikipedia_sockpuppets_of_Peterp.224.csv,16,99459.0,11,5,7,4,0,47.1875,230,5,5.0,5
Category_Wikipedia_sockpuppets_of_SurvivorGuru0717.csv,388,10660015.0,217,171,138,79,0,33.93814432989691,254,58,26.286082474226806,14
Category_Wikipedia_sockpuppets_of_Vassilis81.csv,381,62789224.0,158,223,128,30,0,46.45669291338583,500,48,36.23884514435696,15
Category_Wikipedia_sockpuppets_of_Revant_Krishna.csv,68,91126.0,21,47,12,9,0,30.985294117647058,222,19,11.632352941176471,5
Category_Wikipedia_sockpuppets_of_UpdatedTrackerAccurate.csv,10,292875.0,8,2,3,5,0,6.4,56,15,15.0,15
Category_Wikipedia_sockpuppets_of_Eleonorahon.csv,209,102894338.0,122,87,118,4,0,48.27751196172249,506,73,28.11004784688995,9
Category_Wikipedia_sockpuppets_of_Sunshine773.csv,222,427451.0,100,122,64,36,0,71.82432432432432,476,47,23.783783783783782,9
Category_Wikipedia_sockpuppets_of_Wiki_hamze.csv,389,59094112.0,131,258,113,18,0,60.318766066838045,251,50,19.835475578406168,5
Category_Wikipedia_sockpuppets_of_Peparazzi.csv,973,47403152.0,335,638,298,37,0,42.03699897225077,255,45,24.735868448098664,5
Category_Wikipedia_sockpuppets_of_Numerounovedant.csv,1596,262903750.0,516,1080,500,16,0,43.264411027568926,496,59,15.81328320802005,4
Category_Wikipedia_sockpuppets_of_Aivarlukman.csv,18,1141697.0,14,4,14,0,0,35.05555555555556,156,21,16.555555555555557,16
Category_Wikipedia_sockpuppets_of_Frankypedia.csv,841,117147286.0,198,643,88,110,0,54.48156956004756,358,53,17.618311533888228,3
Category_Wikipedia_sockpuppets_of_Satyashiva.csv,2062,7404993.0,701,1361,500,201,0,33.210960232783705,237,60,20.782250242483027,4
Category_Wikipedia_sockpuppets_of_Sealle.csv,2750,254478602.0,840,1910,500,340,0,51.08509090909091,269,91,20.864363636363635,4
Category_Wikipedia_sockpuppets_of_Cambridge_Guys.csv,996,29891986.0,324,672,156,168,0,46.80722891566265,395,53,18.003012048192772,3
Category_Wikipedia_sockpuppets_of_Hkboy99.csv,88,4966211.0,63,25,29,34,0,47.38636363636363,207,17,15.727272727272727,15
Category_Wikipedia_sockpuppets_of_Lahttiv.csv,91,1514586.0,35,56,29,6,0,64.98901098901099,248,36,28.0,15
Category_Wikipedia_sockpuppets_of_Darpanashukla.csv,116,263635548.0,38,78,35,3,0,50.78448275862069,255,65,15.612068965517242,8
Category_Wikipedia_sockpuppets_of_HJackson77.csv,926,151984051.0,368,558,352,16,0,36.057235421166304,499,62,18.676025917926566,10
Category_Wikipedia_sockpuppets_of_Zionziho.csv,1961,31391944.0,530,1431,500,30,0,45.443141254462006,386,42,12.558898521162671,3
Category_Wikipedia_sockpuppets_of_ProfessorCoffeeBeans.csv,3,17212114.0,3,0,3,0,16,32.333333333333336,53,30,25.333333333333332,19
Category_Wikipedia_sockpuppets_of_Kgjavheri.csv,84,1898246.0,46,38,26,20,0,53.523809523809526,247,27,20.86904761904762,11
Category_Wikipedia_sockpuppets_of_Jiuqan.csv,8,9060232.0,6,2,5,1,0,30.375,116,28,19.625,15
Category_Wikipedia_sockpuppets_of_Brutalgraph.csv,23,86391.0,17,6,9,8,0,11.956521739130435,55,9,8.782608695652174,8
Category_Wikipedia_sockpuppets_of_Newky2k.csv,20,5095038.0,13,7,11,2,0,42.95,283,26,18.2,12
Category_Wikipedia_sockpuppets_of_Sadie_Coles_HQ.csv,112,39065070.0,40,72,35,5,0,32.00892857142857,215,20,11.767857142857142,10
Category_Wikipedia_sockpuppets_of_Thednsagency.csv,43,7347492.0,27,16,19,8,0,36.651162790697676,234,23,12.418604651162791,10
Category_Wikipedia_sockpuppets_of_MKJKEK.csv,15,852.0,12,3,8,4,11,57.13333333333333,146,36,36.0,36
Category_Wikipedia_sockpuppets_of_Jay_Poodles.csv,9,215.0,5,4,5,0,0,41.666666666666664,185,18,18.0,18
Category_Wikipedia_sockpuppets_of_Cameronfree.csv,152,6434915.0,38,114,15,23,0,48.61184210526316,245,36,16.730263157894736,4
Category_Wikipedia_sockpuppets_of_DjJosh.csv,753,67135190.0,206,547,156,50,0,32.265604249667994,222,46,23.96812749003984,4
Category_Wikipedia_sockpuppets_of_Roozie12.csv,804,32272606.0,259,545,101,158,0,40.34701492537314,233,70,20.072139303482587,3
Category_Wikipedia_sockpuppets_of_Sylvia500.csv,34,23142603.0,15,19,14,1,0,49.088235294117645,207,20,16.176470588235293,13
Category_Wikipedia_sockpuppets_of_SandeepMarvah.csv,22,7334390.0,7,15,6,1,13,60.95454545454545,196,34,22.272727272727273,17
Category_Wikipedia_sockpuppets_of_Bmona12.csv,1895,36008583.0,629,1266,500,129,0,52.0311345646438,508,61,22.185224274406334,4
Category_Wikipedia_sockpuppets_of_QBillyBob.csv,43,170461.0,14,29,14,0,0,59.906976744186046,210,21,10.418604651162791,6
Category_Wikipedia_sockpuppets_of_Jassypool.csv,44,18503.0,15,29,5,10,0,83.79545454545455,228,30,17.045454545454547,9
Category_Wikipedia_sockpuppets_of_Metaverse_Yadav.csv,1295,68168590.0,422,873,83,339,0,48.576833976833974,488,60,19.355212355212355,3
Category_Wikipedia_sockpuppets_of_Sonicafs.csv,72,1287501.0,21,51,6,15,0,64.0,388,41,21.291666666666668,10
Category_Wikipedia_sockpuppets_of_CastleKing1440.csv,1962,35008054.0,607,1355,37,570,0,40.68807339449541,255,65,18.780835881753312,4
Category_Wikipedia_sockpuppets_of_Wm5200.csv,1251,43081648.0,493,758,405,88,0,41.65307753796962,246,47,25.50759392486011,8
Category_Wikipedia_sockpuppets_of_Roy_Ward.csv,1364,15139515.0,479,885,134,345,0,45.6766862170088,200,59,20.505131964809383,3
Category_Wikipedia_sockpuppets_of_NaeNae18.csv,80,12866208.0,16,64,15,1,0,23.875,168,18,12.9125,5
Category_Wikipedia_sockpuppets_of_Hcharlonne.csv,86,34381184.0,75,11,23,52,0,26.953488372093023,208,33,25.58139534883721,15
Category_Wikipedia_sockpuppets_of_Art_of_Odessa.csv,1018,98319353.0,431,587,420,11,0,44.49410609037328,291,42,18.102161100196465,3
Category_Wikipedia_sockpuppets_of_NewCanaan.csv,15,1400.0,8,7,8,0,0,10.2,122,23,23.0,23
Category_Wikipedia_sockpuppets_of_Deuterium.csv,1464,1314111.0,519,945,500,19,0,44.83948087431694,250,64,26.773224043715846,5
Category_Wikipedia_sockpuppets_of_Abbijayne.csv,17,183280531.0,5,12,4,1,0,73.70588235294117,202,22,13.882352941176471,10
Category_Wikipedia_sockpuppets_of_Sebastianbourges.csv,88,99457275.0,37,51,24,13,0,49.81818181818182,264,52,17.0,15
Category_Wikipedia_sockpuppets_of_LesleyAnnWarren.csv,1797,6127378.0,645,1152,220,425,0,45.90651085141903,255,82,28.361713967723983,6
Category_Wikipedia_sockpuppets_of_Peisapooran.csv,287,9850759.0,119,168,66,53,0,38.282229965156795,209,43,13.923344947735192,6
Category_Wikipedia_sockpuppets_of_Niyati_Gupta.csv,28,9331269.0,12,16,11,1,0,34.57142857142857,134,33,25.571428571428573,17
Category_Wikipedia_sockpuppets_of_Blogleads.csv,693,67864948.0,246,447,150,96,0,52.49062049062049,478,73,19.64069264069264,3
Category_Wikipedia_sockpuppets_of_Ronpaulfan83.csv,37,839146.0,21,16,21,0,0,55.5945945945946,161,41,26.2972972972973,12
Category_Wikipedia_sockpuppets_of_Creamy3.csv,2965,53395706.0,1146,1819,500,646,0,31.376391231028666,263,83,20.383473861720066,4
Category_Wikipedia_sockpuppets_of_Wenjanglau.csv,814,138052312.0,317,497,306,11,0,48.180589680589684,255,67,17.922604422604422,5
Category_Wikipedia_sockpuppets_of_Ndominick.csv,35,93680.0,24,11,18,6,0,26.885714285714286,191,41,20.771428571428572,14
Category_Wikipedia_sockpuppets_of_Lock_and_load_2013.csv,42,1032860.0,17,25,5,12,0,50.26190476190476,234,20,12.642857142857142,9
Category_Wikipedia_sockpuppets_of_Œ£œÄŒ¨œÅœÑŒ±Œ∫ŒøœÇ.csv,1779,339769258.0,419,1360,124,295,0,45.516582349634625,358,71,19.05564924114671,4
Category_Wikipedia_sockpuppets_of_BasedKhurasaniiiii.csv,826,37498940.0,254,572,202,52,0,49.69249394673123,496,55,21.303874092009686,6
Category_Wikipedia_sockpuppets_of_Shiyasnazar.csv,63,23247298.0,30,33,28,2,0,42.07936507936508,255,48,31.793650793650794,19
Category_Wikipedia_sockpuppets_of_MoonyX.csv,189,449478.0,48,141,36,12,0,43.22751322751323,199,61,18.92063492063492,5
Category_Wikipedia_sockpuppets_of_Netease_Thunderfire_UX.csv,145,13573899.0,58,87,34,24,0,57.9448275862069,267,24,16.56551724137931,9
Category_Wikipedia_sockpuppets_of_Bramma_G.csv,26,57233.0,18,8,12,6,0,21.76923076923077,136,26,20.192307692307693,15
Category_Wikipedia_sockpuppets_of_Lascava.csv,311,19212414.0,80,231,15,65,0,43.17684887459807,252,41,17.183279742765272,5
Category_Wikipedia_sockpuppets_of_LovSLif.csv,2128,143035002.0,504,1624,500,4,0,60.75234962406015,500,54,16.703007518796994,3
Category_Wikipedia_sockpuppets_of_Davidjosephanselmo.csv,910,45714211.0,510,400,500,10,0,20.473626373626374,251,56,22.67142857142857,4
Category_Wikipedia_sockpuppets_of_Smilesnew55.csv,22,4150810.0,6,16,5,1,0,56.90909090909091,190,40,7.2727272727272725,4
Category_Wikipedia_sockpuppets_of_WikiPageviewer.csv,24,796339.0,13,11,7,6,15,67.5,230,28,24.791666666666668,22
Category_Wikipedia_sockpuppets_of_Coolkid786.csv,128,1361293.0,48,80,24,24,0,66.96875,483,34,10.8046875,6
Category_Wikipedia_sockpuppets_of_Chris_funk_bass.csv,184,56225840.0,51,133,31,20,0,25.532608695652176,198,48,19.543478260869566,14
Category_Wikipedia_sockpuppets_of_Ruby968.csv,139,87190203.0,50,89,49,1,0,51.41726618705036,308,37,16.68345323741007,7
Category_Wikipedia_sockpuppets_of_Naturefit_India.csv,2,453.0,2,0,1,1,19,35.0,51,25,17.0,9
Category_Wikipedia_sockpuppets_of_Ryan2394.csv,9,86631.0,5,4,4,1,0,66.88888888888889,124,19,12.88888888888889,8
Category_Wikipedia_sockpuppets_of_Blink_183_Angels_and_Airwaves.csv,1265,249178581.0,316,949,21,295,0,41.52332015810277,496,58,18.817391304347826,3
Category_Wikipedia_sockpuppets_of_DWhiskaZ.csv,2958,4733824.0,960,1998,151,809,0,39.366801893171065,219,54,15.626098715348208,4
Category_Wikipedia_sockpuppets_of_Delta85.csv,15,8029175.0,3,12,2,1,0,19.666666666666668,119,17,14.466666666666667,10
Category_Wikipedia_sockpuppets_of_MohammedShanooj03.csv,43,11855346.0,13,30,5,8,0,51.16279069767442,200,61,28.46511627906977,11
Category_Wikipedia_sockpuppets_of_Keralaboard.csv,46,1857467.0,14,32,7,7,0,55.15217391304348,246,41,26.630434782608695,6
Category_Wikipedia_sockpuppets_of_TheDohnJoe.csv,766,43316482.0,287,479,183,104,0,44.33420365535248,500,59,28.72584856396867,7
Category_Wikipedia_sockpuppets_of_Ploisl.csv,141,13308063.0,79,62,17,62,0,51.56028368794326,255,23,20.340425531914892,18
Category_Wikipedia_sockpuppets_of_Manpreet_dhir.csv,113,7945374.0,50,63,34,16,0,38.663716814159294,157,58,23.008849557522122,6
Category_Wikipedia_sockpuppets_of_Mark_de_Bruggie.csv,29,836.0,10,19,6,4,0,51.51724137931034,186,25,17.413793103448278,13
Category_Wikipedia_sockpuppets_of_Brian_K_Horton.csv,1553,109350617.0,510,1043,119,391,0,54.461043142305215,494,62,31.69800386349002,10
Category_Wikipedia_sockpuppets_of_Ankitm7.csv,351,72565433.0,76,275,20,56,0,42.934472934472936,233,48,16.811965811965813,5
Category_Wikipedia_sockpuppets_of_Hytioplion.csv,274,237483.0,121,153,21,100,0,49.916058394160586,216,25,15.521897810218977,8
Category_Wikipedia_sockpuppets_of_NYC.Geek.csv,1052,185596261.0,379,673,282,97,0,51.06083650190114,275,62,19.50380228136882,7
Category_Wikipedia_sockpuppets_of_Backlook.csv,1013,32533986.0,442,571,312,130,0,30.43040473840079,250,42,15.082922013820335,5
Category_Wikipedia_sockpuppets_of_Surasaman.csv,3313,178655986.0,1008,2305,500,508,0,55.12647147600362,250,63,20.441895562933897,3
Category_Wikipedia_sockpuppets_of_Maxxheth.csv,119,93402563.0,50,69,34,16,0,40.91596638655462,255,51,25.34453781512605,4
Category_Wikipedia_sockpuppets_of_Adilbekkazykhanov.csv,32,6740672.0,12,20,9,3,0,87.34375,255,18,14.0625,6
Category_Wikipedia_sockpuppets_of_Hibapiratistaa.csv,59,52162365.0,14,45,10,4,0,53.57627118644068,192,24,16.271186440677965,10
Category_Wikipedia_sockpuppets_of_Astrologist_praveen.csv,32,742900.0,17,15,9,8,0,47.875,240,39,24.875,13
Category_Wikipedia_sockpuppets_of_Wefindtalent4u.csv,22,699652.0,11,11,11,0,0,45.59090909090909,158,26,17.727272727272727,14
Category_Wikipedia_sockpuppets_of_Goodman09.csv,27,1255.0,15,12,11,4,0,61.629629629629626,178,18,13.296296296296296,8
Category_Wikipedia_sockpuppets_of_RS_7878.csv,37,3880716.0,14,23,8,6,0,68.5945945945946,285,25,11.378378378378379,5
Category_Wikipedia_sockpuppets_of_Knowledge1253.csv,570,13836209.0,322,248,260,62,0,31.828070175438597,298,28,18.9,8
Category_Wikipedia_sockpuppets_of_Dhananjay100.csv,4,144602.0,2,2,2,0,0,49.5,147,24,24.0,24
Category_Wikipedia_sockpuppets_of_Enrique94834.csv,4079,166853033.0,1249,2830,500,749,0,43.8636920813925,500,56,19.43907820544251,3
Category_Wikipedia_sockpuppets_of_Decemberboyl.csv,3119,23852549.0,1103,2016,478,625,0,31.571978198140428,490,63,21.27252324462969,4
Category_Wikipedia_sockpuppets_of_Milesian83.csv,309,151799270.0,83,226,76,7,0,49.53398058252427,255,37,20.116504854368934,4
Category_Wikipedia_sockpuppets_of_Medialove41.csv,843,122427956.0,323,520,223,100,0,38.43534994068802,395,39,16.252669039145907,4
Category_Wikipedia_sockpuppets_of_Kill_me_when_i_die.csv,3117,130942736.0,766,2351,469,297,0,36.049727301892844,251,71,19.301892845684954,3
Category_Wikipedia_sockpuppets_of_Invisiblehovercraft.csv,459,1402109.0,134,325,76,58,0,51.62527233115468,358,33,14.749455337690632,3
Category_Wikipedia_sockpuppets_of_Lilylike.csv,59,516457.0,21,38,20,1,0,52.54237288135593,220,9,7.389830508474576,5
Category_Wikipedia_sockpuppets_of_Tactjuda.csv,63,61281746.0,22,41,21,1,0,31.03174603174603,259,65,21.095238095238095,9
Category_Wikipedia_sockpuppets_of_Savedship99.csv,59,17503738.0,22,37,12,10,0,48.86440677966102,230,25,11.186440677966102,1
Category_Wikipedia_sockpuppets_of_Neptunemusic.csv,359,11393954.0,130,229,119,11,0,29.142061281337046,199,35,20.662952646239553,15
Category_Wikipedia_sockpuppets_of_Bradford.csv,1255,56796146.0,518,737,500,18,0,59.34422310756972,496,60,21.858964143426295,7
Category_Wikipedia_sockpuppets_of_Katine67.csv,4410,66304178.0,1447,2963,500,947,0,53.20907029478458,500,106,22.261224489795918,4
Category_Wikipedia_sockpuppets_of_WilmingMa.csv,83,49939598.0,26,57,22,4,0,54.24096385542169,206,59,19.42168674698795,5
Category_Wikipedia_sockpuppets_of_Judymiller2468.csv,45,134926.0,30,15,17,13,0,47.08888888888889,180,44,16.933333333333334,12
Category_Wikipedia_sockpuppets_of_Snakese.csv,473,1208653.0,168,305,98,70,0,42.38477801268499,199,61,23.621564482029598,1
Category_Wikipedia_sockpuppets_of_Ehinger222.csv,779,73579390.0,276,503,271,5,0,35.46469833119384,214,66,23.19640564826701,3
Category_Wikipedia_sockpuppets_of_BlueShrek.csv,1604,2568088.0,489,1115,472,17,0,33.614713216957604,226,81,22.336658354114714,9
Category_Wikipedia_sockpuppets_of_Chinakpradhan.csv,2232,2206143.0,880,1352,500,380,0,36.60931899641577,500,61,23.928763440860216,4
Category_Wikipedia_sockpuppets_of_Carboncapturer.csv,59,12516744.0,19,40,14,5,0,68.47457627118644,279,53,18.16949152542373,4
Category_Wikipedia_sockpuppets_of_‡∂¥‡∑É‡∑í‡∂≥‡∑î_‡∂ö‡∑è‡∑Ä‡∑í‡∂±‡∑ä‡∂Ø.csv,1809,377494937.0,396,1413,395,1,0,55.85737976782753,366,50,19.16196793808734,3
Category_Wikipedia_sockpuppets_of_NZSA.csv,31,56310965.0,13,18,6,7,0,41.45161290322581,163,53,30.0,14
Category_Wikipedia_sockpuppets_of_Fwamerson1302.csv,1057,72572614.0,439,618,245,194,0,36.22043519394513,254,47,23.2639545884579,4
Category_Wikipedia_sockpuppets_of_Erandhoxha.csv,14,55232275.0,5,9,3,2,0,60.714285714285715,206,25,18.5,11
Category_Wikipedia_sockpuppets_of_HannahBeth01.csv,6,37184130.0,2,4,1,1,0,31.833333333333332,68,23,17.0,11
Category_Wikipedia_sockpuppets_of_Zippy654.csv,208,83046524.0,79,129,60,19,0,46.11057692307692,208,54,21.504807692307693,3
Category_Wikipedia_sockpuppets_of_Magnuzseventh.csv,137,39030729.0,61,76,31,30,0,47.627737226277375,255,24,14.408759124087592,14
Category_Wikipedia_sockpuppets_of_Layla27.csv,2265,11736821.0,774,1491,500,274,0,38.16512141280353,220,54,14.139072847682119,3
Category_Wikipedia_sockpuppets_of_REmmet1984.csv,678,1802899.0,214,464,94,120,0,45.79203539823009,248,62,19.343657817109143,5
Category_Wikipedia_sockpuppets_of_Tomato3141592.csv,137,2598382.0,57,80,32,25,0,41.91240875912409,248,49,20.978102189781023,10
Category_Wikipedia_sockpuppets_of_Princeofdark07.csv,1992,5860354.0,665,1327,500,165,0,41.339859437751,227,55,15.186244979919678,4
Category_Wikipedia_sockpuppets_of_Jayhawk_of_Justice.csv,953,45250090.0,297,656,278,19,0,49.134312696747116,223,65,22.78174186778594,2
Category_Wikipedia_sockpuppets_of_Aureliabrownsalt.csv,10,1331.0,6,4,3,3,0,46.4,141,19,15.8,15
Category_Wikipedia_sockpuppets_of_Nightowlanime.csv,454,4522481.0,222,232,99,123,0,38.07929515418502,496,40,18.151982378854626,4
Category_Wikipedia_sockpuppets_of_Flameviper12.csv,3,215.0,2,1,2,0,0,8.666666666666666,13,42,28.666666666666668,22
Category_Wikipedia_sockpuppets_of_Tuntaszz.csv,77,3904056.0,22,55,11,11,0,64.51948051948052,417,42,14.974025974025974,4
Category_Wikipedia_sockpuppets_of_Constable_T.csv,16,2897.0,10,6,9,1,0,53.0625,177,11,11.0,11
Category_Wikipedia_sockpuppets_of_UnFoldU-_Learning_App.csv,1,0.0,1,0,1,0,196,196.0,196,29,29.0,29
Category_Wikipedia_sockpuppets_of_MyTuppence.csv,1581,11743561.0,513,1068,500,13,0,46.555344718532574,255,75,18.273877292852625,2
Category_Wikipedia_sockpuppets_of_Antibaskin.csv,229,165012688.0,94,135,86,8,0,43.81222707423581,230,27,20.200873362445414,15
Category_Wikipedia_sockpuppets_of_OscarWongLara1999.csv,1852,53547431.0,573,1279,500,73,0,41.83855291576674,500,63,25.63876889848812,8
Category_Wikipedia_sockpuppets_of_Shalom_Yechiel.csv,5728,232949567.0,2071,3657,500,1571,0,45.99127094972067,255,102,24.87866620111732,3
Category_Wikipedia_sockpuppets_of_Chuckcanton.csv,137,15114020.0,47,90,4,43,0,54.277372262773724,440,30,16.036496350364963,7
Category_Wikipedia_sockpuppets_of_Abd.csv,1842,97851752.0,611,1231,500,111,0,60.13680781758958,250,76,22.819761129207382,4
Category_Wikipedia_sockpuppets_of_Eurobeerguide.csv,317,3286264.0,93,224,20,73,0,65.10094637223975,215,52,16.684542586750787,5
Category_Wikipedia_sockpuppets_of_Enormous_Efrit.csv,2259,18888831.0,729,1530,500,229,0,67.48915449313856,378,83,21.218238158477202,3
Category_Wikipedia_sockpuppets_of_Matthewminton.csv,1814,8182393.0,540,1274,173,367,0,15.802094818081587,255,41,19.02590959206174,17
Category_Wikipedia_sockpuppets_of_Atelier-KaRo.csv,54,367323.0,40,14,37,3,0,39.7962962962963,220,45,19.35185185185185,6
Category_Wikipedia_sockpuppets_of_Rafinha10Ano.csv,528,9062726.0,130,398,95,35,0,51.03598484848485,353,45,15.719696969696969,4
Category_Wikipedia_sockpuppets_of_SteveJohnson1.csv,76,18714626.0,31,45,9,22,0,36.94736842105263,217,58,23.38157894736842,10
Category_Wikipedia_sockpuppets_of_Sayan_Basu.csv,329,50303511.0,120,209,43,77,0,44.8419452887538,247,46,15.404255319148936,8
Category_Wikipedia_sockpuppets_of_Runningibis.csv,1921,18833851.0,923,998,500,423,0,37.700156168662154,435,86,19.27693909422176,7
Category_Wikipedia_sockpuppets_of_Nvidiafan58.csv,511,6044313.0,229,282,158,71,0,43.9041095890411,465,65,22.637964774951076,5
Category_Wikipedia_sockpuppets_of_Zimm82.csv,1824,5864155.0,549,1275,500,49,0,52.50219298245614,375,62,25.32949561403509,5
Category_Wikipedia_sockpuppets_of_Boongalings.csv,926,27477033.0,310,616,201,109,0,34.611231101511876,278,53,19.788336933045358,4
Category_Wikipedia_sockpuppets_of_Whiskyrum1852.csv,33,5242456.0,25,8,16,9,0,30.151515151515152,209,33,19.545454545454547,14
Category_Wikipedia_sockpuppets_of_MoviesOnDemand.csv,61,89642.0,42,19,35,7,0,25.688524590163933,190,51,23.65573770491803,12
Category_Wikipedia_sockpuppets_of_Teddycom.csv,1060,274600042.0,212,848,197,15,0,49.152830188679246,258,61,14.813207547169812,3
Category_Wikipedia_sockpuppets_of_Politics555.csv,330,224233921.0,117,213,116,1,0,51.06666666666667,256,51,34.86363636363637,14
Category_Wikipedia_sockpuppets_of_EFL_Edit.csv,5234,70748097.0,1660,3574,500,1160,0,48.92873519296905,417,81,19.55043943446695,3
Category_Wikipedia_sockpuppets_of_Michael_Anthony_M.csv,15,1118240.0,7,8,3,4,0,49.06666666666667,196,28,21.4,10
Category_Wikipedia_sockpuppets_of_NickolasGameiro95.csv,367,31641096.0,125,242,63,62,0,39.880108991825615,255,90,22.572207084468666,6
Category_Wikipedia_sockpuppets_of_FDR.csv,1770,276098928.0,522,1248,500,22,0,44.05593220338983,253,56,16.38813559322034,3
Category_Wikipedia_sockpuppets_of_Corticopia.csv,1480,67004364.0,500,980,500,0,0,56.314189189189186,224,65,18.73310810810811,4
Category_Wikipedia_sockpuppets_of_Stefan_Zev.csv,34,8210236.0,13,21,7,6,0,43.411764705882355,192,22,18.11764705882353,11
Category_Wikipedia_sockpuppets_of_Baytete.csv,286,2515598.0,119,167,84,35,0,50.76223776223776,255,43,16.353146853146853,5
Category_Wikipedia_sockpuppets_of_WI_MANAGER_KI.csv,60,24375510.0,19,41,14,5,0,35.21666666666667,143,38,18.183333333333334,7
Category_Wikipedia_sockpuppets_of_Blscholljim.csv,2314,17281497.0,810,1504,119,691,0,38.998703543647366,500,70,22.010803802938636,4
Category_Wikipedia_sockpuppets_of_Colombianpubliclawcontributor..csv,466,156195740.0,168,298,159,9,0,50.15450643776824,401,66,17.474248927038627,6
Category_Wikipedia_sockpuppets_of_Serpentdove.csv,704,1242302.0,211,493,200,11,0,53.10653409090909,224,50,17.224431818181817,6
Category_Wikipedia_sockpuppets_of_Raymond_Francis.csv,86,176086.0,31,55,30,1,0,43.74418604651163,199,25,18.302325581395348,11
Category_Wikipedia_sockpuppets_of_MetalShark.csv,359,357280.0,147,212,111,36,0,49.90807799442897,210,30,16.18941504178273,8
Category_Wikipedia_sockpuppets_of_Ianassaleem.csv,28,6783434.0,11,17,8,3,0,51.92857142857143,199,25,15.357142857142858,10
Category_Wikipedia_sockpuppets_of_Buggadugga.csv,278,33768390.0,99,179,85,14,0,42.276978417266186,225,54,20.794964028776977,7
Category_Wikipedia_sockpuppets_of_WeLoveKredible.csv,14,84014.0,5,9,3,2,0,64.21428571428571,175,53,37.857142857142854,21
Category_Wikipedia_sockpuppets_of_Arty8731.csv,56,7395610.0,26,30,20,6,4,72.16071428571429,255,48,18.660714285714285,16
Category_Wikipedia_sockpuppets_of_Jinodare.csv,476,8108438.0,163,313,137,26,0,34.464285714285715,239,40,15.086134453781513,4
Category_Wikipedia_sockpuppets_of_Brave_warrior.csv,1950,60111164.0,520,1430,500,20,0,43.67897435897436,219,73,19.264615384615386,3
Category_Wikipedia_sockpuppets_of_Markdabeast1.csv,122,77527362.0,46,76,28,18,0,40.377049180327866,256,27,15.754098360655737,7
Category_Wikipedia_sockpuppets_of_Anna_Bauer2019.csv,78,4747516.0,25,53,15,10,0,40.41025641025641,326,23,11.384615384615385,3
Category_Wikipedia_sockpuppets_of_RussianDewey.csv,2098,161871158.0,672,1426,500,172,0,45.74022878932316,370,60,21.0371782650143,4
"Category_Wikipedia_sockpuppets_of_Rasputin,_Grigoriy_Yefimovich.csv",73,919553.0,28,45,14,14,0,62.73972602739726,228,65,29.71232876712329,20
Category_Wikipedia_sockpuppets_of_The_Middle_East_Conflict_Man.csv,891,20731357.0,332,559,227,105,0,34.7037037037037,189,38,17.028058361391693,5
Category_Wikipedia_sockpuppets_of_Andreisme.csv,3914,106735124.0,819,3095,500,319,0,45.557230454777724,233,59,16.803270311701585,1
Category_Wikipedia_sockpuppets_of_JJ_25.csv,856,41477209.0,252,604,237,15,0,58.88785046728972,492,60,23.380841121495326,5
Category_Wikipedia_sockpuppets_of_Mgmllc.csv,45,69079478.0,16,29,16,0,0,46.48888888888889,184,34,19.533333333333335,13
Category_Wikipedia_sockpuppets_of_Ua7r.csv,1376,90753111.0,476,900,209,267,0,39.338662790697676,372,55,15.359011627906977,4
Category_Wikipedia_sockpuppets_of_Hatashe.csv,1528,279181588.0,555,973,500,55,0,46.70026178010471,255,61,15.55693717277487,3
Category_Wikipedia_sockpuppets_of_Sajib_aust.csv,499,2779159.0,292,207,259,33,0,28.55511022044088,234,38,15.635270541082164,5
Category_Wikipedia_sockpuppets_of_Clinical_&_Experimental_Cardiology.csv,8,270141.0,7,1,3,4,0,30.0,140,44,29.125,14
Category_Wikipedia_sockpuppets_of_Dahiya1208.csv,1433,60463396.0,515,918,294,221,0,41.179344033496164,306,60,16.256803907885555,4
Category_Wikipedia_sockpuppets_of_Hungamastart.csv,12,43589328.0,4,8,3,1,0,48.75,142,22,19.416666666666668,18
Category_Wikipedia_sockpuppets_of_Ap063gang.csv,3753,10822847.0,1107,2646,500,607,0,47.39301891819878,500,73,16.551025845989876,3
Category_Wikipedia_sockpuppets_of_Melaninmedianetwork.csv,72,15445923.0,39,33,33,6,0,54.013888888888886,238,29,14.333333333333334,13
Category_Wikipedia_sockpuppets_of_Buddhakahika.csv,8430,290319638.0,2338,6092,500,1838,0,43.90723606168446,389,57,11.510913404507711,3
Category_Wikipedia_sockpuppets_of_Mujtuba_rox.csv,81,18696105.0,34,47,8,26,0,49.71604938271605,251,44,21.234567901234566,13
Category_Wikipedia_sockpuppets_of_Yoda9234nl4.csv,26,705.0,14,12,7,7,0,51.57692307692308,189,15,12.576923076923077,12
Category_Wikipedia_sockpuppets_of_SchnitzelMannGreek.csv,2067,20695068.0,687,1380,500,187,0,53.56942428640542,255,62,21.65166908563135,3
Category_Wikipedia_sockpuppets_of_Aniflower.csv,884,226985376.0,266,618,67,199,0,55.35746606334842,468,53,17.53846153846154,5
Category_Wikipedia_sockpuppets_of_Kzrulzuall36.csv,52,899.0,13,39,5,8,0,58.23076923076923,182,28,15.346153846153847,4
Category_Wikipedia_sockpuppets_of_Bhoonadnan.csv,1329,4222287.0,415,914,284,131,0,49.20316027088036,500,41,14.47479307750188,3
Category_Wikipedia_sockpuppets_of_Lincolnlover2005.csv,282,28086555.0,88,194,84,4,0,47.06382978723404,313,50,22.78368794326241,7
Category_Wikipedia_sockpuppets_of_Steven0306.csv,738,48110495.0,195,543,126,69,0,43.55691056910569,308,49,24.712737127371273,4
Category_Wikipedia_sockpuppets_of_SunitaDev.csv,19,96420.0,15,4,13,2,0,18.31578947368421,149,25,25.0,25
Category_Wikipedia_sockpuppets_of_Illume1999.csv,606,22527050.0,241,365,236,5,0,52.92574257425743,250,51,13.372937293729374,4
Category_Wikipedia_sockpuppets_of_DangerMouse1234567890.csv,182,1241686.0,80,102,22,58,0,52.64835164835165,265,31,16.74175824175824,3
Category_Wikipedia_sockpuppets_of_Wikip45345.csv,19,2736407.0,8,11,4,4,0,49.31578947368421,196,23,16.157894736842106,12
Category_Wikipedia_sockpuppets_of_Olumideakinsola.csv,265,46401090.0,74,191,48,26,0,46.64905660377359,228,63,17.132075471698112,5
Category_Wikipedia_sockpuppets_of_Proghazalsrinivas.csv,69,19675904.0,50,19,27,23,0,24.347826086956523,196,22,16.08695652173913,15
Category_Wikipedia_sockpuppets_of_Acki90.csv,49,12681485.0,18,31,3,15,0,45.795918367346935,231,22,22.0,22
Category_Wikipedia_sockpuppets_of_Justicequalmodern.csv,686,7416459.0,229,457,136,93,0,50.10787172011662,313,37,14.392128279883382,6
Category_Wikipedia_sockpuppets_of_Biaswarrior.csv,262,4336431.0,80,182,35,45,0,43.69083969465649,199,94,32.83206106870229,8
Category_Wikipedia_sockpuppets_of_Ben_Mandelson.csv,633,47803269.0,294,339,244,50,0,42.0,392,64,18.51658767772512,6
Category_Wikipedia_sockpuppets_of_Mildred_huxtetter.csv,5146,53579951.0,1378,3768,135,1243,0,46.88534784298484,394,75,17.647881849980568,1
Category_Wikipedia_sockpuppets_of_Gwapong_Chikoy.csv,701,20953707.0,311,390,286,25,0,48.00285306704708,500,49,22.00713266761769,5
Category_Wikipedia_sockpuppets_of_Migssant19.csv,693,10698807.0,316,377,314,2,0,24.551226551226552,205,58,26.457431457431458,8
Category_Wikipedia_sockpuppets_of_Passionless.csv,3411,50180772.0,945,2466,500,445,0,51.36734095573146,255,75,28.210788625036646,2
Category_Wikipedia_sockpuppets_of_The_Solutrean.csv,37,6053838.0,9,28,8,1,0,85.56756756756756,255,57,23.83783783783784,10
Category_Wikipedia_sockpuppets_of_Adam_levine_ian_bagg.csv,338,7548364.0,121,217,117,4,0,21.21005917159763,224,49,16.06508875739645,5
Category_Wikipedia_sockpuppets_of_Aman.kumar.goel.csv,3330,13261851.0,1000,2330,500,500,0,61.13663663663664,497,102,24.541441441441442,4
Category_Wikipedia_sockpuppets_of_GTA5Player.csv,1104,170254556.0,376,728,159,217,0,62.90036231884058,500,48,17.622282608695652,3
Category_Wikipedia_sockpuppets_of_R-41.csv,1428,106877635.0,518,910,500,18,0,55.65196078431372,255,47,19.42997198879552,4
Category_Wikipedia_sockpuppets_of_Elijah_Youngblood.csv,751,45771194.0,257,494,207,50,0,49.78695073235686,286,43,16.93475366178429,4
Category_Wikipedia_sockpuppets_of_BRODEINE.csv,233,13322559.0,97,136,20,77,0,33.047210300429185,307,37,13.15450643776824,4
Category_Wikipedia_sockpuppets_of_Heymid.csv,1883,9147835.0,567,1316,500,67,0,50.236325013276684,355,59,19.344662772172065,4
Category_Wikipedia_sockpuppets_of_Yashswami_94.csv,20,64885.0,9,11,6,3,0,41.1,195,18,13.45,8
Category_Wikipedia_sockpuppets_of_Leveque.csv,526,83680099.0,217,309,195,22,0,36.547528517110266,199,37,14.587452471482889,9
Category_Wikipedia_sockpuppets_of_Stephen_Budd_Management.csv,31,24193753.0,10,21,8,2,0,16.387096774193548,97,55,35.70967741935484,11
Category_Wikipedia_sockpuppets_of_Jayce909.csv,50,31092552.0,11,39,6,5,0,61.76,232,33,20.74,6
Category_Wikipedia_sockpuppets_of_OrangeSkunk.csv,370,625947.0,113,257,76,37,0,49.4,241,54,23.943243243243245,5
Category_Wikipedia_sockpuppets_of_SummerThunder.csv,2370,32701931.0,647,1723,500,147,0,39.75105485232068,219,64,25.557383966244725,4
Category_Wikipedia_sockpuppets_of_ArjunachuAk.csv,25,602979.0,19,6,15,4,0,25.44,223,22,10.68,5
Category_Wikipedia_sockpuppets_of_767-249ER.csv,235,42052493.0,104,131,63,41,0,36.39148936170213,196,38,19.817021276595746,11
Category_Wikipedia_sockpuppets_of_Kutlovci.csv,130,8563795.0,50,80,30,20,0,70.93076923076923,500,57,17.923076923076923,4
Category_Wikipedia_sockpuppets_of_Bailey_Rae.csv,97,8457453.0,36,61,32,4,0,52.54639175257732,196,53,24.556701030927837,13
Category_Wikipedia_sockpuppets_of_RicardoSadik.csv,164,29139421.0,72,92,63,9,0,41.76829268292683,378,26,19.591463414634145,10
Category_Wikipedia_sockpuppets_of_DrSolomonJones.csv,9,17451.0,7,2,5,2,0,69.66666666666667,163,50,27.444444444444443,21
Category_Wikipedia_sockpuppets_of_Joe.marotta.csv,29,17998.0,22,7,19,3,0,35.51724137931034,196,24,21.06896551724138,19
Category_Wikipedia_sockpuppets_of_IHR.HIASO.csv,17,168094.0,10,7,7,3,0,50.88235294117647,151,22,12.294117647058824,9
Category_Wikipedia_sockpuppets_of_EOLE79.csv,723,31923497.0,236,487,165,71,0,53.208852005532506,436,47,17.421853388658366,1
Category_Wikipedia_sockpuppets_of_Ibrahima.iyane.thiam.csv,21,3045243.0,17,4,13,4,0,24.333333333333332,110,30,26.38095238095238,19
Category_Wikipedia_sockpuppets_of_Aisha9152.csv,2385,447919908.0,664,1721,500,164,0,50.42767295597484,352,95,23.49853249475891,3
Category_Wikipedia_sockpuppets_of_VivekY1.csv,621,19378140.0,237,384,104,133,0,39.65378421900161,271,66,17.412238325281802,5
Category_Wikipedia_sockpuppets_of_Harrywils.csv,7,81037.0,5,2,2,3,0,56.0,140,48,48.0,48
Category_Wikipedia_sockpuppets_of_Theonlynitin.csv,1581,298414832.0,542,1039,500,42,0,46.40607210626186,376,51,16.900063251106893,5
Category_Wikipedia_sockpuppets_of_Spotteddogsdotorg.csv,1267,3442924.0,500,767,500,0,0,20.90765588003157,200,73,21.363851617995266,3
Category_Wikipedia_sockpuppets_of_Coraopolis412.csv,88,29136.0,47,41,36,11,0,40.52272727272727,196,57,30.454545454545453,8
Category_Wikipedia_sockpuppets_of_Onurhan_Homri≈ü.csv,9,1274572.0,4,5,3,1,0,67.0,205,26,25.11111111111111,24
Category_Wikipedia_sockpuppets_of_Sekk-47.csv,488,9585915.0,223,265,105,118,0,38.15983606557377,439,36,13.184426229508198,5
Category_Wikipedia_sockpuppets_of_Xbajs00.csv,40,2678425.0,15,25,6,9,0,59.2,227,44,27.15,14
Category_Wikipedia_sockpuppets_of_Alimuzaffa22.csv,70,22457563.0,59,11,26,33,0,29.957142857142856,244,22,16.814285714285713,16
Category_Wikipedia_sockpuppets_of_TheCreator5874.csv,15,75578.0,3,12,3,0,19,32.733333333333334,81,18,18.0,18
Category_Wikipedia_sockpuppets_of_FierakuiV√´rtet.csv,1706,52042784.0,510,1196,500,10,0,59.859906213364596,489,52,15.163540445486518,4
Category_Wikipedia_sockpuppets_of_PowerYouTubeYT.csv,23,525917.0,9,14,9,0,0,54.17391304347826,154,23,12.521739130434783,6
Category_Wikipedia_sockpuppets_of_Ssentif.csv,135,525441.0,51,84,32,19,0,57.785185185185185,250,42,20.666666666666668,11
Category_Wikipedia_sockpuppets_of_JacksonAnderson1234.csv,47,140582.0,23,24,12,11,0,49.787234042553195,196,45,24.21276595744681,7
Category_Wikipedia_sockpuppets_of_RoyalKnights3000.csv,1781,8012311.0,738,1043,500,238,0,38.074677147669846,494,63,15.971364402021337,6
Category_Wikipedia_sockpuppets_of_Billmcbride52.csv,9,103358.0,8,1,3,5,0,21.444444444444443,161,42,42.0,42
Category_Wikipedia_sockpuppets_of_Historian_Student.csv,304,13118958.0,113,191,72,41,0,58.17434210526316,255,54,17.832236842105264,5
Category_Wikipedia_sockpuppets_of_Craig_mack378.csv,61,5830824.0,22,39,14,8,0,39.01639344262295,172,53,32.0655737704918,11
Category_Wikipedia_sockpuppets_of_Swan1111.csv,131,34091693.0,49,82,45,4,0,46.717557251908396,196,48,27.15267175572519,16
Category_Wikipedia_sockpuppets_of_Chernenkaya.csv,213,36894305.0,86,127,22,64,0,44.028169014084504,250,52,25.187793427230048,7
Category_Wikipedia_sockpuppets_of_DanFord2.csv,108,2931164.0,81,27,81,0,0,40.157407407407405,189,32,22.27777777777778,15
Category_Wikipedia_sockpuppets_of_Valleriani.csv,80,477962536.0,16,64,16,0,0,47.35,226,20,11.5,10
Category_Wikipedia_sockpuppets_of_Tser83.csv,50,396038.0,18,32,2,16,0,37.3,169,22,15.0,10
Category_Wikipedia_sockpuppets_of_ItsDerriz.csv,461,2471342.0,174,287,114,60,0,48.66377440347072,500,43,20.59652928416486,5
Category_Wikipedia_sockpuppets_of_Philphleg.csv,633,61593707.0,266,367,186,80,0,42.6129541864139,409,56,15.78041074249605,4
Category_Wikipedia_sockpuppets_of_Anti_Scamer.csv,16,792.0,7,9,3,4,0,67.125,133,17,13.25,12
Category_Wikipedia_sockpuppets_of_Ripsonpaulman.csv,68,350282.0,17,51,10,7,0,51.05882352941177,225,27,10.75,3
Category_Wikipedia_sockpuppets_of_Jenkim0918.csv,15,1391085.0,12,3,5,7,0,41.2,172,9,9.0,9
Category_Wikipedia_sockpuppets_of_Nickelodeon1990.csv,253,1758652.0,72,181,49,23,0,37.49802371541502,241,51,29.57707509881423,9
Category_Wikipedia_sockpuppets_of_Theyoungeditor123.csv,111,708213.0,51,60,22,29,0,40.85585585585586,220,52,23.135135135135137,12
Category_Wikipedia_sockpuppets_of_Ransu601.csv,503,209236733.0,188,315,79,109,0,46.39363817097416,310,44,20.359840954274354,9
Category_Wikipedia_sockpuppets_of_GoldGoldee.csv,5,744.0,5,0,5,0,0,60.2,174,23,16.6,15
Category_Wikipedia_sockpuppets_of_Elie_El_Hajj.csv,502,97072872.0,213,289,127,86,0,34.233067729083665,510,46,24.794820717131476,10
Category_Wikipedia_sockpuppets_of_PipalukTan.csv,1,0.0,1,0,1,0,196,196.0,196,15,15.0,15
Category_Wikipedia_sockpuppets_of_BrightR.csv,4025,281415674.0,1096,2929,500,596,0,57.43900621118012,421,83,24.85639751552795,2
Category_Wikipedia_sockpuppets_of_Chichichihua.csv,243,1688981.0,58,185,36,22,0,48.22633744855967,193,50,31.31275720164609,6
Category_Wikipedia_sockpuppets_of_VacuousPoet.csv,1328,35699070.0,529,799,500,29,0,46.371234939759034,217,64,33.31551204819277,10
Category_Wikipedia_sockpuppets_of_Miyokan.csv,1763,4044674.0,500,1263,500,0,0,46.74985819625638,220,90,26.12024957458877,4
Category_Wikipedia_sockpuppets_of_Callum_Sannachan.csv,106,3121221.0,50,56,28,22,0,38.990566037735846,227,36,23.00943396226415,16
Category_Wikipedia_sockpuppets_of_Erytgeryrtyt.csv,9,1219221.0,5,4,2,3,0,39.22222222222222,139,24,17.333333333333332,12
Category_Wikipedia_sockpuppets_of_1987sagarkaul.csv,83,27748.0,46,37,31,15,0,38.493975903614455,208,28,12.91566265060241,4
Category_Wikipedia_sockpuppets_of_Nikhilbarlow.csv,1,0.0,1,0,1,0,56,56.0,56,26,26.0,26
Category_Wikipedia_sockpuppets_of_Accor19.csv,22,463054.0,15,7,6,9,0,136.86363636363637,199,12,10.636363636363637,10
Category_Wikipedia_sockpuppets_of_Slangfield.csv,22,1785704.0,15,7,14,1,0,57.09090909090909,194,22,21.545454545454547,20
Category_Wikipedia_sockpuppets_of_BarkBarkDotCom.csv,185,937626.0,88,97,68,20,0,37.21081081081081,227,33,18.65945945945946,8
Category_Wikipedia_sockpuppets_of_Wikieditor3707.csv,1361,18682331.0,490,871,432,58,0,36.89786921381337,500,46,20.104335047759,5
Category_Wikipedia_sockpuppets_of_Everyandous.csv,70,2754881.0,39,31,17,22,0,35.94285714285714,176,50,24.62857142857143,4
Category_Wikipedia_sockpuppets_of_Josh_Reiner.csv,53,20818531.0,31,22,30,1,0,40.320754716981135,206,47,18.0188679245283,13
Category_Wikipedia_sockpuppets_of_Socratis1978.csv,9,98548.0,6,3,5,1,0,46.888888888888886,170,15,15.0,15
Category_Wikipedia_sockpuppets_of_Jewdefence.csv,15,605.0,4,11,4,0,13,38.46666666666667,96,55,42.46666666666667,19
Category_Wikipedia_sockpuppets_of_Haremuusamah10.csv,31,27454104.0,12,19,12,0,13,75.25806451612904,199,24,15.516129032258064,10
Category_Wikipedia_sockpuppets_of_DogsHeadFalls.csv,624,8387907.0,242,382,67,175,0,52.693910256410255,249,77,18.267628205128204,7
Category_Wikipedia_sockpuppets_of_Elena_Tsaranova.csv,234,68389873.0,66,168,29,37,0,61.00854700854701,253,60,17.61111111111111,4
Category_Wikipedia_sockpuppets_of_Morderngoogle.csv,110,74742752.0,46,64,27,19,0,43.1,315,20,11.481818181818182,5
Category_Wikipedia_sockpuppets_of_AllisonRush.csv,10,108684.0,6,4,4,2,23,83.0,189,33,24.0,18
Category_Wikipedia_sockpuppets_of_RijonKhan.csv,194,54156875.0,101,93,100,1,0,48.20103092783505,255,42,17.47938144329897,9
Category_Wikipedia_sockpuppets_of_Mealwaysrockz007.csv,2104,24489735.0,620,1484,110,510,0,45.254752851711025,255,54,16.226235741444867,3
Category_Wikipedia_sockpuppets_of_Grangepark31.csv,9,240740.0,4,5,3,1,10,71.33333333333333,254,19,19.0,19
Category_Wikipedia_sockpuppets_of_AceGB.csv,102,3774997.0,36,66,20,16,0,52.970588235294116,221,54,23.57843137254902,11
Category_Wikipedia_sockpuppets_of_What_is_this_username_.csv,480,5505662.0,145,335,144,1,0,58.38125,496,48,21.389583333333334,3
Category_Wikipedia_sockpuppets_of_Johniscool3.csv,34,695187.0,25,9,15,10,0,39.23529411764706,162,49,15.5,12
Category_Wikipedia_sockpuppets_of_Vikramkarikalan.csv,159,5859855.0,70,89,67,3,0,36.45283018867924,306,25,21.22012578616352,20
Category_Wikipedia_sockpuppets_of_Bogbuster.csv,458,319801851.0,145,313,119,26,0,45.48689956331878,255,61,19.27947598253275,4
Category_Wikipedia_sockpuppets_of_Straightgrain.csv,3,10341.0,2,1,1,1,21,35.666666666666664,61,47,47.0,47
Category_Wikipedia_sockpuppets_of_Francespennysworth11.csv,36,6222.0,35,1,11,24,0,27.416666666666668,229,30,30.0,30
Category_Wikipedia_sockpuppets_of_Ffdsajkl101.csv,128,5992552.0,41,87,14,27,0,53.7265625,219,17,12.2265625,7
Category_Wikipedia_sockpuppets_of_DavidPatrick70.csv,248,27706499.0,92,156,37,55,0,47.068548387096776,253,38,20.907258064516128,9
Category_Wikipedia_sockpuppets_of_Thespeedoflightneverchanges.csv,344,53283842.0,102,242,71,31,0,49.84593023255814,417,65,36.3343023255814,10
Category_Wikipedia_sockpuppets_of_Blahhhas.csv,441,105082270.0,111,330,47,64,0,46.580498866213155,255,55,19.90702947845805,9
Category_Wikipedia_sockpuppets_of_Kuntan.csv,1254,48563286.0,373,881,209,164,0,34.16347687400319,200,84,21.672248803827753,4
Category_Wikipedia_sockpuppets_of_Itzyecr.csv,37,1267267.0,16,21,11,5,0,48.054054054054056,280,28,15.08108108108108,9
Category_Wikipedia_sockpuppets_of_DominatedBeast321.csv,1396,165479177.0,519,877,500,19,0,41.0823782234957,337,36,15.156160458452723,7
Category_Wikipedia_sockpuppets_of_Keirtheweird.csv,24,257729.0,8,16,6,2,0,63.708333333333336,230,27,15.375,9
Category_Wikipedia_sockpuppets_of_PantherMan.csv,2201,63622274.0,623,1578,500,123,0,42.288959563834624,501,66,22.169922762380736,3
Category_Wikipedia_sockpuppets_of_Arnold_In_The_Shadows_7.0.csv,90,3102304.0,30,60,12,18,0,59.56666666666667,255,45,24.92222222222222,9
Category_Wikipedia_sockpuppets_of_Bluebellcrook.csv,2,88.0,2,0,2,0,0,14.5,29,17,17.0,17
Category_Wikipedia_sockpuppets_of_Blake_Reinken.csv,1030,7085158.0,470,560,458,12,0,28.2,216,50,26.03009708737864,5
Category_Wikipedia_sockpuppets_of_RogerMooreArm.csv,73,1375267.0,29,44,21,8,0,30.753424657534246,196,33,9.054794520547945,6
Category_Wikipedia_sockpuppets_of_Theeasytarget.csv,468,3880523.0,223,245,150,73,0,63.465811965811966,255,35,16.927350427350426,8
Category_Wikipedia_sockpuppets_of_Abdullsaed.csv,1692,11072763.0,594,1098,458,136,0,47.32387706855792,255,67,18.05673758865248,2
Category_Wikipedia_sockpuppets_of_Vishnu_Tiwari_Vines.csv,2,0.0,1,1,1,0,0,0.0,0,53,53.0,53
Category_Wikipedia_sockpuppets_of_Ligerblack.csv,22,28545.0,7,15,4,3,0,72.04545454545455,161,20,13.545454545454545,9
Category_Wikipedia_sockpuppets_of_User_Norlns22.csv,18,168290.0,13,5,13,0,0,56.166666666666664,175,25,17.055555555555557,8
Category_Wikipedia_sockpuppets_of_Sjcmdk.csv,48,1420479.0,23,25,11,12,0,22.666666666666668,196,43,24.375,15
Category_Wikipedia_sockpuppets_of_AliBakr.csv,20,729004.0,15,5,3,12,0,37.65,189,11,11.0,11
Category_Wikipedia_sockpuppets_of_Suryoyutho.csv,291,9143396.0,78,213,64,14,0,64.66323024054982,398,59,17.810996563573884,4
Category_Wikipedia_sockpuppets_of_Richboy45.csv,90,4926676.0,25,65,24,1,0,45.766666666666666,239,19,13.266666666666667,7
Category_Wikipedia_sockpuppets_of_Josepdavidana.csv,72,6954911.0,61,11,49,12,0,22.52777777777778,248,13,13.0,13
Category_Wikipedia_sockpuppets_of_Papa2004.csv,847,83245943.0,319,528,33,286,0,44.09445100354191,491,65,18.08736717827627,4
Category_Wikipedia_sockpuppets_of_JJPennyson.csv,42,9354.0,16,26,14,2,0,31.333333333333332,199,76,52.904761904761905,36
Category_Wikipedia_sockpuppets_of_Sirhan_Kennedy.csv,39,524677.0,13,26,7,6,0,23.102564102564102,134,25,19.974358974358974,8
Category_Wikipedia_sockpuppets_of_Consorveyapaaj2048394.csv,1671,8696752.0,494,1177,122,372,0,47.20227408737283,250,68,19.327348892878515,1
Category_Wikipedia_sockpuppets_of_Hiwatl.csv,1221,84925112.0,518,703,500,18,0,52.88615888615889,312,65,24.272727272727273,5
Category_Wikipedia_sockpuppets_of_Mediapartner111.csv,17,10675414.0,6,11,5,1,0,24.529411764705884,89,28,23.58823529411765,17
Category_Wikipedia_sockpuppets_of_Infinity_Knight.csv,1438,3328534.0,501,937,500,1,0,52.246870653685676,484,61,27.08066759388039,4
Category_Wikipedia_sockpuppets_of_Tamilvj883889.csv,46,9912656.0,29,17,28,1,0,18.956521739130434,208,26,15.891304347826088,13
Category_Wikipedia_sockpuppets_of_Zaydbinumar.csv,1088,289620722.0,423,665,421,2,0,55.92830882352941,451,67,19.801470588235293,10
Category_Wikipedia_sockpuppets_of_Ilovenayarivera.csv,65,71520.0,26,39,23,3,0,45.15384615384615,230,25,14.2,11
Category_Wikipedia_sockpuppets_of_Drnsr.csv,174,168848174.0,50,124,46,4,0,52.63793103448276,255,51,23.126436781609197,5
Category_Wikipedia_sockpuppets_of_BanyanClimber.csv,2133,36712128.0,634,1499,500,134,0,61.895921237693386,486,126,22.902015939990623,3
Category_Wikipedia_sockpuppets_of_Nate.stancil.csv,246,52010370.0,61,185,31,30,0,46.264227642276424,216,45,15.09349593495935,5
Category_Wikipedia_sockpuppets_of_JuiceGrind.csv,125,4514798.0,42,83,24,18,0,53.912,222,49,20.44,4
Category_Wikipedia_sockpuppets_of_Nikitha2007.csv,85,16913557.0,21,64,14,7,0,45.21176470588235,273,28,12.470588235294118,5
Category_Wikipedia_sockpuppets_of_Roxburgher.csv,496,23144088.0,254,242,139,115,0,26.883064516129032,233,58,25.756048387096776,8
Category_Wikipedia_sockpuppets_of_Upulvin_Dissanayaka.csv,4,9490083.0,3,1,2,1,13,49.0,157,44,31.5,19
Category_Wikipedia_sockpuppets_of_InfoOliviavonHalle.csv,26,3130.0,19,7,17,2,0,32.73076923076923,191,16,16.0,16
Category_Wikipedia_sockpuppets_of_Vaibhavedke.csv,129,8300943.0,40,89,34,6,0,53.18604651162791,316,53,25.108527131782946,8
Category_Wikipedia_sockpuppets_of_AdamSara2.csv,13,228063.0,11,2,6,5,0,43.0,136,7,7.0,7
Category_Wikipedia_sockpuppets_of_Jucelio_silva.csv,108,2860130.0,69,39,53,16,0,47.611111111111114,245,26,13.907407407407407,5
Category_Wikipedia_sockpuppets_of_Bet365aminul.csv,19,33004691.0,7,12,4,3,0,74.94736842105263,249,25,12.947368421052632,7
Category_Wikipedia_sockpuppets_of_Aqww.csv,173,13211615.0,54,119,39,15,0,58.79190751445087,500,54,14.358381502890174,5
Category_Wikipedia_sockpuppets_of_Neonnydreams.csv,303,7617061.0,83,220,27,56,0,35.32673267326733,252,60,18.07920792079208,3
Category_Wikipedia_sockpuppets_of_Irthpr.csv,365,5330733.0,144,221,125,19,0,35.09041095890411,199,50,20.835616438356166,10
Category_Wikipedia_sockpuppets_of_Historian_loverr.csv,164,8299825.0,52,112,39,13,0,60.8109756097561,287,50,23.579268292682926,10
Category_Wikipedia_sockpuppets_of_MfactDr.csv,1479,126871526.0,505,974,500,5,0,50.11899932386748,360,61,13.988505747126437,4
Category_Wikipedia_sockpuppets_of_SilentServine.csv,18,141.0,7,11,7,0,0,35.611111111111114,191,36,32.94444444444444,31
Category_Wikipedia_sockpuppets_of_Mailzzang+aus.csv,1828,198755183.0,673,1155,433,240,0,37.50984682713348,254,65,28.771334792122538,3
Category_Wikipedia_sockpuppets_of_Lucasbraden.csv,1,0.0,1,0,1,0,195,195.0,195,16,16.0,16
Category_Wikipedia_sockpuppets_of_Mathew_hopkins.csv,250,8580424.0,88,162,51,37,0,28.004,172,28,13.436,6
Category_Wikipedia_sockpuppets_of_SpadowskiStan.csv,113,105597824.0,45,68,45,0,0,48.60176991150443,252,49,19.13274336283186,9
Category_Wikipedia_sockpuppets_of_Pioneercourthouse.csv,1849,277214279.0,489,1360,46,443,0,47.74256354786371,254,54,20.987560843699296,3
Category_Wikipedia_sockpuppets_of_Suelica.csv,80,27922453.0,29,51,23,6,0,47.2,223,53,24.4875,8
Category_Wikipedia_sockpuppets_of_JDRL_Koala.csv,151,728635.0,43,108,25,18,0,39.384105960264904,231,43,20.211920529801326,6
Category_Wikipedia_sockpuppets_of_Llhhll.csv,52,17751261.0,19,33,12,7,0,42.11538461538461,253,23,10.75,7
Category_Wikipedia_sockpuppets_of_Mariagarciacs.csv,376,24975861.0,169,207,81,88,0,37.263297872340424,318,28,13.377659574468085,9
Category_Wikipedia_sockpuppets_of_Soltesh.csv,733,184604589.0,295,438,263,32,0,47.950886766712145,376,68,16.537517053206003,4
Category_Wikipedia_sockpuppets_of_HonorMT.csv,186,22653920.0,75,111,75,0,0,42.096774193548384,255,28,16.236559139784948,9
Category_Wikipedia_sockpuppets_of_BJ86.csv,473,14965021.0,139,334,137,2,0,34.53699788583509,283,40,17.818181818181817,6
Category_Wikipedia_sockpuppets_of_Gustavo_Pican√ßo.csv,694,8319336.0,190,504,119,71,0,54.221902017291065,430,46,14.822766570605188,7
Category_Wikipedia_sockpuppets_of_Adaveno.csv,152,7611726.0,58,94,13,45,0,69.66447368421052,243,54,18.539473684210527,6
Category_Wikipedia_sockpuppets_of_Alec_Smithson.csv,1431,50035493.0,637,794,500,137,0,41.48078266946192,255,58,19.609364081062193,5
Category_Wikipedia_sockpuppets_of_Boboy9.csv,4,9614.0,2,2,1,1,17,53.75,164,49,49.0,49
Category_Wikipedia_sockpuppets_of_Arishiakter.csv,350,61289877.0,91,259,31,60,0,51.98,500,65,29.434285714285714,12
Category_Wikipedia_sockpuppets_of_Proofficial.csv,19,3796650.0,4,15,4,0,23,53.36842105263158,92,53,41.94736842105263,23
Category_Wikipedia_sockpuppets_of_Dokosboy.csv,31,932331.0,21,10,10,11,0,41.903225806451616,230,39,25.516129032258064,25
Category_Wikipedia_sockpuppets_of_Coathangerabortion.csv,45,15462.0,27,18,24,3,11,47.6,218,29,21.555555555555557,18
Category_Wikipedia_sockpuppets_of_JameyKapuselusiepu.csv,7,6474.0,5,2,3,2,0,39.714285714285715,163,26,17.285714285714285,10
Category_Wikipedia_sockpuppets_of_81.117.200.27.csv,174,1952351.0,63,111,50,13,0,38.52298850574713,191,47,24.022988505747126,9
Category_Wikipedia_sockpuppets_of_Kaixeralvar.csv,237,4304250.0,80,157,33,47,0,29.455696202531644,255,59,31.18143459915612,9
Category_Wikipedia_sockpuppets_of_Helium402.csv,32,8995.0,20,12,14,6,0,60.15625,154,50,42.21875,14
Category_Wikipedia_sockpuppets_of_Khattab_Lord.csv,74,2007912.0,26,48,14,12,0,48.5,180,47,20.37837837837838,16
Category_Wikipedia_sockpuppets_of_Hemantthtm.csv,44,48433977.0,10,34,10,0,0,56.34090909090909,302,53,22.954545454545453,12
Category_Wikipedia_sockpuppets_of_BlueGoose.csv,2300,43035041.0,678,1622,500,178,0,32.79695652173913,242,85,22.67086956521739,4
Category_Wikipedia_sockpuppets_of_Burnsvillemike.csv,137,1421014.0,40,97,5,35,0,42.31386861313869,174,58,17.905109489051096,4
Category_Wikipedia_sockpuppets_of_Zabikn7.csv,268,1645565.0,85,183,85,0,0,36.6455223880597,255,75,19.496268656716417,6
Category_Wikipedia_sockpuppets_of_Footybloke.csv,35,3533373.0,13,22,5,8,0,65.2,292,29,21.228571428571428,9
Category_Wikipedia_sockpuppets_of_The_keymaker.csv,11,870178.0,6,5,6,0,0,24.09090909090909,199,20,18.90909090909091,17
Category_Wikipedia_sockpuppets_of_GreenTheWhite.csv,93,1530439.0,68,25,62,6,0,28.78494623655914,227,19,18.677419354838708,4
Category_Wikipedia_sockpuppets_of_Jeeya0211.csv,20,12186601.0,18,2,16,2,15,36.85,153,21,18.85,14
Category_Wikipedia_sockpuppets_of_An_Leuven.csv,59,7246305.0,45,14,37,8,0,25.45762711864407,148,19,15.474576271186441,14
Category_Wikipedia_sockpuppets_of_Smzainmustafa.csv,190,24942366.0,67,123,22,45,0,44.6,268,67,21.66315789473684,6
Category_Wikipedia_sockpuppets_of_White_American_2023.csv,640,2379948.0,233,407,140,93,0,47.9328125,500,71,19.98125,4
Category_Wikipedia_sockpuppets_of_Richardayoub.csv,23,605253.0,16,7,11,5,0,41.391304347826086,211,40,17.434782608695652,8
Category_Wikipedia_sockpuppets_of_Yasingip.csv,15,21426382.0,4,11,2,2,0,47.4,227,8,8.0,8
Category_Wikipedia_sockpuppets_of_Edwin_Qui√±ones_Rivera.csv,2,0.0,1,1,1,0,36,36.0,36,31,31.0,31
Category_Wikipedia_sockpuppets_of_Biuc.csv,604,5823842.0,181,423,54,127,0,38.99503311258278,464,77,27.08609271523179,10
Category_Wikipedia_sockpuppets_of_Kaleyaldrich.csv,4,50.0,4,0,4,0,0,14.75,31,22,22.0,22
Category_Wikipedia_sockpuppets_of_SadDamMadDam.csv,132,264077.0,56,76,27,29,0,28.40909090909091,168,43,18.53030303030303,7
Category_Wikipedia_sockpuppets_of_Oreilly90.csv,129,4928062.0,49,80,26,23,0,38.27131782945737,203,58,23.03875968992248,6
Category_Wikipedia_sockpuppets_of_Truthsayer62.csv,1496,186948411.0,518,978,500,18,0,60.285427807486634,254,57,21.86764705882353,5
Category_Wikipedia_sockpuppets_of_Hotors497F_.csv,550,97953202.0,249,301,249,0,0,36.334545454545456,368,28,19.747272727272726,13
Category_Wikipedia_sockpuppets_of_Jeuzreel_Villasante.csv,1118,27611419.0,441,677,87,354,0,27.06887298747764,255,33,16.811270125223615,6
Category_Wikipedia_sockpuppets_of_Paintballxtreme.csv,247,2781633.0,97,150,70,27,0,47.51417004048583,233,65,24.08502024291498,9
Category_Wikipedia_sockpuppets_of_Cartiman.csv,29,295540.0,12,17,9,3,0,58.93103448275862,139,34,23.896551724137932,10
Category_Wikipedia_sockpuppets_of_ZakBelch05WP.csv,2,8211.0,2,0,2,0,0,24.5,49,3,3.0,3
Category_Wikipedia_sockpuppets_of_Nirob_Sohel.csv,56,7172167.0,20,36,15,5,0,57.92857142857143,261,23,14.660714285714286,4
Category_Wikipedia_sockpuppets_of_Mobyg.csv,59,199485.0,32,27,17,15,0,32.03389830508475,156,47,16.88135593220339,4
Category_Wikipedia_sockpuppets_of_Molgav.csv,577,241346525.0,270,307,266,4,0,34.55632582322357,279,52,19.19064124783362,9
Category_Wikipedia_sockpuppets_of_AKnight2B.csv,183,1370570.0,59,124,57,2,0,45.48087431693989,219,47,22.147540983606557,14
Category_Wikipedia_sockpuppets_of_RazaqDesigner.csv,107,13284734.0,36,71,29,7,0,56.504672897196265,401,53,21.934579439252335,7
Category_Wikipedia_sockpuppets_of_Pastelaso29.csv,12,1278.0,9,3,6,3,0,94.66666666666667,245,28,28.0,28
Category_Wikipedia_sockpuppets_of_Karan.m.gandhi.csv,1,0.0,1,0,1,0,29,29.0,29,25,25.0,25
Category_Wikipedia_sockpuppets_of_Mr.Verwalter.csv,154,2946139.0,51,103,39,12,0,43.57142857142857,199,69,27.928571428571427,9
Category_Wikipedia_sockpuppets_of_Alifazal.csv,1271,309284560.0,529,742,500,29,0,40.758457907159716,500,76,29.31392604248623,4
Category_Wikipedia_sockpuppets_of_Luk√°≈°_Pern√Ω.csv,127,350315308.0,33,94,23,10,0,54.89763779527559,255,47,25.125984251968504,11
Category_Wikipedia_sockpuppets_of_Lionhead99.csv,1835,19786870.0,563,1272,500,63,0,50.10899182561308,255,58,19.920980926430516,6
Category_Wikipedia_sockpuppets_of_S.A.Database.csv,995,177874346.0,463,532,233,230,0,39.6572864321608,309,34,12.636180904522613,5
Category_Wikipedia_sockpuppets_of_Codywillis.csv,9,3258.0,9,0,9,0,1,26.77777777777778,84,9,9.0,9
Category_Wikipedia_sockpuppets_of_Wikiversidade.csv,398,6899681.0,118,280,73,45,0,68.46231155778895,500,47,13.185929648241206,3
Category_Wikipedia_sockpuppets_of_Delehcs.csv,45,17758451.0,17,28,15,2,0,68.4,268,28,21.91111111111111,11
Category_Wikipedia_sockpuppets_of_Andreibobo29.csv,151,1922895.0,63,88,15,48,0,57.741721854304636,224,25,15.589403973509933,7
Category_Wikipedia_sockpuppets_of_Ezekiel53746.csv,2033,313035656.0,668,1365,472,196,0,45.498278406296116,255,65,24.54795868175111,6
Category_Wikipedia_sockpuppets_of_Cp_braga.csv,45,30048014.0,26,19,19,7,0,40.0,241,21,15.155555555555555,11
Category_Wikipedia_sockpuppets_of_Drizzy0161.csv,8,162539.0,6,2,3,3,0,5.25,28,24,21.5,14
Category_Wikipedia_sockpuppets_of_Yaisamusic.csv,2,140.0,2,0,1,1,36,38.0,40,14,14.0,14
Category_Wikipedia_sockpuppets_of_Pinzunski.csv,1551,20143204.0,500,1051,500,0,0,44.03223726627982,361,97,16.585428755641523,6
Category_Wikipedia_sockpuppets_of_Ashraful.mobarak.csv,5,1321.0,3,2,3,0,16,28.2,77,24,23.4,23
Category_Wikipedia_sockpuppets_of_The_King_of_kings100.csv,194,46555266.0,68,126,61,7,0,51.75257731958763,280,43,22.74742268041237,12
Category_Wikipedia_sockpuppets_of_Hari_bakar.csv,135,8840523.0,37,98,34,3,0,63.370370370370374,276,26,14.503703703703703,7
Category_Wikipedia_sockpuppets_of_Dennisnagpal.csv,119,6651929.0,44,75,27,17,0,28.554621848739497,162,33,30.352941176470587,15
Category_Wikipedia_sockpuppets_of_Ccwstandard.csv,2906,408240263.0,1165,1741,500,665,0,39.35237439779766,508,54,19.60048176187199,4
Category_Wikipedia_sockpuppets_of_DanHowitt.csv,4,740069.0,4,0,4,0,18,18.0,18,13,13.0,13
Category_Wikipedia_sockpuppets_of_Brianis19.csv,1434,322862872.0,527,907,500,27,0,34.63389121338912,386,70,28.467224546722456,9
Category_Wikipedia_sockpuppets_of_Kristopher_Carpenter.csv,41,3711323.0,30,11,23,7,0,21.51219512195122,196,33,23.634146341463413,12
Category_Wikipedia_sockpuppets_of_Hurricanehiker_2208.csv,756,10174243.0,295,461,238,57,0,39.03968253968254,327,52,26.764550264550266,14
Category_Wikipedia_sockpuppets_of_Gellerjake.csv,5,553.0,2,3,2,0,14,33.4,80,18,18.0,18
Category_Wikipedia_sockpuppets_of_Aryashahnaughty.csv,1584,163785439.0,456,1128,57,399,0,50.25441919191919,494,67,29.737373737373737,4
Category_Wikipedia_sockpuppets_of_Anjali_yadav(officail).csv,25,18396765.0,5,20,3,2,0,53.44,175,27,18.8,14
Category_Wikipedia_sockpuppets_of_Woww34.csv,362,23989370.0,142,220,81,61,0,41.98342541436464,424,30,14.660220994475138,11
Category_Wikipedia_sockpuppets_of_Amoaveni.csv,35,2799154.0,25,10,15,10,0,18.37142857142857,115,14,14.0,14
Category_Wikipedia_sockpuppets_of_Binodkpn.csv,476,133565706.0,178,298,137,41,0,33.65756302521008,232,36,16.327731092436974,7
Category_Wikipedia_sockpuppets_of_Spitfire202.csv,1285,23240577.0,492,793,424,68,0,35.757976653696495,250,62,18.92295719844358,6
Category_Wikipedia_sockpuppets_of_√Ü√∞√∞.csv,566,23443394.0,174,392,127,47,0,56.57420494699647,252,51,22.379858657243815,5
Category_Wikipedia_sockpuppets_of_Alloraptor.csv,8,75410.0,8,0,8,0,0,34.375,196,23,20.625,10
Category_Wikipedia_sockpuppets_of_Tanzania888.csv,25,85902.0,16,9,8,8,0,66.88,254,21,11.2,8
Category_Wikipedia_sockpuppets_of_Kingshow2150.csv,117,3012642.0,43,74,37,6,0,55.06837606837607,253,37,12.820512820512821,7
Category_Wikipedia_sockpuppets_of_PJHaseldine.csv,5450,222734080.0,1630,3820,500,1130,0,48.50165137614679,251,80,20.898715596330277,2
Category_Wikipedia_sockpuppets_of_Kashish_Mittal.csv,25,105995993.0,5,20,3,2,0,68.44,255,17,13.16,11
Category_Wikipedia_sockpuppets_of_Sanashaikh72.csv,5,901712.0,2,3,2,0,0,43.0,196,15,15.0,15
Category_Wikipedia_sockpuppets_of_ActuallyWhatYouMeantWas.csv,105,103277751.0,25,80,18,7,0,41.05714285714286,217,35,18.142857142857142,7
Category_Wikipedia_sockpuppets_of_Zachyr_Nickelodeon_Neptune_Animations.csv,1398,6546370.0,534,864,299,235,0,36.38698140200286,408,72,31.675965665236053,5
Category_Wikipedia_sockpuppets_of_Wakanohands.csv,9,87160.0,4,5,2,2,3,47.333333333333336,211,11,9.333333333333334,8
Category_Wikipedia_sockpuppets_of_Yardus_maximus.csv,83,8102142.0,20,63,8,12,0,46.144578313253014,199,42,20.313253012048193,6
Category_Wikipedia_sockpuppets_of_Dhakdhak.csv,1276,27538149.0,436,840,205,231,0,34.02742946708464,307,49,16.63871473354232,5
Category_Wikipedia_sockpuppets_of_Sadequain_Foundation_USA.csv,75,1896899.0,25,50,13,12,0,49.666666666666664,199,36,18.386666666666667,8
Category_Wikipedia_sockpuppets_of_Barfbag666.csv,421,14581120.0,126,295,73,53,0,55.6603325415677,255,78,27.10688836104513,4
Category_Wikipedia_sockpuppets_of_ED209.csv,1571,82134216.0,524,1047,500,24,0,35.168045830681095,221,70,20.299172501591343,7
Category_Wikipedia_sockpuppets_of_GeekMoody19.csv,1126,9698015.0,531,595,500,31,0,27.065719360568384,254,45,18.988454706927175,9
Category_Wikipedia_sockpuppets_of_Tinywings10.csv,504,106069130.0,213,291,193,20,0,43.95634920634921,250,25,15.037698412698413,7
Category_Wikipedia_sockpuppets_of_Idprodomino99.csv,1,0.0,1,0,1,0,47,47.0,47,21,21.0,21
Category_Wikipedia_sockpuppets_of_Annevy_Cristian.csv,924,72071921.0,359,565,310,49,0,32.904761904761905,251,57,23.535714285714285,5
Category_Wikipedia_sockpuppets_of_Aidinshahi.csv,217,47188453.0,142,75,137,5,0,28.207373271889402,212,27,10.7926267281106,5
Category_Wikipedia_sockpuppets_of_Gardo_Versace.csv,1532,195456911.0,528,1004,500,28,0,52.9588772845953,422,83,20.89817232375979,3
Category_Wikipedia_sockpuppets_of_Bennet556.csv,1273,3829529.0,662,611,284,378,0,30.408483896307935,216,51,13.833464257659074,3
Category_Wikipedia_sockpuppets_of_Zorkfan.csv,217,3978544.0,83,134,73,10,0,42.13824884792627,200,50,17.741935483870968,9
Category_Wikipedia_sockpuppets_of_AFI-PUNK.csv,2470,59668478.0,648,1822,200,448,0,30.071659919028342,221,54,18.116194331983806,2
Category_Wikipedia_sockpuppets_of_Jackjone.jack.123456.csv,4,45251.0,3,1,2,1,0,34.75,139,11,11.0,11
Category_Wikipedia_sockpuppets_of_Majorbluff99.csv,62,5896346.0,36,26,19,17,0,64.2258064516129,223,22,14.741935483870968,14
Category_Wikipedia_sockpuppets_of_14macgibbonc.csv,11,135538.0,4,7,4,0,0,77.45454545454545,222,19,12.454545454545455,9
Category_Wikipedia_sockpuppets_of_QuantitativeGeometry.csv,362,75835476.0,199,163,110,89,0,42.24033149171271,329,29,17.41160220994475,11
Category_Wikipedia_sockpuppets_of_Brylleconrad.csv,118,27285946.0,49,69,46,3,0,49.483050847457626,205,31,16.847457627118644,10
Category_Wikipedia_sockpuppets_of_Dheeraj_budhori.csv,709,99190592.0,269,440,153,116,0,50.43582510578279,500,73,25.506346967559942,4
Category_Wikipedia_sockpuppets_of_JayR19.csv,1489,89940495.0,407,1082,180,227,0,40.60779046339825,263,66,24.805238415043654,4
Category_Wikipedia_sockpuppets_of_Multiplyperfect.csv,263,22025656.0,73,190,31,42,0,61.631178707224336,255,47,18.376425855513308,6
Category_Wikipedia_sockpuppets_of_KapilBhardwajWiki.csv,145,3186271.0,37,108,25,12,0,64.22068965517241,267,29,15.275862068965518,3
Category_Wikipedia_sockpuppets_of_Ben2719941.csv,3950,69365284.0,1371,2579,500,871,0,42.11721518987342,395,81,24.725569620253165,5
Category_Wikipedia_sockpuppets_of_Doctor_Andrew_Baldwin_MD.csv,167,2300204.0,57,110,46,11,0,52.30538922155689,257,35,29.275449101796408,14
Category_Wikipedia_sockpuppets_of_Erin93.csv,202,9426622.0,66,136,57,9,0,43.67821782178218,255,57,15.618811881188119,5
Category_Wikipedia_sockpuppets_of_Armaanaziz.csv,486,69754970.0,187,299,101,86,0,57.62551440329218,255,54,20.275720164609055,3
Category_Wikipedia_sockpuppets_of_ArtAndDesignNerd.csv,2,1876.0,2,0,1,1,19,19.0,19,45,45.0,45
Category_Wikipedia_sockpuppets_of_CafeGurrier66.csv,911,7886757.0,287,624,183,104,0,54.461031833150386,500,65,25.220636663007685,7
Category_Wikipedia_sockpuppets_of_Jeeptraveler.csv,1,0.0,1,0,1,0,0,0.0,0,47,47.0,47
Category_Wikipedia_sockpuppets_of_Derunlrw.csv,256,65580815.0,108,148,70,38,0,30.41796875,231,28,19.265625,10
Category_Wikipedia_sockpuppets_of_Postnoonnews.csv,360,10804875.0,115,245,59,56,0,48.28055555555556,230,48,22.266666666666666,6
Category_Wikipedia_sockpuppets_of_Hurricane_Allen.csv,281,22985781.0,105,176,44,61,0,52.89679715302491,242,51,22.16725978647687,13
Category_Wikipedia_sockpuppets_of_Scarfaced_Charley.csv,1325,24777945.0,396,929,246,150,0,44.21056603773585,249,62,21.73433962264151,5
Category_Wikipedia_sockpuppets_of_Baxe.csv,67,38278492.0,31,36,13,18,0,57.40298507462686,199,18,17.16417910447761,9
Category_Wikipedia_sockpuppets_of_JournoZA.csv,34,224439.0,27,7,22,5,0,56.8235294117647,200,25,13.764705882352942,11
Category_Wikipedia_sockpuppets_of_Vkasdg.csv,602,20645568.0,184,418,98,86,0,28.41860465116279,198,74,24.1046511627907,4
Category_Wikipedia_sockpuppets_of_Curiousapien.csv,19,933918.0,16,3,15,1,0,28.63157894736842,196,24,22.105263157894736,22
Category_Wikipedia_sockpuppets_of_ArianaRaykotto.csv,77,12261991.0,25,52,22,3,0,54.1948051948052,208,40,17.48051948051948,6
Category_Wikipedia_sockpuppets_of_LithiumFlash.csv,3907,349462885.0,1231,2676,500,731,0,57.41873560276427,256,69,20.708471973381112,2
Category_Wikipedia_sockpuppets_of_Virasatgaur.csv,540,216944737.0,176,364,55,121,0,43.327777777777776,255,53,18.43148148148148,7
Category_Wikipedia_sockpuppets_of_Lokisandal34.csv,454,16822699.0,215,239,117,98,0,43.370044052863435,460,30,15.85022026431718,10
Category_Wikipedia_sockpuppets_of_ASR368ASR.csv,36,5419723.0,21,15,18,3,0,64.66666666666667,255,16,13.166666666666666,8
Category_Wikipedia_sockpuppets_of_Research_Voltas.csv,2220,12243387.0,827,1393,428,399,0,48.3445945945946,496,52,15.674774774774775,4
Category_Wikipedia_sockpuppets_of_Dealer07.csv,3949,76611872.0,1155,2794,182,973,0,50.90073436312991,499,59,20.609521397822235,3
Category_Wikipedia_sockpuppets_of_TheAlienMan2002.csv,1702,60189036.0,476,1226,407,69,0,65.81786133960047,494,94,21.81081081081081,1
Category_Wikipedia_sockpuppets_of_Karnrawat.csv,70,59167069.0,14,56,12,2,0,73.44285714285714,255,41,14.928571428571429,7
Category_Wikipedia_sockpuppets_of_Cabritos.csv,1354,53973353.0,443,911,408,35,0,47.270310192023636,442,80,21.586410635155097,5
Category_Wikipedia_sockpuppets_of_James_4.csv,1549,36141203.0,712,837,254,458,0,42.25564880568108,255,57,21.16526791478373,6
Category_Wikipedia_sockpuppets_of_Dverma.csv,558,552366131.0,202,356,143,59,0,45.42831541218638,496,65,17.340501792114697,3
Category_Wikipedia_sockpuppets_of_OrtonMysterioRKO619.csv,53,348638.0,16,37,16,0,0,50.9622641509434,238,35,18.81132075471698,12
Category_Wikipedia_sockpuppets_of_Inowen.csv,3320,19021529.0,1013,2307,500,513,0,50.35512048192771,401,63,21.053915662650603,1
Category_Wikipedia_sockpuppets_of_Hertfordshire1234.csv,166,117242735.0,54,112,8,46,0,41.795180722891565,250,64,32.75301204819277,16
Category_Wikipedia_sockpuppets_of_HSO922016.csv,49,17077.0,16,33,8,8,0,43.16326530612245,166,29,19.020408163265305,13
Category_Wikipedia_sockpuppets_of_Nutechdirit.csv,132,4752770.0,55,77,28,27,0,38.07575757575758,302,38,26.348484848484848,16
Category_Wikipedia_sockpuppets_of_AnomiieBOT.csv,539,12196667.0,503,36,500,3,0,23.521335807050093,170,21,13.411873840445269,11
Category_Wikipedia_sockpuppets_of_Furko_Nellis.csv,1506,6990750.0,366,1140,324,42,0,50.69455511288181,249,61,20.50265604249668,3
Category_Wikipedia_sockpuppets_of_Kittybrewster.csv,3937,407470389.0,1122,2815,500,622,0,43.458470916941835,301,91,22.80264160528321,2
Category_Wikipedia_sockpuppets_of_Md_Nurnobi_Islam.csv,5,787677.0,2,3,1,1,14,52.4,85,26,24.0,21
Category_Wikipedia_sockpuppets_of_74tyhegf.csv,831,4877626.0,254,577,118,136,0,60.24428399518652,253,71,25.087845968712394,6
Category_Wikipedia_sockpuppets_of_Alohamesamis.csv,437,7160161.0,141,296,140,1,0,58.0,254,50,17.336384439359268,6
Category_Wikipedia_sockpuppets_of_1Samuel_afful.csv,268,28103521.0,112,156,22,90,0,34.134328358208954,276,36,16.932835820895523,11
Category_Wikipedia_sockpuppets_of_CauseIsayso.csv,38,52457653.0,18,20,16,2,0,73.02631578947368,203,21,12.473684210526315,11
Category_Wikipedia_sockpuppets_of_Editor_without_see_fount_codes.csv,1758,85367963.0,391,1367,389,2,0,38.23890784982935,302,50,18.936291240045506,8
Category_Wikipedia_sockpuppets_of_Anacapa.csv,1432,243194343.0,522,910,500,22,0,49.80027932960894,255,47,12.182960893854748,4
Category_Wikipedia_sockpuppets_of_Celinedionfan123.csv,70,15629542.0,21,49,9,12,0,25.37142857142857,210,47,45.84285714285714,38
Category_Wikipedia_sockpuppets_of_NetWitz.csv,45,165244094.0,9,36,9,0,0,53.24444444444445,201,47,26.177777777777777,9
Category_Wikipedia_sockpuppets_of_Donagluithan.csv,1881,275273103.0,513,1368,348,165,0,47.15098351940457,250,93,21.52259436469963,5
Category_Wikipedia_sockpuppets_of_Vickydvignesh.csv,1415,122505836.0,512,903,387,125,0,58.835335689045934,255,84,19.46148409893993,2
Category_Wikipedia_sockpuppets_of_GVRLS.csv,379,2756835.0,109,270,54,55,0,63.07387862796834,498,54,20.12928759894459,6
Category_Wikipedia_sockpuppets_of_Factsonly94.csv,35,976313.0,25,10,15,10,0,69.65714285714286,205,22,19.942857142857143,11
Category_Wikipedia_sockpuppets_of_Brainbug666.csv,333,31622103.0,134,199,126,8,0,37.56156156156156,214,57,30.456456456456458,3
Category_Wikipedia_sockpuppets_of_Tracy_Hence.csv,968,83974589.0,278,690,255,23,0,45.67045454545455,255,66,16.643595041322314,4
Category_Wikipedia_sockpuppets_of_Kellychi4u.csv,189,175993201.0,62,127,52,10,0,58.195767195767196,254,65,16.608465608465607,6
Category_Wikipedia_sockpuppets_of_Ivan250igan.csv,41,51764155.0,20,21,8,12,0,40.4390243902439,194,63,26.317073170731707,7
Category_Wikipedia_sockpuppets_of_Tazetheog.csv,515,4884583.0,134,381,121,13,0,53.460194174757284,402,46,16.778640776699028,6
Category_Wikipedia_sockpuppets_of_NUCB_UndergraduateCampus.csv,45,70178208.0,22,23,18,4,0,37.13333333333333,150,45,39.55555555555556,25
Category_Wikipedia_sockpuppets_of_Rungofed.csv,168,29111447.0,70,98,20,50,0,45.541666666666664,249,65,18.708333333333332,8
Category_Wikipedia_sockpuppets_of_Gfrsdgerr.csv,203,99701090.0,67,136,59,8,0,43.87684729064039,250,26,15.822660098522167,5
Category_Wikipedia_sockpuppets_of_AndreySetia99.csv,345,11594585.0,207,138,179,28,0,28.579710144927535,298,24,16.594202898550726,7
Category_Wikipedia_sockpuppets_of_FaulconerProductionsMusic.csv,39,1639758.0,28,11,11,17,0,87.07692307692308,496,35,20.846153846153847,15
Category_Wikipedia_sockpuppets_of_Spookee.csv,311,21054751.0,93,218,75,18,0,53.061093247588424,211,56,22.922829581993568,5
Category_Wikipedia_sockpuppets_of_Shenqijing.csv,1328,22785045.0,500,828,487,13,0,57.98343373493976,425,50,16.924698795180724,2
Category_Wikipedia_sockpuppets_of_Bono06.csv,1263,97475483.0,264,999,94,170,0,30.344418052256533,217,47,15.194774346793348,7
Category_Wikipedia_sockpuppets_of_Factsldn15.csv,58,20473297.0,51,7,48,3,0,9.758620689655173,160,12,12.0,12
Category_Wikipedia_sockpuppets_of_Nrochluz.csv,184,1088845.0,70,114,38,32,0,42.72826086956522,370,55,18.891304347826086,5
Category_Wikipedia_sockpuppets_of_Merajul_Islam.fm.csv,94,22745425.0,33,61,11,22,0,68.34042553191489,496,47,21.71276595744681,6
Category_Wikipedia_sockpuppets_of_Knfw.csv,145,76515040.0,50,95,28,22,0,58.56551724137931,346,48,15.227586206896552,10
Category_Wikipedia_sockpuppets_of_Asifmshuvo.csv,3,2981.0,3,0,2,1,36,94.33333333333333,194,26,18.666666666666668,15
Category_Wikipedia_sockpuppets_of_IDcasfs.csv,6,473.0,3,3,2,1,0,95.0,278,16,7.666666666666667,6
Category_Wikipedia_sockpuppets_of_Technoquat.csv,3068,48306139.0,822,2246,70,752,0,47.28683181225554,255,58,25.20762711864407,6
Category_Wikipedia_sockpuppets_of_Ramesmurmu214.csv,256,20397932.0,82,174,38,44,0,40.5703125,316,49,23.98828125,6
Category_Wikipedia_sockpuppets_of_Aditya_debnath_wiki.csv,1549,9444862.0,596,953,500,96,0,35.9244673983215,271,79,28.142672692059392,6
Category_Wikipedia_sockpuppets_of_Averwat.csv,51,8740.0,24,27,13,11,0,48.745098039215684,214,25,15.901960784313726,7
Category_Wikipedia_sockpuppets_of_Duahsefgysdf.csv,972,3711601.0,383,589,361,22,0,39.76543209876543,421,57,38.76851851851852,10
Category_Wikipedia_sockpuppets_of_Cnikolai.csv,153,414853797.0,32,121,28,4,0,53.490196078431374,217,43,29.50980392156863,11
Category_Wikipedia_sockpuppets_of_Lhlhkyk.csv,201,38566333.0,68,133,53,15,0,60.17412935323383,496,34,20.432835820895523,10
Category_Wikipedia_sockpuppets_of_Manolvd1999.csv,406,24353363.0,151,255,149,2,0,40.02709359605911,254,43,23.204433497536947,4
Category_Wikipedia_sockpuppets_of_Alice_M._Hart.csv,6,14103283.0,2,4,1,1,0,46.833333333333336,146,34,26.5,19
Category_Wikipedia_sockpuppets_of_Nickmax1234.csv,16,20396965.0,8,8,7,1,0,17.1875,92,22,16.3125,5
Category_Wikipedia_sockpuppets_of_Only1greenyoshi.csv,2187,5150952.0,863,1324,500,363,0,30.11156835848194,500,77,16.746227709190673,3
Category_Wikipedia_sockpuppets_of_Theusernameistaken.csv,493,15896470.0,132,361,42,90,0,51.004056795131845,482,43,19.88843813387424,4
Category_Wikipedia_sockpuppets_of_Tj363.csv,42,1912518.0,16,26,12,4,0,55.523809523809526,150,41,21.071428571428573,15
Category_Wikipedia_sockpuppets_of_Vanburrena.csv,562,176362706.0,173,389,40,133,0,40.204626334519574,247,77,21.97508896797153,7
Category_Wikipedia_sockpuppets_of_Shia1.csv,886,27628002.0,331,555,290,41,0,32.28668171557562,199,63,18.892776523702032,6
Category_Wikipedia_sockpuppets_of_Shiyal_Naresh.csv,27,686543.0,14,13,14,0,0,42.2962962962963,196,23,20.185185185185187,14
Category_Wikipedia_sockpuppets_of_Spaceghostguy.csv,395,19186107.0,108,287,73,35,0,32.78481012658228,199,52,18.650632911392407,5
Category_Wikipedia_sockpuppets_of_ThunderStrokeMedia.csv,93,12319124.0,27,66,15,12,0,58.11827956989247,253,29,16.301075268817204,6
Category_Wikipedia_sockpuppets_of_Neo_ecijano.csv,6,151.0,2,4,2,0,0,2.0,12,15,13.5,12
Category_Wikipedia_sockpuppets_of_Amirra6212.csv,69,41873523.0,21,48,15,6,0,67.95652173913044,229,18,10.101449275362318,6
Category_Wikipedia_sockpuppets_of_Michael_Ehrmant.csv,311,19919033.0,83,228,58,25,0,54.553054662379424,247,42,16.836012861736336,5
Category_Wikipedia_sockpuppets_of_Stevenbdamelin.csv,221,232628379.0,66,155,36,30,0,48.21266968325792,196,63,25.339366515837103,13
Category_Wikipedia_sockpuppets_of_Ilovekpoppop.csv,52,97363.0,22,30,12,10,0,62.25,205,27,16.673076923076923,6
Category_Wikipedia_sockpuppets_of_Deanops.csv,244,11046946.0,92,152,22,70,0,46.69672131147541,226,46,17.598360655737704,4
Category_Wikipedia_sockpuppets_of_HSX12.csv,9,8716980.0,8,1,8,0,0,56.333333333333336,196,20,15.555555555555555,10
Category_Wikipedia_sockpuppets_of_Vikaschandak915.csv,17,284213075.0,4,13,3,1,11,72.47058823529412,148,27,18.941176470588236,18
Category_Wikipedia_sockpuppets_of_Borinquen122617.csv,2407,8746201.0,586,1821,408,178,0,49.31906938097217,430,77,19.976734524304113,3
Category_Wikipedia_sockpuppets_of_Sarandioti.csv,4276,31667290.0,1473,2803,500,973,0,42.45533208606174,259,53,20.86272217025257,4
Category_Wikipedia_sockpuppets_of_Arepticous.csv,1732,85706712.0,770,962,480,290,0,49.3608545034642,231,66,22.77713625866051,4
Category_Wikipedia_sockpuppets_of_Rang_HD.csv,5549,76040432.0,2094,3455,374,1720,0,39.78626779599928,475,85,16.617588754730583,4
Category_Wikipedia_sockpuppets_of_DaneDN.csv,440,193951425.0,188,252,184,4,0,49.25681818181818,413,58,38.53181818181818,11
Category_Wikipedia_sockpuppets_of_Potatoe_don.csv,165,8711457.0,40,125,21,19,0,43.93333333333333,219,38,18.4,4
Category_Wikipedia_sockpuppets_of_Andi064.csv,4452,68085661.0,1604,2848,500,1104,0,40.59681042228212,266,94,20.165318957771788,4
Category_Wikipedia_sockpuppets_of_TheComParts.csv,15,3119.0,10,5,8,2,15,51.333333333333336,188,25,13.666666666666666,7
Category_Wikipedia_sockpuppets_of_Dodo_elmoghazy.csv,289,24872285.0,73,216,64,9,0,43.32871972318339,325,38,17.501730103806228,9
Category_Wikipedia_sockpuppets_of_Infolithium.csv,112,1363048.0,46,66,45,1,0,18.928571428571427,110,30,20.339285714285715,13
Category_Wikipedia_sockpuppets_of_Arushaan.csv,100,15142176.0,42,58,41,1,0,58.52,276,21,10.38,8
Category_Wikipedia_sockpuppets_of_Veganlover1993.csv,4384,116155125.0,1372,3012,500,872,0,44.67107664233577,435,156,17.939324817518248,1
Category_Wikipedia_sockpuppets_of_LarryDarby.csv,121,784451.0,76,45,50,26,0,33.82644628099174,160,51,20.859504132231404,11
Category_Wikipedia_sockpuppets_of_Bugman94.csv,6992,199366203.0,2694,4298,500,2194,0,47.84110411899314,255,83,24.497282608695652,3
Category_Wikipedia_sockpuppets_of_ALPHA_BOB.csv,491,27212112.0,182,309,144,38,0,59.323828920570264,237,78,32.830957230142566,5
Category_Wikipedia_sockpuppets_of_Usernogood.csv,1631,3360761.0,516,1115,500,16,0,64.3979153893317,352,70,19.91477621091355,4
Category_Wikipedia_sockpuppets_of_TehGuy.csv,871,225405364.0,284,587,271,13,0,46.28817451205511,269,39,16.324913892078072,3
Category_Wikipedia_sockpuppets_of_Ïú§Ìïò_(1988ÎÖÑ).csv,66,160891.0,44,22,33,11,0,58.5,239,22,16.227272727272727,6
Category_Wikipedia_sockpuppets_of_Dark2-z.csv,8,373176.0,3,5,3,0,0,19.25,43,11,10.0,9
Category_Wikipedia_sockpuppets_of_Youtube0117.csv,8,4999373.0,5,3,4,1,0,34.0,59,47,29.0,23
Category_Wikipedia_sockpuppets_of_Saint-billy.csv,61,148773.0,17,44,14,3,0,40.049180327868854,163,33,15.918032786885245,4
Category_Wikipedia_sockpuppets_of_ForestH2.csv,10498,58531296.0,3924,6574,500,3424,0,31.90217184225567,255,88,25.024290341017338,1
Category_Wikipedia_sockpuppets_of_Sarahchuyun.csv,5,1004.0,5,0,5,0,0,43.8,199,32,32.0,32
Category_Wikipedia_sockpuppets_of_Girltechfan15.csv,41,36914947.0,11,30,5,6,0,57.90243902439025,242,26,17.73170731707317,6
Category_Wikipedia_sockpuppets_of_WiccaWeb.csv,3044,98540209.0,797,2247,500,297,0,38.410643889618925,248,66,16.525295663600527,3
Category_Wikipedia_sockpuppets_of_Smart_Aleck.csv,8950,71547891.0,2282,6668,500,1782,0,45.70268156424581,425,67,15.713407821229051,3
Category_Wikipedia_sockpuppets_of_Masevidal.csv,162,4308540.0,53,109,43,10,0,54.98765432098765,420,57,24.24074074074074,6
Category_Wikipedia_sockpuppets_of_TronFactor.csv,6683,494517586.0,2373,4310,500,1873,0,38.54137363459524,496,75,24.594643124345353,2
Category_Wikipedia_sockpuppets_of_PennySeven.csv,5449,203037257.0,2115,3334,500,1615,0,63.13470361534227,255,57,17.976692971187372,3
Category_Wikipedia_sockpuppets_of_Flow234.csv,3226,86892049.0,888,2338,500,388,0,61.81804091754495,255,88,24.198388096714197,3
Category_Wikipedia_sockpuppets_of_Hamprey.csv,199,25608581.0,82,117,54,28,0,29.964824120603016,172,56,25.311557788944725,11
Category_Wikipedia_sockpuppets_of_Destructor_rph.csv,170,132777166.0,36,134,33,3,0,49.95882352941177,255,35,18.50588235294118,5
Category_Wikipedia_sockpuppets_of_ExecBios.csv,79,3896123.0,52,27,49,3,0,25.443037974683545,241,46,21.126582278481013,8
Category_Wikipedia_sockpuppets_of_ShareMan_15.csv,169,85457252.0,52,117,45,7,0,45.26627218934911,209,44,24.94674556213018,11
Category_Wikipedia_sockpuppets_of_Qbucrs.csv,78,76296110.0,50,28,49,1,0,30.58974358974359,255,46,19.32051282051282,14
Category_Wikipedia_sockpuppets_of_ŸÖÿ≠ÿ®ÿ©ÿßŸÑŸÉÿ™ÿ®.csv,712,43121454.0,173,539,131,42,0,48.311797752808985,255,55,13.206460674157304,5
Category_Wikipedia_sockpuppets_of_PleaseTryHarder.csv,602,68998739.0,234,368,204,30,0,47.88538205980066,332,54,17.064784053156146,5
Category_Wikipedia_sockpuppets_of_Asmym_xix.csv,579,1413601.0,183,396,160,23,0,38.90500863557858,255,68,19.854922279792746,4
Category_Wikipedia_sockpuppets_of_Xenophon71.csv,136,1558095.0,57,79,52,5,0,72.42647058823529,439,34,16.61764705882353,8
Category_Wikipedia_sockpuppets_of_FadyNagyEmil.csv,1,0.0,1,0,1,0,39,39.0,39,24,24.0,24
Category_Wikipedia_sockpuppets_of_Chewygum.csv,4046,229474963.0,1755,2291,500,1255,0,34.351705388037566,281,82,33.629016312407316,3
Category_Wikipedia_sockpuppets_of_Glucken123.csv,1572,278780144.0,533,1039,367,166,0,59.1234096692112,412,67,25.10178117048346,6
Category_Wikipedia_sockpuppets_of_Yayme89.csv,576,10676672.0,191,385,81,110,0,43.65277777777778,229,59,25.5625,7
Category_Wikipedia_sockpuppets_of_Yeongchunpark.csv,8,783.0,4,4,4,0,0,42.25,151,50,21.875,5
Category_Wikipedia_sockpuppets_of_RonnieC8.csv,44,2999647.0,20,24,17,3,0,35.93181818181818,162,49,18.545454545454547,8
Category_Wikipedia_sockpuppets_of_PromisesWeKeep.csv,206,49625325.0,80,126,14,66,0,46.407766990291265,237,56,20.033980582524272,6
Category_Wikipedia_sockpuppets_of_Ashu500.csv,15,341101.0,6,9,1,5,0,85.8,317,28,12.733333333333333,7
Category_Wikipedia_sockpuppets_of_Xtremedood.csv,2289,169514800.0,624,1665,500,124,0,48.87505460899956,369,68,21.43381389252949,4
Category_Wikipedia_sockpuppets_of_Renameduser024.csv,1509,66223123.0,509,1000,500,9,0,59.119946984758116,255,108,32.70444002650762,7
Category_Wikipedia_sockpuppets_of_Narendra_Varma_(_Musical_Artist_).csv,2,0.0,1,1,1,0,30,30.0,30,38,38.0,38
Category_Wikipedia_sockpuppets_of_Breezeagentyt.csv,23,89924.0,16,7,15,1,0,39.91304347826087,129,23,22.565217391304348,21
Category_Wikipedia_sockpuppets_of_Ojeffs.csv,2,626.0,2,0,1,1,39,39.0,39,53,53.0,53
Category_Wikipedia_sockpuppets_of_TryToBeFunny.csv,12610,133518769.0,2924,9686,162,2762,0,50.44123711340206,466,83,16.458207771609832,1
Category_Wikipedia_sockpuppets_of_S-man.csv,1587,131860668.0,500,1087,500,0,0,34.91808443604285,260,68,21.875866414618777,1
Category_Wikipedia_sockpuppets_of_Moya13.csv,94,6985144.0,43,51,30,13,0,40.43617021276596,196,24,15.808510638297872,12
Category_Wikipedia_sockpuppets_of_Bluecanoe.csv,543,9079761.0,173,370,126,47,0,26.61694290976059,197,62,20.96316758747698,4
Category_Wikipedia_sockpuppets_of_Badr2234.csv,30,30623.0,16,14,13,3,0,36.233333333333334,144,21,14.466666666666667,9
Category_Wikipedia_sockpuppets_of_Musicchief007.csv,160,887948.0,54,106,28,26,0,50.85625,253,60,22.5,10
Category_Wikipedia_sockpuppets_of_Tundedaniel.csv,50,2895103.0,17,33,14,3,0,45.14,209,46,19.44,4
Category_Wikipedia_sockpuppets_of_Archangelbris.csv,1073,97884728.0,350,723,186,164,0,48.61043802423113,255,37,20.457595526561043,10
Category_Wikipedia_sockpuppets_of_Tapioca123.csv,13,2427042.0,8,5,4,4,0,56.15384615384615,189,12,12.0,12
Category_Wikipedia_sockpuppets_of_Bockeee.csv,61,1787291.0,26,35,14,12,0,30.0,199,23,17.21311475409836,10
Category_Wikipedia_sockpuppets_of_Mcsuperfly.csv,453,60397823.0,166,287,157,9,0,29.571743929359823,208,62,19.781456953642383,5
Category_Wikipedia_sockpuppets_of_Andrew.Allen7867427.csv,48,2834050.0,14,34,8,6,0,35.583333333333336,196,59,27.5,9
Category_Wikipedia_sockpuppets_of_Praveenbansal.csv,3,12808.0,3,0,3,0,0,14.0,28,18,18.0,18
Category_Wikipedia_sockpuppets_of_Mrpainkiller7.csv,294,6394376.0,112,182,45,67,0,29.064625850340136,249,51,24.829931972789115,9
Category_Wikipedia_sockpuppets_of_PAPA_RAO_KVSKS.csv,431,233535281.0,120,311,115,5,0,35.11600928074246,253,47,28.336426914153133,8
Category_Wikipedia_sockpuppets_of_Bikram_malati_in_mb.csv,9,2376.0,3,6,3,0,0,32.111111111111114,77,29,27.333333333333332,26
Category_Wikipedia_sockpuppets_of_UnclePaco.csv,2982,87829392.0,920,2062,500,420,0,46.69416498993964,253,89,23.129443326626426,3
Category_Wikipedia_sockpuppets_of_Jamiesongj.csv,162,5264619.0,58,104,43,15,0,54.24691358024691,222,21,14.25925925925926,8
Category_Wikipedia_sockpuppets_of_Togepi_987.csv,976,18542103.0,343,633,200,143,0,36.20594262295082,199,54,24.549180327868854,3
Category_Wikipedia_sockpuppets_of_Bluewhale45.csv,276,49624198.0,87,189,43,44,0,46.210144927536234,500,41,21.28985507246377,1
Category_Wikipedia_sockpuppets_of_Itz_arka.csv,1456,322450102.0,505,951,500,5,0,34.291895604395606,494,60,23.341346153846153,5
Category_Wikipedia_sockpuppets_of_MattFullerUK.csv,428,13066535.0,108,320,62,46,0,44.649532710280376,305,49,23.161214953271028,3
Category_Wikipedia_sockpuppets_of_TheLawfulOne.csv,42,86257.0,20,22,12,8,0,47.0,200,40,19.595238095238095,6
Category_Wikipedia_sockpuppets_of_Dinvestor.csv,43,113430.0,19,24,14,5,0,78.72093023255815,225,44,21.697674418604652,15
Category_Wikipedia_sockpuppets_of_Labgown.csv,652,39149553.0,281,371,112,169,0,39.13036809815951,255,52,17.599693251533743,6
Category_Wikipedia_sockpuppets_of_Stern_review.csv,1786,34711285.0,815,971,241,574,0,84.21892497200447,231,52,19.126539753639417,4
Category_Wikipedia_sockpuppets_of_Americanboi10.csv,15,9632.0,7,8,4,3,0,54.06666666666667,194,11,9.933333333333334,7
Category_Wikipedia_sockpuppets_of_Giteshkumar122002.csv,8,524051.0,4,4,3,1,0,40.125,81,27,20.75,18
Category_Wikipedia_sockpuppets_of_Michaelse2002.csv,306,2194867.0,108,198,59,49,0,41.911764705882355,496,53,31.019607843137255,9
Category_Wikipedia_sockpuppets_of_UBb2bmarketing.csv,9,253714.0,7,2,7,0,3,21.0,33,24,24.0,24
Category_Wikipedia_sockpuppets_of_Comrade_Sourav.csv,571,59772335.0,190,381,159,31,0,47.2784588441331,496,54,26.929947460595447,6
Category_Wikipedia_sockpuppets_of_Goforth_studios.csv,956,18997392.0,251,705,242,9,0,53.39853556485355,255,65,18.62866108786611,4
Category_Wikipedia_sockpuppets_of_Kishor_Raj_Narayan_Patar.csv,55,11889881.0,26,29,11,15,0,55.72727272727273,196,37,23.89090909090909,17
Category_Wikipedia_sockpuppets_of_Batzarro.csv,1544,1280282.0,519,1025,500,19,0,20.7610103626943,199,50,18.162564766839377,3
Category_Wikipedia_sockpuppets_of_HIM707.csv,368,12596221.0,161,207,70,91,0,46.005434782608695,321,54,19.105978260869566,7
Category_Wikipedia_sockpuppets_of_Elf021.csv,153,223386194.0,52,101,12,40,0,59.35947712418301,199,34,18.058823529411764,6
Category_Wikipedia_sockpuppets_of_SunilGuptaWiki.csv,157,100156934.0,51,106,21,30,0,48.732484076433124,206,46,16.273885350318473,9
Category_Wikipedia_sockpuppets_of_Fenrk.csv,776,55160484.0,255,521,90,165,0,51.134020618556704,500,60,25.39819587628866,8
Category_Wikipedia_sockpuppets_of_Woggy.csv,1336,63309629.0,518,818,286,232,0,32.77694610778443,250,73,25.27994011976048,5
Category_Wikipedia_sockpuppets_of_EthanKP.csv,986,3246408.0,526,460,500,26,0,32.61156186612576,250,53,20.162271805273832,4
Category_Wikipedia_sockpuppets_of_CuriousGolden.csv,268,4247336.0,65,203,65,0,0,54.60820895522388,345,52,20.492537313432837,3
Category_Wikipedia_sockpuppets_of_Sam3346.csv,221,70323415.0,93,128,87,6,0,37.63800904977376,203,72,24.493212669683256,12
Category_Wikipedia_sockpuppets_of_ChocolateCherryNight.csv,505,43122130.0,192,313,103,89,0,32.48514851485149,199,63,20.79009900990099,3
Category_Wikipedia_sockpuppets_of_DefLeppardRules.csv,1395,4549544.0,490,905,160,330,0,39.80143369175627,350,41,15.478136200716845,7
Category_Wikipedia_sockpuppets_of_Ashish_1816.csv,1325,76563846.0,436,889,430,6,0,55.12301886792453,500,62,17.772830188679244,7
Category_Wikipedia_sockpuppets_of_Komodo_lover.csv,3792,74197221.0,1318,2474,185,1133,0,34.847573839662445,250,66,24.337816455696203,2
Category_Wikipedia_sockpuppets_of_LVTW2.csv,2511,44893098.0,704,1807,500,204,0,69.63839107925129,500,97,21.096774193548388,4
Category_Wikipedia_sockpuppets_of_Hickskevin2212.csv,2792,35505562.0,763,2029,500,263,0,55.94627507163324,474,59,21.62858166189112,5
Category_Wikipedia_sockpuppets_of_OdVardara.csv,225,14682265.0,70,155,51,19,0,37.44444444444444,213,50,20.044444444444444,6
Category_Wikipedia_sockpuppets_of_Kaos-Industries.csv,822,52347807.0,227,595,162,65,0,51.24695863746959,361,55,16.712895377128955,5
Category_Wikipedia_sockpuppets_of_Colemerriman.csv,1028,22619740.0,259,769,98,161,0,51.32295719844358,500,52,16.648832684824903,4
Category_Wikipedia_sockpuppets_of_HH_Crown_Prince_Wayne_of_Markham.csv,58,1457538.0,21,37,12,9,0,62.758620689655174,213,42,21.17241379310345,12
Category_Wikipedia_sockpuppets_of_Nzgoodguy.csv,90,6214479.0,86,4,83,3,0,28.244444444444444,230,12,12.0,12
Category_Wikipedia_sockpuppets_of_GAtechnical.csv,1104,1713425.0,500,604,500,0,0,52.57336956521739,255,79,25.943840579710145,6
Category_Wikipedia_sockpuppets_of_Wasir_rahma123.csv,4,7603896.0,4,0,4,0,20,25.0,36,23,23.0,23
Category_Wikipedia_sockpuppets_of_MarkThomas.csv,1839,35767080.0,552,1287,500,52,0,47.068515497553015,255,79,21.182707993474715,4
Category_Wikipedia_sockpuppets_of_Blu_Aardvark.csv,4305,331151535.0,1446,2859,500,946,0,51.28641114982578,255,266,27.008130081300813,3
Category_Wikipedia_sockpuppets_of_Arefin_sazzad.csv,13,543420.0,4,9,3,1,0,55.0,120,52,21.692307692307693,18
Category_Wikipedia_sockpuppets_of_LUZERS!.csv,38,14963.0,20,18,14,6,0,65.23684210526316,214,39,15.026315789473685,7
Category_Wikipedia_sockpuppets_of_BerylTurns50.csv,1639,82673294.0,579,1060,450,129,0,28.877364246491762,253,66,16.661989017693717,5
Category_Wikipedia_sockpuppets_of_PremieroftheSovietUnion.csv,636,59022182.0,222,414,192,30,0,44.56603773584906,494,62,34.2185534591195,7
Category_Wikipedia_sockpuppets_of_Kamista.csv,2007,9343332.0,606,1401,500,106,0,53.18435475834579,496,47,15.637767812655705,4
Category_Wikipedia_sockpuppets_of_Norlns22.csv,2874,39176301.0,1178,1696,500,678,0,39.41753653444676,255,65,20.102992345163536,5
Category_Wikipedia_sockpuppets_of_Lisawalsh.csv,270,127426258.0,109,161,60,49,0,88.9074074074074,254,33,19.414814814814815,6
Category_Wikipedia_sockpuppets_of_Claracalderwood.csv,701,100981004.0,252,449,134,118,0,46.751783166904424,255,45,15.877318116975749,4
Category_Wikipedia_sockpuppets_of_GearTex.csv,49,601854.0,20,29,12,8,0,43.734693877551024,226,65,32.40816326530612,12
Category_Wikipedia_sockpuppets_of_TheOwnkingAyush.csv,155,4849027.0,61,94,28,33,0,46.24516129032258,286,43,20.47741935483871,11
Category_Wikipedia_sockpuppets_of_Tom_EP_Cooke.csv,35,9013229.0,10,25,10,0,0,66.71428571428571,206,25,15.228571428571428,6
Category_Wikipedia_sockpuppets_of_Sonicfan200530.csv,1379,47462813.0,302,1077,239,63,0,40.29151559100798,500,47,20.898477157360407,7
Category_Wikipedia_sockpuppets_of_Zipp_Speed_Weaponry.csv,3,94.0,3,0,3,0,16,17.333333333333332,20,4,4.0,4
Category_Wikipedia_sockpuppets_of_MadTubeSock.csv,26,243199558.0,8,18,6,2,0,53.38461538461539,160,17,14.346153846153847,9
Category_Wikipedia_sockpuppets_of_Rageholic_Filled_With_Rageahol.csv,1635,68198850.0,564,1071,500,64,0,40.87889908256881,264,66,22.61467889908257,4
"Category_Wikipedia_sockpuppets_of_Crouch,_Swale.csv",6833,428648862.0,2379,4454,500,1879,0,48.923752378164785,364,84,20.655788087223765,2
Category_Wikipedia_sockpuppets_of_Charleseugenehill_(resturant).csv,35,57816877.0,9,26,4,5,0,78.77142857142857,218,39,19.485714285714284,10
Category_Wikipedia_sockpuppets_of_Mevagiss.csv,4592,186867133.0,952,3640,500,452,0,49.46297909407666,486,75,17.498257839721255,3
Category_Wikipedia_sockpuppets_of_Woohi.csv,238,5683258.0,65,173,48,17,0,39.46218487394958,254,71,16.907563025210084,6
Category_Wikipedia_sockpuppets_of_AmirKhanVirgenia.csv,8,24926.0,4,4,3,1,0,70.875,180,53,40.125,16
Category_Wikipedia_sockpuppets_of_GustavusPrimus.csv,338,29980620.0,122,216,82,40,0,51.976331360946745,210,50,21.005917159763314,4
Category_Wikipedia_sockpuppets_of_AaliJenab.csv,1197,60374951.0,406,791,397,9,0,40.012531328320804,438,71,22.86549707602339,10
Category_Wikipedia_sockpuppets_of_Apfanclub.csv,504,2808389.0,329,175,324,5,0,24.297619047619047,240,61,21.845238095238095,10
Category_Wikipedia_sockpuppets_of_Findurwayback.csv,194,65628514.0,100,94,79,21,0,51.73711340206186,463,51,25.24742268041237,13
Category_Wikipedia_sockpuppets_of_Opinion_polling_for_the_United_Kingdom_European_Union_membership_referendum.csv,1288,13264018.0,407,881,51,356,0,61.61723602484472,255,111,34.94953416149068,6
Category_Wikipedia_sockpuppets_of_African_LIVES_Matter.csv,118,1069721.0,51,67,15,36,0,47.70338983050848,283,43,16.033898305084747,9
Category_Wikipedia_sockpuppets_of_Bob3321.csv,606,9952395.0,210,396,50,160,0,47.57755775577558,255,40,12.924092409240924,4
Category_Wikipedia_sockpuppets_of_Achun1111y.csv,198,10543934.0,57,141,30,27,0,49.73737373737374,229,45,17.828282828282827,7
Category_Wikipedia_sockpuppets_of_TinyAndo10.csv,42,76758.0,30,12,24,6,0,58.92857142857143,498,25,20.19047619047619,11
Category_Wikipedia_sockpuppets_of_Relpmek.csv,465,252467635.0,156,309,50,106,0,62.178494623655915,250,50,19.107526881720432,9
Category_Wikipedia_sockpuppets_of_Marveldccomicsfan.csv,513,7349918.0,141,372,129,12,0,44.36257309941521,294,53,18.13450292397661,6
Category_Wikipedia_sockpuppets_of_Poroshbangla.csv,2,264199.0,2,0,1,1,34,34.5,35,41,41.0,41
Category_Wikipedia_sockpuppets_of_AppassionatoDiSport.csv,120,5336045.0,62,58,49,13,0,60.141666666666666,227,43,19.608333333333334,9
Category_Wikipedia_sockpuppets_of_Akshay888777.csv,806,36913835.0,210,596,168,42,0,48.11538461538461,374,48,19.803970223325063,5
Category_Wikipedia_sockpuppets_of_Sajith_Thomas.csv,2103,59497630.0,698,1405,497,201,0,37.09082263433191,500,59,16.347123157394197,4
Category_Wikipedia_sockpuppets_of_JakeG987.csv,21,84914.0,8,13,4,4,0,38.285714285714285,219,31,22.761904761904763,15
Category_Wikipedia_sockpuppets_of_Dumdaiduekdingdao.csv,3042,3096724.0,1270,1772,500,770,0,19.289283366206444,339,51,18.45956607495069,6
Category_Wikipedia_sockpuppets_of_Eric_Corbett.csv,4603,210466414.0,1563,3040,500,1063,0,50.79339561155768,331,88,21.64588311970454,4
Category_Wikipedia_sockpuppets_of_Kadribistrica.csv,2795,101415132.0,917,1878,401,516,0,40.66440071556351,255,57,15.486583184257602,4
Category_Wikipedia_sockpuppets_of_Hernan_12.csv,6,15116.0,3,3,3,0,0,50.5,106,57,25.333333333333332,19
Category_Wikipedia_sockpuppets_of_Ruth2304.csv,85,2895731.0,34,51,18,16,0,29.63529411764706,143,45,23.823529411764707,9
Category_Wikipedia_sockpuppets_of_Culture759.csv,783,226958324.0,296,487,278,18,0,50.55555555555556,255,58,25.52234993614304,10
Category_Wikipedia_sockpuppets_of_Afghan1974.csv,1687,41880323.0,660,1027,118,542,0,48.68938944872555,255,79,27.640782454060464,8
Category_Wikipedia_sockpuppets_of_Victoriadseaman.csv,111,108610916.0,41,70,21,20,0,27.576576576576578,175,30,17.90990990990991,12
Category_Wikipedia_sockpuppets_of_Alex_from_Adelaide.csv,67,9508864.0,22,45,5,17,0,75.23880597014926,242,66,35.82089552238806,16
Category_Wikipedia_sockpuppets_of_Ealada612.csv,90,1993900.0,29,61,22,7,0,76.55555555555556,264,54,24.711111111111112,8
Category_Wikipedia_sockpuppets_of_Kanghuitari.csv,2340,203089080.0,793,1547,500,293,0,52.96666666666667,441,91,27.835042735042734,3
Category_Wikipedia_sockpuppets_of_Max7488.csv,53,11755410.0,15,38,13,2,0,51.471698113207545,332,39,18.79245283018868,5
Category_Wikipedia_sockpuppets_of_Mehran_Bottlers_(Pvt.)_Ltd.csv,6,164978.0,4,2,3,1,15,62.166666666666664,174,36,25.333333333333332,20
Category_Wikipedia_sockpuppets_of_Great2693.csv,2473,282887119.0,1073,1400,484,589,0,40.048928427011724,509,62,26.686211079660332,4
Category_Wikipedia_sockpuppets_of_Cheeseburgeraward.csv,429,3025165.0,148,281,63,85,0,51.99067599067599,243,39,18.57808857808858,7
Category_Wikipedia_sockpuppets_of_Abhishekbender235.csv,20,3369.0,13,7,4,9,0,57.2,161,26,12.5,11
Category_Wikipedia_sockpuppets_of_Gwynfeforlife.csv,10,4231210.0,6,4,5,1,0,64.0,199,6,6.0,6
Category_Wikipedia_sockpuppets_of_Buildpd.csv,125,21197600.0,59,66,55,4,0,34.184,191,53,36.936,10
Category_Wikipedia_sockpuppets_of_Mel_n_hel.csv,43,45892815.0,39,4,23,16,0,24.488372093023255,196,19,7.186046511627907,5
Category_Wikipedia_sockpuppets_of_Faisal_chowdhury.csv,803,8825312.0,462,341,413,49,0,26.958904109589042,260,33,15.907845579078456,7
Category_Wikipedia_sockpuppets_of_SuperKevinPlank.csv,89,540246.0,44,45,8,36,0,51.89887640449438,279,28,14.292134831460674,8
Category_Wikipedia_sockpuppets_of_Synphany.csv,26,8792584.0,20,6,16,4,0,15.23076923076923,123,19,9.192307692307692,7
Category_Wikipedia_sockpuppets_of_DonsAreTrash.csv,94,1082523.0,79,15,76,3,0,41.776595744680854,255,33,30.425531914893618,9
Category_Wikipedia_sockpuppets_of_The_Chubby_Brother.csv,99,26119114.0,24,75,16,8,0,43.5959595959596,223,33,22.232323232323232,13
Category_Wikipedia_sockpuppets_of_Hamsacharya_duh.csv,38,259371.0,15,23,15,0,0,52.68421052631579,190,76,32.86842105263158,17
Category_Wikipedia_sockpuppets_of_Redmen007.csv,301,106278948.0,119,182,112,7,0,37.093023255813954,242,50,34.98671096345515,12
Category_Wikipedia_sockpuppets_of_Karrattul.csv,2931,133846395.0,1245,1686,500,745,0,35.28829750938246,255,53,16.167178437393382,4
Category_Wikipedia_sockpuppets_of_Andisetia21.csv,103,35225672.0,35,68,31,4,0,50.883495145631066,375,68,31.41747572815534,16
Category_Wikipedia_sockpuppets_of_MehmoodS.csv,3172,36898020.0,1096,2076,500,596,0,54.17749054224464,496,55,19.753783102143757,2
Category_Wikipedia_sockpuppets_of_RandomBacon.csv,26,257790.0,21,5,21,0,0,20.96153846153846,213,39,29.307692307692307,21
Category_Wikipedia_sockpuppets_of_Cable_Bulgaria_EOOD.csv,116,8381937.0,91,25,12,79,0,32.11206896551724,350,54,27.120689655172413,16
Category_Wikipedia_sockpuppets_of_Gabriel.dukdod.csv,997,4674379.0,529,468,500,29,0,36.778335005015045,428,47,19.029087261785357,4
Category_Wikipedia_sockpuppets_of_Gauatam.csv,3,209.0,2,1,2,0,0,61.0,183,9,9.0,9
Category_Wikipedia_sockpuppets_of_Annatitchener12.csv,41,2080830.0,15,26,6,9,0,48.048780487804876,254,48,20.853658536585368,5
Category_Wikipedia_sockpuppets_of_Alain71.csv,224,27453521.0,120,104,78,42,0,33.95982142857143,231,25,15.084821428571429,9
Category_Wikipedia_sockpuppets_of_Agent.registry.csv,290,8122812.0,92,198,89,3,0,55.46551724137931,287,52,17.02758620689655,4
Category_Wikipedia_sockpuppets_of_Originalmichael.csv,39,785772.0,12,27,7,5,0,72.74358974358974,419,77,35.69230769230769,6
Category_Wikipedia_sockpuppets_of_BomberJoe.csv,1034,76304700.0,278,756,203,75,0,40.89651837524178,250,60,18.382978723404257,6
Category_Wikipedia_sockpuppets_of_Iamalwaysrightalways.csv,1730,61772356.0,468,1262,464,4,0,57.10520231213873,487,83,18.335838150289018,7
Category_Wikipedia_sockpuppets_of_AmyMHollywoodNow.csv,98,994436.0,62,36,59,3,0,71.14285714285714,281,71,24.785714285714285,4
Category_Wikipedia_sockpuppets_of_Manustella.csv,73,5013244.0,39,34,33,6,0,61.73972602739726,255,40,14.821917808219178,9
Category_Wikipedia_sockpuppets_of_Carnotaurus044.csv,1979,37399253.0,572,1407,463,109,0,47.55128852956038,237,54,18.412834765032844,4
Category_Wikipedia_sockpuppets_of_Hodders168.csv,42,235223938.0,22,20,14,8,0,47.57142857142857,347,20,13.5,13
Category_Wikipedia_sockpuppets_of_Onlinenow.csv,2370,453183277.0,982,1388,500,482,0,42.09957805907173,258,59,19.67679324894515,4
Category_Wikipedia_sockpuppets_of_TeamDragonSlayer.csv,58,1538.0,18,40,18,0,0,41.58620689655172,235,51,18.103448275862068,5
Category_Wikipedia_sockpuppets_of_Shadowcat08.csv,8,642.0,7,1,7,0,0,16.375,131,3,3.0,3
Category_Wikipedia_sockpuppets_of_Murcked.csv,78,314685957.0,20,58,17,3,0,47.243589743589745,252,41,21.653846153846153,9
Category_Wikipedia_sockpuppets_of_Joseffar.csv,197,113912221.0,57,140,41,16,0,46.49238578680203,246,43,16.274111675126903,10
Category_Wikipedia_sockpuppets_of_Gladstonegallery.csv,94,21014503.0,64,30,61,3,0,29.96808510638298,255,26,19.79787234042553,15
Category_Wikipedia_sockpuppets_of_Trialing.csv,470,29789160.0,164,306,120,44,0,28.41276595744681,233,61,17.097872340425532,6
Category_Wikipedia_sockpuppets_of_Peridot89.csv,324,62410548.0,107,217,66,41,0,46.425925925925924,255,49,25.311728395061728,9
Category_Wikipedia_sockpuppets_of_Danrivera.csv,2371,47958672.0,557,1814,500,57,0,38.82792070856179,255,63,19.43736819907212,4
Category_Wikipedia_sockpuppets_of_Sanjibroy95.csv,10,529814.0,10,0,7,3,0,30.1,49,24,20.9,19
Category_Wikipedia_sockpuppets_of_UTYVB7.csv,141,985145.0,47,94,12,35,0,41.91489361702128,197,32,20.00709219858156,9
Category_Wikipedia_sockpuppets_of_Joji_Lee.csv,14,317.0,7,7,7,0,0,31.285714285714285,193,13,13.0,13
Category_Wikipedia_sockpuppets_of_Zephram_Stark.csv,1359,18366118.0,508,851,500,8,0,42.55187637969095,210,71,29.393671817512878,4
Category_Wikipedia_sockpuppets_of_Jekhai_Narzary.csv,46,581026.0,20,26,17,3,0,39.45652173913044,196,27,23.91304347826087,10
Category_Wikipedia_sockpuppets_of_ElPilotoDi.csv,7279,133055606.0,2199,5080,500,1699,0,37.739524659980766,270,69,20.86454183266932,4
Category_Wikipedia_sockpuppets_of_Sajad1993.csv,21,318584.0,5,16,3,2,0,35.285714285714285,100,33,31.285714285714285,24
Category_Wikipedia_sockpuppets_of_DomLibrarian.csv,25,434233.0,9,16,9,0,0,57.48,237,34,18.96,15
Category_Wikipedia_sockpuppets_of_Thedudeyouknow.csv,47,4952378.0,18,29,12,6,0,50.08510638297872,181,34,19.80851063829787,13
Category_Wikipedia_sockpuppets_of_Shinny69.csv,14,497325.0,11,3,8,3,11,37.642857142857146,125,27,19.571428571428573,18
Category_Wikipedia_sockpuppets_of_Uneedk.csv,354,67710388.0,96,258,72,24,0,64.22881355932203,254,40,14.259887005649718,5
Category_Wikipedia_sockpuppets_of_Sinashabankhani.csv,53,2116405.0,29,24,23,6,0,31.735849056603772,495,44,21.433962264150942,8
Category_Wikipedia_sockpuppets_of_Mackan01002.csv,14,961.0,8,6,7,1,0,57.285714285714285,227,22,22.0,22
Category_Wikipedia_sockpuppets_of_Eh_heh_toofy_twick_you.csv,8,1416.0,4,4,4,0,0,38.0,162,32,26.0,8
Category_Wikipedia_sockpuppets_of_JohMorris.csv,42,5844452.0,25,17,5,20,0,56.04761904761905,171,14,12.428571428571429,11
Category_Wikipedia_sockpuppets_of_Evil_IloveRumania.csv,14,2187813.0,7,7,4,3,1,78.64285714285714,229,46,18.214285714285715,11
Category_Wikipedia_sockpuppets_of_Seankellywiki.csv,65,30313629.0,13,52,10,3,0,63.184615384615384,252,42,24.76923076923077,15
Category_Wikipedia_sockpuppets_of_ClassicBucks.csv,34,832668.0,22,12,19,3,0,37.529411764705884,331,24,23.029411764705884,18
Category_Wikipedia_sockpuppets_of_Yashweb.csv,183,49302634.0,67,116,43,24,0,45.486338797814206,351,40,16.05464480874317,5
Category_Wikipedia_sockpuppets_of_Hausnico.csv,262,9933317.0,114,148,40,74,0,43.38167938931298,291,46,15.698473282442748,4
Category_Wikipedia_sockpuppets_of_Torkmann.csv,3195,80274010.0,1027,2168,295,732,0,42.46478873239437,255,110,26.74585289514867,4
Category_Wikipedia_sockpuppets_of_BillyHarbert.csv,7,91506.0,4,3,3,1,0,40.285714285714285,132,23,19.285714285714285,15
Category_Wikipedia_sockpuppets_of_Ianawr.csv,9,1183685.0,3,6,2,1,19,65.66666666666667,153,18,16.555555555555557,11
Category_Wikipedia_sockpuppets_of_Expertseo.csv,2256,352584309.0,759,1497,471,288,0,48.871897163120565,250,82,18.309840425531913,4
Category_Wikipedia_sockpuppets_of_Chaudhurisagar.csv,108,11203243.0,42,66,21,21,0,57.01851851851852,304,37,17.916666666666668,7
Category_Wikipedia_sockpuppets_of_Ralfellis.csv,683,196282160.0,201,482,186,15,0,54.23279648609078,255,47,18.202049780380673,6
Category_Wikipedia_sockpuppets_of_Hetoum_I.csv,1453,88229126.0,535,918,500,35,0,39.96902959394357,250,49,18.87543014452856,4
Category_Wikipedia_sockpuppets_of_Ronalditos58815738.csv,1927,55925325.0,729,1198,500,229,0,34.697976128697455,330,54,21.13855734302024,8
Category_Wikipedia_sockpuppets_of_Radoezikova.csv,1248,70850528.0,810,438,326,484,0,27.91346153846154,255,54,40.899839743589745,13
Category_Wikipedia_sockpuppets_of_M-R-Schumacher.csv,1686,9832018.0,664,1022,500,164,0,33.55990510083037,250,56,25.584223013048636,11
Category_Wikipedia_sockpuppets_of_DavidWestT.csv,1437,105851549.0,501,936,500,1,0,61.88308977035491,255,63,18.028531663187195,3
Category_Wikipedia_sockpuppets_of_Nikhil_Srivastava.csv,1915,472603916.0,743,1172,500,243,0,56.96135770234987,500,54,16.371801566579634,4
Category_Wikipedia_sockpuppets_of_Mandalesshwar_Singh.csv,158,52395350.0,45,113,31,14,0,41.72784810126582,252,37,16.873417721518987,4
Category_Wikipedia_sockpuppets_of_Justanother2.csv,6580,37006788.0,1737,4843,500,1237,0,45.452887537993924,446,66,16.806686930091185,3
Category_Wikipedia_sockpuppets_of_Zzashley15zz.csv,1,0.0,1,0,1,0,26,26.0,26,27,27.0,27
Category_Wikipedia_sockpuppets_of_KieranT676.csv,843,4095620.0,275,568,64,211,0,32.15776986951364,225,36,18.627520759193356,2
Category_Wikipedia_sockpuppets_of_Lepricavark.csv,2848,152832051.0,998,1850,500,498,0,45.57373595505618,500,66,17.8813202247191,7
Category_Wikipedia_sockpuppets_of_Adamdaniel864.csv,396,51698579.0,86,310,75,11,0,56.361111111111114,303,43,17.81313131313131,10
Category_Wikipedia_sockpuppets_of_RodVanDam420.csv,539,7202326.0,165,374,40,125,0,39.95547309833024,255,49,14.673469387755102,8
Category_Wikipedia_sockpuppets_of_Oneboygreen.csv,412,93599226.0,142,270,106,36,0,49.08980582524272,265,64,16.37864077669903,4
Category_Wikipedia_sockpuppets_of_Viveckjoshi.csv,62,50052743.0,22,40,18,4,0,36.20967741935484,226,41,20.0,6
Category_Wikipedia_sockpuppets_of_Mustard1994.csv,11,56080.0,6,5,4,2,0,57.45454545454545,197,22,21.90909090909091,21
Category_Wikipedia_sockpuppets_of_Paleolithic1288.csv,1266,4902374.0,362,904,345,17,0,35.92259083728278,250,55,16.46129541864139,5
Category_Wikipedia_sockpuppets_of_Sqadgangsterkilla.csv,40,7796133.0,17,23,17,0,0,30.6,228,44,21.975,5
Category_Wikipedia_sockpuppets_of_WikiUser7.csv,813,7188914.0,231,582,137,94,0,56.87822878228782,250,79,20.333333333333332,4
Category_Wikipedia_sockpuppets_of_Xdigitalkhan.csv,3,4797.0,2,1,2,0,0,59.0,162,11,9.333333333333334,6
Category_Wikipedia_sockpuppets_of_Mhbent.csv,117,64205679.0,34,83,14,20,0,47.34188034188034,233,33,17.025641025641026,7
Category_Wikipedia_sockpuppets_of_Haboharri.csv,23,1180069.0,14,9,8,6,0,22.304347826086957,196,35,33.21739130434783,19
Category_Wikipedia_sockpuppets_of_BasilHero.csv,18,1548884.0,15,3,11,4,0,14.444444444444445,116,42,31.333333333333332,18
Category_Wikipedia_sockpuppets_of_Pez_Pharmaciticals.csv,5,569.0,2,3,1,1,27,71.0,169,21,19.8,19
Category_Wikipedia_sockpuppets_of_Kirbylevel4.csv,119,253225.0,81,38,81,0,0,32.27731092436975,182,29,19.69747899159664,12
Category_Wikipedia_sockpuppets_of_Cataconia.csv,773,2237029.0,340,433,268,72,0,72.58344113842173,252,47,26.847347994825355,12
Category_Wikipedia_sockpuppets_of_Jesus1239090909090909090.csv,4,285138.0,3,1,2,1,0,60.5,160,19,19.0,19
Category_Wikipedia_sockpuppets_of_The_Polka_Poker_Player.csv,33,11251812.0,12,21,3,9,0,55.39393939393939,199,40,21.90909090909091,14
Category_Wikipedia_sockpuppets_of_Ashermadan.csv,1348,79502346.0,538,810,500,38,0,52.416913946587535,255,54,19.367952522255194,8
Category_Wikipedia_sockpuppets_of_RossiLeone.csv,1464,30009694.0,468,996,458,10,0,45.64207650273224,369,69,18.779371584699454,3
Category_Wikipedia_sockpuppets_of_Ctsai1.csv,6,819.0,6,0,6,0,22,22.0,22,48,48.0,48
Category_Wikipedia_sockpuppets_of_NXWave.csv,85,1710200.0,17,68,14,3,0,65.3529411764706,200,54,27.305882352941175,8
Category_Wikipedia_sockpuppets_of_Waitemata.csv,2721,30906311.0,829,1892,500,329,0,55.48474825431826,379,176,22.846380007350238,1
Category_Wikipedia_sockpuppets_of_Tubslubeamorepersempre.csv,4662,114281057.0,1308,3354,320,988,0,51.63277563277563,482,64,16.15808665808666,4
Category_Wikipedia_sockpuppets_of_KnowIG.csv,5099,67167417.0,2024,3075,500,1524,0,49.6489507746617,264,97,25.928025102961364,5
Category_Wikipedia_sockpuppets_of_MYPETCARP.csv,436,17529092.0,203,233,138,65,0,65.5,304,80,16.048165137614678,3
Category_Wikipedia_sockpuppets_of_VentureKit.csv,24066,165283766.0,6060,18006,500,5560,0,50.57649796393252,504,115,15.83279315216488,2
Category_Wikipedia_sockpuppets_of_Toddlerbee12.csv,15,6790.0,6,9,4,2,0,71.86666666666666,208,21,14.333333333333334,9
Category_Wikipedia_sockpuppets_of_Worldanimalsfoundation.csv,24,754452.0,9,15,5,4,0,57.75,193,32,16.833333333333332,10
Category_Wikipedia_sockpuppets_of_Tolga4161.csv,416,74292.0,144,272,71,73,0,43.78365384615385,395,49,17.973557692307693,6
Category_Wikipedia_sockpuppets_of_DonaldTonald.csv,391,67192452.0,116,275,29,87,0,51.65217391304348,253,48,18.421994884910486,4
Category_Wikipedia_sockpuppets_of_Noyuchan.csv,1370,34738490.0,492,878,444,48,0,46.25693430656934,440,49,12.02992700729927,3
Category_Wikipedia_sockpuppets_of_Yummyanaljuices.csv,616,31103295.0,191,425,40,151,0,50.44155844155844,255,59,19.852272727272727,4
Category_Wikipedia_sockpuppets_of_Sunshot_Technologies.csv,6,250396.0,3,3,2,1,0,28.5,111,33,30.5,30
Category_Wikipedia_sockpuppets_of_Abdurrahman_Muslim.csv,250,2176922.0,76,174,38,38,0,57.94,243,61,23.64,4
Category_Wikipedia_sockpuppets_of_Cytowic.csv,449,5083346.0,218,231,212,6,0,36.89532293986637,248,50,17.5456570155902,7
Category_Wikipedia_sockpuppets_of_Adderz08.csv,577,133582240.0,226,351,222,4,0,45.85441941074524,255,52,20.003466204506065,6
Category_Wikipedia_sockpuppets_of_Manowiki123.csv,214,87182395.0,79,135,65,14,0,56.85981308411215,255,40,21.537383177570092,9
Category_Wikipedia_sockpuppets_of_Cmach7.csv,2423,97620255.0,743,1680,500,243,0,48.456871646718945,252,56,21.958728848534875,4
Category_Wikipedia_sockpuppets_of_Utpattiecom.csv,46,2569208.0,19,27,11,8,0,62.30434782608695,151,32,19.76086956521739,13
Category_Wikipedia_sockpuppets_of_Anna_Lao.csv,23,26891073.0,9,14,6,3,0,41.608695652173914,203,33,20.91304347826087,8
Category_Wikipedia_sockpuppets_of_RevGeorgeMcFly.csv,93,1204883.0,28,65,19,9,0,28.333333333333332,142,30,18.236559139784948,7
Category_Wikipedia_sockpuppets_of_Freelancer_Victor_G.csv,12,797.0,8,4,8,0,0,44.583333333333336,222,32,32.0,32
Category_Wikipedia_sockpuppets_of_Zoerecords.csv,20,36980890.0,5,15,4,1,0,27.15,127,53,33.5,17
Category_Wikipedia_sockpuppets_of_Yadavnagendra.csv,4,1200303.0,3,1,3,0,0,62.75,196,41,33.5,26
Category_Wikipedia_sockpuppets_of_OllieChurch.csv,32,69595.0,9,23,6,3,0,63.0625,213,22,11.3125,8
Category_Wikipedia_sockpuppets_of_Vishnu_S_Madappally.csv,36,15264598.0,18,18,18,0,0,51.05555555555556,325,80,25.055555555555557,6
Category_Wikipedia_sockpuppets_of_ReallyThinBread.csv,188,1909387.0,64,124,60,4,0,40.340425531914896,213,50,22.170212765957448,10
Category_Wikipedia_sockpuppets_of_Piingy.csv,73,44866964.0,24,49,24,0,0,42.657534246575345,184,16,9.32876712328767,4
Category_Wikipedia_sockpuppets_of_Giouliana.csv,535,3013646.0,179,356,21,158,0,41.63364485981308,438,53,18.31214953271028,5
Category_Wikipedia_sockpuppets_of_Muljan.csv,184,20728129.0,96,88,89,7,0,42.744565217391305,255,49,18.483695652173914,6
Category_Wikipedia_sockpuppets_of_Amanheheh337.csv,3792,73070254.0,1426,2366,229,1197,0,40.430116033755276,498,78,31.21492616033755,3
Category_Wikipedia_sockpuppets_of_Art4em.csv,1902,235930339.0,700,1202,500,200,0,46.14879074658254,255,139,22.119348054679286,6
Category_Wikipedia_sockpuppets_of_Onems13subh.csv,32,1027013.0,12,20,10,2,0,57.96875,215,45,29.34375,21
Category_Wikipedia_sockpuppets_of_RockingSummer.csv,1243,191988688.0,475,768,473,2,0,44.3266291230893,474,67,22.625905068382945,3
Category_Wikipedia_sockpuppets_of_Deadpool992.csv,1979,4578901.0,620,1359,500,120,0,26.788276907529056,200,60,18.803941384537644,3
Category_Wikipedia_sockpuppets_of_Muhammadahmad79.csv,1818,131194195.0,572,1246,500,72,0,52.74147414741474,442,86,16.503300330033003,3
Category_Wikipedia_sockpuppets_of_ProfDave1970.csv,5,1326.0,4,1,4,0,25,89.4,182,22,14.8,10
Category_Wikipedia_sockpuppets_of_OSHMS.csv,16,1189133.0,15,1,10,5,0,7.8125,40,19,18.375,18
Category_Wikipedia_sockpuppets_of_Hiineedrequestforcomment.csv,497,2788750.0,167,330,134,33,0,54.08651911468813,249,57,24.93963782696177,11
Category_Wikipedia_sockpuppets_of_Andeating56.csv,59,74453.0,30,29,19,11,0,57.6271186440678,259,27,12.423728813559322,4
Category_Wikipedia_sockpuppets_of_Olaoluwa_tinko.csv,1,0.0,1,0,1,0,58,58.0,58,16,16.0,16
Category_Wikipedia_sockpuppets_of_NlGGERKlLLER.csv,14,2969151.0,5,9,3,2,0,61.07142857142857,239,39,24.571428571428573,19
Category_Wikipedia_sockpuppets_of_HistoryPK14.csv,10,57008.0,7,3,4,3,0,65.4,194,35,24.9,19
Category_Wikipedia_sockpuppets_of_Benjetson.csv,523,7243376.0,145,378,78,67,0,49.58699808795411,255,46,19.64244741873805,5
Category_Wikipedia_sockpuppets_of_Mark_W._Rocha.csv,91,1015611.0,51,40,42,9,0,43.46153846153846,253,24,16.087912087912088,13
Category_Wikipedia_sockpuppets_of_Tipraland.csv,9,10598.0,6,3,2,4,0,32.0,201,9,9.0,9
Category_Wikipedia_sockpuppets_of_Dont_block_me_please_i_beg_you.csv,2,0.0,1,1,1,0,5,5.0,5,8,8.0,8
Category_Wikipedia_sockpuppets_of_Tmcraptree.csv,3,381.0,2,1,2,0,0,40.333333333333336,121,35,35.0,35
Category_Wikipedia_sockpuppets_of_Roohollah1988.csv,585,45769661.0,189,396,189,0,0,44.805128205128206,243,32,18.495726495726494,3
Category_Wikipedia_sockpuppets_of_AyaanKapoor.csv,13,209511.0,8,5,6,2,0,31.0,133,23,22.384615384615383,21
Category_Wikipedia_sockpuppets_of_CookieMonster755.csv,1568,284862799.0,558,1010,500,58,0,54.40625,496,73,23.778061224489797,3
Category_Wikipedia_sockpuppets_of_Nikokiris.csv,1084,76934883.0,353,731,146,207,0,52.351476014760145,500,71,26.038745387453876,3
Category_Wikipedia_sockpuppets_of_EuphonyRandolph.csv,860,262147539.0,310,550,119,191,0,50.36976744186047,279,52,22.911627906976744,4
Category_Wikipedia_sockpuppets_of_Musicatransaction.csv,20,67834.0,14,6,9,5,0,31.4,201,27,14.2,11
Category_Wikipedia_sockpuppets_of_Philippinesfan.csv,3168,49821436.0,1196,1972,209,987,0,39.513888888888886,404,56,15.341540404040405,3
Category_Wikipedia_sockpuppets_of_Mamuta_Shakieya.csv,186,1931104.0,85,101,33,52,0,48.096774193548384,307,58,28.306451612903224,8
Category_Wikipedia_sockpuppets_of_Lilsonic.csv,66,311121439.0,19,47,14,5,0,53.484848484848484,206,44,20.151515151515152,6
Category_Wikipedia_sockpuppets_of_Kfahdjr.csv,82,5212622.0,39,43,37,2,0,51.4390243902439,208,44,12.463414634146341,4
Category_Wikipedia_sockpuppets_of_ChinaHistorian.csv,337,27268594.0,124,213,113,11,0,53.86350148367953,219,54,16.949554896142434,7
Category_Wikipedia_sockpuppets_of_SjwishFreak.csv,225,372365.0,78,147,49,29,0,61.51555555555556,208,73,28.52,8
Category_Wikipedia_sockpuppets_of_1292simon.csv,8,886.0,5,3,5,0,28,49.375,78,36,27.125,9
Category_Wikipedia_sockpuppets_of_Liam7.csv,312,2851017.0,169,143,144,25,0,35.092948717948715,200,60,14.423076923076923,7
Category_Wikipedia_sockpuppets_of_Israwatipratiwijefri.csv,5,320311.0,2,3,1,1,0,91.0,161,36,27.2,14
Category_Wikipedia_sockpuppets_of_Mattwebb11.csv,55,171820163.0,14,41,12,2,0,50.872727272727275,183,48,16.89090909090909,3
Category_Wikipedia_sockpuppets_of_Hisham78699.csv,143,19183819.0,55,88,55,0,0,39.95104895104895,253,47,20.51048951048951,6
Category_Wikipedia_sockpuppets_of_Enkiofarcadia.csv,164,147604895.0,41,123,35,6,0,42.51829268292683,239,53,20.024390243902438,12
Category_Wikipedia_sockpuppets_of_BeamAlexander25.csv,1554,2294499.0,531,1023,500,31,0,80.72779922779922,427,77,24.879021879021877,4
Category_Wikipedia_sockpuppets_of_P._Nisse_Mann.csv,69,244736.0,20,49,10,10,0,42.3768115942029,234,33,14.971014492753623,3
Category_Wikipedia_sockpuppets_of_LouisNMcDonald.csv,42,47001304.0,19,23,14,5,0,36.61904761904762,262,43,35.5,11
Category_Wikipedia_sockpuppets_of_Akanemoto.csv,1681,62150765.0,505,1176,500,5,0,31.519333729922664,244,70,10.023200475907197,3
Category_Wikipedia_sockpuppets_of_Dick_Witham.csv,3644,111793936.0,1347,2297,134,1213,0,34.95389681668496,213,57,22.626783754116357,4
Category_Wikipedia_sockpuppets_of_Homealone1990.csv,976,203334890.0,302,674,210,92,0,48.57069672131148,255,57,16.170081967213115,5
Category_Wikipedia_sockpuppets_of_Voyevoda.csv,1961,47084883.0,602,1359,500,102,0,41.36460989291178,250,50,16.371749107598163,3
Category_Wikipedia_sockpuppets_of_Kervyacob.csv,10,1644.0,7,3,6,1,20,56.0,149,20,20.0,20
Category_Wikipedia_sockpuppets_of_Tasos90.csv,1346,74293551.0,438,908,269,169,0,43.90193164933135,221,49,18.12852897473997,5
Category_Wikipedia_sockpuppets_of_Syun_respect_for_music.csv,1141,221453373.0,494,647,454,40,0,37.60210341805434,350,35,17.1034180543383,8
Category_Wikipedia_sockpuppets_of_Teenupnaarp.csv,63,777137.0,47,16,29,18,0,25.428571428571427,196,70,32.36507936507937,21
Category_Wikipedia_sockpuppets_of_SCHUYLER1.csv,51,24886358.0,16,35,7,9,0,49.705882352941174,199,45,18.607843137254903,10
Category_Wikipedia_sockpuppets_of_LoVleyAhmed.csv,506,12305221.0,254,252,128,126,0,33.112648221343875,442,28,14.960474308300395,5
Category_Wikipedia_sockpuppets_of_Ericdaster.csv,191,5360055.0,46,145,13,33,0,48.712041884816756,279,78,20.56020942408377,4
Category_Wikipedia_sockpuppets_of_Editsnowy.csv,60,3185137.0,22,38,7,15,0,51.93333333333333,229,15,14.3,14
Category_Wikipedia_sockpuppets_of_Thandi_moyo.csv,225,4669459.0,82,143,78,4,0,53.18222222222222,240,44,17.053333333333335,5
Category_Wikipedia_sockpuppets_of_Reijiro.csv,1641,341354624.0,596,1045,500,96,0,40.31200487507617,462,55,19.209628275441805,3
Category_Wikipedia_sockpuppets_of_Dylannovacekdog.csv,33,10655489.0,9,24,8,1,0,39.121212121212125,152,28,16.939393939393938,11
Category_Wikipedia_sockpuppets_of_Wicked_maiden.csv,72,7100670.0,44,28,44,0,0,15.444444444444445,148,18,16.166666666666668,12
Category_Wikipedia_sockpuppets_of_BusinessMan077.csv,171,764960.0,54,117,16,38,0,64.09941520467837,284,46,16.23391812865497,5
Category_Wikipedia_sockpuppets_of_Theonewithreason.csv,2297,117770619.0,595,1702,500,95,0,60.99695254680017,500,61,24.676099259904223,3
Category_Wikipedia_sockpuppets_of_Ovid99.csv,3516,4217601.0,1424,2092,500,924,0,44.52758816837315,374,57,17.868316268486918,5
Category_Wikipedia_sockpuppets_of_Hardkid.csv,19,1362.0,9,10,9,0,0,36.63157894736842,137,35,18.157894736842106,8
Category_Wikipedia_sockpuppets_of_Manofculture78.csv,52,20985937.0,27,25,13,14,0,50.90384615384615,255,61,19.384615384615383,12
Category_Wikipedia_sockpuppets_of_Frank_Kreitcherburg.csv,157,990708.0,59,98,44,15,0,45.63694267515923,363,30,14.464968152866241,6
Category_Wikipedia_sockpuppets_of_Epeclect.csv,50,169303.0,23,27,23,0,0,38.18,204,47,27.16,13
Category_Wikipedia_sockpuppets_of_Sudev_Vijay.csv,472,4920760.0,172,300,170,2,0,33.88771186440678,409,61,19.156779661016948,6
Category_Wikipedia_sockpuppets_of_A10223.csv,85,1715096.0,23,62,15,8,0,47.4,174,28,16.08235294117647,4
Category_Wikipedia_sockpuppets_of_Rosinaharris.csv,134,21714573.0,58,76,12,46,0,37.43283582089552,137,46,19.388059701492537,8
Category_Wikipedia_sockpuppets_of_Worldwar1989.csv,4617,59298470.0,1121,3496,500,621,0,49.432748538011694,496,78,22.928525016244315,4
Category_Wikipedia_sockpuppets_of_Krejasibergj333.csv,4025,103326502.0,1002,3023,500,502,0,29.80695652173913,239,47,15.26608695652174,4
Category_Wikipedia_sockpuppets_of_BSPanther18.csv,534,319899951.0,175,359,97,78,0,55.70973782771536,476,36,19.226591760299627,6
Category_Wikipedia_sockpuppets_of_SupremeCommander85.csv,295,9981605.0,89,206,85,4,0,38.779661016949156,227,51,21.969491525423727,7
Category_Wikipedia_sockpuppets_of_Aawjgnekr.csv,3335,68758097.0,1191,2144,500,691,0,45.70494752623688,255,74,18.255172413793105,3
Category_Wikipedia_sockpuppets_of_LadyGaga2015.csv,272,46198711.0,72,200,12,60,0,52.11029411764706,254,42,26.790441176470587,11
Category_Wikipedia_sockpuppets_of_Nydamic123.csv,113,3905.0,38,75,18,20,0,41.49557522123894,150,46,18.68141592920354,4
Category_Wikipedia_sockpuppets_of_Erfhuiwry3987r3.csv,7,301.0,5,2,1,4,76,100.85714285714286,202,3,3.0,3
Category_Wikipedia_sockpuppets_of_HyperTransfer.csv,7,6988.0,5,2,5,0,0,77.85714285714286,193,23,22.285714285714285,18
Category_Wikipedia_sockpuppets_of_Fa8479.csv,962,210476328.0,353,609,236,117,0,43.51143451143451,453,45,20.422037422037423,7
Category_Wikipedia_sockpuppets_of_Annabananaxii.csv,3270,92041410.0,1035,2235,194,841,0,39.822324159021406,500,62,22.631498470948014,1
Category_Wikipedia_sockpuppets_of_A_a_p√∂_yl√§.csv,21,51947.0,15,6,9,6,0,20.714285714285715,130,20,15.523809523809524,12
Category_Wikipedia_sockpuppets_of_James245012.csv,356,85304954.0,170,186,84,86,0,35.55337078651685,240,53,23.348314606741575,11
Category_Wikipedia_sockpuppets_of_BostikLeague.csv,13,173703.0,9,4,5,4,0,34.84615384615385,179,26,21.153846153846153,16
Category_Wikipedia_sockpuppets_of_Deepakgietmca.csv,22,69270074.0,8,14,5,3,6,45.45454545454545,177,26,18.59090909090909,11
Category_Wikipedia_sockpuppets_of_Joeptchjijihhtgghbyjhhmkkkl.csv,2680,56035676.0,895,1785,392,503,0,56.58171641791045,500,57,21.594029850746267,4
Category_Wikipedia_sockpuppets_of_Freeknowledgecreator.csv,5562,233267098.0,1500,4062,500,1000,0,48.94552319309601,490,77,26.29737504494786,4
Category_Wikipedia_sockpuppets_of_SpecialFXavier.csv,165,89865068.0,60,105,50,10,0,69.04242424242425,253,50,26.042424242424243,13
Category_Wikipedia_sockpuppets_of_IM_TEM.csv,13,1373.0,7,6,3,4,16,62.84615384615385,187,26,13.923076923076923,12
Category_Wikipedia_sockpuppets_of_Persia2.csv,2410,6820185.0,482,1928,179,303,0,45.21535269709543,250,51,15.96390041493776,3
Category_Wikipedia_sockpuppets_of_Andrewwikiedit.csv,2634,32532082.0,923,1711,500,423,0,42.48367501898254,258,55,22.739939255884586,4
Category_Wikipedia_sockpuppets_of_Anna_Pask.csv,162,8613866.0,52,110,29,23,0,42.25308641975309,290,23,13.851851851851851,11
Category_Wikipedia_sockpuppets_of_RadoslawDav.csv,24,8044.0,12,12,7,5,0,102.91666666666667,495,29,16.333333333333332,9
Category_Wikipedia_sockpuppets_of_HN4131741.csv,192,117431902.0,74,118,40,34,0,41.744791666666664,229,28,21.255208333333332,7
Category_Wikipedia_sockpuppets_of_Filipz123.csv,4710,160945531.0,1144,3566,147,997,0,53.12696390658174,498,64,17.768152866242037,3
Category_Wikipedia_sockpuppets_of_Sacchuras.csv,99,802886.0,37,62,15,22,0,40.24242424242424,210,43,11.717171717171718,4
Category_Wikipedia_sockpuppets_of_Tennischeck.csv,34,360671.0,21,13,11,10,0,23.794117647058822,92,48,28.11764705882353,9
Category_Wikipedia_sockpuppets_of_Comebackproductions.csv,123,100959888.0,36,87,34,2,0,53.13008130081301,247,43,22.504065040650406,15
Category_Wikipedia_sockpuppets_of_Callmeanxious.csv,123,45351247.0,41,82,22,19,0,26.96747967479675,188,53,19.6260162601626,11
Category_Wikipedia_sockpuppets_of_Jacob2727.csv,198,44313005.0,75,123,75,0,0,59.44949494949495,221,44,27.141414141414142,11
Category_Wikipedia_sockpuppets_of_H3sam91.csv,278,1895124.0,137,141,122,15,0,65.5863309352518,287,42,39.093525179856115,17
Category_Wikipedia_sockpuppets_of_Jemappelleungarcon.csv,2102,3491596.0,727,1375,500,227,0,43.96907706945766,255,50,20.65509039010466,4
Category_Wikipedia_sockpuppets_of_Zaheer_UD_Din_Babar_(ZUB).csv,5,353787.0,2,3,1,1,0,24.4,82,61,32.2,25
Category_Wikipedia_sockpuppets_of_360sport.csv,12,174940.0,4,8,2,2,8,62.5,106,33,20.166666666666668,18
Category_Wikipedia_sockpuppets_of_Samrecods2021.csv,6,8712.0,5,1,3,2,11,80.0,185,18,13.0,11
Category_Wikipedia_sockpuppets_of_Kristy22.csv,780,5173421.0,286,494,127,159,0,36.85769230769231,218,54,20.96025641025641,9
Category_Wikipedia_sockpuppets_of_Dallascowboysftw.csv,1806,289497492.0,509,1297,500,9,0,46.04761904761905,345,67,23.189922480620154,8
Category_Wikipedia_sockpuppets_of_Cmd368.csv,24,11329.0,24,0,24,0,0,70.20833333333333,103,30,23.541666666666668,15
Category_Wikipedia_sockpuppets_of_Penguinsruleman.csv,82,3996578.0,36,46,18,18,0,67.70731707317073,231,26,17.195121951219512,6
Category_Wikipedia_sockpuppets_of_Check77.csv,529,16787205.0,183,346,170,13,0,38.51039697542533,243,50,23.964083175803403,5
Category_Wikipedia_sockpuppets_of_Pokemon315066.csv,1156,196106218.0,409,747,387,22,0,41.858131487889274,255,61,27.740484429065745,16
Category_Wikipedia_sockpuppets_of_Earthling504.csv,74,315863653.0,19,55,10,9,0,45.24324324324324,186,45,34.486486486486484,22
Category_Wikipedia_sockpuppets_of_Xesteak.csv,8,122975.0,7,1,6,1,50,66.125,134,34,34.0,34
Category_Wikipedia_sockpuppets_of_Bluefrog854759.csv,136,881332.0,47,89,17,30,0,51.286764705882355,500,40,24.78676470588235,12
Category_Wikipedia_sockpuppets_of_Blue_Barette_Bam.csv,311,293403501.0,104,207,30,74,0,55.5016077170418,376,54,18.983922829581992,4
Category_Wikipedia_sockpuppets_of_12Rolando.csv,61,97514260.0,20,41,19,1,0,28.19672131147541,164,34,11.180327868852459,7
Category_Wikipedia_sockpuppets_of_Lotus109.csv,590,57396535.0,166,424,72,94,0,60.208474576271186,435,47,15.915254237288135,5
Category_Wikipedia_sockpuppets_of_Ricardojoseph20052010.csv,512,130191401.0,143,369,26,117,0,45.4765625,277,40,16.513671875,5
Category_Wikipedia_sockpuppets_of_3MalteseFalcons.csv,54,6652618.0,18,36,5,13,0,70.01851851851852,199,23,12.0,9
Category_Wikipedia_sockpuppets_of_Pickles0001.csv,7,7566.0,5,2,4,1,0,129.57142857142858,200,21,21.0,21
Category_Wikipedia_sockpuppets_of_Rajeshkumar999.csv,225,85677680.0,81,144,50,31,0,46.23555555555556,209,47,18.288888888888888,5
Category_Wikipedia_sockpuppets_of_A22ount.csv,1405,94540154.0,549,856,500,49,0,31.39928825622776,253,52,19.908896797153027,5
Category_Wikipedia_sockpuppets_of_TheLastOfTheGiants.csv,797,17715602.0,216,581,209,7,0,57.48808030112924,500,65,26.70012547051443,10
Category_Wikipedia_sockpuppets_of_Editor_XXV.csv,3872,47609010.0,1380,2492,500,880,0,44.98372933884298,255,228,28.567665289256198,4
Category_Wikipedia_sockpuppets_of_Roniboy03.csv,86,72671296.0,31,55,13,18,0,36.325581395348834,181,56,24.406976744186046,17
Category_Wikipedia_sockpuppets_of_Aleksandr_suvorov.csv,25,8997085.0,8,17,6,2,0,64.04,226,21,13.48,4
Category_Wikipedia_sockpuppets_of_Patrick_Mcdermott25.csv,1578,49506368.0,422,1156,317,105,0,60.80608365019011,499,73,18.050697084917616,3
Category_Wikipedia_sockpuppets_of_JovanAndreano.csv,2196,140795158.0,633,1563,206,427,0,42.20992714025501,255,51,14.077413479052824,3
Category_Wikipedia_sockpuppets_of_Dokestheamazing.csv,44,29368263.0,11,33,11,0,0,51.81818181818182,224,31,14.681818181818182,7
Category_Wikipedia_sockpuppets_of_EditorIslam.csv,64,8554803.0,29,35,25,4,0,64.984375,199,19,13.25,11
Category_Wikipedia_sockpuppets_of_Sprayitchyo.csv,18266,171052463.0,5634,12632,500,5134,0,40.40605496550969,490,95,18.850541990583597,4
Category_Wikipedia_sockpuppets_of_InPursuitOfAMorePerfectUnion.csv,3322,21758898.0,1041,2281,500,541,0,45.305237808549066,498,61,19.927152317880793,3
Category_Wikipedia_sockpuppets_of_Adnarkey.csv,168,88433.0,63,105,39,24,0,60.44047619047619,235,25,16.428571428571427,8
Category_Wikipedia_sockpuppets_of_Robert_Blair.csv,1228,28275656.0,526,702,500,26,0,36.11319218241042,226,56,19.098534201954397,6
Category_Wikipedia_sockpuppets_of_Space_in_face.csv,29,984.0,16,13,8,8,0,40.51724137931034,104,28,23.20689655172414,13
Category_Wikipedia_sockpuppets_of_Joltzipper.csv,444,47513287.0,192,252,190,2,0,59.950450450450454,255,25,13.707207207207206,8
Category_Wikipedia_sockpuppets_of_Zeitgeist-Movement-Member.csv,157,5106150.0,89,68,42,47,8,40.29299363057325,251,35,27.40764331210191,24
Category_Wikipedia_sockpuppets_of_Novotitle.csv,9,350.0,5,4,3,2,0,27.666666666666668,114,21,15.222222222222221,11
Category_Wikipedia_sockpuppets_of_Krisdas.csv,62,288262.0,36,26,18,18,0,43.354838709677416,242,25,16.951612903225808,13
Category_Wikipedia_sockpuppets_of_John_Daker.csv,7903,331159169.0,2498,5405,500,1998,0,51.74161710742756,395,103,22.428824497026447,2
Category_Wikipedia_sockpuppets_of_JFBurton.csv,2094,320634883.0,551,1543,500,51,0,42.53772683858644,250,58,18.314708691499522,4
Category_Wikipedia_sockpuppets_of_Sounderk.csv,769,214521632.0,310,459,170,140,0,58.751625487646294,499,44,19.621586475942784,9
Category_Wikipedia_sockpuppets_of_Gp75motorsports.csv,490,45647164.0,170,320,117,53,0,50.648979591836735,223,71,23.585714285714285,5
Category_Wikipedia_sockpuppets_of_Gregkarais.csv,1050,70932251.0,374,676,275,99,0,44.179047619047616,254,117,16.595238095238095,4
Category_Wikipedia_sockpuppets_of_Moetzes.csv,364,2165878.0,138,226,114,24,0,54.01648351648352,252,47,19.928571428571427,5
Category_Wikipedia_sockpuppets_of_Ni10God.csv,8,19196434.0,8,0,7,1,0,65.875,194,28,23.75,23
Category_Wikipedia_sockpuppets_of_Lyricalmigibalvd.csv,156,140776886.0,44,112,4,40,0,51.18589743589744,294,31,24.03205128205128,10
Category_Wikipedia_sockpuppets_of_Michaelism_X.csv,5,629733.0,4,1,3,1,0,85.8,197,19,18.2,17
Category_Wikipedia_sockpuppets_of_Ordenrecords.csv,39,7472800.0,29,10,16,13,0,41.64102564102564,167,26,19.641025641025642,15
Category_Wikipedia_sockpuppets_of_Huik01.csv,734,96505918.0,233,501,129,104,0,46.321525885558586,248,57,19.681198910081743,3
Category_Wikipedia_sockpuppets_of_Capulet1.csv,310,289373349.0,106,204,75,31,0,41.94193548387097,197,69,26.838709677419356,8
Category_Wikipedia_sockpuppets_of_Catcrazy5.csv,145,10776815.0,50,95,44,6,0,57.227586206896554,216,30,15.855172413793104,3
Category_Wikipedia_sockpuppets_of_Colombiabeauty.csv,2948,14549672.0,871,2077,500,371,0,28.72761194029851,255,48,17.957937584803258,5
Category_Wikipedia_sockpuppets_of_Anish_Kayamkulam.csv,107,81636442.0,37,70,21,16,0,50.54205607476636,253,41,21.065420560747665,6
Category_Wikipedia_sockpuppets_of_Rnavjr0405.csv,246,4760705.0,97,149,83,14,0,41.4390243902439,255,34,14.83739837398374,9
Category_Wikipedia_sockpuppets_of_Basq6587.csv,1040,33681846.0,300,740,197,103,0,52.43653846153846,489,41,15.6,6
Category_Wikipedia_sockpuppets_of_Rolandhelper.csv,1524,27041705.0,512,1012,253,259,0,47.82086614173228,255,53,18.22244094488189,4
Category_Wikipedia_sockpuppets_of_EdiTHORial.csv,962,160274756.0,246,716,138,108,0,65.87214137214137,392,62,16.034303534303536,3
Category_Wikipedia_sockpuppets_of_9k7kq3.csv,1048,103605466.0,250,798,216,34,0,45.62213740458015,255,73,24.419847328244273,3
Category_Wikipedia_sockpuppets_of_ResearchingSI.csv,12,3068699.0,4,8,3,1,0,38.333333333333336,115,13,13.0,13
Category_Wikipedia_sockpuppets_of_Bad_good_dragosh98.csv,2289,43620893.0,856,1433,278,578,0,26.731323722149412,253,40,17.72083879423329,4
Category_Wikipedia_sockpuppets_of_Briannawayland.csv,19,877964.0,8,11,4,4,0,82.63157894736842,249,18,15.736842105263158,15
Category_Wikipedia_sockpuppets_of_DipanwitaDatta0.csv,13,11130612.0,8,5,5,3,0,44.15384615384615,196,51,22.307692307692307,7
Category_Wikipedia_sockpuppets_of_Bouket.csv,1555,58549867.0,418,1137,359,59,0,44.22379421221865,270,59,24.356913183279744,4
Category_Wikipedia_sockpuppets_of_161.73.32.132.csv,8,27379.0,5,3,5,0,0,49.125,147,20,16.25,15
Category_Wikipedia_sockpuppets_of_Huyu90.csv,3267,16515720.0,1364,1903,500,864,0,36.272421181512094,517,89,21.349556167737987,4
Category_Wikipedia_sockpuppets_of_Asaphsarrows.csv,54,39433012.0,29,25,18,11,0,51.18518518518518,493,25,18.85185185185185,14
Category_Wikipedia_sockpuppets_of_KibangaWiki.csv,250,6704998.0,90,160,33,57,0,54.316,496,34,16.068,8
Category_Wikipedia_sockpuppets_of_Sumonrahman.csv,1293,252179277.0,470,823,468,2,0,36.52049497293117,286,50,21.470997679814385,4
Category_Wikipedia_sockpuppets_of_Knetbook.csv,73,23843971.0,31,42,23,8,0,35.12328767123287,163,37,23.767123287671232,12
Category_Wikipedia_sockpuppets_of_Mychicken4444.csv,849,13476525.0,242,607,121,121,0,42.95406360424028,255,47,15.371024734982333,3
Category_Wikipedia_sockpuppets_of_Normartin21.csv,14,19755176.0,9,5,6,3,0,30.214285714285715,196,31,14.5,10
Category_Wikipedia_sockpuppets_of_Coder196.csv,79,3018659.0,32,47,21,11,0,37.11392405063291,232,53,32.45569620253165,10
Category_Wikipedia_sockpuppets_of_Mohdtalib2.csv,88,4783577.0,32,56,19,13,0,55.23863636363637,363,22,15.545454545454545,10
Category_Wikipedia_sockpuppets_of_Countryboyjohn.csv,47,8394118.0,13,34,13,0,0,35.851063829787236,199,32,17.51063829787234,10
Category_Wikipedia_sockpuppets_of_Veracitycounts.csv,93,1939369.0,37,56,35,2,0,41.376344086021504,179,24,19.021505376344088,7
Category_Wikipedia_sockpuppets_of_Saatvik.Jacob_Material_Scientist.csv,1207,85383502.0,444,763,153,291,0,42.31483015741508,287,76,15.491300745650372,4
Category_Wikipedia_sockpuppets_of_Sana148.csv,161,572390.0,54,107,14,40,0,44.732919254658384,250,41,21.25465838509317,7
Category_Wikipedia_sockpuppets_of_Geeky1127.csv,1988,54403775.0,870,1118,362,508,0,44.58249496981891,498,71,39.91197183098591,4
Category_Wikipedia_sockpuppets_of_BUZZLIGHTYEAR99.csv,2747,113971540.0,752,1995,368,384,0,58.41754641427011,500,73,21.47834000728067,4
Category_Wikipedia_sockpuppets_of_BarzanPDK18.csv,3480,185644949.0,1049,2431,162,887,0,35.84310344827586,255,49,15.946551724137931,3
Category_Wikipedia_sockpuppets_of_Djjesse123.csv,495,28139816.0,124,371,100,24,0,37.10909090909091,232,40,17.713131313131314,8
Category_Wikipedia_sockpuppets_of_Haris_Sharif_Mohammad.csv,38,70747387.0,9,29,7,2,0,35.26315789473684,189,47,18.157894736842106,10
Category_Wikipedia_sockpuppets_of_PabasaraJayakody.csv,79,1256406.0,25,54,13,12,0,52.278481012658226,232,33,18.139240506329113,8
Category_Wikipedia_sockpuppets_of_Holding_the_trophy.csv,226,7798216.0,60,166,8,52,0,47.557522123893804,384,61,25.424778761061948,6
Category_Wikipedia_sockpuppets_of_Same_As_It_Ever_Was.csv,2118,20324558.0,699,1419,500,199,0,36.78328611898017,261,68,19.652030217186024,3
Category_Wikipedia_sockpuppets_of_Iamanunkownuser.csv,17,360299.0,10,7,7,3,0,44.705882352941174,136,28,17.352941176470587,10
Category_Wikipedia_sockpuppets_of_PureFire.csv,538,29207181.0,125,413,66,59,0,33.21747211895911,200,47,17.16171003717472,3
Category_Wikipedia_sockpuppets_of_ClimateFictions12345.csv,394,7081141.0,134,260,49,85,0,45.61675126903553,254,45,16.997461928934012,5
Category_Wikipedia_sockpuppets_of_Edwards_Scholar.csv,206,676709.0,63,143,54,9,0,50.907766990291265,183,51,19.71359223300971,7
Category_Wikipedia_sockpuppets_of_AlonaBalicao.csv,114,1193721.0,43,71,40,3,0,40.99122807017544,255,24,14.18421052631579,11
Category_Wikipedia_sockpuppets_of_SonicClub.csv,1636,75070347.0,522,1114,500,22,0,42.37347188264059,337,56,22.02567237163814,5
Category_Wikipedia_sockpuppets_of_Si_Thu_Moe_Min.csv,280,115518855.0,117,163,20,97,0,47.832142857142856,331,53,22.303571428571427,6
Category_Wikipedia_sockpuppets_of_Mohatu2020.csv,60,25566565.0,40,20,27,13,0,33.71666666666667,237,30,22.533333333333335,14
Category_Wikipedia_sockpuppets_of_ÿπŸÑŸä_ÿ£ÿ®Ÿà_ÿπŸÖÿ±.csv,2738,208337233.0,1008,1730,225,783,0,45.826515704894085,496,66,21.43864134404675,4
Category_Wikipedia_sockpuppets_of_Gillyh.csv,466,32400200.0,103,363,103,0,0,43.062231759656655,248,40,16.130901287553648,10
Category_Wikipedia_sockpuppets_of_Littleowl94.csv,24,3671.0,16,8,9,7,0,30.625,85,67,51.0,43
Category_Wikipedia_sockpuppets_of_Justice4shanta.csv,14,141226.0,10,4,6,4,0,78.07142857142857,210,6,6.0,6
Category_Wikipedia_sockpuppets_of_Andrewixl1.csv,3,36.0,2,1,2,0,0,46.666666666666664,140,14,14.0,14
Category_Wikipedia_sockpuppets_of_Nariman.kirgizbaev.csv,135,20741449.0,44,91,25,19,0,61.837037037037035,193,54,21.014814814814816,8
Category_Wikipedia_sockpuppets_of_Javamen.csv,880,82860379.0,278,602,145,133,0,41.32272727272727,231,62,18.39318181818182,5
Category_Wikipedia_sockpuppets_of_Cynthia_Ann_Christine_Rothrock.csv,131,27641473.0,43,88,16,27,0,57.396946564885496,323,42,21.946564885496183,12
Category_Wikipedia_sockpuppets_of_Phi2012.csv,86,41736447.0,18,68,18,0,0,50.83720930232558,224,17,13.232558139534884,13
Category_Wikipedia_sockpuppets_of_Inet_read.csv,18,692507.0,10,8,7,3,0,51.27777777777778,135,17,17.0,17
Category_Wikipedia_sockpuppets_of_NedicFan88.csv,105,7583220.0,41,64,13,28,0,61.75238095238095,396,45,28.20952380952381,17
Category_Wikipedia_sockpuppets_of_Captainclegg.csv,1744,24070663.0,587,1157,500,87,0,45.37729357798165,254,50,15.282683486238533,5
Category_Wikipedia_sockpuppets_of_No_name_2365.csv,265,23334085.0,75,190,36,39,0,48.04150943396226,321,82,19.59245283018868,4
Category_Wikipedia_sockpuppets_of_Cantseeshit.csv,40,62578.0,36,4,21,15,0,11.4,160,31,10.15,5
Category_Wikipedia_sockpuppets_of_Amitbellavita.csv,136,1985473.0,36,100,22,14,0,45.786764705882355,283,39,20.558823529411764,7
Category_Wikipedia_sockpuppets_of_Ouvaismahrus.csv,8,6118886.0,6,2,4,2,0,46.125,153,24,22.375,19
Category_Wikipedia_sockpuppets_of_Investreport.csv,4,585316.0,4,0,2,2,35,45.75,78,61,52.0,25
Category_Wikipedia_sockpuppets_of_Scottycraig.csv,283,3197668.0,125,158,88,37,0,38.724381625441694,255,32,14.353356890459365,4
Category_Wikipedia_sockpuppets_of_Tyciol.csv,11619,391095251.0,3629,7990,500,3129,0,50.03752474395387,494,76,18.353300628281264,2
Category_Wikipedia_sockpuppets_of_Soy_Hermoso.csv,1578,22637830.0,394,1184,226,168,0,36.20342205323194,255,53,25.05386565272497,5
Category_Wikipedia_sockpuppets_of_B.Bhargava_Teja.csv,1730,160779756.0,628,1102,500,128,0,31.872254335260116,487,34,17.24971098265896,6
Category_Wikipedia_sockpuppets_of_TITIT55.csv,20,604706.0,9,11,4,5,0,51.15,213,25,19.95,16
Category_Wikipedia_sockpuppets_of_GIorius_Engine.csv,34,415956.0,14,20,4,10,0,85.29411764705883,496,33,24.764705882352942,12
Category_Wikipedia_sockpuppets_of_Lndpunjab.csv,481,1896217.0,167,314,62,105,0,40.020790020790024,250,31,9.69022869022869,4
Category_Wikipedia_sockpuppets_of_Chaplinmark.csv,2,0.0,1,1,1,0,15,15.0,15,41,41.0,41
Category_Wikipedia_sockpuppets_of_Cow_cleaner_5000.csv,5941,287062905.0,1576,4365,500,1076,0,76.67715872748695,401,100,23.279750883689616,3
Category_Wikipedia_sockpuppets_of_Marmidukay.csv,6937,30381468.0,2023,4914,500,1523,0,55.03603863341502,500,70,19.111863918120225,3
Category_Wikipedia_sockpuppets_of_Isabelamadrigal3737.csv,88,442354.0,28,60,14,14,0,60.47727272727273,494,27,18.386363636363637,12
Category_Wikipedia_sockpuppets_of_BluegrassCompanies.csv,117,4046072.0,50,67,13,37,0,42.26495726495727,255,51,23.555555555555557,8
Category_Wikipedia_sockpuppets_of_Thescarid.csv,438,362368248.0,157,281,149,8,0,56.31050228310502,558,39,15.30365296803653,6
Category_Wikipedia_sockpuppets_of_Lola.2580.csv,63,42934458.0,20,43,17,3,0,70.0,249,28,15.412698412698413,7
Category_Wikipedia_sockpuppets_of_Nowaaaaay.csv,29,947937.0,19,10,10,9,0,65.72413793103448,174,23,18.310344827586206,16
Category_Wikipedia_sockpuppets_of_Andhownz.csv,452,101825601.0,178,274,139,39,0,38.703539823008846,232,51,31.535398230088497,8
Category_Wikipedia_sockpuppets_of_HyeSK.csv,572,22016460.0,190,382,187,3,0,53.40734265734266,256,101,21.23951048951049,5
Category_Wikipedia_sockpuppets_of_Kwalifide.csv,4,527.0,2,2,2,0,0,24.0,50,17,17.0,17
Category_Wikipedia_sockpuppets_of_Ps3nerd.csv,63,5162040.0,14,49,14,0,0,33.301587301587304,138,31,13.0,7
Category_Wikipedia_sockpuppets_of_Ijumdiya_wadzani.csv,1605,48178530.0,614,991,137,477,0,46.39127725856698,500,66,17.808722741433023,3
Category_Wikipedia_sockpuppets_of_WonderBoy1998.csv,1752,335962716.0,535,1217,500,35,0,53.44063926940639,376,67,23.070776255707763,4
Category_Wikipedia_sockpuppets_of_KoshVorlon.csv,3443,105586627.0,1000,2443,500,500,0,59.34243392390357,287,81,32.296834156259074,4
Category_Wikipedia_sockpuppets_of_ItsMagic35.csv,9,299097.0,3,6,3,0,0,27.555555555555557,54,33,28.666666666666668,20
Category_Wikipedia_sockpuppets_of_Samyakesesem.csv,727,167097060.0,184,543,181,3,0,51.66850068775791,379,43,16.519944979367263,5
Category_Wikipedia_sockpuppets_of_Epic_super_helpful_man.csv,25,267399.0,10,15,7,3,0,47.32,149,49,26.6,17
Category_Wikipedia_sockpuppets_of_666himself.csv,1834,11702154.0,546,1288,391,155,0,55.73173391494002,500,49,18.079607415485277,4
Category_Wikipedia_sockpuppets_of_Peanutbutter8200.csv,10,13313.0,10,0,7,3,0,0.0,0,14,14.0,14
Category_Wikipedia_sockpuppets_of_Hazzard_Dblon.csv,204,9756230.0,107,97,45,62,0,104.0343137254902,500,25,13.137254901960784,9
Category_Wikipedia_sockpuppets_of_TomDickHarryOfCos.csv,106,1061397.0,44,62,39,5,0,63.60377358490566,287,39,29.830188679245282,13
Category_Wikipedia_sockpuppets_of_Simonliyiyu.csv,20,26106.0,11,9,6,5,0,16.4,77,60,51.3,43
Category_Wikipedia_sockpuppets_of_SXIAOSHUAI.csv,3,464.0,3,0,1,2,119,119.0,119,26,26.0,26
Category_Wikipedia_sockpuppets_of_TheFutureIsHere2100.csv,155,2341441.0,43,112,34,9,0,72.72258064516129,313,49,15.593548387096774,5
Category_Wikipedia_sockpuppets_of_Rabt_man.csv,2125,26757418.0,759,1366,500,259,0,47.88,255,51,15.22870588235294,4
Category_Wikipedia_sockpuppets_of_Pressteck.csv,28,1966629.0,13,15,8,5,0,47.82142857142857,199,23,14.142857142857142,11
Category_Wikipedia_sockpuppets_of_Dentmaster.csv,12,359880.0,10,2,7,3,22,44.75,132,21,21.0,21
Category_Wikipedia_sockpuppets_of_Insectron.csv,1754,21626454.0,919,835,500,419,0,27.02394526795895,347,34,14.618586088939567,11
Category_Wikipedia_sockpuppets_of_Hometech.csv,8011,289487683.0,1986,6025,500,1486,0,50.24790912495319,316,105,19.288603170640368,3
Category_Wikipedia_sockpuppets_of_Allancass.csv,285,480150819.0,93,192,91,2,0,51.954385964912284,473,45,17.649122807017545,8
Category_Wikipedia_sockpuppets_of_MustafaO.csv,6732,236917053.0,2656,4076,500,2156,0,57.7363339275104,500,69,15.276440879382056,4
Category_Wikipedia_sockpuppets_of_Codeplowed.csv,267,82003537.0,124,143,116,8,0,54.262172284644194,213,38,18.94007490636704,11
Category_Wikipedia_sockpuppets_of_Robertb11.csv,54,23396055.0,22,32,15,7,0,54.24074074074074,210,46,15.648148148148149,10
Category_Wikipedia_sockpuppets_of_Exxolon.csv,1899,11247749.0,507,1392,500,7,0,47.144813059505005,263,71,27.193786203264875,2
Category_Wikipedia_sockpuppets_of_Thekim2.0.csv,358,6679182.0,107,251,77,30,0,42.29050279329609,500,29,12.432960893854748,4
Category_Wikipedia_sockpuppets_of_Boaxy.csv,2348,366463168.0,691,1657,480,211,0,39.34838160136286,255,79,19.515758091993185,5
Category_Wikipedia_sockpuppets_of_Blackvankina.csv,63,74334042.0,20,43,11,9,0,48.17460317460318,237,15,14.365079365079366,7
Category_Wikipedia_sockpuppets_of_Hankmann619.csv,54,12864635.0,19,35,16,3,0,37.425925925925924,228,38,18.666666666666668,12
Category_Wikipedia_sockpuppets_of_JoeCornHole.csv,13,2760.0,8,5,3,5,0,40.53846153846154,131,11,11.0,11
Category_Wikipedia_sockpuppets_of_BlueIsNotRandom.csv,15,1947.0,9,6,4,5,0,52.333333333333336,191,27,26.533333333333335,20
Category_Wikipedia_sockpuppets_of_Bh6thman.csv,95,10168111.0,33,62,24,9,0,33.084210526315786,178,29,21.86315789473684,12
Category_Wikipedia_sockpuppets_of_Beranger2225.csv,91,33010808.0,51,40,40,11,0,45.395604395604394,174,34,26.208791208791208,10
Category_Wikipedia_sockpuppets_of_Somani14.csv,24,176512.0,21,3,14,7,0,92.875,196,30,21.5,6
Category_Wikipedia_sockpuppets_of_Gobbo7214.csv,6,89237.0,5,1,3,2,0,30.666666666666668,106,18,18.0,18
Category_Wikipedia_sockpuppets_of_AustinMusicFoundation.csv,6,10918.0,3,3,3,0,7,49.666666666666664,198,17,17.0,17
Category_Wikipedia_sockpuppets_of_Sapphie_Jewelpet.csv,656,99919398.0,144,512,133,11,0,50.166158536585364,340,82,21.10670731707317,6
Category_Wikipedia_sockpuppets_of_Polieditor.csv,26,3549778.0,10,16,5,5,0,77.07692307692308,230,29,22.692307692307693,9
Category_Wikipedia_sockpuppets_of_ZaRhod16.csv,60,310090.0,46,14,42,4,0,38.483333333333334,206,44,12.35,9
Category_Wikipedia_sockpuppets_of_Wkrukenberg2.csv,858,15446855.0,249,609,52,197,0,51.14801864801865,250,30,16.27039627039627,3
Category_Wikipedia_sockpuppets_of_NickNbeezy.csv,265,7437201.0,79,186,77,2,0,25.162264150943397,243,28,12.539622641509434,4
Category_Wikipedia_sockpuppets_of_Bluegoblin7.csv,1575,224397352.0,500,1075,500,0,0,46.74031746031746,250,69,28.32952380952381,9
Category_Wikipedia_sockpuppets_of_Rollaball_Rocko.csv,37,71289.0,19,18,14,5,0,46.189189189189186,200,26,19.37837837837838,12
Category_Wikipedia_sockpuppets_of_Javier93h.csv,1206,55317555.0,418,788,188,230,0,41.44278606965174,254,54,26.960199004975124,3
Category_Wikipedia_sockpuppets_of_Sergeynexus.csv,62,48803926.0,29,33,20,9,0,64.80645161290323,216,24,18.548387096774192,14
Category_Wikipedia_sockpuppets_of_Mr._Punk_Pirate.csv,3491,182408231.0,1013,2478,500,513,0,46.67888857061014,500,54,14.736751647092523,4
Category_Wikipedia_sockpuppets_of_Xselant.csv,2177,7866237.0,747,1430,500,247,0,53.149288011024346,500,67,17.020211299954067,5
Category_Wikipedia_sockpuppets_of_Riza_tbzli.csv,3080,27733927.0,1124,1956,500,624,0,25.261363636363637,500,46,16.571103896103896,6
Category_Wikipedia_sockpuppets_of_Californianinexile.csv,827,3740652.0,506,321,500,6,0,34.08706166868198,462,60,45.30108827085852,32
Category_Wikipedia_sockpuppets_of_Arifer.csv,931,489752883.0,319,612,116,203,0,59.78625134264232,351,51,19.312567132116005,6
Category_Wikipedia_sockpuppets_of_Bulgarian_Archer.csv,2370,27040830.0,610,1760,171,439,0,54.7957805907173,266,70,16.29957805907173,4
Category_Wikipedia_sockpuppets_of_Hereaadish.csv,11,1293183.0,3,8,2,1,22,61.45454545454545,156,23,22.181818181818183,20
Category_Wikipedia_sockpuppets_of_Punkox.csv,463,46520422.0,147,316,93,54,0,28.151187904967603,197,36,24.248380129589634,12
Category_Wikipedia_sockpuppets_of_HugoZHackenbusch.csv,153,7256213.0,122,31,83,39,0,52.24183006535948,222,26,15.006535947712418,10
Category_Wikipedia_sockpuppets_of_ItsFound.csv,56,3767390.0,24,32,16,8,0,23.071428571428573,208,44,19.660714285714285,5
Category_Wikipedia_sockpuppets_of_DoctorBananarama22.csv,66,308814.0,25,41,12,13,0,52.15151515151515,288,45,29.681818181818183,12
Category_Wikipedia_sockpuppets_of_DullaisLatvietis.csv,164,2167924.0,54,110,46,8,0,58.798780487804876,359,47,21.134146341463413,1
Category_Wikipedia_sockpuppets_of_Stodieck.csv,1646,367121190.0,508,1138,500,8,0,56.504860267314704,394,59,18.346294046172538,4
Category_Wikipedia_sockpuppets_of_Ohnooo2346.csv,33,17496552.0,11,22,6,5,0,38.878787878787875,180,21,18.757575757575758,15
Category_Wikipedia_sockpuppets_of_Horizontal_Law.csv,2096,196966695.0,759,1337,263,496,0,45.00620229007634,269,65,19.84685114503817,3
Category_Wikipedia_sockpuppets_of_Niocs.csv,33,3227935.0,7,26,7,0,0,71.18181818181819,223,38,33.666666666666664,10
Category_Wikipedia_sockpuppets_of_4by40.csv,539,3147794.0,203,336,128,75,0,36.41372912801484,211,51,23.82931354359926,7
Category_Wikipedia_sockpuppets_of_Kissmyheart.csv,476,7700328.0,146,330,78,68,0,40.24159663865546,416,51,22.718487394957982,8
Category_Wikipedia_sockpuppets_of_MrTeja.csv,401,417656249.0,132,269,127,5,0,44.19201995012469,264,51,18.820448877805486,6
Category_Wikipedia_sockpuppets_of_Skirti100.csv,37,63907884.0,22,15,15,7,0,43.91891891891892,196,54,20.027027027027028,12
Category_Wikipedia_sockpuppets_of_ScienceAdvisor.csv,1821,140888490.0,776,1045,500,276,0,42.88248215266337,500,74,23.9615595826469,6
Category_Wikipedia_sockpuppets_of_DragonTiger23.csv,2895,38814904.0,1127,1768,500,627,0,43.80587219343696,255,83,23.2566493955095,4
Category_Wikipedia_sockpuppets_of_Avfnx.csv,1458,50578735.0,520,938,455,65,0,37.81069958847737,208,65,19.571330589849108,4
Category_Wikipedia_sockpuppets_of_Six_Legged_Petrol_Handle.csv,47,2536.0,27,20,10,17,0,47.97872340425532,176,22,11.02127659574468,10
Category_Wikipedia_sockpuppets_of_HipHopfan4life.csv,5251,47181683.0,1875,3376,500,1375,0,32.24757189106837,259,70,13.387164349647685,3
Category_Wikipedia_sockpuppets_of_Thebaidurafeyor.csv,15,5187974.0,4,11,2,2,0,32.86666666666667,132,48,28.4,6
Category_Wikipedia_sockpuppets_of_Kaas3142435.csv,7,3023797.0,4,3,2,2,0,62.714285714285715,196,27,11.571428571428571,9
Category_Wikipedia_sockpuppets_of_TimRaines.csv,67,58734729.0,26,41,15,11,0,16.238805970149254,125,41,24.059701492537314,8
Category_Wikipedia_sockpuppets_of_Suraj_neeraj.csv,6,3234.0,5,1,5,0,0,2.8333333333333335,17,12,11.5,11
Category_Wikipedia_sockpuppets_of_Hritik89.csv,528,1661687.0,168,360,38,130,0,43.82007575757576,249,52,14.238636363636363,4
Category_Wikipedia_sockpuppets_of_Cool_a123.csv,3096,126431390.0,1287,1809,500,787,0,33.05200258397933,496,60,28.927325581395348,4
Category_Wikipedia_sockpuppets_of_Deepeshdharmchari.csv,414,109638249.0,158,256,83,75,0,50.94685990338164,255,58,28.582125603864736,5
Category_Wikipedia_sockpuppets_of_JenR32.csv,366,16674331.0,106,260,84,22,0,50.44535519125683,226,58,21.7103825136612,3
Category_Wikipedia_sockpuppets_of_Vicarious_Visions.csv,15,14634.0,9,6,8,1,0,28.2,224,31,20.0,16
Category_Wikipedia_sockpuppets_of_SeanMXD.csv,40,38782434.0,21,19,21,0,0,36.075,140,17,15.25,12
Category_Wikipedia_sockpuppets_of_Garvit_Chouhan.csv,2425,67229235.0,649,1776,500,149,0,30.783505154639176,395,45,16.351752577319587,5
Category_Wikipedia_sockpuppets_of_Chuanze.csv,6,46617.0,5,1,4,1,0,64.66666666666667,246,21,21.0,21
Category_Wikipedia_sockpuppets_of_Pokemon721.csv,18,7049.0,8,10,2,6,0,24.444444444444443,134,39,19.38888888888889,11
Category_Wikipedia_sockpuppets_of_AkramBinWallid.csv,230,200905.0,93,137,64,29,0,57.76086956521739,250,54,27.713043478260868,4
Category_Wikipedia_sockpuppets_of_Bd_clark_07.csv,1248,121515807.0,483,765,149,334,0,35.138621794871796,250,78,22.27003205128205,8
Category_Wikipedia_sockpuppets_of_Heeeeeeelllllloooooo.csv,6,2162.0,4,2,3,1,0,50.166666666666664,172,23,23.0,23
Category_Wikipedia_sockpuppets_of_Parkirovskieng.csv,135,1124906.0,61,74,32,29,0,40.67407407407408,180,52,23.392592592592592,5
Category_Wikipedia_sockpuppets_of_Wikipediadancemom.csv,2054,22465586.0,634,1420,500,134,0,37.700584225900684,255,56,24.860272638753653,6
Category_Wikipedia_sockpuppets_of_1BGhimire.csv,208,47988373.0,68,140,42,26,0,60.07692307692308,333,54,26.54326923076923,11
Category_Wikipedia_sockpuppets_of_Horsesarereallygreat.csv,53,3902030.0,15,38,12,3,0,64.81132075471699,227,24,16.22641509433962,9
Category_Wikipedia_sockpuppets_of_CarloMagno96.csv,225,1863420.0,84,141,49,35,0,46.96,259,30,19.284444444444443,9
Category_Wikipedia_sockpuppets_of_R9tgokunks.csv,1670,536673547.0,537,1133,500,37,0,49.4125748502994,494,57,22.938922155688623,3
Category_Wikipedia_sockpuppets_of_Pepedafrog.csv,69,1029216.0,30,39,10,20,0,61.028985507246375,233,28,13.971014492753623,6
Category_Wikipedia_sockpuppets_of_Wikkidd.csv,2222,25872196.0,726,1496,473,253,0,48.954095409540955,246,54,17.247074707470748,4
Category_Wikipedia_sockpuppets_of_Ascilto.csv,30,345312594.0,9,21,9,0,0,36.13333333333333,164,18,14.166666666666666,9
Category_Wikipedia_sockpuppets_of_Steven_Dacres.csv,35,664438.0,14,21,13,1,0,21.771428571428572,188,29,20.37142857142857,5
Category_Wikipedia_sockpuppets_of_Samjackson93436.csv,24,18039.0,13,11,9,4,0,18.041666666666668,90,51,42.0,19
Category_Wikipedia_sockpuppets_of_Safety14.csv,16,6219.0,5,11,4,1,0,47.875,205,35,10.9375,6
Category_Wikipedia_sockpuppets_of_Nabeelkallayil.csv,311,37144211.0,122,189,61,61,0,41.045016077170416,213,43,19.758842443729904,8
Category_Wikipedia_sockpuppets_of_Lawinformationhelper.csv,37,217718.0,22,15,22,0,0,38.810810810810814,184,36,21.45945945945946,12
Category_Wikipedia_sockpuppets_of_Wait333.csv,23,2747431.0,13,10,7,6,0,71.04347826086956,157,21,18.565217391304348,12
Category_Wikipedia_sockpuppets_of_Indianahoosier860.csv,89,43813242.0,38,51,33,5,0,46.247191011235955,255,11,10.853932584269662,10
Category_Wikipedia_sockpuppets_of_Tanner_Mortimer.csv,2,0.0,1,1,1,0,12,12.0,12,20,20.0,20
Category_Wikipedia_sockpuppets_of_Gearnape.csv,6,1232.0,3,3,2,1,0,93.5,196,53,53.0,53
Category_Wikipedia_sockpuppets_of_JonsanWhitters.csv,8,70164.0,5,3,5,0,30,35.875,43,20,20.0,20
Category_Wikipedia_sockpuppets_of_Skyhook1.csv,923,14776536.0,507,416,500,7,0,52.7919826652221,255,47,20.47670639219935,7
Category_Wikipedia_sockpuppets_of_Hmhainwhja.csv,11,4852.0,5,6,1,4,1,65.9090909090909,175,35,22.636363636363637,17
Category_Wikipedia_sockpuppets_of_Marian1981.csv,508,104534401.0,233,275,143,90,0,38.18503937007874,255,72,26.909448818897637,9
Category_Wikipedia_sockpuppets_of_Olaf_Kosinsky.csv,1681,88315445.0,557,1124,500,57,0,66.46579417013682,500,61,20.900654372397383,3
Category_Wikipedia_sockpuppets_of_Saswati6371.csv,2,593393.0,2,0,2,0,19,20.5,22,19,16.5,14
Category_Wikipedia_sockpuppets_of_JugulatorJJ.csv,2010,38612885.0,617,1393,500,117,0,50.528358208955225,472,71,22.12039800995025,4
Category_Wikipedia_sockpuppets_of_SGD833.csv,39,1518773.0,12,27,6,6,0,63.94871794871795,199,22,13.307692307692308,8
Category_Wikipedia_sockpuppets_of_SHRIPADVAIDYA.csv,287,84958850.0,70,217,66,4,0,62.01393728222997,238,43,20.114982578397214,4
Category_Wikipedia_sockpuppets_of_Jagged_ruby.csv,144,4382011.0,50,94,14,36,0,34.80555555555556,188,33,19.29861111111111,9
Category_Wikipedia_sockpuppets_of_Emmasomersetdavis.csv,19,9045.0,6,13,4,2,12,73.57894736842105,177,33,26.210526315789473,23
Category_Wikipedia_sockpuppets_of_Stephaniemuue.csv,839,47513558.0,235,604,42,193,0,43.51013110846245,253,56,21.65911799761621,4
Category_Wikipedia_sockpuppets_of_Udaiveersharma.csv,322,20120763.0,77,245,59,18,0,52.58074534161491,455,40,14.972049689440993,6
Category_Wikipedia_sockpuppets_of_Itailevi00.csv,451,48552879.0,184,267,66,118,0,43.1019955654102,255,53,18.855875831485587,5
Category_Wikipedia_sockpuppets_of_Bcliot33.csv,1916,65530023.0,556,1360,500,56,0,58.69624217118998,496,50,17.363778705636744,6
Category_Wikipedia_sockpuppets_of_Naivaidyammishra.csv,125,29628494.0,51,74,41,10,0,42.88,196,24,17.328,12
Category_Wikipedia_sockpuppets_of_Ossamamoorish.csv,23,1979646.0,12,11,7,5,0,88.8695652173913,474,20,12.434782608695652,6
Category_Wikipedia_sockpuppets_of_Princess_Derpy.csv,334,8239360.0,115,219,66,49,0,33.81437125748503,249,94,31.691616766467067,4
Category_Wikipedia_sockpuppets_of_Stephenlewis.csv,1483,39387470.0,355,1128,177,178,0,29.2049898853675,219,80,15.683074848280512,3
Category_Wikipedia_sockpuppets_of_Wirterss.csv,38,399398.0,21,17,20,1,0,22.763157894736842,166,13,7.473684210526316,4
Category_Wikipedia_sockpuppets_of_Banimustafa.csv,796,370092310.0,303,493,240,63,0,46.33291457286432,250,54,15.459798994974875,3
Category_Wikipedia_sockpuppets_of_Zargonafatima.csv,36,373388.0,11,25,9,2,0,62.44444444444444,195,31,17.36111111111111,10
Category_Wikipedia_sockpuppets_of_Journalistdavidoff.csv,187,70660022.0,79,108,53,26,0,40.93048128342246,237,72,35.51336898395722,13
Category_Wikipedia_sockpuppets_of_Sabbyguy.csv,1,0.0,1,0,1,0,28,28.0,28,19,19.0,19
Category_Wikipedia_sockpuppets_of_Oldlawprof.csv,47,24110698.0,16,31,8,8,0,72.0,199,50,16.851063829787233,9
Category_Wikipedia_sockpuppets_of_WikiEditorAd.csv,445,8985016.0,107,338,52,55,0,48.89887640449438,242,70,19.543820224719102,5
Category_Wikipedia_sockpuppets_of_JavadShirazi696.csv,45,5191473.0,22,23,10,12,0,48.62222222222222,174,54,21.31111111111111,10
Category_Wikipedia_sockpuppets_of_Vanessa98.csv,35,37302.0,18,17,11,7,0,26.085714285714285,173,27,21.914285714285715,13
Category_Wikipedia_sockpuppets_of_Beckdella123.csv,277,12314773.0,115,162,35,80,0,41.891696750902526,226,63,21.978339350180505,4
Category_Wikipedia_sockpuppets_of_Frabel.csv,47,213603.0,40,7,37,3,0,16.638297872340427,157,43,20.4468085106383,16
Category_Wikipedia_sockpuppets_of_Crowdradio3.csv,34,189411051.0,8,26,3,5,0,44.61764705882353,209,28,22.764705882352942,10
Category_Wikipedia_sockpuppets_of_RK_Drollinger.csv,202,13918808.0,83,119,50,33,0,44.39108910891089,248,51,24.113861386138613,6
Category_Wikipedia_sockpuppets_of_Irub_Man.csv,2174,37255561.0,587,1587,500,87,0,30.58325666973321,220,86,20.456761729530818,3
Category_Wikipedia_sockpuppets_of_FALKIRKFAN76.csv,113,157049.0,50,63,24,26,0,54.54867256637168,273,47,16.43362831858407,10
Category_Wikipedia_sockpuppets_of_Rahul_Singh_Agnihotri.csv,96,4132091.0,39,57,18,21,0,41.010416666666664,300,53,33.166666666666664,14
Category_Wikipedia_sockpuppets_of_Rgulerdem.csv,1694,6257519.0,659,1035,500,159,0,32.43801652892562,200,66,24.763872491145218,7
Category_Wikipedia_sockpuppets_of_LilDennie_Wikipedia.csv,619,9501823.0,196,423,115,81,0,41.38933764135703,242,38,18.145395799676898,4
Category_Wikipedia_sockpuppets_of_Kevincsman.csv,9,4559.0,8,1,7,1,0,13.11111111111111,118,58,58.0,58
Category_Wikipedia_sockpuppets_of_Ytzesza.csv,1878,29562976.0,480,1398,427,53,0,47.047390841320556,494,48,18.89084132055378,3
Category_Wikipedia_sockpuppets_of_Hmkwfrance.csv,857,44161082.0,320,537,185,135,0,47.18203033838973,457,61,17.117852975495914,6
Category_Wikipedia_sockpuppets_of_Didetaexe.csv,3218,157601792.0,792,2426,417,375,0,45.81789931634555,376,97,15.40863890615289,3
Category_Wikipedia_sockpuppets_of_Kungfuw.csv,118,151309570.0,49,69,31,18,0,83.77118644067797,278,48,43.11864406779661,10
Category_Wikipedia_sockpuppets_of_TamilMirchi.csv,1352,3345333.0,573,779,500,73,0,42.96819526627219,500,62,20.32248520710059,4
Category_Wikipedia_sockpuppets_of_Robotpotato.csv,2063,24779759.0,631,1432,500,131,0,32.10954920019389,233,63,16.776054289869123,5
Category_Wikipedia_sockpuppets_of_Dimp3001.csv,102,67452530.0,32,70,32,0,0,43.98039215686274,214,46,20.558823529411764,4
Category_Wikipedia_sockpuppets_of_Alex_penton.csv,64,43041561.0,13,51,9,4,0,59.125,254,26,17.125,7
Category_Wikipedia_sockpuppets_of_Philanthropist_1001.csv,831,41619476.0,339,492,212,127,0,45.139590854392296,255,66,15.459687123947052,4
Category_Wikipedia_sockpuppets_of_Jshpinar.csv,1643,73939261.0,510,1133,111,399,0,48.62020693852708,365,62,20.76993304930006,6
Category_Wikipedia_sockpuppets_of_Gwalker69420.csv,17,209028.0,9,8,4,5,0,46.294117647058826,180,34,28.705882352941178,14
Category_Wikipedia_sockpuppets_of_Savagepb1.csv,605,72377667.0,187,418,184,3,0,32.34710743801653,255,50,24.114049586776858,6
Category_Wikipedia_sockpuppets_of_BogusDingle.csv,53,202948.0,47,6,28,19,0,25.0,166,8,8.0,8
Category_Wikipedia_sockpuppets_of_Spring3100.csv,317,21447347.0,84,233,76,8,0,29.47634069400631,195,58,22.63722397476341,3
Category_Wikipedia_sockpuppets_of_Redman2022.csv,78,1145716.0,46,32,23,23,0,59.333333333333336,186,20,16.44871794871795,14
Category_Wikipedia_sockpuppets_of_Ellis_Means_Bad_boy.csv,17,3940.0,11,6,6,5,0,29.41176470588235,202,15,15.0,15
Category_Wikipedia_sockpuppets_of_Fmg2007.csv,35,10804.0,16,19,15,1,0,54.31428571428572,177,20,13.771428571428572,7
Category_Wikipedia_sockpuppets_of_Shahil_raichand.csv,24,23320797.0,9,15,5,4,0,52.125,192,25,12.875,3
Category_Wikipedia_sockpuppets_of_Bonbondash1234.csv,166,56768348.0,37,129,36,1,0,48.53012048192771,247,57,32.13855421686747,10
Category_Wikipedia_sockpuppets_of_Youreallycan.csv,3334,56411063.0,1027,2307,500,527,0,53.5371925614877,255,93,34.46310737852429,6
Category_Wikipedia_sockpuppets_of_RIXIANGHUANG.csv,10,10249.0,5,5,3,2,0,18.7,69,53,46.1,30
Category_Wikipedia_sockpuppets_of_TheMadTim.csv,683,4803099.0,240,443,229,11,0,33.63689604685212,200,88,25.05856515373353,9
Category_Wikipedia_sockpuppets_of_CowboyKing.csv,278,135253234.0,75,203,44,31,0,50.39928057553957,301,61,18.85251798561151,7
Category_Wikipedia_sockpuppets_of_Inflation'sLastLaugh.csv,15,2683438.0,9,6,6,3,0,167.66666666666666,461,30,26.533333333333335,26
Category_Wikipedia_sockpuppets_of_Diamondring001.csv,53,2662196.0,22,31,15,7,0,53.54716981132076,166,22,19.09433962264151,12
Category_Wikipedia_sockpuppets_of_Woody_ty.csv,507,7252363.0,154,353,82,72,0,43.08086785009862,249,29,17.416173570019723,10
Category_Wikipedia_sockpuppets_of_Eurovoicecritic.csv,7,86954.0,5,2,3,2,0,32.42857142857143,97,19,15.571428571428571,15
Category_Wikipedia_sockpuppets_of_JohnKragen1611.csv,1951,96578673.0,458,1493,417,41,0,50.82778062532035,499,68,21.381855458739107,2
Category_Wikipedia_sockpuppets_of_Tot_real_fact.csv,5,317.0,3,2,2,1,0,40.0,128,20,20.0,20
Category_Wikipedia_sockpuppets_of_Gyppedagain.csv,42,86249.0,29,13,9,20,0,86.14285714285714,152,13,9.30952380952381,8
Category_Wikipedia_sockpuppets_of_DolphinQT.csv,10,994.0,4,6,4,0,0,73.5,177,22,14.8,9
Category_Wikipedia_sockpuppets_of_Quinn_Gruv.csv,42,183662.0,31,11,14,17,0,24.928571428571427,160,27,12.095238095238095,11
Category_Wikipedia_sockpuppets_of_Rectangularfetus.csv,32,1288660.0,17,15,9,8,0,53.03125,225,27,10.875,9
Category_Wikipedia_sockpuppets_of_Panelgets.csv,152,7737045.0,44,108,17,27,0,53.83552631578947,191,50,25.105263157894736,1
Category_Wikipedia_sockpuppets_of_Clevercworldwide.csv,1,0.0,1,0,1,0,30,30.0,30,29,29.0,29
Category_Wikipedia_sockpuppets_of_Mumbaifreaks.csv,2676,14421547.0,915,1761,376,539,0,36.10986547085202,239,51,14.89611360239163,4
Category_Wikipedia_sockpuppets_of_Carmel's_Hope.csv,7,3672929.0,4,3,2,2,0,44.857142857142854,191,23,21.571428571428573,18
Category_Wikipedia_sockpuppets_of_Lilithceusan.csv,299,18170313.0,104,195,81,23,0,42.72909698996656,281,71,25.73913043478261,8
Category_Wikipedia_sockpuppets_of_Nyon_Business_School.csv,10,152680.0,8,2,7,1,0,44.0,128,35,32.0,30
Category_Wikipedia_sockpuppets_of_Makkarpaiyan.csv,35,6221419.0,14,21,13,1,0,52.2,196,22,17.742857142857144,14
Category_Wikipedia_sockpuppets_of_Kenzo4000.csv,109,135710942.0,38,71,27,11,0,44.56880733944954,199,23,13.513761467889909,8
Category_Wikipedia_sockpuppets_of_Thanetpromo.csv,6,1620.0,3,3,3,0,0,54.5,161,46,26.833333333333332,7
Category_Wikipedia_sockpuppets_of_Krillin107.csv,34,7965647.0,16,18,9,7,0,48.38235294117647,231,20,20.0,20
Category_Wikipedia_sockpuppets_of_WarrenMoonSoon.csv,560,26108744.0,149,411,109,40,0,41.89107142857143,247,47,17.9375,5
Category_Wikipedia_sockpuppets_of_Vrghs_jacob.csv,9934,264490316.0,3044,6890,500,2544,0,48.873968190054356,255,75,21.44554056774713,3
Category_Wikipedia_sockpuppets_of_„Éâ„Ç∞„É™.csv,84,1524829.0,29,55,25,4,0,52.476190476190474,219,48,32.5,14
Category_Wikipedia_sockpuppets_of_NewsPalace.csv,106,564257.0,35,71,23,12,0,48.490566037735846,269,23,12.877358490566039,5
Category_Wikipedia_sockpuppets_of_Ph·∫°m_VƒÉn_R·∫°ng.csv,19880,136927694.0,5766,14114,500,5266,0,47.030985915492955,500,70,18.833802816901407,4
Category_Wikipedia_sockpuppets_of_Aksh_539.csv,1383,59781141.0,504,879,391,113,0,39.17715112075199,496,49,19.449023861171366,5
Category_Wikipedia_sockpuppets_of_Bea_Binene.csv,150,7703562.0,59,91,30,29,0,38.12,225,26,14.906666666666666,9
Category_Wikipedia_sockpuppets_of_Krishnamurthy_GovindaReddy.csv,1103,18214568.0,229,874,187,42,0,49.81776971894832,359,52,17.225747960108794,3
Category_Wikipedia_sockpuppets_of_Art_Sampson.csv,1849,2816308.0,568,1281,500,68,0,48.428880475932935,259,57,24.49972958355868,2
Category_Wikipedia_sockpuppets_of_BlackSkinninyNinja.csv,4,86803.0,3,1,2,1,15,70.75,235,18,18.0,18
Category_Wikipedia_sockpuppets_of_Iabhibmsce.csv,1,0.0,1,0,1,0,0,0.0,0,17,17.0,17
Category_Wikipedia_sockpuppets_of_Thomas_Ptarmigan.csv,1964,157977509.0,527,1437,388,139,0,52.616089613034625,350,74,15.566700610997964,3
Category_Wikipedia_sockpuppets_of_Accurateinfotoday.csv,112,2520318.0,55,57,30,25,0,42.82142857142857,246,51,15.928571428571429,9
Category_Wikipedia_sockpuppets_of_Cgsailor94.csv,458,291721326.0,158,300,142,16,0,38.5,238,44,21.94759825327511,6
Category_Wikipedia_sockpuppets_of_Gilbertine_goldmark.csv,3356,51975996.0,954,2402,495,459,0,43.79439809296782,249,80,20.831942789034564,4
Category_Wikipedia_sockpuppets_of_Chapstickkk.csv,21,948723.0,9,12,7,2,0,51.285714285714285,199,21,13.380952380952381,9
Category_Wikipedia_sockpuppets_of_Zaikarim.csv,23,1017702.0,9,14,6,3,0,21.434782608695652,123,12,11.565217391304348,11
Category_Wikipedia_sockpuppets_of_LongShanks12.csv,13,89130.0,9,4,5,4,0,69.6923076923077,141,10,10.0,10
Category_Wikipedia_sockpuppets_of_Haweiuyt.csv,10,193636.0,10,0,5,5,0,5.8,58,15,15.0,15
Category_Wikipedia_sockpuppets_of_Nibbo_2.csv,6579,90739703.0,2006,4573,500,1506,0,37.27526979784162,255,81,19.38394892840857,3
Category_Wikipedia_sockpuppets_of_LIL_PROTON.csv,470,1048289.0,168,302,168,0,0,29.197872340425533,199,42,20.908510638297873,3
Category_Wikipedia_sockpuppets_of_Dnangelfreak2.csv,14,209728.0,8,6,4,4,0,39.214285714285715,140,17,14.428571428571429,13
Category_Wikipedia_sockpuppets_of_PIRRO_BURRI.csv,653,9610593.0,250,403,105,145,0,38.537519142419605,213,25,13.448698315467075,6
Category_Wikipedia_sockpuppets_of_Cro..Scream.csv,512,21019131.0,146,366,136,10,0,33.708984375,190,65,20.607421875,3
Category_Wikipedia_sockpuppets_of_Dexclaw.csv,202,242406989.0,66,136,60,6,0,55.301980198019805,429,39,16.53960396039604,8
Category_Wikipedia_sockpuppets_of_JoinFluffy250.csv,721,397613395.0,227,494,110,117,0,50.50624133148405,446,71,20.15395284327323,6
Category_Wikipedia_sockpuppets_of_BigMan3782.csv,5,435.0,3,2,2,1,0,51.4,133,10,10.0,10
Category_Wikipedia_sockpuppets_of_Ramzilaharach.csv,243,41016053.0,53,190,33,20,0,47.70781893004115,251,30,16.419753086419753,1
Category_Wikipedia_sockpuppets_of_Julius_Santos_III.csv,3348,50649822.0,1089,2259,500,589,0,27.035543608124254,271,56,22.023297491039425,3
Category_Wikipedia_sockpuppets_of_Northsaintpaulresident.csv,6,1922.0,4,2,4,0,20,112.16666666666667,163,25,25.0,25
Category_Wikipedia_sockpuppets_of_Cadkwah.csv,48,20550010.0,23,25,17,6,0,69.83333333333333,244,20,16.083333333333332,11
Category_Wikipedia_sockpuppets_of_Darin_Fidika.csv,4576,128611429.0,1773,2803,500,1273,0,38.75983391608391,256,67,17.10249125874126,3
Category_Wikipedia_sockpuppets_of_Truthprofessor.csv,449,142002325.0,152,297,121,31,0,47.87750556792873,222,54,16.826280623608017,8
Category_Wikipedia_sockpuppets_of_Perfecshun.csv,94,513620.0,29,65,21,8,0,44.53191489361702,229,36,22.51063829787234,5
Category_Wikipedia_sockpuppets_of_Deepak_k_Banerjee.csv,25,6291930.0,13,12,7,6,0,42.52,202,22,15.76,14
Category_Wikipedia_sockpuppets_of_Iamrhyssmart.csv,4,86149.0,4,0,3,1,0,21.75,29,22,19.0,18
Category_Wikipedia_sockpuppets_of_Friedlibend_und_tapfer.csv,4675,294771015.0,1000,3675,500,500,0,47.87935828877006,255,68,17.51486631016043,1
Category_Wikipedia_sockpuppets_of_Dnywlsh.csv,1339,397621506.0,344,995,287,57,0,51.84316654219567,429,58,20.731142643764002,3
Category_Wikipedia_sockpuppets_of_Meharsultana.csv,26,12615652.0,10,16,7,3,0,45.07692307692308,135,27,22.423076923076923,13
Category_Wikipedia_sockpuppets_of_Kgeza67.csv,1925,336115006.0,473,1452,101,372,0,51.75220779220779,255,100,19.322077922077924,5
Category_Wikipedia_sockpuppets_of_Masoom.bilal73.csv,728,191936070.0,349,379,154,195,0,38.582417582417584,419,49,11.604395604395604,5
Category_Wikipedia_sockpuppets_of_Chuhdohpdh.csv,6,75126.0,5,1,4,1,0,41.333333333333336,115,22,22.0,22
Category_Wikipedia_sockpuppets_of_Osteocorrect.csv,426,288089422.0,144,282,141,3,0,58.26995305164319,251,41,20.15962441314554,10
Category_Wikipedia_sockpuppets_of_Licusoara.csv,38,24195634.0,18,20,13,5,0,35.39473684210526,155,35,20.68421052631579,11
Category_Wikipedia_sockpuppets_of_Would_you_like_to_tickle_my_pickle.csv,25,779469.0,9,16,9,0,0,57.8,287,25,20.08,18
Category_Wikipedia_sockpuppets_of_Oseremi.csv,123,121937627.0,33,90,15,18,0,55.08130081300813,237,50,16.016260162601625,5
Category_Wikipedia_sockpuppets_of_HGJ345.csv,277,110725332.0,108,169,106,2,0,36.75451263537906,234,25,15.740072202166065,7
Category_Wikipedia_sockpuppets_of_BIGCANDICEFAN.csv,266,2062583.0,107,159,99,8,0,30.330827067669173,201,27,16.518796992481203,7
Category_Wikipedia_sockpuppets_of_RevolverOcelotX.csv,6931,18816642.0,1782,5149,500,1282,0,26.221180204876642,212,85,17.36372817775213,2
Category_Wikipedia_sockpuppets_of_098mi.csv,1027,150016941.0,420,607,317,103,0,36.71178188899708,267,41,23.59396299902629,10
Category_Wikipedia_sockpuppets_of_Ineedtostopforgetting.csv,15381,113714885.0,4168,11213,500,3668,0,48.041739808855084,500,97,19.874195435927444,3
Category_Wikipedia_sockpuppets_of_Ainu_nigam_Singer.csv,48,67678269.0,21,27,17,4,0,35.333333333333336,226,53,27.833333333333332,17
Category_Wikipedia_sockpuppets_of_MaloneyW.F.C.csv,1593,115115092.0,779,814,500,279,0,25.78468298807282,253,38,16.919648462021343,9
Category_Wikipedia_sockpuppets_of_Mr.Strat_Starky.csv,203,900302.0,90,113,78,12,0,43.80295566502463,255,55,34.576354679802954,13
Category_Wikipedia_sockpuppets_of_Wikivuyo.csv,32,5462006.0,13,19,13,0,0,50.71875,233,33,22.03125,13
Category_Wikipedia_sockpuppets_of_Lindokuhle_Modi.csv,1176,107239376.0,397,779,224,173,0,37.75,500,57,17.47874149659864,4
Category_Wikipedia_sockpuppets_of_Curious_bystander.csv,1695,11484241.0,475,1220,283,192,0,47.146902654867255,255,68,25.06489675516224,4
Category_Wikipedia_sockpuppets_of_GhettoFashion.csv,243,6560749.0,81,162,77,4,0,43.75308641975309,268,44,22.012345679012345,9
Category_Wikipedia_sockpuppets_of_Laxide13.csv,113,241651.0,49,64,45,4,0,45.876106194690266,243,45,16.460176991150444,6
Category_Wikipedia_sockpuppets_of_Volcano_Girl.csv,10,104712.0,6,4,5,1,0,72.1,176,19,17.8,16
Category_Wikipedia_sockpuppets_of_BlackDemon666.csv,18,1093.0,8,10,1,7,53,64.38888888888889,68,31,24.166666666666668,19
Category_Wikipedia_sockpuppets_of_Shahab_sarwar.csv,45,225439084.0,17,28,16,1,0,57.91111111111111,334,34,17.844444444444445,14
Category_Wikipedia_sockpuppets_of_KBAllstar97.csv,51,739370.0,15,36,9,6,0,36.6078431372549,253,44,20.0,8
Category_Wikipedia_sockpuppets_of_Smith_Jones.csv,2301,193541976.0,634,1667,500,134,0,50.25510647544546,250,80,24.172099087353324,6
Category_Wikipedia_sockpuppets_of_SacredNefarious.csv,2319,7502602.0,726,1593,150,576,0,47.54980595084088,255,99,18.041397153945667,5
Category_Wikipedia_sockpuppets_of_Chuwils.csv,523,27134258.0,170,353,66,104,0,39.94646271510516,210,51,18.575525812619503,7
Category_Wikipedia_sockpuppets_of_OzPressler.csv,82,4561194.0,27,55,27,0,0,22.536585365853657,228,30,14.841463414634147,11
Category_Wikipedia_sockpuppets_of_Nemanja1455.csv,64,734655.0,38,26,31,7,0,27.453125,222,21,12.765625,11
Category_Wikipedia_sockpuppets_of_Launebee.csv,1900,25448518.0,607,1293,500,107,0,46.246315789473684,255,74,31.655789473684212,8
Category_Wikipedia_sockpuppets_of_Aleixa77.csv,7,41766980.0,3,4,3,0,0,17.857142857142858,55,28,26.285714285714285,26
Category_Wikipedia_sockpuppets_of_Mmor123.csv,400,10556109.0,123,277,110,13,0,29.7675,230,43,24.215,7
Category_Wikipedia_sockpuppets_of_Petersfield_Museum.csv,8,1637239.0,5,3,4,1,0,22.25,59,28,21.75,18
Category_Wikipedia_sockpuppets_of_Timlaieditor.csv,2481,47316840.0,772,1709,389,383,0,60.20636839983877,395,73,18.17210802095929,4
Category_Wikipedia_sockpuppets_of_PaniRada.csv,108,19025362.0,31,77,10,21,0,41.833333333333336,151,27,16.87962962962963,6
Category_Wikipedia_sockpuppets_of_GreenWitherYT.csv,93,1896302.0,39,54,23,16,0,54.24731182795699,235,30,18.731182795698924,6
Category_Wikipedia_sockpuppets_of_Lancashirehotpot74.csv,79,252882.0,28,51,20,8,0,49.44303797468354,255,40,19.430379746835442,9
Category_Wikipedia_sockpuppets_of_Kaabasane.csv,334,65517103.0,103,231,10,93,0,46.461077844311376,233,28,11.802395209580839,3
Category_Wikipedia_sockpuppets_of_WebHamster.csv,5441,79126374.0,1530,3911,500,1030,0,60.700422716412426,265,67,21.757213747472893,4
Category_Wikipedia_sockpuppets_of_Dwlr.csv,45,1822913.0,12,33,10,2,0,58.68888888888889,250,36,11.977777777777778,5
Category_Wikipedia_sockpuppets_of_Awaad_Lukwago.csv,52,103526.0,22,30,18,4,0,45.86538461538461,246,53,30.192307692307693,8
Category_Wikipedia_sockpuppets_of_Sureshsharma5.csv,2,176.0,2,0,2,0,0,0.0,0,23,23.0,23
Category_Wikipedia_sockpuppets_of_Healthspectrum.csv,34,14769899.0,15,19,14,1,0,50.911764705882355,160,35,21.558823529411764,12
Category_Wikipedia_sockpuppets_of_Mayujain.csv,30,129779878.0,6,24,6,0,0,28.666666666666668,164,35,19.4,7
Category_Wikipedia_sockpuppets_of_Wadamz.csv,2690,261256943.0,1096,1594,500,596,0,29.173234200743494,297,57,17.927881040892192,4
Category_Wikipedia_sockpuppets_of_Rajosmk2.csv,95,2623109.0,42,53,36,6,0,25.86315789473684,171,52,24.389473684210525,17
Category_Wikipedia_sockpuppets_of_A_Friendly_Wiki_Editor.csv,236,107846747.0,71,165,26,45,0,55.516949152542374,407,70,17.02542372881356,4
Category_Wikipedia_sockpuppets_of_Idontremember2012.csv,48,16784347.0,19,29,18,1,0,40.3125,201,27,15.6875,3
Category_Wikipedia_sockpuppets_of_Dkjhbrewfhyjegfuygf.csv,510,37088055.0,185,325,87,98,0,40.76274509803922,234,37,17.633333333333333,8
Category_Wikipedia_sockpuppets_of_Dp1973.csv,28,3721752.0,9,19,7,2,0,50.357142857142854,234,43,16.857142857142858,11
Category_Wikipedia_sockpuppets_of_Vandalist1235.csv,4,1066.0,2,2,1,1,0,77.5,174,18,18.0,18
Category_Wikipedia_sockpuppets_of_EllEffer.csv,23,2225872.0,17,6,15,2,0,29.956521739130434,199,13,8.130434782608695,4
Category_Wikipedia_sockpuppets_of_Andreasyiangoumelbourne.csv,464,2169494.0,174,290,90,84,0,40.86206896551724,255,48,16.963362068965516,4
Category_Wikipedia_sockpuppets_of_Ghana_Armed_Forces.csv,31,327853.0,15,16,8,7,0,55.225806451612904,315,31,20.193548387096776,10
Category_Wikipedia_sockpuppets_of_Carbine.csv,917,147236245.0,319,598,224,95,0,35.17557251908397,222,51,21.652126499454745,4
Category_Wikipedia_sockpuppets_of_Tem√©rdek.csv,26,236225091.0,11,15,7,4,0,39.88461538461539,196,61,23.192307692307693,8
Category_Wikipedia_sockpuppets_of_Euless.csv,15,1382612.0,4,11,2,2,0,43.46666666666667,157,44,26.4,12
Category_Wikipedia_sockpuppets_of_TechnicalDevityoutube.csv,32,755133.0,12,20,6,6,0,61.3125,224,38,22.21875,10
Category_Wikipedia_sockpuppets_of_Garvit34507.csv,2074,10711967.0,658,1416,448,210,0,37.14513018322083,326,45,16.241080038572807,3
Category_Wikipedia_sockpuppets_of_Jonathanbrune.csv,15,1722280.0,6,9,4,2,9,55.13333333333333,131,37,21.533333333333335,15
Category_Wikipedia_sockpuppets_of_Thylacinus_cynocephalus.csv,4252,296615066.0,986,3266,500,486,0,51.94543744120414,325,69,18.25846660395108,3
Category_Wikipedia_sockpuppets_of_Jaidon_Lacy.csv,35,2926244.0,13,22,9,4,0,64.88571428571429,153,66,22.428571428571427,8
Category_Wikipedia_sockpuppets_of_SethMacfarlaneGypsy.csv,310,41257312.0,62,248,4,58,0,49.69032258064516,254,24,13.380645161290323,8
Category_Wikipedia_sockpuppets_of_Intracall.csv,2600,69349375.0,793,1807,500,293,0,45.269615384615385,515,92,19.308846153846154,3
Category_Wikipedia_sockpuppets_of_SujianGu.csv,50,3753882.0,32,18,26,6,0,42.42,185,20,16.6,10
Category_Wikipedia_sockpuppets_of_Mercilesschaos.csv,4,263.0,3,1,3,0,5,41.25,138,31,31.0,31
Category_Wikipedia_sockpuppets_of_MAKAMURE.csv,176,19103994.0,62,114,34,28,0,59.63068181818182,329,41,19.482954545454547,6
Category_Wikipedia_sockpuppets_of_Fieldmarshalgoldenboy.csv,457,45699883.0,160,297,144,16,0,42.901531728665205,254,52,26.571115973741794,8
Category_Wikipedia_sockpuppets_of_Dansham.csv,2991,218192424.0,677,2314,500,177,0,39.85623537278502,255,72,22.71146773654296,3
Category_Wikipedia_sockpuppets_of_Adnanzakir.csv,58,3787563.0,49,9,47,2,0,21.448275862068964,196,20,11.53448275862069,11
Category_Wikipedia_sockpuppets_of_Ramny.csv,45,152355534.0,12,33,9,3,0,54.733333333333334,196,25,18.555555555555557,7
Category_Wikipedia_sockpuppets_of_Timothyhere.csv,3414,98085767.0,903,2511,213,690,0,49.09285295840656,255,73,29.75659050966608,8
Category_Wikipedia_sockpuppets_of_Unorginal.csv,126,9914240.0,49,77,16,33,0,58.56349206349206,255,44,31.76984126984127,7
Category_Wikipedia_sockpuppets_of_Omarsito_1972.csv,294,5911516.0,159,135,124,35,0,30.023809523809526,232,36,27.367346938775512,13
Category_Wikipedia_sockpuppets_of_Bruhmoo.csv,19,40342.0,11,8,7,4,0,41.21052631578947,213,21,14.789473684210526,11
Category_Wikipedia_sockpuppets_of_Helper916.csv,54,2193.0,36,18,18,18,0,21.814814814814813,96,55,41.425925925925924,14
Category_Wikipedia_sockpuppets_of_Sharkoii.csv,642,88208063.0,183,459,78,105,0,58.66822429906542,500,65,21.993769470404985,4
Category_Wikipedia_sockpuppets_of_Zarao099884556.csv,758,2182253.0,264,494,60,204,0,40.96965699208443,255,37,14.969656992084433,5
Category_Wikipedia_sockpuppets_of_Hasan342.csv,126,1945958.0,57,69,34,23,0,90.85714285714286,500,32,18.58730158730159,6
Category_Wikipedia_sockpuppets_of_Deedstar.csv,37,752496.0,16,21,11,5,2,43.432432432432435,195,42,24.45945945945946,5
Category_Wikipedia_sockpuppets_of_TRLIJC18.csv,1473,100400073.0,411,1062,373,38,0,37.24304141208418,263,70,16.924643584521384,6
Category_Wikipedia_sockpuppets_of_Theknowhowman.csv,1276,10109058.0,501,775,500,1,0,49.86990595611285,395,57,13.803291536050157,3
Category_Wikipedia_sockpuppets_of_Alexanderfriend.csv,1058,149201492.0,245,813,241,4,0,43.80245746691872,253,44,16.307183364839318,3
Category_Wikipedia_sockpuppets_of_Minimalone.csv,335,9295071.0,187,148,55,132,0,38.84776119402985,250,46,17.605970149253732,8
Category_Wikipedia_sockpuppets_of_Ustesians.csv,167,33844303.0,79,88,31,48,0,28.634730538922156,228,44,28.88622754491018,12
Category_Wikipedia_sockpuppets_of_BookWorm44.csv,4507,33225356.0,1511,2996,500,1011,0,45.00532504992234,254,68,18.78389172398491,5
Category_Wikipedia_sockpuppets_of_Ebubay01.csv,423,336000984.0,151,272,150,1,0,49.26004728132388,255,54,21.664302600472812,5
Category_Wikipedia_sockpuppets_of_Party4321.csv,123,10681344.0,37,86,20,17,0,36.68292682926829,225,16,6.878048780487805,5
Category_Wikipedia_sockpuppets_of_Perfect_Orange_Sphere.csv,3119,106425992.0,987,2132,500,487,0,55.61526130169926,255,77,23.73260660468099,4
Category_Wikipedia_sockpuppets_of_Cute_1_4_u.csv,2517,10149921.0,735,1782,500,235,0,21.668255860150975,255,51,15.973778307508939,3
Category_Wikipedia_sockpuppets_of_RAwriter1105.csv,10,410622.0,5,5,3,2,0,47.6,178,22,16.0,13
Category_Wikipedia_sockpuppets_of_Paulosfedon.csv,8,1011266.0,5,3,3,2,0,73.125,199,18,17.5,16
Category_Wikipedia_sockpuppets_of_‡¶∏‡¶ø‡¶°‡¶æ‡¶ü‡¶ø‡¶≠_‡¶π‡¶ø‡¶™‡¶®‡ßã‡¶ü‡¶ø‡¶ï‡ßç‡¶∏.csv,306,235276606.0,88,218,76,12,0,59.3562091503268,417,53,23.797385620915033,3
Category_Wikipedia_sockpuppets_of_TheQ_Editor.csv,1898,192187061.0,544,1354,500,44,0,67.68282402528978,295,66,20.35721812434141,3
Category_Wikipedia_sockpuppets_of_Yoxon.csv,140,52685644.0,45,95,35,10,0,60.65714285714286,227,26,13.92142857142857,5
Category_Wikipedia_sockpuppets_of_SplitLickRepeat.csv,63,2253840.0,16,47,10,6,0,53.63492063492063,239,37,20.96825396825397,10
Category_Wikipedia_sockpuppets_of_Jesteron27.csv,1166,26186457.0,507,659,500,7,0,35.53344768439108,500,47,22.449399656946827,9
Category_Wikipedia_sockpuppets_of_Rattankumardatta.csv,9,430788.0,6,3,4,2,0,45.55555555555556,246,26,23.22222222222222,17
Category_Wikipedia_sockpuppets_of_Sidzadaun.csv,62,17558747.0,23,39,16,7,0,42.53225806451613,224,71,28.403225806451612,4
Category_Wikipedia_sockpuppets_of_Nalina.E.Nalina.csv,3135,7911104.0,1000,2135,500,500,0,32.34066985645933,406,50,16.648803827751195,3
Category_Wikipedia_sockpuppets_of_Julian3676.csv,29,593725.0,17,12,17,0,0,30.06896551724138,197,31,10.10344827586207,5
Category_Wikipedia_sockpuppets_of_Iamrichturner.csv,55,6718527.0,54,1,47,7,0,21.01818181818182,496,23,17.490909090909092,17
Category_Wikipedia_sockpuppets_of_Coinmaster1.csv,141,2633530.0,46,95,14,32,0,41.836879432624116,233,63,18.666666666666668,5
Category_Wikipedia_sockpuppets_of_Oopsie_poopsie.csv,703,81716069.0,244,459,94,150,0,45.226173541963014,219,35,14.714082503556188,4
Category_Wikipedia_sockpuppets_of_EnglishYard.csv,61,17202826.0,31,30,16,15,0,42.57377049180328,170,41,26.16393442622951,13
Category_Wikipedia_sockpuppets_of_EditorJ16.csv,362,129383307.0,96,266,60,36,0,54.488950276243095,332,40,15.867403314917127,6
Category_Wikipedia_sockpuppets_of_Gldgenga471834gldben.csv,705,28791068.0,276,429,109,167,0,44.57021276595745,319,47,22.086524822695036,7
Category_Wikipedia_sockpuppets_of_Gaurh.csv,3062,67103469.0,1000,2062,500,500,0,40.77465708687133,294,73,23.201828870019597,4
Category_Wikipedia_sockpuppets_of_Lolyoullneverknow.csv,1,0.0,1,0,1,0,56,56.0,56,6,6.0,6
Category_Wikipedia_sockpuppets_of_Allison419.csv,124,12703587.0,44,80,40,4,0,50.056451612903224,252,45,15.89516129032258,7
Category_Wikipedia_sockpuppets_of_Winebloom.csv,655,47935293.0,145,510,70,75,0,52.93282442748092,225,41,15.070229007633587,4
Category_Wikipedia_sockpuppets_of_JoaquindeMosquerayFigueroa.csv,683,5786404.0,271,412,270,1,0,49.756954612005856,500,37,21.740849194729137,6
Category_Wikipedia_sockpuppets_of_Leandro_da_silva_pereira_santos.csv,3756,16877665.0,1023,2733,500,523,0,33.33413205537806,255,61,16.70846645367412,6
Category_Wikipedia_sockpuppets_of_R_128.40.76.3.csv,419,18331585.0,148,271,48,100,0,37.66825775656324,200,47,19.269689737470166,6
Category_Wikipedia_sockpuppets_of_Historical_Mensch.csv,178,22380931.0,88,90,84,4,0,37.337078651685395,252,23,11.47191011235955,9
Category_Wikipedia_sockpuppets_of_Dstaebler.csv,53,23582.0,26,27,18,8,0,65.71698113207547,207,21,16.62264150943396,16
Category_Wikipedia_sockpuppets_of_Richardson_j.csv,1385,131232818.0,471,914,406,65,0,43.86064981949458,254,58,18.788447653429603,6
Category_Wikipedia_sockpuppets_of_Atcurrent.csv,261,5610563.0,137,124,60,77,0,37.75478927203065,255,35,21.93486590038314,9
Category_Wikipedia_sockpuppets_of_Mirror_Man.csv,193,2046136.0,82,111,52,30,0,38.715025906735754,200,45,27.621761658031087,10
Category_Wikipedia_sockpuppets_of_Philip_Jesta.csv,3,565.0,3,0,1,2,30,30.0,30,26,24.666666666666668,24
Category_Wikipedia_sockpuppets_of_Egyptianjoker9.csv,14,9493.0,8,6,4,4,14,46.714285714285715,219,24,19.714285714285715,18
Category_Wikipedia_sockpuppets_of_Xeyal.csv,671,82588136.0,247,424,124,123,0,38.135618479880776,492,71,17.934426229508198,4
Category_Wikipedia_sockpuppets_of_Carlraschke.csv,531,2663825.0,223,308,74,149,0,66.06214689265536,255,51,22.239171374764595,5
Category_Wikipedia_sockpuppets_of_K_Melwani.csv,729,22906317.0,326,403,199,127,0,35.77777777777778,222,32,11.016460905349794,3
Category_Wikipedia_sockpuppets_of_Garvey_Holmes.csv,241,299331.0,120,121,65,55,0,38.829875518672196,219,42,18.991701244813278,9
Category_Wikipedia_sockpuppets_of_WahPow.csv,120,74734192.0,37,83,37,0,0,67.39166666666667,270,20,13.916666666666666,10
Category_Wikipedia_sockpuppets_of_Coatsplc.csv,14,1202489.0,8,6,5,3,0,51.0,162,11,11.0,11
Category_Wikipedia_sockpuppets_of_Techwithsurya.csv,5,14422.0,4,1,3,1,0,19.6,44,39,32.4,22
Category_Wikipedia_sockpuppets_of_Mrbenchua.csv,11,847.0,7,4,4,3,0,62.36363636363637,139,5,3.909090909090909,3
Category_Wikipedia_sockpuppets_of_Jokintonoto.csv,9,529.0,5,4,3,2,0,48.666666666666664,157,25,23.22222222222222,17
Category_Wikipedia_sockpuppets_of_Big_Willy_willy_in_the_nilly.csv,9,2834860.0,4,5,3,1,0,79.77777777777777,208,64,21.22222222222222,5
Category_Wikipedia_sockpuppets_of_SMGJohn.csv,328,291546439.0,67,261,65,2,0,61.28963414634146,254,49,16.475609756097562,5
Category_Wikipedia_sockpuppets_of_AhnSoonKyung.csv,1861,244395404.0,526,1335,500,26,0,44.7990327780763,378,79,16.54540569586244,3
Category_Wikipedia_sockpuppets_of_Noelemahc.csv,1629,17524337.0,511,1118,500,11,0,33.27133210558625,227,47,15.715776550030693,4
Category_Wikipedia_sockpuppets_of_Fakir005.csv,141,3710651.0,45,96,45,0,0,42.205673758865245,200,47,17.666666666666668,7
Category_Wikipedia_sockpuppets_of_Pmr99.csv,264,46931733.0,71,193,55,16,0,52.71212121212121,357,53,24.34090909090909,3
Category_Wikipedia_sockpuppets_of_Accessquasar.csv,177,95790.0,56,121,16,40,0,48.3728813559322,254,66,31.98870056497175,7
Category_Wikipedia_sockpuppets_of_Sarumio.csv,6410,85958331.0,2187,4223,500,1687,0,34.12496099843994,247,65,23.242901716068644,6
Category_Wikipedia_sockpuppets_of_GrantLumb.csv,101,71841740.0,43,58,17,26,0,23.07920792079208,213,9,9.0,9
Category_Wikipedia_sockpuppets_of_Robotboy199.csv,886,22545188.0,292,594,211,81,0,41.36681715575621,231,50,19.112866817155755,6
Category_Wikipedia_sockpuppets_of_TheRahulAbhishek.csv,12,1946111.0,7,5,7,0,0,51.5,187,33,13.25,11
Category_Wikipedia_sockpuppets_of_Applecabige.csv,149,3183716.0,51,98,14,37,0,60.966442953020135,357,33,17.516778523489933,5
Category_Wikipedia_sockpuppets_of_Le_Poete_Grand_Bleu.csv,87,42958827.0,50,37,28,22,0,34.632183908045974,189,29,20.310344827586206,13
Category_Wikipedia_sockpuppets_of_Massiv3.csv,7,6356127.0,5,2,5,0,0,20.857142857142858,116,17,14.428571428571429,14
Category_Wikipedia_sockpuppets_of_Muhdamin10.csv,17,229579.0,4,13,2,2,0,28.176470588235293,196,23,13.588235294117647,13
Category_Wikipedia_sockpuppets_of_Polrout.csv,766,185149056.0,244,522,133,111,0,49.87206266318538,402,57,27.31201044386423,7
Category_Wikipedia_sockpuppets_of_Quinn2425.csv,441,131234137.0,140,301,134,6,0,45.53741496598639,249,73,22.09750566893424,7
Category_Wikipedia_sockpuppets_of_Miko10022.csv,52,57805538.0,32,20,23,9,0,38.05769230769231,151,42,25.98076923076923,13
Category_Wikipedia_sockpuppets_of_Andrewtaylor1977.csv,16,2328830.0,8,8,4,4,0,26.0,95,27,18.5,13
Category_Wikipedia_sockpuppets_of_Richindiogo12.csv,1095,4667774.0,503,592,277,226,0,41.5013698630137,468,50,11.923287671232877,3
Category_Wikipedia_sockpuppets_of_Farhanfaroo.csv,36,22115858.0,13,23,13,0,0,53.72222222222222,196,36,20.27777777777778,11
Category_Wikipedia_sockpuppets_of_Jacobsipod.csv,89,18780017.0,27,62,18,9,0,57.561797752808985,227,44,18.51685393258427,3
Category_Wikipedia_sockpuppets_of_Astutescholar.csv,394,21764355.0,163,231,113,50,0,46.46192893401015,199,54,24.20812182741117,7
Category_Wikipedia_sockpuppets_of_User_Westburylyndhurst.csv,2,284.0,2,0,2,0,13,14.5,16,23,23.0,23
Category_Wikipedia_sockpuppets_of_Sreelekshmi_R.csv,3,119661.0,2,1,1,1,44,145.33333333333334,196,32,28.0,26
Category_Wikipedia_sockpuppets_of_ApokryItaroes.csv,143,20653284.0,47,96,13,34,0,60.74125874125874,234,47,16.545454545454547,3
Category_Wikipedia_sockpuppets_of_Arth3225.csv,195,7680564.0,58,137,21,37,0,63.01025641025641,263,29,13.225641025641025,5
Category_Wikipedia_sockpuppets_of_Dina_d99.csv,89,714916.0,21,68,11,10,0,70.2247191011236,248,42,19.831460674157302,11
Category_Wikipedia_sockpuppets_of_Mambambo.J.csv,1,0.0,1,0,1,0,35,35.0,35,11,11.0,11
Category_Wikipedia_sockpuppets_of_EMcDermott83.csv,75,279657.0,32,43,21,11,0,47.54666666666667,234,34,17.16,10
Category_Wikipedia_sockpuppets_of_JUGAL70.csv,232,5100163.0,116,116,93,23,0,54.51293103448276,223,27,14.620689655172415,8
Category_Wikipedia_sockpuppets_of_Azamatumbetov.csv,36,45405439.0,17,19,16,1,0,38.80555555555556,161,15,14.666666666666666,9
Category_Wikipedia_sockpuppets_of_Ellisrude.csv,13,86279.0,9,4,7,2,7,56.0,219,43,10.846153846153847,5
Category_Wikipedia_sockpuppets_of_James_ryals.csv,14,4710659.0,11,3,10,1,22,54.07142857142857,80,21,20.642857142857142,16
Category_Wikipedia_sockpuppets_of_Tharunrb.csv,3,98456.0,2,1,2,0,11,18.333333333333332,29,26,18.666666666666668,15
Category_Wikipedia_sockpuppets_of_PENTAGONALIS777.csv,192,1768161.0,82,110,31,51,0,53.505208333333336,254,44,20.776041666666668,7
Category_Wikipedia_sockpuppets_of_Matthewkchopin.csv,24,1277427.0,11,13,6,5,0,36.5,142,7,4.541666666666667,4
Category_Wikipedia_sockpuppets_of_VADemocrat2021.csv,12,11458.0,9,3,3,6,0,29.25,120,28,28.0,28
Category_Wikipedia_sockpuppets_of_NikolaosFanaris.csv,1446,67717196.0,447,999,427,20,0,66.94260027662517,500,64,27.55739972337483,9
Category_Wikipedia_sockpuppets_of_Genuinewikiuser.csv,2307,40420900.0,1000,1307,500,500,0,42.0,496,37,16.899869960988298,5
Category_Wikipedia_sockpuppets_of_Maldaph.csv,35,874.0,10,25,10,0,0,67.74285714285715,247,31,14.857142857142858,4
Category_Wikipedia_sockpuppets_of_Aram-van.csv,29,1390159.0,10,19,10,0,0,52.241379310344826,166,41,25.79310344827586,11
Category_Wikipedia_sockpuppets_of_Hack421.csv,52,8284205.0,20,32,13,7,0,58.92307692307692,246,53,31.0,11
Category_Wikipedia_sockpuppets_of_Labstore.csv,995,107485520.0,343,652,267,76,0,49.73969849246231,255,59,26.0070351758794,4
Category_Wikipedia_sockpuppets_of_Rishabh.s2123.csv,124,8032231.0,57,67,32,25,0,49.516129032258064,274,47,17.838709677419356,6
Category_Wikipedia_sockpuppets_of_Sandeepanchal.csv,28,25835549.0,8,20,7,1,0,62.464285714285715,225,60,19.75,12
Category_Wikipedia_sockpuppets_of_Dvexx.csv,265,8367452.0,82,183,75,7,0,52.55849056603773,243,49,22.343396226415095,4
Category_Wikipedia_sockpuppets_of_SudheerTelaprolu.csv,1122,44580714.0,503,619,498,5,0,30.20142602495544,500,42,15.618538324420678,5
Category_Wikipedia_sockpuppets_of_Ppizzo278.csv,409,44493279.0,146,263,135,11,0,56.9119804400978,488,54,21.04889975550122,3
Category_Wikipedia_sockpuppets_of_Tunedel.csv,364,7625988.0,138,226,18,120,0,36.6510989010989,497,52,17.46978021978022,7
Category_Wikipedia_sockpuppets_of_Acfei.csv,50,6822408.0,14,36,14,0,0,55.56,205,47,21.3,13
Category_Wikipedia_sockpuppets_of_WeerasekaraMHH.csv,178,11253696.0,99,79,73,26,0,37.30898876404494,412,56,27.56741573033708,7
Category_Wikipedia_sockpuppets_of_Mailmeaf.csv,364,6541783.0,125,239,42,83,0,58.5521978021978,255,26,14.684065934065934,9
Category_Wikipedia_sockpuppets_of_Uplaq.csv,160,4175712.0,68,92,29,39,0,45.26875,253,40,29.8375,15
Category_Wikipedia_sockpuppets_of_Agustin03072005.csv,251,16744099.0,106,145,26,80,0,44.374501992031874,493,41,14.350597609561753,5
Category_Wikipedia_sockpuppets_of_Mainstreet_man.csv,66,423.0,17,49,17,0,0,49.06060606060606,199,37,20.0,5
Category_Wikipedia_sockpuppets_of_Muhd_FUad.csv,1992,17023614.0,1205,787,500,705,0,32.73644578313253,255,56,25.25050200803213,8
Category_Wikipedia_sockpuppets_of_Astrcast125.csv,2074,8292196.0,906,1168,500,406,0,32.19672131147541,323,46,14.333172613307617,4
Category_Wikipedia_sockpuppets_of_WALEED3030.csv,482,4649476.0,201,281,153,48,0,47.0746887966805,237,42,19.018672199170126,8
Category_Wikipedia_sockpuppets_of_ARTPR001.csv,191,241081836.0,93,98,57,36,0,41.795811518324605,472,33,19.026178010471206,9
Category_Wikipedia_sockpuppets_of_Ajhenson21.csv,7062,38027026.0,3252,3810,500,2752,0,35.462333616539226,418,58,24.32880203908241,4
Category_Wikipedia_sockpuppets_of_Whereistheproof.csv,73,109347.0,38,35,34,4,0,38.602739726027394,202,51,27.54794520547945,12
Category_Wikipedia_sockpuppets_of_Draykaay.csv,329,2166999.0,147,182,84,63,0,45.598784194528875,212,63,19.696048632218844,5
Category_Wikipedia_sockpuppets_of_Gvbttygytrg.csv,12,174172.0,11,1,8,3,0,11.666666666666666,140,15,14.166666666666666,14
Category_Wikipedia_sockpuppets_of_WalterKlaus3.csv,303,44364554.0,113,190,58,55,0,42.600660066006604,492,47,22.38943894389439,8
Category_Wikipedia_sockpuppets_of_Pakistani_Wikipedian.csv,98,242887589.0,27,71,21,6,0,47.1530612244898,220,61,19.602040816326532,8
Category_Wikipedia_sockpuppets_of_Nokia212.csv,27,3015564.0,8,19,6,2,0,104.0,543,57,21.666666666666668,13
Category_Wikipedia_sockpuppets_of_Elvisandhismagicpelvis.csv,534,9211395.0,208,326,110,98,0,40.646067415730336,215,56,19.249063670411985,9
Category_Wikipedia_sockpuppets_of_MrStefanWolf.csv,502,11627004.0,249,253,163,86,0,61.91434262948207,436,54,23.639442231075698,4
Category_Wikipedia_sockpuppets_of_BarkingFish.csv,3528,233714577.0,1296,2232,500,796,0,56.305839002267575,255,105,26.13095238095238,2
Category_Wikipedia_sockpuppets_of_Lina211.csv,3095,15973860.0,906,2189,326,580,0,55.83780290791599,496,66,15.792245557350565,1
Category_Wikipedia_sockpuppets_of_Salar_King.csv,5,1334811.0,3,2,1,2,0,52.4,148,25,19.8,15
Category_Wikipedia_sockpuppets_of_Sirhappydude.csv,790,129299389.0,257,533,244,13,0,59.90506329113924,489,77,23.845569620253166,7
Category_Wikipedia_sockpuppets_of_Fdaonline.csv,80,3462820.0,23,57,23,0,0,58.1625,211,26,15.3125,9
Category_Wikipedia_sockpuppets_of_Ivan_Bogdanov.csv,1436,25299102.0,500,936,500,0,0,23.73955431754875,255,71,25.12116991643454,6
Category_Wikipedia_sockpuppets_of_Mansi338.csv,123,5622166.0,62,61,54,8,0,44.203252032520325,201,29,21.21951219512195,13
Category_Wikipedia_sockpuppets_of_Ultimatehooly.csv,861,130530659.0,232,629,137,95,0,47.32404181184669,251,59,22.97677119628339,3
Category_Wikipedia_sockpuppets_of_Bojdufa.csv,161,47378396.0,64,97,29,35,0,48.88819875776397,255,57,16.142857142857142,10
Category_Wikipedia_sockpuppets_of_Md_karim_Didar.csv,9,18762773.0,4,5,3,1,0,45.333333333333336,122,27,24.0,18
Category_Wikipedia_sockpuppets_of_PassionforFashion57.csv,19,1802760.0,11,8,8,3,0,42.73684210526316,167,12,12.0,12
Category_Wikipedia_sockpuppets_of_Edit_king2.csv,143,16504832.0,56,87,37,19,0,42.42657342657343,212,53,21.027972027972027,4
Category_Wikipedia_sockpuppets_of_Slice_It_Up!.csv,421,10287470.0,143,278,36,107,0,62.43942992874109,252,41,21.8646080760095,7
Category_Wikipedia_sockpuppets_of_Adman511.csv,196,219621297.0,64,132,35,29,0,72.23469387755102,349,46,19.93877551020408,4
Category_Wikipedia_sockpuppets_of_Giveleft1.csv,22,25913.0,16,6,7,9,0,33.59090909090909,119,24,21.045454545454547,14
Category_Wikipedia_sockpuppets_of_Awesomemccoy18.csv,254,306807118.0,84,170,83,1,0,46.22834645669291,235,49,27.38976377952756,14
Category_Wikipedia_sockpuppets_of_Clarify29.csv,571,5735305.0,171,400,47,124,0,42.576182136602455,255,61,28.416812609457093,5
Category_Wikipedia_sockpuppets_of_Developigng.csv,1146,47064033.0,411,735,180,231,0,42.083769633507856,500,77,35.338568935427574,8
Category_Wikipedia_sockpuppets_of_Shylaja_chetlur.csv,2,358.0,2,0,2,0,12,14.5,17,15,15.0,15
Category_Wikipedia_sockpuppets_of_Marcellokf.csv,9,4334.0,5,4,3,2,0,41.44444444444444,145,22,18.11111111111111,15
Category_Wikipedia_sockpuppets_of_Danielfuinogl.csv,3134,32060779.0,1061,2073,500,561,0,32.517230376515634,255,57,25.039566049776642,2
Category_Wikipedia_sockpuppets_of_Andyccr.csv,288,4061094.0,85,203,49,36,0,55.09375,500,32,13.76388888888889,4
Category_Wikipedia_sockpuppets_of_Dallasmayor.csv,34,5657281.0,15,19,8,7,0,54.76470588235294,149,28,19.08823529411765,11
Category_Wikipedia_sockpuppets_of_SudaniWiki.csv,151,5992325.0,109,42,98,11,0,54.63576158940398,500,20,9.748344370860927,6
Category_Wikipedia_sockpuppets_of_Peeta_Singh.csv,1657,40646107.0,634,1023,500,134,0,48.97103198551599,255,89,24.471333735666867,5
Category_Wikipedia_sockpuppets_of_Lintdnor.csv,10,826386.0,6,4,2,4,0,0.0,0,18,18.0,18
Category_Wikipedia_sockpuppets_of_Jericho900.csv,219,35852544.0,51,168,29,22,0,29.273972602739725,255,36,19.771689497716896,9
Category_Wikipedia_sockpuppets_of_LylaBean.csv,4,743.0,3,1,2,1,12,50.5,135,19,19.0,19
Category_Wikipedia_sockpuppets_of_Hugule_19.csv,221,9346484.0,81,140,23,58,0,53.06334841628959,228,35,21.968325791855204,7
Category_Wikipedia_sockpuppets_of_Abidemi234.csv,23,6678697.0,11,12,6,5,0,66.6086956521739,196,40,24.304347826086957,16
Category_Wikipedia_sockpuppets_of_Arabianlenzo178.csv,262,6732954.0,138,124,62,76,0,42.545801526717554,496,52,31.374045801526716,11
Category_Wikipedia_sockpuppets_of_Cfbohner.csv,39,66822856.0,14,25,8,6,0,37.43589743589744,196,44,30.205128205128204,10
Category_Wikipedia_sockpuppets_of_SlitherioFan2016.csv,1004,8423618.0,342,662,105,237,0,62.19223107569721,255,71,22.407370517928285,4
Category_Wikipedia_sockpuppets_of_Janitzius.csv,1465,6877402.0,500,965,500,0,0,49.72627986348123,499,54,18.00750853242321,5
Category_Wikipedia_sockpuppets_of_Muhammad_Farrel_D.csv,4494,53107138.0,1520,2974,500,1020,0,38.41010235870049,424,53,11.720961281708945,4
Category_Wikipedia_sockpuppets_of_LongorioVerification.csv,1,0.0,1,0,1,0,0,0.0,0,23,23.0,23
Category_Wikipedia_sockpuppets_of_JuggaloDan2013.csv,174,759980.0,63,111,50,13,0,41.85057471264368,252,57,25.367816091954023,9
Category_Wikipedia_sockpuppets_of_Filthy_frank_nyes.csv,41,593658.0,18,23,12,6,4,69.53658536585365,268,29,22.195121951219512,13
Category_Wikipedia_sockpuppets_of_Muhammad_wajahid_saeed.csv,97,58171376.0,29,68,28,1,0,50.2680412371134,194,40,23.371134020618555,13
Category_Wikipedia_sockpuppets_of_Hajoon0102.csv,930,85234610.0,509,421,500,9,0,47.196774193548386,496,58,21.455913978494625,3
Category_Wikipedia_sockpuppets_of_KingR2r.csv,76,250983883.0,37,39,33,4,0,43.21052631578947,212,19,16.42105263157895,11
Category_Wikipedia_sockpuppets_of_IranicaEditor.csv,1509,20659389.0,514,995,500,14,0,49.979456593770706,506,53,21.959575878064943,5
Category_Wikipedia_sockpuppets_of_McWomble.csv,1443,20590846.0,547,896,500,47,0,41.53915453915454,224,85,27.302148302148304,4
Category_Wikipedia_sockpuppets_of_GermanKity.csv,2847,191434305.0,1305,1542,500,805,0,60.037232174218474,470,71,27.735159817351597,4
Category_Wikipedia_sockpuppets_of_DelosHarriman.csv,388,21361296.0,124,264,84,40,0,34.28092783505155,191,50,19.7319587628866,6
Category_Wikipedia_sockpuppets_of_PRASHANTT_GUPTHA.csv,22,78407.0,14,8,14,0,0,30.181818181818183,85,26,26.0,26
Category_Wikipedia_sockpuppets_of_JACUBANHELADO.csv,1553,16132452.0,773,780,500,273,0,32.811976819059886,255,54,21.83386992916935,8
Category_Wikipedia_sockpuppets_of_Hasfie.csv,1519,13130460.0,1252,267,185,1067,0,21.291639236339698,232,47,21.86965108624095,11
Category_Wikipedia_sockpuppets_of_Jdjcjj.csv,19,4911134.0,9,10,5,4,0,63.421052631578945,226,6,5.105263157894737,4
Category_Wikipedia_sockpuppets_of_Terfslayer.csv,18,454295.0,11,7,10,1,0,54.388888888888886,129,27,15.777777777777779,12
Category_Wikipedia_sockpuppets_of_Sanjaygp.csv,38,769069.0,31,7,5,26,0,118.89473684210526,231,33,20.42105263157895,9
Category_Wikipedia_sockpuppets_of_Mig33_(It's_fun!_Are_you_).csv,11,98626.0,7,4,7,0,0,28.818181818181817,96,20,15.909090909090908,10
Category_Wikipedia_sockpuppets_of_Ionas68224.csv,3710,96413727.0,1195,2515,424,771,0,40.69137466307278,250,77,20.636388140161724,1
Category_Wikipedia_sockpuppets_of_WideOpenInternet.csv,49,4809.0,20,29,4,16,0,67.3265306122449,240,16,15.489795918367347,14
Category_Wikipedia_sockpuppets_of_Alexa_65656565.csv,26,2245919.0,16,10,8,8,0,47.80769230769231,141,42,33.96153846153846,14
Category_Wikipedia_sockpuppets_of_Wiki_wolfname.csv,900,18663545.0,291,609,109,182,0,47.07,500,49,17.446666666666665,4
Category_Wikipedia_sockpuppets_of_Tcheeku.csv,140,114108431.0,85,55,69,16,0,35.42857142857143,231,23,17.607142857142858,12
Category_Wikipedia_sockpuppets_of_Owenrose1021.csv,935,67627386.0,270,665,137,133,0,44.27058823529412,300,46,16.29625668449198,6
Category_Wikipedia_sockpuppets_of_Viii007.csv,1724,40030550.0,856,868,500,356,0,49.04930394431555,240,84,23.070185614849187,5
Category_Wikipedia_sockpuppets_of_Pirveis.csv,5,117.0,4,1,4,0,0,0.0,0,17,17.0,17
Category_Wikipedia_sockpuppets_of_Aneconomist.csv,403,5574272.0,175,228,42,133,0,40.33002481389578,214,46,13.665012406947891,5
Category_Wikipedia_sockpuppets_of_Wizgirl1470.csv,148,30658829.0,73,75,49,24,0,55.62162162162162,301,24,19.47972972972973,11
Category_Wikipedia_sockpuppets_of_3ejhi.csv,102,12629192.0,43,59,9,34,0,54.549019607843135,190,27,16.431372549019606,10
Category_Wikipedia_sockpuppets_of_BobTheBuilder1997.csv,259,3140314.0,63,196,21,42,0,44.93436293436294,232,52,17.683397683397683,4
Category_Wikipedia_sockpuppets_of_KBlott.csv,1793,99930040.0,684,1109,500,184,0,51.955939765755716,250,50,18.983268265476855,3
Category_Wikipedia_sockpuppets_of_Elphas_Mashamba.csv,67,20996259.0,23,44,17,6,0,50.43283582089552,196,53,32.343283582089555,18
Category_Wikipedia_sockpuppets_of_Secretive_lobbyist.csv,243,32652864.0,94,149,92,2,0,48.534979423868315,354,47,20.695473251028808,7
Category_Wikipedia_sockpuppets_of_David_Adam_Kess.csv,2174,157240297.0,677,1497,500,177,0,89.94342226310948,499,78,18.12695492180313,3
Category_Wikipedia_sockpuppets_of_Oldyorke.csv,1477,46528411.0,543,934,500,43,0,46.90995260663507,255,52,17.283683141503047,3
Category_Wikipedia_sockpuppets_of_Alexmchoward.csv,16,65065.0,9,7,6,3,0,70.0625,177,21,20.875,20
Category_Wikipedia_sockpuppets_of_Moka_Mo.csv,5699,47596808.0,1382,4317,500,882,0,54.998420775574665,500,62,16.32514476223899,4
Category_Wikipedia_sockpuppets_of_Always420.csv,154,9415417.0,46,108,10,36,0,40.37012987012987,187,31,27.74025974025974,15
Category_Wikipedia_sockpuppets_of_Davedh.csv,86,271038606.0,27,59,25,2,0,55.348837209302324,265,44,21.069767441860463,5
Category_Wikipedia_sockpuppets_of_VTP_Apps.csv,10,523368.0,5,5,4,1,0,87.7,238,18,14.8,12
Category_Wikipedia_sockpuppets_of_Discourseur.csv,1335,27817109.0,418,917,233,185,0,43.81722846441948,254,66,20.27640449438202,3
Category_Wikipedia_sockpuppets_of_Helloitsurmomlol.csv,20,73150.0,11,9,10,1,6,74.5,147,33,19.2,12
Category_Wikipedia_sockpuppets_of_Mumbaiker.csv,1927,241503306.0,695,1232,223,472,0,54.972496107939804,500,69,20.740010378827193,4
Category_Wikipedia_sockpuppets_of_CS_41.csv,12,1445668.0,4,8,3,1,0,43.5,119,24,19.75,17
Category_Wikipedia_sockpuppets_of_Fazmeerdj.csv,94,206681700.0,32,62,29,3,0,56.351063829787236,228,50,33.45744680851064,14
Category_Wikipedia_sockpuppets_of_Aizaz_Shahid.csv,1028,78978481.0,255,773,63,192,0,56.3239299610895,368,57,17.797665369649806,5
Category_Wikipedia_sockpuppets_of_KJ332.csv,1361,7619698.0,398,963,140,258,0,33.26965466568699,497,65,27.296105804555474,4
Category_Wikipedia_sockpuppets_of_Dileep.mann.csv,1,0.0,1,0,1,0,17,17.0,17,19,19.0,19
Category_Wikipedia_sockpuppets_of_ThisIsMyWikipediaName111.csv,129,21677184.0,30,99,29,1,0,48.651162790697676,495,41,20.75968992248062,18
Category_Wikipedia_sockpuppets_of_Kroshta.csv,1070,56987828.0,459,611,358,101,0,40.2803738317757,346,43,12.42803738317757,4
Category_Wikipedia_sockpuppets_of_AKASH_TH15.csv,2107,27953277.0,719,1388,500,219,0,36.396298054105365,496,49,18.168960607498814,5
Category_Wikipedia_sockpuppets_of_Gladys_Tuffnell.csv,1780,113941191.0,704,1076,409,295,0,22.87696629213483,233,66,16.642134831460673,3
Category_Wikipedia_sockpuppets_of_Tenant23.csv,1009,798795.0,242,767,153,89,0,17.496531219028743,200,54,19.871159563924678,12
Category_Wikipedia_sockpuppets_of_Prafful_Vishnoi.csv,8,403049.0,4,4,2,2,33,101.5,195,31,25.25,23
Category_Wikipedia_sockpuppets_of_Jdzarlino.csv,832,209658286.0,266,566,145,121,0,51.671875,255,59,16.78846153846154,4
Category_Wikipedia_sockpuppets_of_Nyage01.csv,378,4585552.0,236,142,70,166,0,31.402116402116402,239,30,15.865079365079366,11
Category_Wikipedia_sockpuppets_of_Yankees5861.csv,1,0.0,1,0,1,0,32,32.0,32,14,14.0,14
Category_Wikipedia_sockpuppets_of_Willjones2020.csv,259,38176323.0,60,199,22,38,0,61.00772200772201,351,37,16.1003861003861,10
Category_Wikipedia_sockpuppets_of_KunalArvian.csv,19,183649.0,9,10,8,1,0,47.36842105263158,192,15,13.263157894736842,10
Category_Wikipedia_sockpuppets_of_Laxmimadhesiya.csv,150,6392781.0,64,86,30,34,0,48.68666666666667,255,78,19.966666666666665,10
Category_Wikipedia_sockpuppets_of_Vrave98.csv,140,8560042.0,44,96,39,5,0,51.18571428571428,250,49,23.585714285714285,6
Category_Wikipedia_sockpuppets_of_Waterbucket123.csv,69,4073355.0,21,48,19,2,0,35.82608695652174,209,53,34.289855072463766,18
Category_Wikipedia_sockpuppets_of_Clodmuse.csv,138,121350160.0,44,94,43,1,0,65.0,495,56,18.07246376811594,8
Category_Wikipedia_sockpuppets_of_By78.csv,3413,53831542.0,906,2507,500,406,0,58.8962789334896,250,70,20.685613829475535,3
Category_Wikipedia_sockpuppets_of_Ginger806.csv,120,12804673.0,90,30,85,5,0,21.358333333333334,235,22,10.091666666666667,7
Category_Wikipedia_sockpuppets_of_Pmorley1.csv,397,161576503.0,148,249,92,56,0,51.66750629722922,241,43,17.16624685138539,4
Category_Wikipedia_sockpuppets_of_Kanoouwa1.csv,391,18903657.0,139,252,34,105,0,56.41432225063939,332,60,16.754475703324808,4
Category_Wikipedia_sockpuppets_of_Sak_433.csv,19,7976.0,10,9,8,2,0,53.36842105263158,213,14,14.0,14
Category_Wikipedia_sockpuppets_of_Jahfresh15.csv,120,3697647.0,50,70,12,38,0,47.425,242,32,9.766666666666667,5
Category_Wikipedia_sockpuppets_of_Player1505.csv,2,0.0,1,1,1,0,193,193.0,193,18,18.0,18
Category_Wikipedia_sockpuppets_of_Knikhil21.csv,203,271177134.0,58,145,30,28,0,49.98522167487685,255,27,14.448275862068966,5
Category_Wikipedia_sockpuppets_of_Gongwool.csv,2696,36111239.0,969,1727,500,469,0,56.38724035608308,255,56,23.221439169139465,4
Category_Wikipedia_sockpuppets_of_JamesReynolds331.csv,172,102202902.0,43,129,43,0,0,70.51744186046511,496,47,18.674418604651162,5
Category_Wikipedia_sockpuppets_of_Pacifist007.csv,467,40987751.0,191,276,82,109,0,46.58886509635974,429,38,16.64453961456103,8
Category_Wikipedia_sockpuppets_of_RaunaNekomba.csv,106,858204.0,64,42,16,48,0,76.76415094339623,496,32,18.27358490566038,9
Category_Wikipedia_sockpuppets_of_Jmayhoff.csv,16,1545.0,11,5,5,6,0,44.8125,158,29,28.25,23
Category_Wikipedia_sockpuppets_of_Aaaasrdf.csv,44,614222.0,16,28,12,4,0,54.5,169,34,24.954545454545453,10
Category_Wikipedia_sockpuppets_of_Peterye2005.csv,1818,124688302.0,549,1269,500,49,0,60.36743674367437,312,75,22.20682068206821,3
Category_Wikipedia_sockpuppets_of_ALizee1233.csv,1,0.0,1,0,1,0,0,0.0,0,21,21.0,21
Category_Wikipedia_sockpuppets_of_Devoter.csv,600,85975106.0,209,391,119,90,0,50.06333333333333,496,67,19.376666666666665,5
Category_Wikipedia_sockpuppets_of_Coooolllllgaalllll.csv,8,543.0,5,3,3,2,0,63.875,220,40,39.375,39
Category_Wikipedia_sockpuppets_of_Aapka_Aakash.csv,698,6286236.0,244,454,156,88,0,41.24785100286533,399,62,15.163323782234958,5
Category_Wikipedia_sockpuppets_of_Venezoltan.csv,22,5090131.0,10,12,3,7,15,74.5909090909091,247,20,17.272727272727273,16
Category_Wikipedia_sockpuppets_of_Owoyed.csv,656,4194920.0,197,459,94,103,0,49.15548780487805,286,52,18.275914634146343,4
Category_Wikipedia_sockpuppets_of_Qattus1055.csv,1422,31794388.0,501,921,79,422,0,53.13291139240506,249,54,20.147679324894515,4
Category_Wikipedia_sockpuppets_of_Dhanashriadm.csv,15,1645691.0,5,10,2,3,10,56.53333333333333,138,18,14.933333333333334,10
Category_Wikipedia_sockpuppets_of_Walteredwardsenglish.csv,13,1202442.0,7,6,4,3,0,100.61538461538461,243,31,21.0,6
Category_Wikipedia_sockpuppets_of_GrazyPolis.csv,80,5537160.0,23,57,20,3,0,35.9125,318,20,13.1375,7
Category_Wikipedia_sockpuppets_of_Ninni89.csv,9,10834190.0,5,4,3,2,0,37.22222222222222,96,46,22.0,7
Category_Wikipedia_sockpuppets_of_Mychele_Trempetich.csv,1774,487433784.0,574,1200,500,74,0,48.56538895152198,494,55,16.8945885005637,2
Category_Wikipedia_sockpuppets_of_Swans_ltd.csv,6,434091.0,2,4,2,0,0,26.833333333333332,135,33,20.0,7
Category_Wikipedia_sockpuppets_of_Princedj485.csv,925,4615112.0,469,456,153,316,0,35.464864864864865,233,43,22.647567567567567,4
Category_Wikipedia_sockpuppets_of_HaterLomit.csv,3,646743.0,2,1,1,1,0,3.3333333333333335,10,16,16.0,16
Category_Wikipedia_sockpuppets_of_Golfeditor1.csv,147,237307730.0,53,94,53,0,0,39.91156462585034,227,33,18.564625850340136,13
Category_Wikipedia_sockpuppets_of_IHateRepublicans.csv,1,0.0,1,0,1,0,61,61.0,61,26,26.0,26
Category_Wikipedia_sockpuppets_of_Paulo_Leonel.csv,250,2159383.0,86,164,64,22,0,34.72,209,45,19.92,11
Category_Wikipedia_sockpuppets_of_Thelonerex.csv,888,113645330.0,284,604,230,54,0,41.277027027027025,250,53,19.26689189189189,6
Category_Wikipedia_sockpuppets_of_Trueknowledge789.csv,1837,19793176.0,665,1172,278,387,0,46.80130647795318,500,61,17.3745236799129,4
Category_Wikipedia_sockpuppets_of_Amvivek.csv,1444,181457238.0,525,919,101,424,0,44.520083102493075,274,61,19.61288088642659,5
Category_Wikipedia_sockpuppets_of_Derito.csv,241,6532856.0,107,134,41,66,0,44.053941908713696,199,46,28.0,12
Category_Wikipedia_sockpuppets_of_SOFWERX1.csv,28,17206.0,13,15,9,4,0,25.0,70,43,22.0,5
Category_Wikipedia_sockpuppets_of_Arshia_Shaikh.csv,45,2332.0,16,29,4,12,0,57.977777777777774,198,20,9.133333333333333,4
Category_Wikipedia_sockpuppets_of_RCSIRCSIRCSI.csv,1054,32626941.0,506,548,500,6,0,20.92125237191651,239,50,24.307400379506642,3
Category_Wikipedia_sockpuppets_of_Renz_1919.csv,684,46932439.0,198,486,155,43,0,46.134502923976605,301,57,23.149122807017545,6
Category_Wikipedia_sockpuppets_of_Surjendranil.csv,414,73011498.0,242,172,50,192,0,40.67632850241546,241,73,22.729468599033815,6
Category_Wikipedia_sockpuppets_of_Maclayfriend.csv,8,464247.0,5,3,4,1,0,161.25,255,19,15.25,13
Category_Wikipedia_sockpuppets_of_Nonononocat.csv,226,9852138.0,66,160,43,23,0,67.61061946902655,228,55,20.63274336283186,9
Category_Wikipedia_sockpuppets_of_Tgr4.csv,210,2341978.0,86,124,66,20,0,36.285714285714285,255,44,27.571428571428573,14
Category_Wikipedia_sockpuppets_of_Odinson878.csv,433,8603029.0,179,254,85,94,0,74.7621247113164,513,41,18.494226327944574,9
Category_Wikipedia_sockpuppets_of_POV_Detective.csv,596,13513196.0,276,320,163,113,0,64.64093959731544,226,43,21.901006711409394,8
Category_Wikipedia_sockpuppets_of_Wiki-11233.csv,1903,67455673.0,689,1214,462,227,0,34.384655806621126,260,55,20.837624802942724,8
Category_Wikipedia_sockpuppets_of_Aryan_Ashik.csv,398,37961423.0,122,276,106,16,0,41.334170854271356,225,55,17.22613065326633,5
Category_Wikipedia_sockpuppets_of_FlowerStorm48.csv,2415,87362245.0,743,1672,91,652,0,41.1991718426501,255,65,18.07329192546584,4
Category_Wikipedia_sockpuppets_of_AAAACCCCDDDDCCCC.csv,386,92436066.0,121,265,82,39,0,45.9119170984456,250,47,25.015544041450777,7
Category_Wikipedia_sockpuppets_of_KC626266.csv,1162,19191201.0,285,877,69,216,0,52.045611015490536,496,46,16.870912220309812,2
Category_Wikipedia_sockpuppets_of_SMGeorge34.csv,5308,53152904.0,1617,3691,500,1117,0,52.477204220045216,254,71,17.102486812358705,3
Category_Wikipedia_sockpuppets_of_FFMSettlements.csv,91,953539.0,66,25,41,25,12,37.42857142857143,181,57,52.285714285714285,18
Category_Wikipedia_sockpuppets_of_Mike_Matthews17.csv,509,117845950.0,119,390,37,82,0,60.03339882121807,278,47,18.326129666011788,6
Category_Wikipedia_sockpuppets_of_Betacommand.csv,5616,68020539.0,1665,3951,500,1165,0,46.38782051282051,255,123,20.17361111111111,1
Category_Wikipedia_sockpuppets_of_Annrex.csv,376,813677.0,122,254,42,80,0,50.037234042553195,200,50,29.18882978723404,6
Category_Wikipedia_sockpuppets_of_Artmimi.csv,47,915192.0,17,30,10,7,0,43.191489361702125,207,51,19.04255319148936,10
Category_Wikipedia_sockpuppets_of_Kagome_85.csv,20575,396122859.0,5936,14639,500,5436,0,40.301142162818955,343,67,19.520437424058322,1
Category_Wikipedia_sockpuppets_of_Wikiwriterpro.csv,27,973297.0,7,20,7,0,0,48.25925925925926,163,53,26.88888888888889,15
Category_Wikipedia_sockpuppets_of_Geoff.L.Simmons.csv,39,1258039.0,12,27,8,4,0,86.41025641025641,498,23,11.0,2
Category_Wikipedia_sockpuppets_of_Themattster127.csv,3725,8889059.0,1266,2459,500,766,0,34.94845637583892,481,70,31.200536912751677,8
Category_Wikipedia_sockpuppets_of_Adamcavz.csv,222,59638603.0,63,159,47,16,0,44.333333333333336,243,44,18.05855855855856,8
Category_Wikipedia_sockpuppets_of_Cambodier.csv,1095,45245936.0,497,598,400,97,0,53.84200913242009,364,42,18.03835616438356,6
Category_Wikipedia_sockpuppets_of_Steven130793.csv,995,55548157.0,371,624,365,6,0,36.040201005025125,209,65,22.275376884422112,5
Category_Wikipedia_sockpuppets_of_Rosalinares1.csv,1638,81902495.0,546,1092,315,231,0,33.915140415140414,271,46,13.674603174603174,3
Category_Wikipedia_sockpuppets_of_Lasalle86.csv,37,587027.0,11,26,3,8,0,66.75675675675676,224,27,14.27027027027027,5
Category_Wikipedia_sockpuppets_of_Tvarchivist.csv,755,114770570.0,151,604,71,80,0,41.209271523178806,213,45,13.455629139072848,8
Category_Wikipedia_sockpuppets_of_Hamidbash.csv,12,24365344.0,4,8,4,0,0,53.583333333333336,148,32,19.75,15
Category_Wikipedia_sockpuppets_of_Prakash_Baghel_Raj.csv,98,716238.0,44,54,36,8,0,53.47959183673469,388,51,13.520408163265307,5
Category_Wikipedia_sockpuppets_of_Red1hasan.csv,24,72036930.0,18,6,15,3,0,58.958333333333336,148,31,19.25,14
Category_Wikipedia_sockpuppets_of_Abby_92.csv,2768,4527313.0,852,1916,455,397,0,41.77348265895954,235,50,18.29407514450867,3
Category_Wikipedia_sockpuppets_of_Dude95.csv,3724,107213494.0,1322,2402,500,822,0,33.17481203007519,262,58,21.758324382384533,3
Category_Wikipedia_sockpuppets_of_LauraLeeT.csv,2766,100087210.0,1024,1742,500,524,0,46.23427331887202,255,51,16.39009399855387,5
Category_Wikipedia_sockpuppets_of_Maggyb80.csv,56,3794300.0,23,33,21,2,0,69.875,191,50,30.642857142857142,14
Category_Wikipedia_sockpuppets_of_Marius2003Korn.csv,3455,18294027.0,1203,2252,500,703,0,40.52445730824891,255,51,17.75137481910275,5
Category_Wikipedia_sockpuppets_of_Blabmone.csv,621,3061070.0,235,386,213,22,0,63.24154589371981,255,78,20.689210950080515,4
Category_Wikipedia_sockpuppets_of_Âß´ÂÆÆÁé≤Â≠ê.csv,2462,7781457.0,795,1667,485,310,0,33.52071486596263,262,107,23.110073111291634,4
Category_Wikipedia_sockpuppets_of_Sadeeqzaria.csv,2708,15227064.0,1153,1555,500,653,0,39.16322008862629,500,64,17.73744460856721,6
Category_Wikipedia_sockpuppets_of_Badehmasare.csv,1598,138035938.0,509,1089,470,39,0,50.91239048811014,412,55,18.97872340425532,3
Category_Wikipedia_sockpuppets_of_Mahalanobis51.csv,6,755926.0,3,3,2,1,0,93.0,161,20,19.666666666666668,19
Category_Wikipedia_sockpuppets_of_ThatieY.csv,14,241658.0,8,6,8,0,0,57.285714285714285,159,36,30.285714285714285,17
Category_Wikipedia_sockpuppets_of_TheGeneralofWar.csv,2091,31112067.0,523,1568,500,23,0,48.0545193687231,255,59,17.506934481109518,3
Category_Wikipedia_sockpuppets_of_ScottishUnionist.csv,45,5459555.0,31,14,27,4,0,25.57777777777778,198,26,19.8,13
Category_Wikipedia_sockpuppets_of_Abbycarroll.csv,240,9256104.0,107,133,102,5,0,45.37916666666667,232,53,25.408333333333335,5
Category_Wikipedia_sockpuppets_of_Ciphers.csv,5603,41286709.0,1200,4403,500,700,0,52.589862573621275,475,77,17.47867213992504,3
Category_Wikipedia_sockpuppets_of_Mediaent123.csv,53,2121514.0,21,32,9,12,0,39.528301886792455,196,51,23.49056603773585,8
Category_Wikipedia_sockpuppets_of_Shubhendu9087.csv,17,2362.0,8,9,6,2,0,70.11764705882354,205,25,15.294117647058824,7
Category_Wikipedia_sockpuppets_of_Umairjabbaro.csv,1,0.0,1,0,1,0,0,0.0,0,19,19.0,19
Category_Wikipedia_sockpuppets_of_Mulman82.csv,341,93600633.0,123,218,123,0,0,42.3049853372434,336,35,18.00293255131965,7
Category_Wikipedia_sockpuppets_of_Wikip√©ire.csv,10844,97195887.0,3253,7591,500,2753,0,47.444485429730726,267,94,20.437200295094062,3
Category_Wikipedia_sockpuppets_of_David_Nicolas14.csv,696,31257080.0,176,520,89,87,0,37.08764367816092,254,50,22.554597701149426,9
Category_Wikipedia_sockpuppets_of_JonathanBaird.csv,1054,29464343.0,361,693,199,162,0,37.85768500948767,264,75,29.4876660341556,12
Category_Wikipedia_sockpuppets_of_Efedros.csv,82,3170064.0,41,41,14,27,0,44.073170731707314,283,43,28.71951219512195,12
Category_Wikipedia_sockpuppets_of_Nawafuyfc.csv,355,61009630.0,118,237,41,77,0,39.64225352112676,490,44,19.985915492957748,10
Category_Wikipedia_sockpuppets_of_Julian_Khachan.csv,1490,2699540.0,521,969,500,21,0,33.81543624161074,500,55,19.175167785234898,4
Category_Wikipedia_sockpuppets_of_Smarojitbiz.csv,88,18089623.0,40,48,30,10,0,49.17045454545455,245,53,20.238636363636363,5
Category_Wikipedia_sockpuppets_of_Herman21.csv,65,379053.0,24,41,10,14,0,54.43076923076923,204,31,14.738461538461538,4
Category_Wikipedia_sockpuppets_of_GreenTeaExtracts.csv,42,45532784.0,9,33,7,2,0,48.357142857142854,220,78,46.45238095238095,18
Category_Wikipedia_sockpuppets_of_Bradley_the_Bloke.csv,359,46441071.0,90,269,19,71,0,55.26462395543175,248,58,20.919220055710305,5
Category_Wikipedia_sockpuppets_of_Blainetologist.csv,1011,73716050.0,270,741,132,138,0,45.612265084075176,219,67,18.98219584569733,5
Category_Wikipedia_sockpuppets_of_Buck9999.csv,215,7737110.0,65,150,16,49,0,31.251162790697673,234,45,21.111627906976743,3
Category_Wikipedia_sockpuppets_of_The_Ultimate_Boss.csv,636,56005412.0,200,436,200,0,0,50.820754716981135,401,52,14.24056603773585,8
Category_Wikipedia_sockpuppets_of_Gekay_job_solutions.csv,296,38073742.0,107,189,60,47,0,50.41554054054054,224,59,25.506756756756758,5
Category_Wikipedia_sockpuppets_of_WomenOlympians.csv,65,2343678.0,37,28,16,21,0,50.83076923076923,276,50,22.43076923076923,12
Category_Wikipedia_sockpuppets_of_Chijimon.csv,27,1210365.0,15,12,15,0,0,20.22222222222222,121,18,11.592592592592593,9
Category_Wikipedia_sockpuppets_of_WowSoCool112.csv,2309,17113847.0,549,1760,457,92,0,53.526634906886095,500,58,15.687743611953227,3
Category_Wikipedia_sockpuppets_of_Sdc3000.csv,705,83892020.0,216,489,79,137,0,48.05531914893617,254,94,20.46099290780142,7
Category_Wikipedia_sockpuppets_of_Neeraj_Ahirwar_(M.P).csv,302,17878822.0,124,178,55,69,0,46.13576158940398,384,33,17.066225165562916,6
Category_Wikipedia_sockpuppets_of_Ankita.m88.csv,4,1017618.0,2,2,2,0,23,83.0,139,10,10.0,10
Category_Wikipedia_sockpuppets_of_Loriclean.csv,91,8973891.0,26,65,9,17,0,60.494505494505496,329,37,23.021978021978022,11
Category_Wikipedia_sockpuppets_of_Daniel_L._Barth.csv,6305,241746645.0,2365,3940,500,1865,0,34.880888183980964,255,88,22.048057097541633,2
Category_Wikipedia_sockpuppets_of_ÿπÿ±ÿ®Ÿä-Ÿ£Ÿ°.csv,2410,89257795.0,730,1680,500,230,0,43.26680497925311,287,78,15.967634854771784,1
Category_Wikipedia_sockpuppets_of_Hackneyhound.csv,926,60361836.0,318,608,133,185,0,45.412526997840175,247,74,25.623110151187905,6
Category_Wikipedia_sockpuppets_of_WikiSports1982.csv,23,3799296.0,16,7,10,6,0,57.78260869565217,196,51,19.82608695652174,6
Category_Wikipedia_sockpuppets_of_The_Good_Doctor_Fry.csv,1082,318084006.0,383,699,364,19,0,73.58133086876155,255,51,14.158964879852126,6
Category_Wikipedia_sockpuppets_of_Becambuisness.csv,45,2928.0,19,26,19,0,0,51.77777777777778,184,24,19.4,12
Category_Wikipedia_sockpuppets_of_Karmendra.kr.csv,213,28638315.0,79,134,69,10,0,37.30046948356807,255,32,13.7981220657277,4
Category_Wikipedia_sockpuppets_of_On.Elpeleg.csv,906,53371881.0,355,551,350,5,0,40.977924944812365,214,70,25.747240618101547,10
Category_Wikipedia_sockpuppets_of_Layla_ayaka_ayato_simin.csv,64,12531.0,16,48,4,12,0,86.578125,407,20,12.59375,6
Category_Wikipedia_sockpuppets_of_Kiran_Kamath_Verma.csv,78,8642674.0,30,48,12,18,0,30.23076923076923,202,31,14.615384615384615,4
Category_Wikipedia_sockpuppets_of_Classical_liberal_za.csv,325,4397571.0,186,139,179,7,0,73.94153846153846,500,47,23.59076923076923,9
Category_Wikipedia_sockpuppets_of_Brian_Baugh.csv,34,3378481.0,9,25,6,3,0,27.264705882352942,89,59,20.823529411764707,12
Category_Wikipedia_sockpuppets_of_Peocaradeano.csv,48,1048375.0,18,30,14,4,0,66.29166666666667,496,26,16.1875,10
Category_Wikipedia_sockpuppets_of_Alansin2.csv,492,37059063.0,159,333,87,72,0,53.39837398373984,250,63,16.672764227642276,4
Category_Wikipedia_sockpuppets_of_Serolss.csv,463,22292969.0,169,294,81,88,0,62.4622030237581,500,87,32.038876889848815,6
Category_Wikipedia_sockpuppets_of_Little_Angel_IVF.csv,194,9405235.0,70,124,57,13,0,40.61340206185567,494,47,19.11340206185567,6
Category_Wikipedia_sockpuppets_of_Funkygishh.csv,141,127959674.0,49,92,23,26,0,51.205673758865245,223,57,24.23404255319149,9
Category_Wikipedia_sockpuppets_of_KimTheGiraffe.csv,89,2671695.0,30,59,17,13,0,53.13483146067416,235,49,18.719101123595507,12
Category_Wikipedia_sockpuppets_of_Nqltiny.csv,106,1340017.0,56,50,26,30,0,49.339622641509436,255,18,13.518867924528301,6
Category_Wikipedia_sockpuppets_of_Technofreeq1.csv,207,114713865.0,65,142,28,37,0,40.971014492753625,232,50,30.942028985507246,9
Category_Wikipedia_sockpuppets_of_Chandan_Kumar_Shee.csv,110,60132536.0,32,78,18,14,0,48.28181818181818,282,42,17.736363636363638,7
Category_Wikipedia_sockpuppets_of_Playballz.csv,66,18668921.0,54,12,14,40,0,24.772727272727273,145,18,18.0,18
Category_Wikipedia_sockpuppets_of_David_Hanna_Flight_Paramedic.csv,11,5142.0,5,6,5,0,0,31.181818181818183,103,38,38.0,38
Category_Wikipedia_sockpuppets_of_Sheeshbattle99.csv,117,7862273.0,38,79,18,20,0,63.76068376068376,262,32,17.931623931623932,3
Category_Wikipedia_sockpuppets_of_Yahadzija.csv,1532,180340376.0,662,870,500,162,0,50.324412532637076,362,46,15.98107049608355,4
Category_Wikipedia_sockpuppets_of_Jasleen_Ahluwalia.csv,1316,102390960.0,316,1000,74,242,0,52.96048632218845,343,62,16.01671732522796,4
Category_Wikipedia_sockpuppets_of_Falconfly.csv,3971,269984676.0,1039,2932,500,539,0,53.99017879627298,500,52,14.229161420297155,3
Category_Wikipedia_sockpuppets_of_NewWorriedLad.csv,7,767906.0,5,2,4,1,0,28.857142857142858,47,21,21.0,21
Category_Wikipedia_sockpuppets_of_IceManNJD.csv,2190,504819971.0,438,1752,154,284,0,42.14931506849315,470,50,19.873059360730593,3
Category_Wikipedia_sockpuppets_of_Sanghapal.shelke.csv,2,619.0,2,0,2,0,60,60.0,60,12,12.0,12
Category_Wikipedia_sockpuppets_of_Michelle_Ridomi.csv,1108,17043713.0,420,688,324,96,0,52.76985559566787,253,56,23.471119133574007,6
Category_Wikipedia_sockpuppets_of_GoodGrammar4Life.csv,110,57579580.0,28,82,22,6,0,54.763636363636365,365,45,14.781818181818181,4
Category_Wikipedia_sockpuppets_of_UrsMair.csv,1,0.0,1,0,1,0,64,64.0,64,47,47.0,47
Category_Wikipedia_sockpuppets_of_Gerballsy.csv,19,2119.0,6,13,3,3,0,37.0,148,21,9.157894736842104,6
Category_Wikipedia_sockpuppets_of_PonchoChet.csv,483,1303501.0,178,305,97,81,0,48.577639751552795,260,98,25.908902691511386,10
Category_Wikipedia_sockpuppets_of_Operpowerop3.csv,41,7756476.0,9,32,2,7,0,49.707317073170735,249,48,16.463414634146343,5
Category_Wikipedia_sockpuppets_of_Joearnest.csv,32,447113.0,17,15,10,7,0,68.03125,236,27,9.375,6
Category_Wikipedia_sockpuppets_of_Buggerhed.csv,430,3748974.0,181,249,93,88,0,37.02325581395349,208,64,26.911627906976744,3
Category_Wikipedia_sockpuppets_of_Dubbin.csv,1905,98097109.0,659,1246,500,159,0,56.98845144356955,294,67,21.82257217847769,2
Category_Wikipedia_sockpuppets_of_Jimmy_Two_Trees.csv,66,7227604.0,17,49,8,9,0,41.43939393939394,247,60,24.151515151515152,4
Category_Wikipedia_sockpuppets_of_Bijayan_tripura.csv,160,3858572.0,51,109,31,20,0,42.375,251,39,16.1125,5
Category_Wikipedia_sockpuppets_of_Hamburg_Hops.csv,4,123.0,2,2,2,0,0,40.25,147,42,42.0,42
Category_Wikipedia_sockpuppets_of_Satchel_Cohen_hoaxer.csv,33,2076929.0,12,21,5,7,0,13.787878787878787,137,30,22.545454545454547,13
Category_Wikipedia_sockpuppets_of_Idevon348.csv,138,87092035.0,53,85,32,21,0,40.02173913043478,207,51,20.166666666666668,10
Category_Wikipedia_sockpuppets_of_JimmiJaiswal.csv,34,94788614.0,13,21,12,1,0,51.529411764705884,195,83,75.52941176470588,22
Category_Wikipedia_sockpuppets_of_Wikkkj3.csv,555,46326403.0,144,411,106,38,0,45.81981981981982,496,42,17.504504504504503,4
Category_Wikipedia_sockpuppets_of_Nallasandeepkumar.csv,23,1718469.0,8,15,5,3,0,45.69565217391305,131,33,24.652173913043477,12
Category_Wikipedia_sockpuppets_of_AnkitChaudharyM.Speaker.csv,1,0.0,1,0,1,0,0,0.0,0,34,34.0,34
Category_Wikipedia_sockpuppets_of_Rollosmokes.csv,6616,150822142.0,1712,4904,500,1212,0,39.19603990326481,261,68,13.32723700120919,3
Category_Wikipedia_sockpuppets_of_Balacachini.csv,363,71312781.0,120,243,120,0,0,45.97520661157025,322,58,21.203856749311296,3
Category_Wikipedia_sockpuppets_of_Asad.Alam.csv,165,7937184.0,129,36,20,109,0,30.066666666666666,203,26,16.6,8
Category_Wikipedia_sockpuppets_of_Matthewjoule.csv,172,63846438.0,69,103,66,3,0,39.95348837209303,228,26,19.71511627906977,10
Category_Wikipedia_sockpuppets_of_MehulWB.csv,13031,72293407.0,4932,8099,500,4432,0,46.643619062236205,261,84,19.744148568797485,2
Category_Wikipedia_sockpuppets_of_Cheese_editor.csv,192,4526743.0,59,133,23,36,0,77.92708333333333,394,49,23.630208333333332,7
Category_Wikipedia_sockpuppets_of_Surajprasad9279.csv,9,7082.0,8,1,6,2,0,7.111111111111111,16,12,12.0,12
Category_Wikipedia_sockpuppets_of_Mr_Wiki_Pro.csv,2739,93804314.0,1041,1698,500,541,0,55.52500912741876,255,80,24.339539978094194,4
Category_Wikipedia_sockpuppets_of_Zakoni.csv,1069,20900451.0,308,761,177,131,0,46.94948550046772,255,51,13.442469597754911,5
Category_Wikipedia_sockpuppets_of_Wpa7.csv,1344,206996493.0,407,937,372,35,0,34.13467261904762,254,52,16.63764880952381,6
Category_Wikipedia_sockpuppets_of_OTIS1951.csv,139,279664801.0,51,88,33,18,0,61.78417266187051,232,28,14.928057553956835,12
Category_Wikipedia_sockpuppets_of_Gantuya_eng.csv,2165,132476487.0,666,1499,500,166,0,46.43325635103926,248,58,16.92147806004619,4
Category_Wikipedia_sockpuppets_of_Angelmtz22.csv,1076,18610434.0,504,572,500,4,0,30.70817843866171,297,54,23.28438661710037,12
Category_Wikipedia_sockpuppets_of_Dhiren_Barot.csv,11,866715.0,9,2,8,1,0,43.27272727272727,139,12,12.0,12
Category_Wikipedia_sockpuppets_of_Ednagans321.csv,17,99958.0,11,6,7,4,13,65.82352941176471,189,15,11.352941176470589,10
Category_Wikipedia_sockpuppets_of_ZenZung.csv,2150,25881348.0,658,1492,500,158,0,38.54186046511628,377,53,16.113023255813953,4
Category_Wikipedia_sockpuppets_of_Nicolina_Altera.csv,11,15942.0,10,1,10,0,0,16.818181818181817,94,44,38.81818181818182,13
Category_Wikipedia_sockpuppets_of_TheNameIsMuhammadHusayn.csv,157,7116888.0,56,101,36,20,0,49.254777070063696,250,33,16.78980891719745,8
Category_Wikipedia_sockpuppets_of_SamCham10.csv,95,69493605.0,19,76,12,7,0,45.136842105263156,237,35,18.273684210526316,5
Category_Wikipedia_sockpuppets_of_Technur2.0.csv,108,85943496.0,26,82,6,20,0,63.69444444444444,237,53,35.93518518518518,15
Category_Wikipedia_sockpuppets_of_Smadge1.csv,1885,369789544.0,518,1367,500,18,0,59.259946949602124,255,63,21.890185676392573,1
Category_Wikipedia_sockpuppets_of_VeNeMousKAT.csv,327,824585.0,97,230,66,31,0,65.62691131498471,232,49,18.68195718654434,4
Category_Wikipedia_sockpuppets_of_Jimmychases.csv,19,16162603.0,6,13,3,3,0,50.26315789473684,189,47,27.94736842105263,15
Category_Wikipedia_sockpuppets_of_Narayan_chouhan.csv,84,93067998.0,32,52,13,19,0,55.73809523809524,326,64,21.166666666666668,6
Category_Wikipedia_sockpuppets_of_MahsaMehran.csv,194,15703207.0,163,31,95,68,0,28.072164948453608,246,18,13.18041237113402,13
Category_Wikipedia_sockpuppets_of_Sibtain_007.csv,2092,105815280.0,618,1474,175,443,0,48.15344168260038,255,63,17.859942638623327,4
Category_Wikipedia_sockpuppets_of_Chiragh_Baloch.csv,27,25777038.0,8,19,5,3,0,54.44444444444444,196,30,23.22222222222222,18
Category_Wikipedia_sockpuppets_of_FruitPunch.csv,2329,31576517.0,676,1653,164,512,0,39.040790038643195,255,53,14.942893945899527,1
Category_Wikipedia_sockpuppets_of_Rtekleab.csv,43,4156997.0,35,8,33,2,0,27.069767441860463,232,14,14.0,14
Category_Wikipedia_sockpuppets_of_Jarrettthegoalie.csv,52,37369626.0,16,36,14,2,0,65.82692307692308,232,30,18.5,8
Category_Wikipedia_sockpuppets_of_Blotchun.csv,112,1660035.0,39,73,6,33,0,29.116071428571427,177,44,23.169642857142858,10
Category_Wikipedia_sockpuppets_of_Happy_puff.csv,169,8207511.0,43,126,23,20,0,71.3905325443787,209,53,16.70414201183432,6
Category_Wikipedia_sockpuppets_of_ClassicYoghurt.csv,6048,59390898.0,1718,4330,500,1218,0,59.40046296296296,495,114,18.25975529100529,3
Category_Wikipedia_sockpuppets_of_Lceliku.csv,870,14341464.0,242,628,158,84,0,44.679310344827584,223,50,14.677011494252874,5
Category_Wikipedia_sockpuppets_of_Alex.csgoreview.csv,8,682547.0,4,4,3,1,0,44.125,161,13,11.5,9
Category_Wikipedia_sockpuppets_of_Jackwolf3468542.csv,3963,15895621.0,1436,2527,500,936,0,37.96997224325006,452,82,23.756749936916478,5
Category_Wikipedia_sockpuppets_of_Mrm7171.csv,1468,49768259.0,530,938,500,30,0,60.52179836512261,254,50,23.447547683923705,4
Category_Wikipedia_sockpuppets_of_Sj221234.csv,358,513373966.0,116,242,72,44,0,50.04469273743017,316,58,26.036312849162012,3
Category_Wikipedia_sockpuppets_of_Kayleyrae319.csv,46,7242907.0,19,27,18,1,0,63.76086956521739,283,40,15.434782608695652,6
Category_Wikipedia_sockpuppets_of_DonkeyGoatFace.csv,136,2154048.0,49,87,23,26,0,44.11764705882353,245,66,23.36764705882353,6
Category_Wikipedia_sockpuppets_of_MustafaKara05.csv,158,1209360.0,45,113,36,9,0,63.29746835443038,500,23,14.19620253164557,5
Category_Wikipedia_sockpuppets_of_Beefeeb99.csv,70,49426972.0,14,56,9,5,0,48.72857142857143,219,16,12.1,9
Category_Wikipedia_sockpuppets_of_Louismuyalde0012.csv,301,93508279.0,78,223,44,34,0,66.4717607973422,367,40,24.498338870431894,18
Category_Wikipedia_sockpuppets_of_Raheelejaz907.csv,456,202394554.0,135,321,109,26,0,50.73464912280702,278,47,27.734649122807017,10
Category_Wikipedia_sockpuppets_of_Shishamahesh.csv,33,1092182.0,15,18,15,0,0,35.21212121212121,213,52,20.393939393939394,5
Category_Wikipedia_sockpuppets_of_Pakinaka.csv,66,4070690.0,26,40,23,3,0,51.28787878787879,252,28,26.62121212121212,16
Category_Wikipedia_sockpuppets_of_Leeraroyu.csv,9,491.0,5,4,4,1,0,14.222222222222221,118,21,18.22222222222222,16
Category_Wikipedia_sockpuppets_of_Tezaswiniisrani.csv,220,15613304.0,78,142,40,38,0,48.95454545454545,326,54,24.48181818181818,7
Category_Wikipedia_sockpuppets_of_Taifansari.csv,289,824184.0,104,185,69,35,0,55.46020761245675,232,48,23.93771626297578,7
Category_Wikipedia_sockpuppets_of_Jjones75.csv,95,71717765.0,19,76,5,14,0,57.68421052631579,224,34,27.2,14
Category_Wikipedia_sockpuppets_of_Ejbaluyot.csv,564,28563289.0,161,403,138,23,0,43.20744680851064,215,47,17.611702127659573,3
Category_Wikipedia_sockpuppets_of_Porguppy.csv,914,2425643.0,285,629,274,11,0,32.288840262582056,312,103,21.700218818380744,4
Category_Wikipedia_sockpuppets_of_CastellanetaFan.csv,2061,18148522.0,663,1398,500,163,0,51.999514798641435,255,57,17.712275594371665,5
Category_Wikipedia_sockpuppets_of_Wizzmoalim.csv,16,11126699.0,11,5,5,6,0,64.6875,196,20,17.0,8
Category_Wikipedia_sockpuppets_of_Wicak80.csv,669,145198567.0,253,416,227,26,0,36.83856502242153,266,62,21.95067264573991,5
Category_Wikipedia_sockpuppets_of_Marko_R.csv,23,221519.0,10,13,9,1,0,64.82608695652173,245,35,24.304347826086957,10
Category_Wikipedia_sockpuppets_of_Taiki0409.csv,1225,235645832.0,405,820,193,212,0,36.734693877551024,255,70,23.00408163265306,5
Category_Wikipedia_sockpuppets_of_OMGOMG2009.csv,536,22337095.0,135,401,64,71,0,32.757462686567166,200,55,21.01679104477612,13
Category_Wikipedia_sockpuppets_of_Mjdav1.csv,40,117851861.0,13,27,12,1,0,48.475,188,35,19.1,12
Category_Wikipedia_sockpuppets_of_KillMaverick.csv,67,101607.0,31,36,19,12,0,31.313432835820894,258,28,14.373134328358208,8
Category_Wikipedia_sockpuppets_of_Kyliex2008.csv,1796,8355678.0,808,988,500,308,0,32.797327394209354,439,52,16.104677060133632,4
Category_Wikipedia_sockpuppets_of_TheYieldCurve.csv,23,22646.0,9,14,9,0,0,56.08695652173913,195,34,20.782608695652176,12
Category_Wikipedia_sockpuppets_of_Scottydog77.csv,259,36035145.0,60,199,41,19,0,50.25096525096525,200,47,16.382239382239383,10
Category_Wikipedia_sockpuppets_of_J.T._Amble.csv,87,261623.0,46,41,28,18,0,18.436781609195403,195,53,29.091954022988507,13
Category_Wikipedia_sockpuppets_of_Jsw48.csv,76,1401094.0,28,48,5,23,0,30.394736842105264,194,33,15.460526315789474,7
Category_Wikipedia_sockpuppets_of_Timtempleton.csv,1627,15215423.0,514,1113,500,14,0,60.266133988936694,442,92,20.181929932390904,3
Category_Wikipedia_sockpuppets_of_Daaask.csv,4628,22666851.0,1638,2990,500,1138,0,35.54969749351772,512,74,19.74351771823682,3
Category_Wikipedia_sockpuppets_of_ZaDoraemonzu7.csv,3784,20256069.0,1232,2552,500,732,0,36.69688160676533,484,64,28.61654334038055,5
Category_Wikipedia_sockpuppets_of_Alberuni.csv,5908,97300945.0,1617,4291,500,1117,0,35.32735274204469,255,87,19.003554502369667,4
Category_Wikipedia_sockpuppets_of_Shierwin_Carl.csv,312,2043817.0,125,187,55,70,0,35.01923076923077,254,52,16.15705128205128,7
Category_Wikipedia_sockpuppets_of_Gabriella~four.3-6.csv,5081,150785746.0,2106,2975,500,1606,0,42.878173587876404,310,62,20.67053729580791,5
Category_Wikipedia_sockpuppets_of_Tehseenahmad91.csv,541,72136518.0,148,393,53,95,0,41.21072088724584,255,50,19.1275415896488,8
Category_Wikipedia_sockpuppets_of_Thiago_Juliaci.csv,11,28191032.0,7,4,5,2,0,47.90909090909091,149,26,21.181818181818183,17
Category_Wikipedia_sockpuppets_of_Random-5000.csv,2570,352681482.0,655,1915,155,500,0,51.194941634241246,255,54,15.692996108949416,4
Category_Wikipedia_sockpuppets_of_GuyCritic.csv,15,15690.0,3,12,1,2,8,50.4,124,47,47.0,47
Category_Wikipedia_sockpuppets_of_Ansif.csv,35,314849029.0,11,24,5,6,0,43.82857142857143,255,53,26.085714285714285,10
Category_Wikipedia_sockpuppets_of_Tibusheikh.csv,130,20395294.0,36,94,21,15,0,51.89230769230769,272,29,14.576923076923077,4
Category_Wikipedia_sockpuppets_of_Ikutamen123.csv,97,607451.0,46,51,31,15,0,49.391752577319586,500,29,17.164948453608247,5
Category_Wikipedia_sockpuppets_of_PRASANTA_KR_SAHA.csv,10,201827.0,6,4,4,2,11,48.3,159,13,8.1,6
Category_Wikipedia_sockpuppets_of_Stephmnews.csv,17,2439490.0,11,6,6,5,0,34.1764705882353,196,54,39.1764705882353,20
Category_Wikipedia_sockpuppets_of_Spotted_in_Iceland.csv,317,687329.0,121,196,31,90,0,54.55205047318612,279,53,22.0788643533123,8
Category_Wikipedia_sockpuppets_of_Siyam2siyam.csv,14,38573.0,9,5,7,2,14,68.14285714285714,188,21,15.714285714285714,9
Category_Wikipedia_sockpuppets_of_Elbatli.csv,3599,141500178.0,1523,2076,362,1161,0,33.665184773548205,492,82,17.075854404001113,3
Category_Wikipedia_sockpuppets_of_Nika1234.csv,960,18229010.0,226,734,170,56,0,52.21041666666667,255,43,15.123958333333333,7
Category_Wikipedia_sockpuppets_of_Mumasah.csv,91,36261919.0,27,64,10,17,0,83.92307692307692,378,45,20.846153846153847,9
Category_Wikipedia_sockpuppets_of_Mitesh_Kumar_Sharma.csv,48,1562096.0,18,30,17,1,0,33.541666666666664,196,41,24.6875,10
Category_Wikipedia_sockpuppets_of_Witshuntied.csv,130,774345.0,52,78,30,22,0,54.01538461538462,210,51,18.838461538461537,9
Category_Wikipedia_sockpuppets_of_Mrcitizenx.csv,100,471515.0,55,45,55,0,0,32.84,196,51,41.79,15
Category_Wikipedia_sockpuppets_of_Jakartajones.csv,196,51177059.0,73,123,72,1,0,42.19897959183673,194,24,12.0,5
Category_Wikipedia_sockpuppets_of_Ilyaskhan.csv,19,2707472.0,7,12,5,2,0,58.21052631578947,158,25,14.894736842105264,10
Category_Wikipedia_sockpuppets_of_Amerheb2018.csv,119,1385630.0,40,79,26,14,0,85.04201680672269,367,30,14.378151260504202,6
Category_Wikipedia_sockpuppets_of_Kumioko.csv,5007,214707498.0,1818,3189,500,1318,0,60.1322148991412,259,106,25.338725783902536,4
Category_Wikipedia_sockpuppets_of_Megastar7.csv,2811,490897059.0,949,1862,500,449,0,52.71326929918179,479,54,19.181785841337604,3
Category_Wikipedia_sockpuppets_of_Berooznews.csv,74,299057982.0,18,56,14,4,0,69.0945945945946,225,24,15.621621621621621,4
Category_Wikipedia_sockpuppets_of_Bacanaleranica.csv,483,5758624.0,141,342,57,84,0,43.289855072463766,200,46,16.610766045548655,5
Category_Wikipedia_sockpuppets_of_Shomari15.csv,1060,22355553.0,212,848,206,6,0,25.736792452830187,187,63,14.666981132075472,3
Category_Wikipedia_sockpuppets_of_Majestic_Savior.csv,249,1791073.0,86,163,70,16,0,51.07630522088353,238,47,26.453815261044177,8
Category_Wikipedia_sockpuppets_of_IrzaKhanz69.csv,492,16290933.0,176,316,10,166,0,55.573170731707314,381,48,12.25,8
Category_Wikipedia_sockpuppets_of_Al-Munthir.csv,47,1004128.0,24,23,20,4,0,35.53191489361702,199,40,24.46808510638298,15
Category_Wikipedia_sockpuppets_of_Jones1708.csv,36,26053.0,19,17,12,7,0,42.611111111111114,232,19,16.61111111111111,12
Category_Wikipedia_sockpuppets_of_Johnrichardhall.csv,66,804393.0,27,39,27,0,0,68.84848484848484,390,26,18.318181818181817,14
Category_Wikipedia_sockpuppets_of_GeneralErwinStanley.csv,836,4543746.0,272,564,133,139,0,46.122009569377994,296,42,17.863636363636363,9
Category_Wikipedia_sockpuppets_of_Rohie.csv,48,898274.0,28,20,28,0,0,17.9375,125,15,12.958333333333334,9
Category_Wikipedia_sockpuppets_of_Qwertyuiop1994.csv,1485,271868245.0,324,1161,312,12,0,46.356228956228954,255,83,18.82087542087542,3
Category_Wikipedia_sockpuppets_of_Alvawacko.csv,29,138244499.0,7,22,7,0,0,61.10344827586207,216,14,12.793103448275861,9
Category_Wikipedia_sockpuppets_of_Rogmac1175.csv,8,11331889.0,6,2,5,1,0,44.125,173,10,10.0,10
Category_Wikipedia_sockpuppets_of_Manto_yadav.csv,524,15278846.0,210,314,185,25,0,43.50763358778626,376,40,17.99618320610687,4
Category_Wikipedia_sockpuppets_of_First_Holdings.csv,86,15286191.0,67,19,52,15,0,39.883720930232556,215,37,34.72093023255814,15
Category_Wikipedia_sockpuppets_of_LIGATTSecurity.csv,72,121510961.0,22,50,16,6,0,41.68055555555556,116,51,26.36111111111111,11
Category_Wikipedia_sockpuppets_of_Obaidullah_ak.csv,221,7976425.0,66,155,21,45,0,59.8235294117647,255,45,14.65158371040724,4
Category_Wikipedia_sockpuppets_of_David6865.csv,115,371046326.0,23,92,19,4,0,40.85217391304348,201,33,15.817391304347826,8
Category_Wikipedia_sockpuppets_of_Ruralman1.csv,20,711635.0,18,2,17,1,0,24.75,129,26,25.0,24
Category_Wikipedia_sockpuppets_of_Karthikcsk777.csv,38,71050.0,28,10,24,4,0,25.973684210526315,235,26,14.368421052631579,8
Category_Wikipedia_sockpuppets_of_Theawesomebeeotchguy.csv,20,514553.0,7,13,7,0,0,61.85,180,15,9.7,3
Category_Wikipedia_sockpuppets_of_Shayan7.csv,3493,251954009.0,1202,2291,500,702,0,38.541941024906954,256,66,15.649871170913254,3
Category_Wikipedia_sockpuppets_of_Chris_Hadden.csv,39,10466438.0,22,17,16,6,0,36.48717948717949,132,38,27.076923076923077,17
Category_Wikipedia_sockpuppets_of_Arkbg.csv,149,238009542.0,51,98,32,19,0,57.26845637583892,202,44,24.630872483221477,10
Category_Wikipedia_sockpuppets_of_Faunadolls.csv,46,7255472.0,18,28,17,1,0,37.08695652173913,185,34,24.543478260869566,22
Category_Wikipedia_sockpuppets_of_Izunwaonu.csv,128,161788535.0,32,96,13,19,0,62.5,254,62,26.640625,11
Category_Wikipedia_sockpuppets_of_Zzremin.csv,187,3145836.0,52,135,41,11,0,48.593582887700535,164,53,23.155080213903744,12
Category_Wikipedia_sockpuppets_of_Parissa_Official.csv,5,210.0,2,3,2,0,0,38.8,184,19,15.8,11
Category_Wikipedia_sockpuppets_of_Thechinesekid.csv,561,5747655.0,164,397,143,21,0,42.78431372549019,249,65,19.431372549019606,3
Category_Wikipedia_sockpuppets_of_3ln.csv,27,840929.0,18,9,12,6,0,11.962962962962964,60,41,41.0,41
Category_Wikipedia_sockpuppets_of_Junipersgrao.csv,2436,133098202.0,727,1709,406,321,0,46.95771756978654,255,54,20.110426929392446,5
Category_Wikipedia_sockpuppets_of_N_Kumar_Pandey.csv,24,168247.0,11,13,4,7,0,79.0,263,41,25.458333333333332,12
Category_Wikipedia_sockpuppets_of_Lzki.csv,532,9935769.0,160,372,45,115,0,34.347744360902254,255,52,19.539473684210527,4
Category_Wikipedia_sockpuppets_of_Jacobm_co.csv,615,86486276.0,270,345,196,74,0,87.16910569105691,436,78,36.699186991869915,8
Category_Wikipedia_sockpuppets_of_OJIV.csv,603,18080056.0,352,251,347,5,0,18.960199004975124,496,42,25.5787728026534,9
Category_Wikipedia_sockpuppets_of_OnyxHurtz.csv,23,213325.0,12,11,8,4,0,46.91304347826087,193,22,18.347826086956523,18
Category_Wikipedia_sockpuppets_of_–§–µ–ª–∏–∫—Å_–ö–æ–º–∞—Ä–æ–≤.csv,202,118957009.0,85,117,59,26,0,34.257425742574256,386,28,17.386138613861387,5
Category_Wikipedia_sockpuppets_of_DavidManchester44.csv,121,1303272.0,39,82,19,20,0,59.05785123966942,439,50,20.760330578512395,13
Category_Wikipedia_sockpuppets_of_Pppreas.csv,220,122624500.0,44,176,19,25,0,55.99090909090909,254,43,20.431818181818183,4
Category_Wikipedia_sockpuppets_of_Rajiv_Hu_Main.csv,308,10244137.0,108,200,25,83,0,52.5,277,46,16.483766233766232,7
Category_Wikipedia_sockpuppets_of_Jbusch8899.csv,132,39044581.0,42,90,34,8,0,48.0,220,40,20.689393939393938,12
Category_Wikipedia_sockpuppets_of_Samantha1rouge.csv,129,9149451.0,40,89,28,12,0,76.5891472868217,250,34,21.875968992248062,8
Category_Wikipedia_sockpuppets_of_Wiki_libs.csv,14718,56547739.0,3241,11477,500,2741,0,58.147574398695475,250,68,16.82307378719935,3
Category_Wikipedia_sockpuppets_of_Thomasnyc.csv,78,1512022.0,33,45,10,23,0,33.06410256410256,158,61,34.666666666666664,14
Category_Wikipedia_sockpuppets_of_Hotroddude.csv,27,4166553.0,12,15,10,2,0,42.77777777777778,215,34,19.074074074074073,15
Category_Wikipedia_sockpuppets_of_TarasKozak.csv,88,5872008.0,40,48,22,18,0,66.17045454545455,215,45,19.454545454545453,5
Category_Wikipedia_sockpuppets_of_DailyPakistan687.csv,59,1211431.0,57,2,57,0,0,5.084745762711864,84,26,15.559322033898304,15
Category_Wikipedia_sockpuppets_of_Purplecherry.csv,68,44924184.0,40,28,18,22,0,66.23529411764706,463,48,36.26470588235294,17
Category_Wikipedia_sockpuppets_of_Ravi44pk.csv,192,140047944.0,46,146,37,9,0,45.442708333333336,257,34,16.869791666666668,9
Category_Wikipedia_sockpuppets_of_Edsheeranidontcarewithjustinbieber.csv,57,77870565.0,22,35,11,11,0,70.3157894736842,398,39,22.087719298245613,7
Category_Wikipedia_sockpuppets_of_Mrmmabati.csv,21,5547480.0,7,14,5,2,0,32.61904761904762,184,23,18.0,14
Category_Wikipedia_sockpuppets_of_Stefan_Toporcer.csv,10,95626.0,6,4,5,1,15,49.0,138,26,23.1,18
Category_Wikipedia_sockpuppets_of_Amin_balochstani.csv,301,28433278.0,103,198,17,86,0,42.61461794019934,420,36,15.744186046511627,4
Category_Wikipedia_sockpuppets_of_Kadir_Avcƒ±.csv,18,7345937.0,6,12,3,3,0,32.94444444444444,106,32,21.0,14
Category_Wikipedia_sockpuppets_of_Alberto_flood.csv,1278,149236374.0,507,771,500,7,0,34.69405320813772,255,39,18.91627543035994,10
Category_Wikipedia_sockpuppets_of_MmCineplexes.csv,9,423626.0,7,2,7,0,0,12.777777777777779,42,27,23.666666666666668,22
Category_Wikipedia_sockpuppets_of_Mackenzie86.csv,6,304.0,4,2,4,0,0,52.666666666666664,173,19,19.0,19
Category_Wikipedia_sockpuppets_of_Mutia_ti_la_union_updates.csv,2412,11011410.0,876,1536,187,689,0,52.93946932006634,500,61,19.306384742951906,4
Category_Wikipedia_sockpuppets_of_HeatLife.csv,70,184196.0,49,21,31,18,0,38.25714285714286,243,29,25.228571428571428,13
Category_Wikipedia_sockpuppets_of_Green_Party_Rep.csv,11,1128.0,5,6,3,2,13,70.81818181818181,192,16,12.818181818181818,9
Category_Wikipedia_sockpuppets_of_Markus_Albertine.csv,29,3822703.0,11,18,6,5,0,59.13793103448276,216,58,25.82758620689655,6
Category_Wikipedia_sockpuppets_of_Ryan_phillips101.csv,20,1324.0,6,14,4,2,0,83.55,193,49,18.1,8
Category_Wikipedia_sockpuppets_of_Mdhamim1226.csv,8,91088.0,6,2,6,0,0,23.375,44,24,19.5,16
Category_Wikipedia_sockpuppets_of_ZizizizizizizjzjzjzjzI_zjzzjz.csv,203,5000717.0,75,128,41,34,0,43.53694581280788,255,84,23.886699507389164,5
Category_Wikipedia_sockpuppets_of_Globo2014.csv,6,16221.0,5,1,4,1,0,62.0,196,14,6.5,5
Category_Wikipedia_sockpuppets_of_Filmser.csv,17,18103.0,11,6,6,5,0,35.8235294117647,98,22,19.352941176470587,17
Category_Wikipedia_sockpuppets_of_She_Who_Photographs.csv,47,483891.0,29,18,26,3,0,42.659574468085104,160,55,24.659574468085108,24
Category_Wikipedia_sockpuppets_of_Habbib123.csv,1,0.0,1,0,1,0,0,0.0,0,35,35.0,35
Category_Wikipedia_sockpuppets_of_Mojuchowdhury-hat.csv,358,20084819.0,140,218,93,47,0,48.19553072625698,243,37,19.91899441340782,3
Category_Wikipedia_sockpuppets_of_AravindanLakshmikanthan.csv,368,2101928.0,134,234,45,89,0,44.30163043478261,267,64,27.991847826086957,5
Category_Wikipedia_sockpuppets_of_Spacepeas101.csv,158,75020878.0,33,125,15,18,0,52.5,230,37,14.860759493670885,3
Category_Wikipedia_sockpuppets_of_Edti1980.csv,61,632717.0,34,27,14,20,0,38.77049180327869,238,41,31.950819672131146,5
Category_Wikipedia_sockpuppets_of_Angela_Merkel_is_sexy.csv,29,3809363.0,18,11,14,4,0,59.689655172413794,182,31,16.551724137931036,5
Category_Wikipedia_sockpuppets_of_1948remembered.csv,130,611378.0,47,83,42,5,0,62.13846153846154,203,54,36.16153846153846,16
Category_Wikipedia_sockpuppets_of_Super_Enemy_Boy.csv,33,2664.0,12,21,6,6,0,51.333333333333336,202,51,21.424242424242426,10
Category_Wikipedia_sockpuppets_of_KitKat_Wizard.csv,52,36227.0,16,36,14,2,0,57.07692307692308,191,26,14.826923076923077,7
Category_Wikipedia_sockpuppets_of_APSSAXENA123.csv,12,5379884.0,6,6,5,1,0,63.083333333333336,252,22,12.083333333333334,9
Category_Wikipedia_sockpuppets_of_Reema_m_h.csv,265,116462692.0,147,118,98,49,0,32.40754716981132,233,45,19.505660377358492,7
Category_Wikipedia_sockpuppets_of_This_is_not_my_last_name.csv,827,6059722.0,223,604,147,76,0,52.367593712212816,250,86,26.48246674727932,3
Category_Wikipedia_sockpuppets_of_Lfierro743.csv,49,21230624.0,18,31,16,2,0,67.63265306122449,203,60,27.163265306122447,13
Category_Wikipedia_sockpuppets_of_Hadiyana.csv,1254,84593807.0,500,754,500,0,0,37.77830940988836,220,54,15.763157894736842,2
Category_Wikipedia_sockpuppets_of_Idsigis.csv,2,50.0,2,0,2,0,14,18.0,22,15,15.0,15
Category_Wikipedia_sockpuppets_of_DoDung2001.csv,1061,19435342.0,320,741,177,143,0,47.62770970782281,255,104,27.53722902921772,5
Category_Wikipedia_sockpuppets_of_ShaynDiamond.csv,2752,82261542.0,695,2057,73,622,0,49.57667151162791,500,70,12.821947674418604,3
Category_Wikipedia_sockpuppets_of_Pretty_Lydie.csv,9,14349941.0,7,2,7,0,17,48.44444444444444,199,21,21.0,21
Category_Wikipedia_sockpuppets_of_Shrekfan1.csv,50,52965163.0,11,39,9,2,0,59.44,206,42,22.02,7
Category_Wikipedia_sockpuppets_of_Qwertyyyqqqip.csv,163,38820497.0,46,117,43,3,0,57.625766871165645,253,39,20.030674846625768,7
Category_Wikipedia_sockpuppets_of_Ramiroprod.csv,2,54.0,2,0,2,0,0,23.5,47,20,20.0,20
Category_Wikipedia_sockpuppets_of_FernandoTX.csv,207,1826995.0,100,107,71,29,0,28.502415458937197,245,49,18.729468599033815,7
Category_Wikipedia_sockpuppets_of_Ooohaaah.csv,217,4252106.0,67,150,31,36,0,48.41013824884793,255,49,18.967741935483872,1
Category_Wikipedia_sockpuppets_of_Raj_Hospitality.csv,9,1386053.0,6,3,3,3,0,54.77777777777778,128,29,29.0,29
Category_Wikipedia_sockpuppets_of_Maiensheina.csv,6,172991.0,2,4,1,1,14,74.16666666666667,199,24,16.0,8
Category_Wikipedia_sockpuppets_of_ImTheCool.csv,449,2138518.0,175,274,45,130,0,55.42093541202673,251,50,25.752783964365257,3
Category_Wikipedia_sockpuppets_of_Japanese_History_1300.csv,50,4474.0,20,30,11,9,0,48.64,226,29,20.46,6
Category_Wikipedia_sockpuppets_of_Puppy_General_Kitten.csv,9,1877.0,3,6,3,0,9,72.11111111111111,140,33,30.11111111111111,22
Category_Wikipedia_sockpuppets_of_20th_anniversary_in_Texas.csv,61,4852563.0,16,45,4,12,0,61.50819672131148,318,47,38.22950819672131,14
Category_Wikipedia_sockpuppets_of_2sc945.csv,3977,142553401.0,953,3024,500,453,0,41.34573799346241,255,79,19.146341463414632,2
Category_Wikipedia_sockpuppets_of_Arrow_Nande.csv,10,22666238.0,4,6,3,1,0,58.9,190,21,17.4,15
Category_Wikipedia_sockpuppets_of_Fronsdorf.csv,1347,13463658.0,544,803,500,44,0,39.25686711210096,213,44,16.138827023014105,8
Category_Wikipedia_sockpuppets_of_Wikiweb10011.csv,163,14713912.0,50,113,39,11,0,47.38650306748466,227,54,24.024539877300615,8
Category_Wikipedia_sockpuppets_of_Mactorsplairs.csv,36,320255.0,21,15,13,8,0,160.88888888888889,498,30,20.77777777777778,10
Category_Wikipedia_sockpuppets_of_Charmk.csv,892,153809549.0,501,391,500,1,0,38.98654708520179,366,103,21.15358744394619,4
Category_Wikipedia_sockpuppets_of_Mujeeb1715.csv,92,53834135.0,66,26,42,24,0,24.52173913043478,257,20,9.369565217391305,6
Category_Wikipedia_sockpuppets_of_Film_knowledge_1.csv,45,106040.0,28,17,16,12,0,35.15555555555556,352,19,12.0,10
Category_Wikipedia_sockpuppets_of_ZestyLemonz.csv,24443,241438918.0,10082,14361,500,9582,0,42.66927136603527,517,108,25.85766886225095,3
Category_Wikipedia_sockpuppets_of_JackyAustine.csv,858,53564847.0,230,628,80,150,0,51.61888111888112,255,35,18.294871794871796,3
Category_Wikipedia_sockpuppets_of_DVMt.csv,119,41057439.0,40,79,38,2,0,62.05042016806723,255,58,19.941176470588236,11
Category_Wikipedia_sockpuppets_of_Isaacwshearer.csv,4242,62312991.0,1497,2745,500,997,0,42.075671852899575,496,72,25.71970768505422,4
Category_Wikipedia_sockpuppets_of_Elham377mm.csv,196,1223636.0,58,138,31,27,0,56.90816326530612,270,46,17.770408163265305,3
Category_Wikipedia_sockpuppets_of_Saaduddin20.csv,88,119523656.0,33,55,19,14,0,55.60227272727273,225,26,19.420454545454547,8
Category_Wikipedia_sockpuppets_of_Coramandel23.csv,876,89003219.0,326,550,207,119,0,31.090182648401825,210,39,18.39611872146119,5
Category_Wikipedia_sockpuppets_of_Andrew939321787.csv,1485,16747218.0,431,1054,251,180,0,41.87474747474747,296,57,16.645117845117845,3
Category_Wikipedia_sockpuppets_of_W3forum.csv,169,6619148.0,40,129,13,27,0,69.57396449704142,253,53,19.071005917159763,6
Category_Wikipedia_sockpuppets_of_Hunterstrawberry.csv,397,13725956.0,173,224,85,88,0,42.55667506297229,304,49,22.9823677581864,9
Category_Wikipedia_sockpuppets_of_Hilary_T.csv,1262,4603944.0,515,747,297,218,0,42.62519809825674,217,123,34.40570522979398,5
Category_Wikipedia_sockpuppets_of_JJonz.csv,1234,94612188.0,256,978,125,131,0,43.02674230145867,223,34,13.429497568881686,4
Category_Wikipedia_sockpuppets_of_Cmedia316.csv,38,21615628.0,14,24,4,10,0,59.63157894736842,495,27,19.55263157894737,12
Category_Wikipedia_sockpuppets_of_Hj√§lp_p√•.csv,25,14532123.0,8,17,3,5,0,39.76,152,37,23.88,12
Category_Wikipedia_sockpuppets_of_Vibezafric.csv,1,0.0,1,0,1,0,36,36.0,36,20,20.0,20
Category_Wikipedia_sockpuppets_of_Hindustaci.csv,800,20569125.0,279,521,120,159,0,50.3825,391,50,16.93125,5
Category_Wikipedia_sockpuppets_of_Conner_Kent_o_superboy.csv,2368,7713577.0,727,1641,500,227,0,33.83994932432432,276,39,19.30489864864865,6
Category_Wikipedia_sockpuppets_of_Chickenbrain897.csv,597,17524929.0,198,399,155,43,0,66.96984924623115,500,31,17.99329983249581,11
Category_Wikipedia_sockpuppets_of_Yeungkahchun.csv,1762,128467669.0,511,1251,500,11,0,50.899545970488084,500,92,19.47616345062429,5
Category_Wikipedia_sockpuppets_of_Omniscientmoose42.csv,1996,30071760.0,594,1402,500,94,0,50.069138276553105,301,84,19.066633266533067,4
Category_Wikipedia_sockpuppets_of_Francis89.csv,41,99710.0,19,22,7,12,0,51.951219512195124,150,21,18.317073170731707,15
Category_Wikipedia_sockpuppets_of_Coolbro247.csv,1895,20050815.0,642,1253,323,319,0,44.863324538258574,284,69,16.52981530343008,2
Category_Wikipedia_sockpuppets_of_Pancaiks&Butter.csv,39,403284.0,18,21,9,9,0,44.87179487179487,235,31,26.0,18
Category_Wikipedia_sockpuppets_of_Maleabroad.csv,8612,98848294.0,2471,6141,500,1971,0,39.11274965164886,250,58,13.93427775197399,2
Category_Wikipedia_sockpuppets_of_An_Old_Switchblade.csv,373,7274328.0,116,257,17,99,0,42.683646112600535,248,32,14.0,8
Category_Wikipedia_sockpuppets_of_Itstrailer55197332806.csv,92,485165.0,38,54,29,9,0,47.55434782608695,338,23,17.934782608695652,9
Category_Wikipedia_sockpuppets_of_FreshCorp619.csv,8450,302984109.0,2131,6319,500,1631,0,39.01562130177515,366,82,23.723076923076924,3
Category_Wikipedia_sockpuppets_of_Kbabej.csv,5685,279557822.0,1726,3959,500,1226,0,49.76956904133685,446,76,21.617062445030783,6
Category_Wikipedia_sockpuppets_of_Xn4.csv,5988,79597104.0,2229,3759,500,1729,0,37.62825651302605,248,76,21.833333333333332,3
Category_Wikipedia_sockpuppets_of_Chuckstreet.csv,1604,22566546.0,694,910,500,194,0,71.99376558603491,500,61,24.92705735660848,4
Category_Wikipedia_sockpuppets_of_Tonyjenkins450.csv,2889,115911212.0,657,2232,144,513,0,40.829006576670125,424,32,13.708549671166494,5
Category_Wikipedia_sockpuppets_of_Philipdarby.csv,220,31452762.0,44,176,24,20,0,42.64090909090909,190,18,11.613636363636363,7
Category_Wikipedia_sockpuppets_of_Beeni-cheer.csv,10,9948577.0,5,5,2,3,0,65.5,153,38,24.4,21
Category_Wikipedia_sockpuppets_of_Kryce_Armonio.csv,491,73567102.0,179,312,161,18,0,42.413441955193484,485,64,23.14663951120163,3
Category_Wikipedia_sockpuppets_of_Ajithpithu.csv,923,314231931.0,291,632,285,6,0,34.329360780065,395,73,17.435536294691225,8
Category_Wikipedia_sockpuppets_of_Arthurfan828.csv,2925,81736765.0,896,2029,326,570,0,53.883760683760684,425,83,20.963418803418804,2
Category_Wikipedia_sockpuppets_of_Marco_lion.csv,197,13570166.0,46,151,14,32,0,54.441624365482234,469,62,31.512690355329948,7
Category_Wikipedia_sockpuppets_of_Xparta.csv,134,75429182.0,58,76,27,31,0,21.888059701492537,249,34,9.619402985074627,5
Category_Wikipedia_sockpuppets_of_Darshak.parmar.csv,130,524042264.0,33,97,27,6,0,53.99230769230769,226,64,17.276923076923076,5
Category_Wikipedia_sockpuppets_of_Rickyfernandez2003.csv,17,1491373.0,9,8,3,6,0,54.529411764705884,196,14,12.411764705882353,8
Category_Wikipedia_sockpuppets_of_Flex_Liberia.csv,402,40316271.0,160,242,34,126,0,50.17661691542288,344,64,24.606965174129353,5
Category_Wikipedia_sockpuppets_of_Snksounak.csv,36,220066286.0,17,19,14,3,0,31.02777777777778,240,46,29.444444444444443,7
Category_Wikipedia_sockpuppets_of_Mrigangka.csv,5,306.0,3,2,3,0,0,0.0,0,12,12.0,12
Category_Wikipedia_sockpuppets_of_SarahatJailstoJobs.csv,142,1806381.0,52,90,49,3,0,53.54929577464789,182,36,20.302816901408452,13
Category_Wikipedia_sockpuppets_of_Gareth_Carraway.csv,476,8847882.0,138,338,129,9,0,45.510504201680675,243,59,24.247899159663866,4
Category_Wikipedia_sockpuppets_of_Nonna_Angelina.csv,79,862255.0,29,50,28,1,0,38.58227848101266,289,32,21.78481012658228,13
Category_Wikipedia_sockpuppets_of_Oofoof27.csv,82,48259560.0,25,57,14,11,0,52.25609756097561,215,49,16.097560975609756,7
Category_Wikipedia_sockpuppets_of_Deep4012.csv,36,2758529.0,13,23,10,3,0,54.44444444444444,196,21,16.38888888888889,12
Category_Wikipedia_sockpuppets_of_Placeholder1.csv,1,0.0,1,0,1,0,0,0.0,0,28,28.0,28
Category_Wikipedia_sockpuppets_of_Kidhackr.csv,959,76870250.0,395,564,122,273,0,36.46611053180396,499,48,16.907194994786234,5
Category_Wikipedia_sockpuppets_of_Rajishev.csv,538,373267066.0,195,343,190,5,0,41.674721189591075,243,51,10.219330855018587,4
Category_Wikipedia_sockpuppets_of_Vasu1206.csv,2285,85639469.0,1100,1185,386,714,0,42.03807439824946,403,49,17.856017505470458,4
Category_Wikipedia_sockpuppets_of_JournalOfAntiAging.csv,43,3991926.0,20,23,6,14,0,30.697674418604652,176,54,19.069767441860463,6
Category_Wikipedia_sockpuppets_of_Iron_max_2.csv,867,3927303.0,287,580,131,156,0,34.951557093425606,243,34,20.980392156862745,6
Category_Wikipedia_sockpuppets_of_Tkeyahd1.csv,272,8901340.0,75,197,37,38,0,58.58455882352941,496,50,20.53676470588235,8
Category_Wikipedia_sockpuppets_of_Riz-vs-ric.csv,194,10260119.0,57,137,20,37,0,41.850515463917525,212,45,21.010309278350515,3
Category_Wikipedia_sockpuppets_of_KnowledgeHunter9090.csv,164,805928.0,78,86,64,14,0,53.390243902439025,408,47,26.865853658536587,10
Category_Wikipedia_sockpuppets_of_Gutchan.csv,918,66916255.0,250,668,246,4,0,44.57516339869281,426,40,18.116557734204793,5
Category_Wikipedia_sockpuppets_of_Guddasimonardottir.csv,363,169329525.0,80,283,69,11,0,38.17355371900826,246,46,15.151515151515152,8
Category_Wikipedia_sockpuppets_of_Dar_book.csv,1832,424202669.0,512,1320,500,12,0,43.47762008733624,475,78,25.679039301310045,3
Category_Wikipedia_sockpuppets_of_Jon_Smith_(Sports_Agent).csv,98,18744392.0,37,61,24,13,0,47.785714285714285,196,53,27.806122448979593,12
Category_Wikipedia_sockpuppets_of_Wrisleyae.csv,1,0.0,1,0,1,0,50,50.0,50,19,19.0,19
Category_Wikipedia_sockpuppets_of_◊§◊ê◊®◊ï◊ß.csv,1571,95016141.0,598,973,500,98,0,43.175047740292804,255,59,18.902609802673457,7
Category_Wikipedia_sockpuppets_of_ÿπÿ´ŸÖÿßŸÜ_ÿÆŸÑ€åŸÑ.csv,1757,17953489.0,426,1331,216,210,0,49.132043255549235,252,63,16.616960728514513,4
Category_Wikipedia_sockpuppets_of_Tushar_chitkara.csv,41,5771804.0,14,27,4,10,0,66.7560975609756,236,30,23.29268292682927,12
Category_Wikipedia_sockpuppets_of_SPSutherland.csv,205,34367494.0,115,90,114,1,0,38.453658536585365,255,22,18.55609756097561,5
Category_Wikipedia_sockpuppets_of_Coal_Press_Nation.csv,2485,122749445.0,1037,1448,255,782,0,48.77223340040241,255,82,18.646277665995974,2
Category_Wikipedia_sockpuppets_of_Kimsa_Sok.csv,24,11792122.0,13,11,7,6,0,96.33333333333333,435,20,18.375,12
Category_Wikipedia_sockpuppets_of_Divalicio.csv,585,7617045.0,181,404,72,109,0,53.43418803418803,496,45,18.982905982905983,5
Category_Wikipedia_sockpuppets_of_Entity_of_the_Void.csv,74,1442735.0,24,50,24,0,0,29.2027027027027,163,49,22.445945945945947,7
Category_Wikipedia_sockpuppets_of_Rowillows.csv,3,14881.0,2,1,2,0,0,112.0,195,20,18.0,14
Category_Wikipedia_sockpuppets_of_Bbadwan3.csv,23,433711.0,13,10,11,2,0,62.95652173913044,186,31,29.434782608695652,25
Category_Wikipedia_sockpuppets_of_Scooter321.csv,136,80667025.0,43,93,28,15,0,55.544117647058826,200,39,17.889705882352942,3
Category_Wikipedia_sockpuppets_of_Ameer_al_safar.csv,3007,16483186.0,1206,1801,500,706,0,34.77319587628866,388,50,19.43066178915863,5
Category_Wikipedia_sockpuppets_of_LoganBlade.csv,1841,19089373.0,583,1258,500,83,0,66.7588267246062,499,69,19.976099945681696,3
Category_Wikipedia_sockpuppets_of_Stumink.csv,2828,81724208.0,639,2189,500,139,0,58.6488684582744,459,60,18.457567185289957,4
Category_Wikipedia_sockpuppets_of_Joshua_Boniventure_Chen_1..csv,1038,88630438.0,497,541,142,355,0,40.970134874759154,357,46,22.39980732177264,8
Category_Wikipedia_sockpuppets_of_Paulatolentino.csv,2,0.0,1,1,1,0,85,85.0,85,27,27.0,27
Category_Wikipedia_sockpuppets_of_Podgorski37.csv,121,7438402.0,39,82,23,16,0,52.71900826446281,209,60,18.677685950413224,9
Category_Wikipedia_sockpuppets_of_Tambilexplorer.csv,384,3018782.0,155,229,139,16,0,30.263020833333332,344,54,28.729166666666668,11
Category_Wikipedia_sockpuppets_of_JoeGATTOHubert.csv,120,30587083.0,27,93,15,12,0,59.875,364,32,15.341666666666667,8
Category_Wikipedia_sockpuppets_of_Thetamtran57.csv,624,8155477.0,184,440,58,126,0,35.53525641025641,440,56,20.378205128205128,4
Category_Wikipedia_sockpuppets_of_Floodsmy.csv,738,28173939.0,222,516,163,59,0,47.04471544715447,275,44,20.788617886178862,7
Category_Wikipedia_sockpuppets_of_Coloner.nair.csv,69,2418064.0,46,23,43,3,0,25.89855072463768,177,25,14.855072463768115,14
Category_Wikipedia_sockpuppets_of_RobinJenssen.csv,137,81993.0,90,47,67,23,0,26.846715328467152,242,25,12.277372262773723,11
Category_Wikipedia_sockpuppets_of_Ella_Purnell.csv,9,1295233.0,5,4,3,2,0,73.55555555555556,229,12,12.0,12
Category_Wikipedia_sockpuppets_of_Ucla90024.csv,1401,148741344.0,542,859,500,42,0,37.92005710206995,255,79,28.501784439685938,2
Category_Wikipedia_sockpuppets_of_Spartan1977.csv,842,360329627.0,368,474,315,53,0,41.2541567695962,409,65,23.95724465558195,4
Category_Wikipedia_sockpuppets_of_Waiting4.csv,456,2482147.0,210,246,48,162,0,31.29385964912281,236,77,30.06798245614035,4
Category_Wikipedia_sockpuppets_of_Tue2011tue.csv,852,63712795.0,266,586,207,59,0,37.29577464788732,255,40,19.748826291079812,6
Category_Wikipedia_sockpuppets_of_Moiidthg.csv,183,8361643.0,62,121,57,5,0,45.431693989071036,241,47,20.78688524590164,5
Category_Wikipedia_sockpuppets_of_Dangerpanditankit.csv,2,362.0,2,0,2,0,0,9.5,19,27,27.0,27
Category_Wikipedia_sockpuppets_of_Zavia345.csv,209,41566991.0,64,145,14,50,0,51.57416267942584,364,44,22.56937799043062,7
Category_Wikipedia_sockpuppets_of_Werdnawerdna.csv,4520,18284332.0,1099,3421,500,599,0,42.92168141592921,249,56,17.269026548672567,2
Category_Wikipedia_sockpuppets_of_MatthewLanez.csv,34,11901584.0,18,16,15,3,0,40.64705882352941,169,38,19.705882352941178,12
Category_Wikipedia_sockpuppets_of_GoogleMeNowPlease.csv,1399,46566381.0,477,922,275,202,0,61.92351679771265,495,119,24.258756254467478,5
Category_Wikipedia_sockpuppets_of_Iamroki.csv,461,11229347.0,218,243,196,22,0,30.392624728850326,275,38,19.509761388286336,4
Category_Wikipedia_sockpuppets_of_Generalmesse.csv,1687,33617569.0,764,923,500,264,0,31.086544161232958,210,50,23.556016597510375,8
Category_Wikipedia_sockpuppets_of_Ali_banu_sistani.csv,1534,62997973.0,501,1033,500,1,0,42.73989569752282,496,40,16.789439374185136,4
Category_Wikipedia_sockpuppets_of_Mod_objective.csv,1666,41735372.0,624,1042,175,449,0,38.752701080432175,214,51,16.562424969987994,3
Category_Wikipedia_sockpuppets_of_Mqsobhan.csv,54,351746660.0,33,21,30,3,0,54.2037037037037,506,18,12.796296296296296,12
Category_Wikipedia_sockpuppets_of_AlanCity20.csv,7622,114300923.0,1672,5950,239,1433,0,54.79178693256363,500,97,20.88401994227237,3
Category_Wikipedia_sockpuppets_of_Robert_Lee_III.csv,17,507317.0,12,5,6,6,0,22.705882352941178,159,9,9.0,9
Category_Wikipedia_sockpuppets_of_R.Lemkin.csv,3002,88375726.0,1000,2002,500,500,0,63.945036642238506,500,66,25.122584943371088,3
Category_Wikipedia_sockpuppets_of_Jajidjajidisastan.csv,102,250715.0,28,74,18,10,0,49.8235294117647,178,54,24.323529411764707,14
Category_Wikipedia_sockpuppets_of_Fakeobsession.csv,44,112044037.0,14,30,11,3,0,53.43181818181818,250,32,23.65909090909091,13
Category_Wikipedia_sockpuppets_of_Umesh_Tharuka_Malaviarachchi.csv,6,61102572.0,5,1,4,1,0,18.0,46,38,36.333333333333336,33
Category_Wikipedia_sockpuppets_of_Luke_Farrelly-Spain.csv,153,136414607.0,34,119,25,9,0,44.869281045751634,220,54,17.41830065359477,9
Category_Wikipedia_sockpuppets_of_Doctor_Doomsday.csv,907,122589674.0,255,652,213,42,0,32.98015435501654,211,61,19.89084895259096,4
Category_Wikipedia_sockpuppets_of_Red_plosion.csv,5611,62047862.0,1651,3960,500,1151,0,42.19497415790412,500,57,15.81179825343076,3
Category_Wikipedia_sockpuppets_of_Rakeshsrivastava.dir.csv,332,114040516.0,123,209,60,63,0,38.85843373493976,225,61,19.3644578313253,8
Category_Wikipedia_sockpuppets_of_Prativa_rai.csv,24,10487.0,12,12,8,4,0,320.875,502,46,40.333333333333336,22
Category_Wikipedia_sockpuppets_of_Victory_Clarion.csv,347,6980333.0,122,225,46,76,0,53.671469740634,238,32,14.377521613832853,4
Category_Wikipedia_sockpuppets_of_Syjytg.csv,2192,113169246.0,843,1349,500,343,0,38.28284671532847,250,65,26.422901459854014,8
Category_Wikipedia_sockpuppets_of_Ants226.csv,69,214451.0,21,48,13,8,0,93.31884057971014,269,27,14.695652173913043,5
Category_Wikipedia_sockpuppets_of_Reciv2007.csv,65,69188.0,25,40,14,11,0,56.43076923076923,196,36,15.738461538461538,5
Category_Wikipedia_sockpuppets_of_Odiahistory.csv,925,10018444.0,292,633,115,177,0,46.07459459459459,429,52,19.39027027027027,4
Category_Wikipedia_sockpuppets_of_Thesmartguy1737485.csv,21,920233.0,14,7,4,10,0,39.76190476190476,227,18,18.0,18
Category_Wikipedia_sockpuppets_of_Sr_76.csv,1186,234543277.0,510,676,500,10,0,51.709949409780776,422,46,19.51096121416526,6
Category_Wikipedia_sockpuppets_of_Slmah.csv,100,2325708.0,31,69,16,15,0,71.22,267,30,16.25,6
Category_Wikipedia_sockpuppets_of_Matrusri.csv,670,35825012.0,274,396,202,72,0,34.49850746268657,224,52,23.33731343283582,11
Category_Wikipedia_sockpuppets_of_Dangled10.csv,595,8561911.0,192,403,101,91,0,45.80504201680672,508,60,16.926050420168067,5
Category_Wikipedia_sockpuppets_of_Normads.csv,64,4387344.0,24,40,10,14,0,36.6875,236,20,13.609375,7
Category_Wikipedia_sockpuppets_of_Abhineett.csv,31,333618.0,23,8,20,3,0,89.06451612903226,255,41,35.32258064516129,19
Category_Wikipedia_sockpuppets_of_BK10021.csv,222,6760044.0,91,131,27,64,0,64.90090090090091,363,31,14.617117117117116,9
Category_Wikipedia_sockpuppets_of_Loveableone.csv,1460,49954957.0,634,826,500,134,0,30.352054794520548,267,50,22.42054794520548,5
Category_Wikipedia_sockpuppets_of_Dwdpuma.csv,1092,154961277.0,321,771,154,167,0,38.951465201465204,252,69,15.934065934065934,5
Category_Wikipedia_sockpuppets_of_Jason_like.csv,74,5770732.0,21,53,9,12,0,50.013513513513516,208,60,29.45945945945946,8
Category_Wikipedia_sockpuppets_of_R.o.t.csv,5070,128210651.0,1613,3457,500,1113,0,49.45207100591716,481,56,18.28698224852071,3
Category_Wikipedia_sockpuppets_of_Crusaderjaixon.csv,120,19137650.0,45,75,41,4,0,48.61666666666667,250,52,24.691666666666666,7
Category_Wikipedia_sockpuppets_of_Che_Guvara.csv,321,4336205.0,132,189,48,84,0,23.130841121495326,197,63,20.91588785046729,7
Category_Wikipedia_sockpuppets_of_LEGEND_IN_MODERN.csv,599,4330833.0,222,377,203,19,0,51.39232053422371,242,43,16.283806343906512,3
Category_Wikipedia_sockpuppets_of_Shadowoneone.csv,243,1101640.0,93,150,69,24,0,57.86008230452675,229,47,20.135802469135804,6
Category_Wikipedia_sockpuppets_of_Whalley123456.csv,40,24169767.0,10,30,6,4,0,33.675,165,22,15.75,10
Category_Wikipedia_sockpuppets_of_Keegscee.csv,1902,252060363.0,549,1353,500,49,0,69.02891692954785,255,55,19.344374342797057,3
Category_Wikipedia_sockpuppets_of_Cloddy_Hans.csv,62,7266345.0,15,47,6,9,0,57.82258064516129,194,62,36.32258064516129,15
Category_Wikipedia_sockpuppets_of_MatthewRay.csv,2,111.0,2,0,2,0,13,16.5,20,20,20.0,20
Category_Wikipedia_sockpuppets_of_Ntelabi_Bukari.csv,140,4453761.0,45,95,20,25,0,46.72857142857143,235,35,15.021428571428572,3
Category_Wikipedia_sockpuppets_of_Revizorrr.csv,64,26950.0,50,14,40,10,0,31.25,160,17,9.6875,8
Category_Wikipedia_sockpuppets_of_Sky19395.csv,25,254702027.0,6,19,5,1,0,48.64,145,20,16.36,13
Category_Wikipedia_sockpuppets_of_Sina_javadi74.csv,195,1503481.0,106,89,29,77,0,51.43589743589744,202,51,19.666666666666668,6
Category_Wikipedia_sockpuppets_of_D4iNa4.csv,2153,369342919.0,542,1611,500,42,0,56.65861588481189,323,105,18.89084997677659,3
Category_Wikipedia_sockpuppets_of_Alag2001.csv,277,249524.0,117,160,91,26,0,23.56678700361011,231,26,16.743682310469314,5
Category_Wikipedia_sockpuppets_of_Ooh_Saad.csv,1354,4213494.0,418,936,319,99,0,49.839734121122596,359,43,15.31314623338257,1
Category_Wikipedia_sockpuppets_of_Iryanapinto.csv,90,5704988.0,63,27,58,5,0,40.71111111111111,196,25,18.6,13
Category_Wikipedia_sockpuppets_of_Drhusseinnet.csv,74,29650464.0,23,51,15,8,0,57.41891891891892,368,7,7.0,7
Category_Wikipedia_sockpuppets_of_DylanDunn11.csv,16,1374561.0,11,5,3,8,0,89.375,212,5,5.0,5
Category_Wikipedia_sockpuppets_of_Pee_po_belly_bum_drawers.csv,75,1450967.0,24,51,23,1,0,51.906666666666666,196,55,34.333333333333336,16
Category_Wikipedia_sockpuppets_of_–•—Ä–∞–º—É–ª–∏–Ω_–í–ª–∞–¥–∏–º–∏—Ä_–í–∞–ª–µ—Ä—å–µ–≤–∏—á.csv,52,3247906.0,34,18,31,3,0,31.634615384615383,260,35,19.0,14
Category_Wikipedia_sockpuppets_of_PYOENT.csv,160,32870535.0,46,114,45,1,0,34.55625,176,34,12.4875,6
Category_Wikipedia_sockpuppets_of_Holstebro.csv,551,184931628.0,217,334,216,1,0,42.12885662431942,500,54,21.372050816696916,7
Category_Wikipedia_sockpuppets_of_Mohamedashiqrahman.csv,284,17328810.0,95,189,66,29,0,35.65845070422535,251,28,13.154929577464788,4
Category_Wikipedia_sockpuppets_of_Trusha.daware.csv,479,30610167.0,132,347,71,61,0,44.16910229645094,269,23,13.24634655532359,7
Category_Wikipedia_sockpuppets_of_Paid_Editing.csv,12,1230.0,7,5,2,5,0,21.5,78,48,41.25,39
Category_Wikipedia_sockpuppets_of_Muhammadyeakubhasan111.csv,96,419962.0,25,71,15,10,0,41.75,224,49,20.375,11
Category_Wikipedia_sockpuppets_of_Matthew7878.csv,73,16012758.0,43,30,23,20,0,45.013698630136986,249,21,15.698630136986301,14
Category_Wikipedia_sockpuppets_of_Auno3.csv,2238,60531223.0,571,1667,436,135,0,36.249776586237715,214,78,15.214924039320822,3
Category_Wikipedia_sockpuppets_of_BenHDev.csv,1226,46773064.0,530,696,500,30,0,45.568515497553015,500,47,15.583197389885807,4
Category_Wikipedia_sockpuppets_of_ÎÖ∏Î¨¥Îî±Î∂ÑÏã†Ïà†.csv,80,45862184.0,17,63,16,1,0,56.8875,278,38,19.2,8
Category_Wikipedia_sockpuppets_of_Fffrtrttt.csv,34,3464667.0,12,22,3,9,0,57.705882352941174,226,24,16.705882352941178,8
Category_Wikipedia_sockpuppets_of_FNH004.csv,1409,80640959.0,573,836,500,73,0,37.80127750177431,496,75,26.9013484740951,6
Category_Wikipedia_sockpuppets_of_AmericanDirectory.csv,158,22195993.0,54,104,33,21,0,40.537974683544306,170,53,19.835443037974684,7
Category_Wikipedia_sockpuppets_of_YoMamma6188.csv,2489,22377677.0,981,1508,279,702,0,32.59421454399357,255,77,22.200080353555645,3
Category_Wikipedia_sockpuppets_of_Bhatti31.csv,135,2920383.0,45,90,31,14,0,43.96296296296296,345,58,21.466666666666665,7
Category_Wikipedia_sockpuppets_of_Agon_Mustafa.csv,632,99475266.0,186,446,174,12,0,36.29272151898734,386,76,24.67721518987342,4
Category_Wikipedia_sockpuppets_of_Greatshah876.csv,10,76405.0,8,2,5,3,12,41.1,128,16,16.0,16
Category_Wikipedia_sockpuppets_of_ProblemBesucher.csv,68,14001625.0,30,38,24,6,0,77.08823529411765,483,33,24.794117647058822,12
Category_Wikipedia_sockpuppets_of_Oliverrox.csv,874,31194588.0,240,634,218,22,0,40.25629290617849,258,43,18.334096109839816,7
Category_Wikipedia_sockpuppets_of_KrytenK.csv,108,2506588.0,49,59,31,18,0,55.47222222222222,253,41,18.62037037037037,8
Category_Wikipedia_sockpuppets_of_Kitia.csv,1644,20778738.0,553,1091,500,53,0,37.663625304136254,216,93,21.121654501216543,4
Category_Wikipedia_sockpuppets_of_RoseAllynPR.csv,3,4882595.0,2,1,2,0,19,27.333333333333332,36,21,21.0,21
Category_Wikipedia_sockpuppets_of_FUtheresa.csv,2154,336133917.0,607,1547,406,201,0,51.876973073351905,273,55,14.870009285051069,3
Category_Wikipedia_sockpuppets_of_Joshmangel.csv,1,0.0,1,0,1,0,13,13.0,13,21,21.0,21
Category_Wikipedia_sockpuppets_of_Asucena.csv,746,8728648.0,211,535,140,71,0,47.30563002680965,212,78,18.853887399463808,5
Category_Wikipedia_sockpuppets_of_Billphil1.csv,7,115619.0,4,3,4,0,0,55.285714285714285,196,25,15.142857142857142,10
Category_Wikipedia_sockpuppets_of_Balangir123456.csv,100,13668539.0,25,75,15,10,0,57.68,259,24,13.4,6
Category_Wikipedia_sockpuppets_of_Gdv777.csv,90,20315614.0,48,42,48,0,0,54.955555555555556,229,74,25.022222222222222,11
Category_Wikipedia_sockpuppets_of_Keralean.csv,208,1078889.0,82,126,64,18,0,40.71634615384615,230,51,27.620192307692307,10
Category_Wikipedia_sockpuppets_of_JEPHTER_R_CHOMBA.csv,34,24302952.0,13,21,10,3,0,38.61764705882353,111,53,42.8235294117647,15
Category_Wikipedia_sockpuppets_of_Wikipagecreator101.csv,35,37965330.0,17,18,15,2,0,37.17142857142857,161,50,30.62857142857143,22
Category_Wikipedia_sockpuppets_of_SHARONHIRLEY.csv,14,3952.0,6,8,5,1,0,31.357142857142858,137,28,6.785714285714286,3
Category_Wikipedia_sockpuppets_of_Vishaal_Elias_Manesh.csv,7427,45135423.0,2585,4842,500,2085,0,41.02989093846775,500,69,19.630806516763162,4
Category_Wikipedia_sockpuppets_of_Natsecobserver.csv,301,177825707.0,130,171,125,5,0,63.1328903654485,254,65,24.877076411960132,10
Category_Wikipedia_sockpuppets_of_Jovialedit.csv,32,10039214.0,11,21,6,5,0,35.59375,164,53,30.15625,12
Category_Wikipedia_sockpuppets_of_Keiana.csv,7,860874.0,2,5,2,0,12,66.14285714285714,135,11,11.0,11
Category_Wikipedia_sockpuppets_of_Hoaxinator.csv,35,831.0,11,24,9,2,0,51.25714285714286,250,34,17.114285714285714,10
Category_Wikipedia_sockpuppets_of_Pclnahqcomms.csv,53,254964767.0,25,28,24,1,0,28.49056603773585,196,25,16.50943396226415,16
Category_Wikipedia_sockpuppets_of_IbankingMM.csv,756,20475892.0,373,383,276,97,0,38.03042328042328,241,54,22.952380952380953,11
Category_Wikipedia_sockpuppets_of_Lyanbox782.csv,2283,24896946.0,650,1633,382,268,0,51.93298291721419,499,53,15.513797634691196,3
Category_Wikipedia_sockpuppets_of_Semso98.csv,2228,167918440.0,1000,1228,500,500,0,36.202872531418315,513,76,30.40664272890485,4
Category_Wikipedia_sockpuppets_of_Summer_bbya.csv,266,16949432.0,155,111,31,124,0,38.87218045112782,443,32,12.033834586466165,7
Category_Wikipedia_sockpuppets_of_Nuada79.csv,1939,74091046.0,626,1313,308,318,0,36.30428055698814,224,55,16.554409489427538,4
Category_Wikipedia_sockpuppets_of_Tazlinc1.csv,1469,112816299.0,342,1127,69,273,0,41.23144996596324,383,40,14.40435670524166,2
Category_Wikipedia_sockpuppets_of_Snowballgamers.csv,226,19420753.0,84,142,83,1,0,40.81858407079646,322,50,18.884955752212388,4
Category_Wikipedia_sockpuppets_of_Shankar.raghoba.csv,76,163171.0,28,48,8,20,0,45.026315789473685,161,25,12.592105263157896,6
Category_Wikipedia_sockpuppets_of_Foxtv89.csv,59,6920233.0,21,38,7,14,0,24.677966101694917,252,29,10.101694915254237,7
Category_Wikipedia_sockpuppets_of_Leaveituptome1234.csv,146,23511680.0,36,110,27,9,0,38.26027397260274,204,50,17.232876712328768,9
Category_Wikipedia_sockpuppets_of_Japeters1.csv,149,260294.0,62,87,1,61,0,52.624161073825505,311,39,11.664429530201343,2
Category_Wikipedia_sockpuppets_of_Flack.inspired.csv,851,80538447.0,262,589,78,184,0,47.169212690951824,500,53,18.90364277320799,4
Category_Wikipedia_sockpuppets_of_Umberto_Bottura.csv,3961,433738266.0,1082,2879,500,582,0,31.08659429437011,499,49,20.07775814188336,4
Category_Wikipedia_sockpuppets_of_MorbidStories.csv,1889,65743138.0,546,1343,500,46,0,53.09105346744309,469,55,20.407623080995236,4
Category_Wikipedia_sockpuppets_of_AnotherCastleMusic.csv,203,13616900.0,57,146,22,35,0,31.0,235,32,14.807881773399014,6
Category_Wikipedia_sockpuppets_of_Mark_Ely.csv,32,349302.0,15,17,4,11,10,48.15625,113,72,60.09375,15
Category_Wikipedia_sockpuppets_of_NepaliHelper.csv,2393,18748423.0,1071,1322,299,772,0,30.589218554116172,253,62,15.520685332218973,3
Category_Wikipedia_sockpuppets_of_Lpoho.csv,6,726.0,6,0,5,1,0,0.0,0,24,24.0,24
Category_Wikipedia_sockpuppets_of_JohnnyCanuck.csv,1114,22523278.0,423,691,409,14,0,24.767504488330342,199,89,22.03321364452424,7
Category_Wikipedia_sockpuppets_of_Zeke1999.csv,3451,389624639.0,1268,2183,500,768,0,51.38423645320197,255,79,20.27644161112721,3
Category_Wikipedia_sockpuppets_of_Virani_q.csv,277,12874830.0,101,176,68,33,0,36.5956678700361,221,53,15.743682310469314,6
Category_Wikipedia_sockpuppets_of_Cristodelosgitanos.csv,845,13887088.0,309,536,214,95,0,56.27455621301775,496,54,19.392899408284023,6
Category_Wikipedia_sockpuppets_of_Nalanidil.csv,3285,30962405.0,1025,2260,500,525,0,45.35646879756469,496,64,17.3662100456621,4
Category_Wikipedia_sockpuppets_of_Phaseyour2.csv,479,3876919.0,143,336,60,83,0,45.609603340292274,234,72,20.95615866388309,7
Category_Wikipedia_sockpuppets_of_Sorenedsel.csv,279,35716557.0,61,218,41,20,0,20.551971326164875,197,52,17.827956989247312,4
Category_Wikipedia_sockpuppets_of_Tylerbrizyy.csv,7,929878.0,2,5,1,1,17,54.142857142857146,112,31,18.142857142857142,16
Category_Wikipedia_sockpuppets_of_Riarklematthews.csv,329,29080363.0,115,214,57,58,0,57.26747720364742,255,38,17.5258358662614,3
Category_Wikipedia_sockpuppets_of_Froggie19Dude.csv,125,40450407.0,40,85,40,0,0,45.592,165,56,39.56,17
Category_Wikipedia_sockpuppets_of_Sinar_Zaito.csv,280,20312501.0,88,192,74,14,0,55.77142857142857,247,41,18.925,4
Category_Wikipedia_sockpuppets_of_Virgiliosarvanitis.csv,666,200469878.0,223,443,163,60,0,62.887387387387385,453,64,16.63213213213213,6
Category_Wikipedia_sockpuppets_of_SpecialAgent047.csv,682,7072434.0,218,464,169,49,0,45.617302052785924,458,36,17.602639296187682,8
Category_Wikipedia_sockpuppets_of_UncomfortablySmug.csv,3985,93378115.0,1073,2912,500,573,0,52.673776662484315,500,68,22.896110414052696,5
Category_Wikipedia_sockpuppets_of_Yoland83.csv,104,11301892.0,44,60,8,36,0,41.81730769230769,228,47,23.0,7
Category_Wikipedia_sockpuppets_of_Sivadarsan_Kannan.csv,1527,40660786.0,361,1166,107,254,0,39.917485265225935,500,38,16.994760969220692,3
Category_Wikipedia_sockpuppets_of_Php7788.csv,304,37579201.0,123,181,52,71,0,33.73026315789474,255,44,25.37828947368421,8
Category_Wikipedia_sockpuppets_of_Schreiber1mike.csv,6,2319534.0,5,1,3,2,0,96.16666666666667,189,33,27.0,23
Category_Wikipedia_sockpuppets_of_Malvinworks.csv,62,13733278.0,28,34,17,11,0,42.596774193548384,184,52,30.419354838709676,13
Category_Wikipedia_sockpuppets_of_Ianmode.csv,14,6577383.0,4,10,3,1,0,39.42857142857143,151,23,19.071428571428573,16
Category_Wikipedia_sockpuppets_of_Johnny15678.csv,98,6144435.0,37,61,13,24,0,46.45918367346939,244,44,24.581632653061224,15
Category_Wikipedia_sockpuppets_of_Viva2015.csv,122,780128.0,80,42,78,2,0,47.32786885245902,255,39,31.450819672131146,9
Category_Wikipedia_sockpuppets_of_Solanki2015.csv,155,206530913.0,52,103,33,19,0,41.32258064516129,295,24,15.670967741935485,6
Category_Wikipedia_sockpuppets_of_GooseMail1996.csv,230,3138208.0,66,164,64,2,0,50.45652173913044,255,48,20.47826086956522,1
Category_Wikipedia_sockpuppets_of_Monicahflynn.csv,85,7753087.0,35,50,7,28,0,59.705882352941174,199,34,18.67058823529412,7
Category_Wikipedia_sockpuppets_of_Kolby669.csv,780,21070643.0,246,534,197,49,0,32.325641025641026,255,53,18.526923076923076,4
Category_Wikipedia_sockpuppets_of_Aj2k.csv,175,4141561.0,46,129,30,16,0,38.0,200,19,13.674285714285714,5
Category_Wikipedia_sockpuppets_of_MalikGary1919.csv,163,1691175.0,43,120,14,29,0,65.73006134969326,343,30,11.754601226993865,5
Category_Wikipedia_sockpuppets_of_Samfreshnews.csv,34,3799499.0,12,22,5,7,0,52.64705882352941,204,39,20.558823529411764,12
Category_Wikipedia_sockpuppets_of_Beststoryteller.csv,16,117486.0,9,7,7,2,0,86.375,233,40,26.1875,14
Category_Wikipedia_sockpuppets_of_Ednei_Campos_De_Jesus_De_Brito.csv,943,20133045.0,438,505,407,31,0,37.3796394485684,404,53,19.98833510074231,5
Category_Wikipedia_sockpuppets_of_L√†nh_kon_ƒë·∫πp_zai.csv,68,2163125.0,20,48,17,3,0,55.161764705882355,260,19,13.617647058823529,10
Category_Wikipedia_sockpuppets_of_Mr_Hamza.csv,1044,27120058.0,364,680,61,303,0,34.42911877394636,250,54,14.673371647509578,5
Category_Wikipedia_sockpuppets_of_Asaboiz.csv,357,43716253.0,129,228,86,43,0,26.529411764705884,196,54,22.439775910364144,13
Category_Wikipedia_sockpuppets_of_Rabinhos221.csv,398,8214484.0,122,276,96,26,0,45.733668341708544,255,47,20.020100502512562,8
Category_Wikipedia_sockpuppets_of_Pele_the_king.csv,22,118335.0,16,6,8,8,0,43.40909090909091,147,32,12.727272727272727,6
Category_Wikipedia_sockpuppets_of_Themagician123456.csv,31,1659498.0,21,10,21,0,0,12.806451612903226,152,26,13.225806451612904,8
Category_Wikipedia_sockpuppets_of_Youtubek.csv,3665,142794857.0,1350,2315,464,886,0,36.353342428376536,255,51,21.394270122783084,3
Category_Wikipedia_sockpuppets_of_Icecreamland.csv,335,3137482.0,103,232,72,31,0,49.31044776119403,317,48,29.81492537313433,4
Category_Wikipedia_sockpuppets_of_Camogie_History.csv,1596,55538599.0,698,898,500,198,0,48.856516290726816,247,48,19.966791979949875,7
Category_Wikipedia_sockpuppets_of_Queen.flordeliza.csv,4,121.0,2,2,1,1,65,163.25,196,30,29.75,29
Category_Wikipedia_sockpuppets_of_Katiecat1110.csv,1,0.0,1,0,1,0,3,3.0,3,9,9.0,9
Category_Wikipedia_sockpuppets_of_Coat_of_Many_Colours.csv,5065,113010931.0,2050,3015,500,1550,0,49.19703849950642,255,141,25.096150049358343,4
Category_Wikipedia_sockpuppets_of_Sundra16.csv,105,76008782.0,21,84,17,4,0,56.161904761904765,223,61,24.704761904761906,10
Category_Wikipedia_sockpuppets_of_Sheldon_the_God.csv,1927,11929432.0,469,1458,429,40,0,45.651790347690714,495,49,17.391800726517904,4
Category_Wikipedia_sockpuppets_of_Mmoates.csv,1454,371936623.0,514,940,382,132,0,44.29160935350757,292,71,29.537826685006877,8
Category_Wikipedia_sockpuppets_of_Jude_Enemy.csv,64,69035342.0,25,39,8,17,0,51.8125,234,25,14.078125,8
Category_Wikipedia_sockpuppets_of_–ö–æ—Ä–∏–æ–ª–∞–Ω—ã—á.csv,6431,130642750.0,2723,3708,500,2223,0,40.11164671124242,457,73,18.30772819157207,4
Category_Wikipedia_sockpuppets_of_Prof._Homerton.csv,18,101201.0,13,5,9,4,0,7.222222222222222,113,16,16.0,16
Category_Wikipedia_sockpuppets_of_Theraulbrady.csv,22,723.0,7,15,5,2,11,60.81818181818182,154,23,18.40909090909091,10
Category_Wikipedia_sockpuppets_of_Jouletale.csv,242,17269367.0,97,145,22,75,0,45.8099173553719,424,48,13.62396694214876,5
Category_Wikipedia_sockpuppets_of_Lagatinofficial.csv,49,17442143.0,15,34,13,2,0,43.95918367346939,153,25,17.122448979591837,10
Category_Wikipedia_sockpuppets_of_Tdrhsnam.csv,228,7970790.0,161,67,27,134,0,27.25,255,54,24.662280701754387,10
Category_Wikipedia_sockpuppets_of_Ê†πÊã†ÂéüÂâá.csv,256,17882870.0,100,156,90,10,0,42.6015625,500,42,21.27734375,7
Category_Wikipedia_sockpuppets_of_Matan_ibn_Uthman.csv,1531,5442233.0,516,1015,500,16,0,46.4467668190725,499,40,18.672109732201175,4
Category_Wikipedia_sockpuppets_of_Bluemarine.csv,1442,356988955.0,529,913,500,29,0,44.92787794729542,260,59,20.787101248266296,6
Category_Wikipedia_sockpuppets_of_ROXETTE88.csv,1174,7680409.0,408,766,219,189,0,49.94378194207837,253,45,18.415672913117547,3
Category_Wikipedia_sockpuppets_of_Nurdinjaelani17.csv,91,6590938.0,40,51,28,12,0,37.527472527472526,271,26,19.0,2
Category_Wikipedia_sockpuppets_of_Jermzc.csv,309,159444532.0,106,203,97,9,0,38.10679611650485,247,47,21.57281553398058,7
Category_Wikipedia_sockpuppets_of_Ganguly_mm.csv,371,51490468.0,169,202,131,38,0,31.137466307277627,326,30,13.064690026954178,10
Category_Wikipedia_sockpuppets_of_Membrane-biologist.csv,480,52202669.0,145,335,59,86,0,50.05625,252,62,22.685416666666665,5
Category_Wikipedia_sockpuppets_of_ChaceWatson.csv,324,8258989.0,103,221,61,42,0,45.56172839506173,259,41,17.546296296296298,7
Category_Wikipedia_sockpuppets_of_Decite.csv,91,2684646.0,40,51,35,5,0,23.626373626373628,183,58,24.78021978021978,11
Category_Wikipedia_sockpuppets_of_Psl85.csv,695,9115774.0,194,501,189,5,0,61.082014388489206,251,62,20.753956834532374,3
Category_Wikipedia_sockpuppets_of_A_portah29.csv,1105,42291744.0,513,592,500,13,0,39.469683257918554,255,39,23.520361990950228,8
Category_Wikipedia_sockpuppets_of_MikeCrest500.csv,51,447798.0,22,29,13,9,0,43.90196078431372,253,33,14.333333333333334,9
Category_Wikipedia_sockpuppets_of_SamratBornToPlay.csv,62,51174513.0,22,40,7,15,0,49.53225806451613,210,47,27.725806451612904,15
Category_Wikipedia_sockpuppets_of_Daffy11.csv,194,158650554.0,69,125,55,14,0,45.43814432989691,238,33,18.711340206185568,4
Category_Wikipedia_sockpuppets_of_Ghjgghbhgh.csv,298,44099229.0,94,204,84,10,0,23.674496644295303,232,41,22.98993288590604,6
Category_Wikipedia_sockpuppets_of_Zharta.csv,232,154575.0,100,132,91,9,0,29.00862068965517,181,35,14.987068965517242,2
Category_Wikipedia_sockpuppets_of_Kbs987.csv,1376,54682714.0,449,927,126,323,0,42.39970930232558,442,80,18.813953488372093,4
Category_Wikipedia_sockpuppets_of_Willie_Bin_Laden.csv,13,88262.0,9,4,6,3,0,77.23076923076923,138,41,28.076923076923077,13
Category_Wikipedia_sockpuppets_of_MatthewCenance.csv,2548,466727230.0,732,1816,500,232,0,49.13461538461539,376,61,19.914442700156986,3
Category_Wikipedia_sockpuppets_of_Notabilitypatrol.csv,2110,21474861.0,855,1255,500,355,0,34.40331753554502,250,70,23.639810426540283,4
Category_Wikipedia_sockpuppets_of_Ansegam.csv,990,16423418.0,506,484,500,6,0,50.42929292929293,255,50,25.995959595959597,7
Category_Wikipedia_sockpuppets_of_DavidLondon51.csv,21,6300053.0,10,11,8,2,0,105.52380952380952,344,25,21.19047619047619,15
Category_Wikipedia_sockpuppets_of_Masky2.csv,40,248301594.0,10,30,7,3,0,53.375,225,42,21.025,12
Category_Wikipedia_sockpuppets_of_829uw.csv,116,1392320.0,66,50,39,27,0,48.310344827586206,370,32,18.413793103448278,12
Category_Wikipedia_sockpuppets_of_Sh068h.csv,1,0.0,1,0,1,0,89,89.0,89,21,21.0,21
Category_Wikipedia_sockpuppets_of_Robert_Daconto.csv,70,10100958.0,32,38,29,3,0,35.128571428571426,205,26,18.02857142857143,15
Category_Wikipedia_sockpuppets_of_BassProShopsTruex.csv,43,88909.0,15,28,8,7,0,64.5813953488372,207,21,12.906976744186046,6
Category_Wikipedia_sockpuppets_of_WoodDaver.csv,42,4996075.0,20,22,17,3,0,20.238095238095237,131,47,25.095238095238095,15
Category_Wikipedia_sockpuppets_of_Bernard.wiki1.csv,142,8755663.0,46,96,29,17,0,50.38028169014085,263,53,16.767605633802816,7
Category_Wikipedia_sockpuppets_of_Lampachee.csv,148,2266653.0,49,99,30,19,0,38.979729729729726,223,28,16.844594594594593,5
Category_Wikipedia_sockpuppets_of_Steeldayena.csv,11,24707.0,6,5,3,3,5,29.545454545454547,89,37,22.818181818181817,16
Category_Wikipedia_sockpuppets_of_Lentleka.csv,1,0.0,1,0,1,0,66,66.0,66,18,18.0,18
Category_Wikipedia_sockpuppets_of_LeticiaLL.csv,1934,90566825.0,529,1405,382,147,0,54.65873836608066,500,43,16.180972078593587,3
Category_Wikipedia_sockpuppets_of_MarthaFiles.csv,455,5098478.0,203,252,26,177,0,49.753846153846155,211,51,16.978021978021978,7
Category_Wikipedia_sockpuppets_of_Uponleft.csv,239,4311045.0,133,106,93,40,0,32.69456066945607,198,81,42.91213389121339,5
Category_Wikipedia_sockpuppets_of_Osmosys_Software_Solutions_Pvt_Ltd.csv,15,92273.0,10,5,5,5,0,16.666666666666668,132,59,33.4,20
Category_Wikipedia_sockpuppets_of_204060baby.csv,1933,8022568.0,825,1108,500,325,0,42.56544231764097,496,67,27.92240041386446,4
Category_Wikipedia_sockpuppets_of_Sparte_Media.csv,2,0.0,1,1,1,0,36,36.0,36,22,22.0,22
Category_Wikipedia_sockpuppets_of_Koopa24.csv,254,32498041.0,96,158,95,1,0,48.09448818897638,255,37,15.318897637795276,5
Category_Wikipedia_sockpuppets_of_Mudigital.csv,1,0.0,1,0,1,0,30,30.0,30,10,10.0,10
Category_Wikipedia_sockpuppets_of_Arianasmithy74.csv,753,117518418.0,218,535,159,59,0,50.764940239043824,480,54,26.12483399734396,4
Category_Wikipedia_sockpuppets_of_Heatherwhea.csv,640,273804970.0,206,434,111,95,0,44.971875,255,59,17.809375,6
Category_Wikipedia_sockpuppets_of_Busy_Bee.csv,1018,54176655.0,290,728,275,15,0,38.74066797642436,220,47,14.1188605108055,2
Category_Wikipedia_sockpuppets_of_Calleville.csv,32,777018.0,24,8,23,1,0,25.84375,163,51,44.59375,20
Category_Wikipedia_sockpuppets_of_Bobanfasil.csv,589,60765822.0,239,350,102,137,0,39.21052631578947,274,41,15.512733446519524,5
Category_Wikipedia_sockpuppets_of_Kichappan.csv,4783,277611687.0,1687,3096,500,1187,0,38.57244407275768,255,51,16.33765419192975,4
Category_Wikipedia_sockpuppets_of_Hagohel.csv,53,1388134.0,41,12,23,18,0,21.735849056603772,195,47,23.62264150943396,4
Category_Wikipedia_sockpuppets_of_IssyIsAwesome.csv,38,150803.0,21,17,14,7,0,38.1578947368421,176,23,11.078947368421053,8
Category_Wikipedia_sockpuppets_of_Sword-Site.csv,55,23903619.0,24,31,19,5,0,52.127272727272725,235,32,13.2,5
Category_Wikipedia_sockpuppets_of_Sathyassb.csv,1,0.0,1,0,1,0,0,0.0,0,19,19.0,19
Category_Wikipedia_sockpuppets_of_Scubadiver99.csv,356,43945187.0,126,230,70,56,0,52.3623595505618,210,48,17.85674157303371,4
Category_Wikipedia_sockpuppets_of_Its_Pytch.._Hon.csv,1630,5279618.0,738,892,500,238,0,34.10122699386503,218,57,18.979141104294477,4
Category_Wikipedia_sockpuppets_of_–ï–Ω—Ç—É—Å–∏–∞—Å—Ç—ä.csv,2576,23667487.0,756,1820,500,256,0,52.32531055900621,500,74,19.874611801242235,3
Category_Wikipedia_sockpuppets_of_Anthony_5432.csv,310,970083.0,78,232,78,0,0,34.196774193548386,218,55,28.429032258064517,4
Category_Wikipedia_sockpuppets_of_Atlantictire.csv,1575,81227541.0,501,1074,500,1,0,52.06349206349206,255,68,31.734603174603176,12
Category_Wikipedia_sockpuppets_of_Judo112.csv,2630,16507980.0,1005,1625,500,505,0,32.13041825095057,250,82,20.922813688212926,3
Category_Wikipedia_sockpuppets_of_Hq2130_brother.csv,141,3353782.0,113,28,38,75,0,39.00709219858156,240,22,11.212765957446809,8
Category_Wikipedia_sockpuppets_of_Thefrontdoor.csv,33,956165.0,15,18,5,10,0,32.45454545454545,153,20,14.393939393939394,11
Category_Wikipedia_sockpuppets_of_Jefcostello.csv,52,109759.0,28,24,18,10,0,31.173076923076923,104,36,21.23076923076923,16
Category_Wikipedia_sockpuppets_of_Bananasasas.csv,323,16059613.0,138,185,72,66,0,96.41795665634675,498,66,23.393188854489164,6
Category_Wikipedia_sockpuppets_of_NickystheThicky.csv,123,1541984.0,40,83,28,12,0,50.56910569105691,329,53,21.398373983739837,10
Category_Wikipedia_sockpuppets_of_Inetcafebooth6.csv,656,46537227.0,240,416,229,11,0,58.61280487804878,244,58,30.04420731707317,4
Category_Wikipedia_sockpuppets_of_GeorgiaRancid.csv,18,661.0,8,10,5,3,0,76.5,230,28,20.555555555555557,5
Category_Wikipedia_sockpuppets_of_MegaCyanide666.csv,1888,23073199.0,677,1211,495,182,0,35.27489406779661,250,49,20.341631355932204,3
Category_Wikipedia_sockpuppets_of_SaulSJ.csv,613,25999472.0,135,478,70,65,0,56.451876019575856,313,67,15.64437194127243,4
Category_Wikipedia_sockpuppets_of_HockeyHistorian.csv,148,16299220.0,45,103,38,7,0,28.824324324324323,145,57,23.445945945945947,5
Category_Wikipedia_sockpuppets_of_Dashingfiona1231.csv,16,1387705.0,6,10,4,2,15,46.0625,128,47,23.5,12
Category_Wikipedia_sockpuppets_of_Tiramisoo.csv,2615,93951913.0,599,2016,370,229,0,45.14263862332696,250,60,16.049713193116634,3
Category_Wikipedia_sockpuppets_of_Legolover6969.csv,371,11055733.0,117,254,18,99,0,48.75202156334232,235,88,25.959568733153638,12
Category_Wikipedia_sockpuppets_of_Drankcarat.csv,162,2503986.0,68,94,31,37,0,82.08024691358025,495,55,26.925925925925927,14
Category_Wikipedia_sockpuppets_of_KingofFilm.csv,546,27281132.0,168,378,151,17,0,41.50732600732601,228,61,20.97252747252747,3
Category_Wikipedia_sockpuppets_of_IPN23.csv,534,71928916.0,171,363,101,70,0,45.848314606741575,490,53,18.312734082397004,7
Category_Wikipedia_sockpuppets_of_Television_station_logos.csv,377,6539990.0,137,240,130,7,0,39.6631299734748,403,38,9.644562334217506,3
Category_Wikipedia_sockpuppets_of_Tangotopaz.csv,1450,9980366.0,553,897,500,53,0,43.609655172413795,255,59,26.570344827586208,14
Category_Wikipedia_sockpuppets_of_Patsietan.csv,62,205825567.0,19,43,11,8,0,38.11290322580645,199,14,12.370967741935484,3
Category_Wikipedia_sockpuppets_of_Pranay99patil.csv,596,7440209.0,160,436,9,151,0,66.76677852348993,255,38,13.689597315436242,4
Category_Wikipedia_sockpuppets_of_Waskerton.csv,9515,173376888.0,2961,6554,500,2461,0,59.382448765107725,500,128,26.69721492380452,2
Category_Wikipedia_sockpuppets_of_Chienyichu1221.csv,36,3453673.0,17,19,17,0,0,22.02777777777778,148,24,21.22222222222222,19
Category_Wikipedia_sockpuppets_of_Physik.csv,1500,6658988.0,500,1000,500,0,0,25.316,209,62,18.628,4
Category_Wikipedia_sockpuppets_of_David_Julius_Arogula.csv,77,3429654.0,24,53,11,13,0,58.81818181818182,247,50,15.220779220779221,7
Category_Wikipedia_sockpuppets_of_ValarianB.csv,3878,208618493.0,1000,2878,500,500,0,65.45074780814853,416,92,24.39272821041774,3
Category_Wikipedia_sockpuppets_of_AliRasoulLTD.csv,11,1345552.0,6,5,5,1,0,25.181818181818183,91,47,24.636363636363637,7
Category_Wikipedia_sockpuppets_of_Kay_Uwe_B√∂hm.csv,463,5099699.0,180,283,180,0,0,40.45788336933045,233,35,21.019438444924408,11
Category_Wikipedia_sockpuppets_of_ProudIrishAspie.csv,8439,54386612.0,2197,6242,500,1697,0,40.765375044436546,255,75,20.419243986254294,2
Category_Wikipedia_sockpuppets_of_Asdfg12345678.csv,66,670114.0,42,24,36,6,0,24.984848484848484,156,47,27.40909090909091,11
Category_Wikipedia_sockpuppets_of_Saleh_Gadau.csv,7,361130.0,3,4,3,0,0,30.857142857142858,95,19,16.428571428571427,13
Category_Wikipedia_sockpuppets_of_Hjonbenjamin178.csv,470,5223815.0,168,302,97,71,0,36.93829787234043,350,49,31.48723404255319,9
Category_Wikipedia_sockpuppets_of_Collins_wisdom.csv,37,5002361.0,10,27,3,7,0,54.5945945945946,196,41,28.864864864864863,7
Category_Wikipedia_sockpuppets_of_Sonphan1.csv,292,41222923.0,87,205,19,68,0,61.715753424657535,254,40,17.921232876712327,10
Category_Wikipedia_sockpuppets_of_StarcreativesTV.csv,26,304793.0,8,18,4,4,0,14.076923076923077,155,31,16.73076923076923,14
Category_Wikipedia_sockpuppets_of_Dodgechris.csv,8903,103103231.0,3525,5378,500,3025,0,31.56823542626081,259,93,24.8871167022352,4
Category_Wikipedia_sockpuppets_of_Udimu.csv,1370,446722267.0,552,818,500,52,0,57.806569343065696,496,56,15.216058394160584,4
Category_Wikipedia_sockpuppets_of_Beehonsect.csv,716,134567961.0,186,530,66,120,0,46.624301675977655,315,29,14.494413407821229,5
Category_Wikipedia_sockpuppets_of_Ifni95.csv,360,369714098.0,81,279,38,43,0,49.57222222222222,442,32,15.558333333333334,4
Category_Wikipedia_sockpuppets_of_Productions_music.csv,13,2686249.0,3,10,3,0,0,49.61538461538461,137,27,20.23076923076923,12
Category_Wikipedia_sockpuppets_of_Kkm010.csv,21606,339975129.0,4884,16722,500,4384,0,49.47264648708692,500,70,17.40821993890586,1
Category_Wikipedia_sockpuppets_of_Blocci.csv,2177,375514862.0,618,1559,500,118,0,42.16031235645384,283,61,24.569131832797428,4
Category_Wikipedia_sockpuppets_of_SillaJen.csv,26,8209758.0,12,14,6,6,0,33.84615384615385,183,38,25.923076923076923,8
Category_Wikipedia_sockpuppets_of_DarwinandBrianEdits.csv,2392,107221119.0,750,1642,179,571,0,43.02759197324415,406,73,17.07608695652174,3
Category_Wikipedia_sockpuppets_of_Berendale1.csv,81,1305934.0,22,59,22,0,0,43.95061728395062,184,26,11.654320987654321,3
Category_Wikipedia_sockpuppets_of_Marcus_lyon.csv,124,29653504.0,25,99,9,16,0,56.685483870967744,237,37,16.306451612903224,4
Category_Wikipedia_sockpuppets_of_Breye7x.csv,274,146870598.0,103,171,69,34,0,43.54014598540146,255,57,18.48175182481752,7
Category_Wikipedia_sockpuppets_of_Nawab_Faisal_Nafees_Khan.csv,75,5816141.0,27,48,24,3,0,57.29333333333334,255,81,32.28,16
Category_Wikipedia_sockpuppets_of_Musicfanlondon.csv,270,151240202.0,108,162,98,10,0,49.96296296296296,224,55,20.455555555555556,6
Category_Wikipedia_sockpuppets_of_Halcyon2017.csv,18,11062805.0,14,4,10,4,0,44.72222222222222,196,22,19.333333333333332,10
Category_Wikipedia_sockpuppets_of_Travelradars.csv,174,1177483.0,57,117,44,13,0,61.0,302,49,21.304597701149426,4
Category_Wikipedia_sockpuppets_of_Facttime00.csv,25,380272.0,15,10,6,9,0,56.08,159,14,12.72,11
Category_Wikipedia_sockpuppets_of_Jobas.csv,11054,210595720.0,2792,8262,500,2292,0,49.916772209155056,500,82,17.64003980459562,3
Category_Wikipedia_sockpuppets_of_Supermansaga.csv,384,53367771.0,146,238,123,23,0,37.231770833333336,254,61,18.372395833333332,6
Category_Wikipedia_sockpuppets_of_Chaq3232.csv,19,262519.0,10,9,10,0,0,50.8421052631579,187,49,23.736842105263158,15
Category_Wikipedia_sockpuppets_of_Trueblood786.csv,1383,109782514.0,557,826,500,57,0,40.11713665943601,243,71,19.370932754880695,4
Category_Wikipedia_sockpuppets_of_Sports_Fan_1997.csv,2085,55856018.0,720,1365,500,220,0,45.4757793764988,440,58,28.69208633093525,8
Category_Wikipedia_sockpuppets_of_BlueLankan.csv,1992,65263578.0,787,1205,500,287,0,31.34538152610442,250,57,21.628012048192772,3
Category_Wikipedia_sockpuppets_of_Migueldbravo.csv,140,2515049.0,69,71,65,4,0,49.41428571428571,255,47,28.12857142857143,11
Category_Wikipedia_sockpuppets_of_NisarKand.csv,17913,104962198.0,5929,11984,500,5429,0,37.082844861273934,261,58,16.479316697370624,4
Category_Wikipedia_sockpuppets_of_Vimla_vinod_singh.csv,222,994820.0,97,125,23,74,0,35.770270270270274,310,27,16.45045045045045,6
Category_Wikipedia_sockpuppets_of_Rjbronn.csv,186,1324287.0,69,117,58,11,0,39.97849462365591,200,37,17.086021505376344,5
Category_Wikipedia_sockpuppets_of_A_flumine_usque_ad_mare.csv,140,1125733.0,47,93,26,21,0,44.93571428571428,291,33,13.342857142857143,2
Category_Wikipedia_sockpuppets_of_Tigertibs.csv,26,216048498.0,9,17,5,4,0,39.92307692307692,221,46,28.653846153846153,16
Category_Wikipedia_sockpuppets_of_Panairjdde.csv,20415,293930280.0,5254,15161,500,4754,0,37.11809943668871,255,90,19.34450159196669,3
Category_Wikipedia_sockpuppets_of_Prince.aliabbas.csv,1372,64792138.0,500,872,323,177,0,37.25072886297376,255,42,18.23615160349854,3
Category_Wikipedia_sockpuppets_of_Officialdez.csv,255,54303625.0,71,184,66,5,0,42.89019607843137,320,44,17.870588235294118,9
Category_Wikipedia_sockpuppets_of_Satsdaily.csv,33,12065.0,18,15,18,0,19,50.484848484848484,194,20,12.363636363636363,11
Category_Wikipedia_sockpuppets_of_I'm_On_Base.csv,2008,176382151.0,748,1260,378,370,0,34.383466135458164,247,70,22.720617529880478,6
Category_Wikipedia_sockpuppets_of_FrancoIacomella.csv,215,404982590.0,56,159,43,13,0,47.72558139534884,287,45,20.748837209302327,6
Category_Wikipedia_sockpuppets_of_Twenty5degrees.csv,17,19445.0,6,11,3,3,7,89.23529411764706,276,21,16.941176470588236,7
Category_Wikipedia_sockpuppets_of_AynuraJafarova.csv,312,6821228.0,113,199,74,39,0,35.21153846153846,169,50,23.57371794871795,15
Category_Wikipedia_sockpuppets_of_Prashantv79.csv,215,72914.0,119,96,91,28,0,39.04186046511628,194,55,23.21395348837209,10
Category_Wikipedia_sockpuppets_of_Itallian_With_A_Two-Way_Radio.csv,73,18234395.0,18,55,6,12,0,35.71232876712329,148,39,37.75342465753425,32
Category_Wikipedia_sockpuppets_of_Enfeksiyonizm.csv,12,763.0,6,6,1,5,0,56.0,198,22,22.0,22
Category_Wikipedia_sockpuppets_of_Franklin482.csv,655,13349840.0,222,433,194,28,0,41.82442748091603,271,42,22.209160305343513,4
Category_Wikipedia_sockpuppets_of_Irving1110.csv,409,266786021.0,151,258,32,119,0,59.349633251833744,323,39,21.31051344743276,10
Category_Wikipedia_sockpuppets_of_Ahoalton.csv,122,13009670.0,45,77,27,18,0,42.704918032786885,199,61,29.18032786885246,18
Category_Wikipedia_sockpuppets_of_RJ_CG.csv,2806,24897659.0,893,1913,500,393,0,44.683178902352104,254,72,20.13863150392017,3
Category_Wikipedia_sockpuppets_of_Herblouise945.csv,1844,5818647.0,622,1222,500,122,0,36.68329718004338,255,69,19.70119305856833,7
Category_Wikipedia_sockpuppets_of_Papyrus_cyrus.csv,72,2844627.0,28,44,26,2,0,59.56944444444444,500,25,16.805555555555557,5
Category_Wikipedia_sockpuppets_of_Tobytobias.csv,74,12427850.0,31,43,16,15,0,50.04054054054054,236,60,16.094594594594593,4
Category_Wikipedia_sockpuppets_of_Farhad2010.csv,208,65189638.0,74,134,36,38,0,34.72596153846154,212,45,21.048076923076923,6
Category_Wikipedia_sockpuppets_of_Wwwwwwwwhatsup.csv,7,2413.0,4,3,2,2,0,110.85714285714286,199,23,18.714285714285715,14
Category_Wikipedia_sockpuppets_of_Veramack95.csv,444,22348275.0,103,341,19,84,0,54.75675675675676,320,41,20.153153153153152,7
Category_Wikipedia_sockpuppets_of_BarelyEphemeral.csv,87,3433871.0,34,53,28,6,0,68.04597701149426,249,50,24.620689655172413,11
Category_Wikipedia_sockpuppets_of_FabulosWorld.csv,283,2245702.0,111,172,55,56,0,45.75265017667844,222,44,19.731448763250885,8
Category_Wikipedia_sockpuppets_of_Justanotherwikipediauser.csv,116,4360912.0,40,76,34,6,0,40.38793103448276,316,34,16.31896551724138,5
Category_Wikipedia_sockpuppets_of_Chandan_Tara.csv,656,775488.0,194,462,109,85,0,42.33841463414634,451,47,15.387195121951219,2
Category_Wikipedia_sockpuppets_of_Federstift.csv,51,994610.0,23,28,12,11,0,46.627450980392155,217,59,19.84313725490196,6
Category_Wikipedia_sockpuppets_of_Edill_flores.csv,563,22077280.0,235,328,206,29,0,30.758436944937834,267,37,7.859680284191829,4
Category_Wikipedia_sockpuppets_of_Whitelight77.csv,155,159471491.0,110,45,65,45,0,22.032258064516128,182,45,17.238709677419354,13
Category_Wikipedia_sockpuppets_of_Kamen_rider_saber.csv,2617,54098556.0,637,1980,500,137,0,76.5475735575086,460,66,17.199847153228887,2
Category_Wikipedia_sockpuppets_of_J23dreamer.csv,282,120825124.0,103,179,75,28,0,43.50354609929078,255,58,16.088652482269502,4
Category_Wikipedia_sockpuppets_of_Wanghuibin.csv,55,37421017.0,21,34,13,8,0,47.654545454545456,235,45,17.054545454545455,4
Category_Wikipedia_sockpuppets_of_Amorrow.csv,9880,101855153.0,3193,6687,500,2693,0,36.06548582995951,255,116,18.088663967611335,2
Category_Wikipedia_sockpuppets_of_Kurdmax_show.csv,87,1630607.0,32,55,30,2,0,51.14942528735632,223,27,16.35632183908046,8
Category_Wikipedia_sockpuppets_of_Asax547.csv,153,2567760.0,53,100,44,9,0,75.83660130718954,500,37,20.352941176470587,5
Category_Wikipedia_sockpuppets_of_Bmwnick2.csv,1156,39072114.0,285,871,225,60,0,48.09515570934256,255,51,17.35467128027682,3
Category_Wikipedia_sockpuppets_of_Dominatingpals.csv,1,0.0,1,0,1,0,0,0.0,0,23,23.0,23
Category_Wikipedia_sockpuppets_of_Marcoa1000.csv,51,8923297.0,25,26,5,20,0,40.76470588235294,194,25,19.058823529411764,14
Category_Wikipedia_sockpuppets_of_Newbie57.csv,14,1343.0,8,6,2,6,19,51.142857142857146,215,29,20.071428571428573,11
Category_Wikipedia_sockpuppets_of_Metalist310.csv,109,354003.0,27,82,27,0,0,42.04587155963303,221,27,17.577981651376145,6
Category_Wikipedia_sockpuppets_of_Mziboy.csv,334,28975826.0,116,218,115,1,0,48.865269461077844,243,79,34.203592814371255,12
Category_Wikipedia_sockpuppets_of_Akchaudhuri.csv,82,117530578.0,22,60,15,7,0,43.46341463414634,204,53,19.365853658536587,7
Category_Wikipedia_sockpuppets_of_Johnny_the_Vandal.csv,619,105018142.0,161,458,13,148,0,44.59612277867528,234,57,16.17447495961228,5
Category_Wikipedia_sockpuppets_of_EducationThruLists.csv,999,9080493.0,327,672,205,122,0,46.926926926926924,289,63,26.64964964964965,5
Category_Wikipedia_sockpuppets_of_Yadavji2003.csv,86,7472843.0,28,58,25,3,0,51.08139534883721,346,26,13.5,6
Category_Wikipedia_sockpuppets_of_Mishi_dar.csv,2241,51145140.0,616,1625,500,116,0,44.95760821062026,512,60,19.972780008924587,5
Category_Wikipedia_sockpuppets_of_Lord_of_Fantasy.csv,1500,77039244.0,521,979,500,21,0,53.06666666666667,496,67,21.105333333333334,5
Category_Wikipedia_sockpuppets_of_Leckhure_Omam√∂senlecker.csv,15,723368.0,9,6,7,2,0,49.93333333333333,163,33,20.533333333333335,16
Category_Wikipedia_sockpuppets_of_Joewendt.csv,429,199062192.0,143,286,105,38,0,58.68531468531469,479,92,35.52913752913753,11
Category_Wikipedia_sockpuppets_of_Technical_13.csv,3213,3179552.0,1000,2213,500,500,0,79.8708372237784,255,76,19.70899470899471,4
Category_Wikipedia_sockpuppets_of_Hkbusfan.csv,1803,51906161.0,543,1260,500,43,0,52.18968386023295,454,62,16.519689406544646,1
Category_Wikipedia_sockpuppets_of_Mypassis1234.csv,53,1645.0,18,35,17,1,0,76.49056603773585,231,8,4.566037735849057,2
Category_Wikipedia_sockpuppets_of_Wikimakerforartist.csv,22,82578.0,9,13,6,3,0,52.86363636363637,252,68,42.72727272727273,23
Category_Wikipedia_sockpuppets_of_Br4011.csv,2455,23677435.0,1039,1416,500,539,0,25.467617107942974,262,55,12.824032586558046,5
Category_Wikipedia_sockpuppets_of_LjevyJ.csv,18,3369482.0,4,14,3,1,0,74.55555555555556,245,24,15.944444444444445,9
Category_Wikipedia_sockpuppets_of_Aleksig6.csv,645,201114365.0,174,471,168,6,0,63.93953488372093,244,47,17.545736434108527,5
Category_Wikipedia_sockpuppets_of_Gjokokostoski.csv,19,5010.0,6,13,5,1,0,61.73684210526316,152,26,16.68421052631579,5
Category_Wikipedia_sockpuppets_of_Guitarrock165.csv,103,7868178.0,69,34,65,4,0,22.893203883495147,128,44,23.12621359223301,13
Category_Wikipedia_sockpuppets_of_Amjad_z4.csv,297,379989960.0,85,212,81,4,0,40.033670033670035,224,50,35.04040404040404,6
Category_Wikipedia_sockpuppets_of_Sagehosm.csv,12,10054.0,6,6,3,3,0,37.166666666666664,131,53,29.0,16
Category_Wikipedia_sockpuppets_of_Galaxywriting.csv,48,368175.0,19,29,19,0,10,56.729166666666664,206,29,22.375,10
Category_Wikipedia_sockpuppets_of_Lttakeus.csv,13,102125716.0,5,8,3,2,0,47.76923076923077,143,23,21.076923076923077,18
Category_Wikipedia_sockpuppets_of_Fredyfchin.csv,48,392210.0,22,26,13,9,0,54.104166666666664,196,47,25.291666666666668,7
Category_Wikipedia_sockpuppets_of_Recoveryinamerica.csv,5,2426.0,2,3,2,0,19,36.4,57,47,47.0,47
Category_Wikipedia_sockpuppets_of_Jrdyhrberg.csv,79,96901585.0,36,43,21,15,0,42.20253164556962,236,41,20.227848101265824,14
Category_Wikipedia_sockpuppets_of_Laborious.csv,96,6152132.0,22,74,13,9,0,33.708333333333336,199,32,18.697916666666668,11
Category_Wikipedia_sockpuppets_of_Lane89mr.csv,42,385917.0,21,21,16,5,0,39.666666666666664,183,45,18.952380952380953,7
Category_Wikipedia_sockpuppets_of_Mesereauyu.csv,43,6588936.0,24,19,10,14,0,26.813953488372093,149,24,17.511627906976745,15
Category_Wikipedia_sockpuppets_of_Wonderfool.csv,12111,432124335.0,3200,8911,500,2700,0,45.2724795640327,376,87,22.842622409379903,2
Category_Wikipedia_sockpuppets_of_Rajuditchopra.csv,23,16934264.0,7,16,6,1,0,29.130434782608695,135,44,28.043478260869566,15
Category_Wikipedia_sockpuppets_of_Bhushan_m_bhandari.csv,2503,25314791.0,973,1530,500,473,0,24.402716739912105,376,38,16.60047942469037,5
Category_Wikipedia_sockpuppets_of_Cl√°udio_C√©sar_Dias_Baptista.csv,216,2962595.0,59,157,29,30,0,37.81018518518518,184,59,37.226851851851855,8
Category_Wikipedia_sockpuppets_of_Demoreasimpson16.csv,2099,29132689.0,905,1194,500,405,0,26.634111481657932,253,56,6.621248213434969,4
Category_Wikipedia_sockpuppets_of_Jinah3948.csv,321,6839176.0,74,247,33,41,0,43.51090342679128,226,43,21.68847352024922,8
Category_Wikipedia_sockpuppets_of_Keosamnangkh9999.csv,10,50106145.0,4,6,2,2,0,52.6,139,38,30.0,16
Category_Wikipedia_sockpuppets_of_CrybabiesAfoot.csv,125,4127929.0,46,79,28,18,0,55.792,496,47,20.624,6
Category_Wikipedia_sockpuppets_of_Ishakkaihatu.csv,1150,8654797.0,571,579,500,71,0,36.64086956521739,339,56,25.29826086956522,8
Category_Wikipedia_sockpuppets_of_Drishti2021.csv,1055,54452588.0,313,742,132,181,0,68.87014218009479,379,47,12.048341232227488,4
Category_Wikipedia_sockpuppets_of_Mr.Tin_Myanmar.csv,344,19188682.0,195,149,194,1,0,25.712209302325583,322,81,31.156976744186046,15
Category_Wikipedia_sockpuppets_of_LumCel.csv,177,217977003.0,51,126,26,25,0,54.7909604519774,231,43,18.587570621468927,10
Category_Wikipedia_sockpuppets_of_Charlesbronsonyes.csv,29,1581.0,11,18,10,1,0,36.51724137931034,212,34,15.172413793103448,9
Category_Wikipedia_sockpuppets_of_Biggfann.csv,1,0.0,1,0,1,0,7,7.0,7,28,28.0,28
Category_Wikipedia_sockpuppets_of_Antiserb.csv,48,844468.0,21,27,15,6,0,80.70833333333333,452,18,11.395833333333334,8
Category_Wikipedia_sockpuppets_of_Cabbe123.csv,4,368.0,3,1,3,0,0,34.5,138,9,9.0,9
Category_Wikipedia_sockpuppets_of_Coorslite.csv,3,1085.0,2,1,2,0,15,29.0,53,17,16.333333333333332,15
Category_Wikipedia_sockpuppets_of_Bobuxian.csv,43,16337904.0,17,26,9,8,0,54.27906976744186,258,26,19.302325581395348,18
Category_Wikipedia_sockpuppets_of_LevilRowe.csv,198,19433622.0,63,135,31,32,0,53.888888888888886,246,54,21.6010101010101,7
Category_Wikipedia_sockpuppets_of_Disco_Steven_Lua.csv,593,134728027.0,204,389,63,141,0,29.72849915682968,217,51,17.647554806070826,6
Category_Wikipedia_sockpuppets_of_Wenger256.csv,159,5173846.0,112,47,111,1,0,21.60377358490566,199,29,16.628930817610062,13
Category_Wikipedia_sockpuppets_of_Krakhesh.csv,902,396186729.0,338,564,173,165,0,47.787139689578716,496,62,21.014412416851442,4
Category_Wikipedia_sockpuppets_of_Soniahansen22.csv,2,196.0,2,0,2,0,0,98.0,196,18,18.0,18
Category_Wikipedia_sockpuppets_of_Cangbush.csv,621,11326245.0,286,335,189,97,0,22.486312399355878,204,84,27.85185185185185,9
Category_Wikipedia_sockpuppets_of_JewishPride6.csv,2746,21907472.0,956,1790,463,493,0,38.594319009468315,255,59,25.997086671522215,5
Category_Wikipedia_sockpuppets_of_Kennedy_&_Co..csv,192,954351.0,59,133,43,16,0,38.036458333333336,197,46,15.932291666666666,7
Category_Wikipedia_sockpuppets_of_Lachskai.csv,3322,46129064.0,1135,2187,226,909,0,45.855207706201085,500,53,17.154425045153523,1
Category_Wikipedia_sockpuppets_of_Feats-O-Strength.csv,1395,256892530.0,426,969,375,51,0,47.168458781362006,254,61,17.078853046594983,4
Category_Wikipedia_sockpuppets_of_Bobicerox1356.csv,18,91491972.0,6,12,6,0,0,24.166666666666668,169,13,8.666666666666666,5
Category_Wikipedia_sockpuppets_of_OLoveofYash.csv,61,886.0,20,41,12,8,0,52.442622950819676,237,61,21.049180327868854,9
Category_Wikipedia_sockpuppets_of_Kiwisleep.csv,17,2220240.0,14,3,12,2,0,28.88235294117647,156,30,23.529411764705884,19
Category_Wikipedia_sockpuppets_of_ÂÜè.csv,1010,296214402.0,301,709,255,46,0,53.3990099009901,488,42,14.75049504950495,2
Category_Wikipedia_sockpuppets_of_Rllymark.csv,15,4153.0,13,2,9,4,13,42.46666666666667,166,9,9.0,9
Category_Wikipedia_sockpuppets_of_Sievert_81.csv,1994,15395766.0,526,1468,434,92,0,78.4924774322969,498,68,20.665496489468406,2
Category_Wikipedia_sockpuppets_of_Caillou_Pettis.csv,1957,113666676.0,562,1395,393,169,0,37.00613183444047,395,79,20.20337250894226,4
Category_Wikipedia_sockpuppets_of_Finladikpo.csv,57,955549.0,57,0,21,36,0,25.614035087719298,196,22,10.912280701754385,6
Category_Wikipedia_sockpuppets_of_Dodo19.csv,6721,111799635.0,2102,4619,500,1602,0,57.88097009373605,250,92,21.938550810891236,5
Category_Wikipedia_sockpuppets_of_Radyanskysoldativ.csv,1935,67773119.0,463,1472,343,120,0,51.676485788113695,255,59,17.4640826873385,4
Category_Wikipedia_sockpuppets_of_Writers_Without_Margins.csv,2,0.0,1,1,1,0,36,36.0,36,33,33.0,33
Category_Wikipedia_sockpuppets_of_Eyeradio_Government.csv,188,885536.0,112,76,41,71,0,55.12234042553192,196,32,28.148936170212767,23
Category_Wikipedia_sockpuppets_of_Lildude32.csv,10,87991.0,8,2,6,2,16,55.7,217,22,18.4,18
Category_Wikipedia_sockpuppets_of_Vishwaknri.csv,395,77506035.0,134,261,58,76,0,46.35443037974684,291,35,19.746835443037973,7
Category_Wikipedia_sockpuppets_of_Jose_Enes.csv,61,43309256.0,33,28,23,10,0,65.73770491803279,254,24,19.229508196721312,18
Category_Wikipedia_sockpuppets_of_Seeit12.csv,390,86574985.0,78,312,17,61,0,40.53333333333333,215,34,11.302564102564103,4
Category_Wikipedia_sockpuppets_of_Tylerkermit.csv,374,35837013.0,98,276,85,13,0,56.975935828877006,255,46,15.524064171122994,3
Category_Wikipedia_sockpuppets_of_Totallyepicgamer.csv,134,4323198.0,52,82,48,4,0,55.04477611940298,217,46,21.604477611940297,5
Category_Wikipedia_sockpuppets_of_Abhisingla87.csv,755,322603944.0,213,542,198,15,0,45.01456953642384,346,34,14.920529801324504,2
Category_Wikipedia_sockpuppets_of_Eeewww1.csv,541,7684175.0,219,322,164,55,0,29.743068391866913,214,49,19.01109057301294,8
Category_Wikipedia_sockpuppets_of_74.211.84.233.csv,117,16740896.0,39,78,29,10,0,50.17094017094017,199,28,19.752136752136753,4
Category_Wikipedia_sockpuppets_of_JohnOCornSucks.csv,118,127973.0,70,48,70,0,0,31.296610169491526,200,48,22.45762711864407,9
Category_Wikipedia_sockpuppets_of_H25.csv,12,367454641.0,3,9,3,0,0,35.5,108,25,22.25,22
Category_Wikipedia_sockpuppets_of_Nindia24.csv,101,11590067.0,28,73,15,13,0,63.35643564356435,272,27,12.990099009900991,4
Category_Wikipedia_sockpuppets_of_PoulstonJordan.csv,252,8346578.0,84,168,21,63,0,51.535714285714285,251,48,16.400793650793652,5
Category_Wikipedia_sockpuppets_of_ReginaA.csv,40,415348.0,27,13,8,19,0,24.05,128,44,44.0,44
Category_Wikipedia_sockpuppets_of_Andrew.h.chen.csv,9,2651426.0,2,7,2,0,0,35.55555555555556,93,25,24.666666666666668,24
Category_Wikipedia_sockpuppets_of_Abdur9470.csv,70,27376364.0,32,38,20,12,0,54.55714285714286,471,29,18.571428571428573,12
Category_Wikipedia_sockpuppets_of_Zimmermanh1997.csv,78,59097909.0,37,41,35,2,0,30.935897435897434,225,9,4.384615384615385,4
Category_Wikipedia_sockpuppets_of_Cornelis_Dopper.csv,583,41584935.0,188,395,109,79,0,50.21097770154374,320,54,29.029159519725557,9
Category_Wikipedia_sockpuppets_of_Neutralhomer.csv,3172,539471951.0,1102,2070,500,602,0,40.97730138713745,496,70,15.474779319041614,3
Category_Wikipedia_sockpuppets_of_Spaz-o-pedia.csv,97,231115603.0,32,65,11,21,0,48.65979381443299,229,24,12.587628865979381,4
Category_Wikipedia_sockpuppets_of_ExtonTheWhole.csv,132,3563812.0,28,104,16,12,0,49.96969696969697,511,29,17.257575757575758,13
Category_Wikipedia_sockpuppets_of_Finspond.csv,12,46995660.0,4,8,3,1,0,48.666666666666664,151,21,17.0,5
Category_Wikipedia_sockpuppets_of_MetaphorEnt.csv,245,42765055.0,83,162,64,19,0,39.78367346938776,231,47,31.53061224489796,11
Category_Wikipedia_sockpuppets_of_Radis_sitmu_chho.csv,8,2853702.0,5,3,3,2,0,40.5,114,7,7.0,7
Category_Wikipedia_sockpuppets_of_Johnmichaelfitzpatrick.csv,1915,12222757.0,383,1532,295,88,0,35.49138381201045,250,59,20.463707571801567,4
Category_Wikipedia_sockpuppets_of_Jordanhenrie.csv,170,72936399.0,45,125,35,10,0,65.81176470588235,288,30,13.205882352941176,5
Category_Wikipedia_sockpuppets_of_Asparagu.csv,20,46419398.0,9,11,6,3,0,41.25,141,10,10.0,10
Category_Wikipedia_sockpuppets_of_Bobby_Jerry.csv,153,1033250.0,42,111,10,32,0,55.04575163398693,307,34,14.4640522875817,5
Category_Wikipedia_sockpuppets_of_Jcullinan.csv,218,870295.0,105,113,36,69,0,43.642201834862384,255,48,31.34862385321101,11
Category_Wikipedia_sockpuppets_of_Ethan_C.csv,220,217419.0,73,147,51,22,0,28.71818181818182,199,19,12.213636363636363,10
Category_Wikipedia_sockpuppets_of_MySonLikesTrump.csv,291,32418498.0,94,197,92,2,0,52.06185567010309,306,66,22.463917525773194,8
Category_Wikipedia_sockpuppets_of_Kbarrettart.csv,42,2858220.0,33,9,24,9,0,47.38095238095238,340,21,14.571428571428571,9
Category_Wikipedia_sockpuppets_of_Gage.parrott.csv,104,271341.0,51,53,26,25,0,27.0,196,33,22.634615384615383,8
Category_Wikipedia_sockpuppets_of_Tfisher112.csv,29,12388679.0,10,19,6,4,0,33.03448275862069,208,13,13.0,13
Category_Wikipedia_sockpuppets_of_Tryst_IITD.csv,16,27152.0,7,9,7,0,0,32.125,77,53,39.875,23
Category_Wikipedia_sockpuppets_of_Cancer322.csv,65,358124.0,18,47,12,6,0,79.26153846153846,254,50,26.26153846153846,5
Category_Wikipedia_sockpuppets_of_Obinovincent.csv,6,1969.0,6,0,6,0,0,4.333333333333333,17,17,17.0,17
Category_Wikipedia_sockpuppets_of_MariaGioTV.csv,6,3351.0,3,3,2,1,0,27.5,68,44,44.0,44
Category_Wikipedia_sockpuppets_of_Aditya_n06.csv,76,55681004.0,26,50,21,5,0,37.39473684210526,203,61,20.263157894736842,10
Category_Wikipedia_sockpuppets_of_Go_leafs_go_3000.csv,2086,112056964.0,571,1515,500,71,0,62.65484180249281,251,60,21.169702780441035,2
Category_Wikipedia_sockpuppets_of_EvaDiva1234567.csv,1,0.0,1,0,1,0,15,15.0,15,5,5.0,5
Category_Wikipedia_sockpuppets_of_Daekro1.csv,383,21948562.0,169,214,123,46,0,40.532637075718014,351,66,30.357702349869452,17
Category_Wikipedia_sockpuppets_of_PositiVethinkerr.csv,1,0.0,1,0,1,0,0,0.0,0,19,19.0,19
Category_Wikipedia_sockpuppets_of_YethuIsMyName.csv,1143,72154445.0,677,466,436,241,0,30.321084864391953,274,71,17.11461067366579,6
Category_Wikipedia_sockpuppets_of_Burntsauce.csv,1765,5823966.0,503,1262,500,3,0,54.46912181303116,247,96,20.622662889518413,4
Category_Wikipedia_sockpuppets_of_Jpstar10.csv,21,1574625.0,13,8,5,8,0,23.238095238095237,60,35,19.38095238095238,14
Category_Wikipedia_sockpuppets_of_Baloon0808.csv,1,0.0,1,0,1,0,39,39.0,39,18,18.0,18
Category_Wikipedia_sockpuppets_of_Mainemainer.csv,115,5839285.0,37,78,21,16,0,38.55652173913043,198,54,33.91304347826087,14
Category_Wikipedia_sockpuppets_of_Hardikjoshi22887.csv,208,50144831.0,124,84,107,17,0,28.70673076923077,255,44,15.533653846153847,12
Category_Wikipedia_sockpuppets_of_Pavan_actor_TV_industry_pavan_acharya.csv,14,75045.0,5,9,5,0,0,43.214285714285715,123,21,20.285714285714285,19
Category_Wikipedia_sockpuppets_of_Carmendi.csv,267,10894477.0,101,166,7,94,0,77.8314606741573,230,19,11.273408239700375,5
Category_Wikipedia_sockpuppets_of_Mitchell_Henderson.csv,41,12976384.0,14,27,14,0,0,29.24390243902439,177,25,12.804878048780488,9
Category_Wikipedia_sockpuppets_of_Milesaway0.csv,85,10192251.0,57,28,55,2,0,69.14117647058823,408,24,16.71764705882353,12
Category_Wikipedia_sockpuppets_of_SamRenBotch.csv,6,2126.0,5,1,5,0,0,5.333333333333333,32,6,5.333333333333333,5
Category_Wikipedia_sockpuppets_of_Nomad3919.csv,835,102195917.0,248,587,226,22,0,38.90419161676647,294,46,24.450299401197604,8
Category_Wikipedia_sockpuppets_of_Oneilm542.csv,59,17256583.0,24,35,14,10,0,41.13559322033898,222,33,13.220338983050848,10
Category_Wikipedia_sockpuppets_of_Burrburr.csv,4258,23670323.0,1085,3173,160,925,0,39.130577736026304,222,63,16.971817754814467,3
Category_Wikipedia_sockpuppets_of_Etcetraz.csv,1,0.0,1,0,1,0,22,22.0,22,6,6.0,6
Category_Wikipedia_sockpuppets_of_Saivyam.csv,63,4163164.0,24,39,15,9,0,39.76190476190476,204,24,16.19047619047619,7
Category_Wikipedia_sockpuppets_of_Dipu2093.csv,850,3386076.0,290,560,179,111,0,39.24823529411765,268,61,16.834117647058825,5
Category_Wikipedia_sockpuppets_of_Merlingoth88.csv,23,1882714.0,6,17,6,0,10,51.130434782608695,100,48,38.21739130434783,22
Category_Wikipedia_sockpuppets_of_HollywoodREDIRECTOR.csv,1911,8266043.0,558,1353,476,82,0,51.8749345892203,500,50,18.418628990057563,3
"Category_Wikipedia_sockpuppets_of_Joe_Smythe,_AAAA,_MAAAA.csv",249,17296523.0,81,168,80,1,0,33.24497991967871,193,50,29.285140562248998,11
Category_Wikipedia_sockpuppets_of_Aceuswa.csv,89,1461368.0,49,40,47,2,0,65.88764044943821,306,43,27.651685393258425,10
Category_Wikipedia_sockpuppets_of_Bikram_L_malati.csv,107,95233203.0,33,74,17,16,0,46.467289719626166,188,58,22.1588785046729,10
Category_Wikipedia_sockpuppets_of_Curandero101.csv,212,76827042.0,85,127,60,25,0,35.570754716981135,200,41,11.132075471698114,4
Category_Wikipedia_sockpuppets_of_Kishintuchis.csv,37,487065.0,35,2,26,9,0,48.54054054054054,119,21,20.89189189189189,17
Category_Wikipedia_sockpuppets_of_Tarekulislammain.csv,5,1794.0,4,1,4,0,0,27.8,59,26,26.0,26
Category_Wikipedia_sockpuppets_of_Kpop05.csv,30,179623.0,11,19,7,4,0,34.233333333333334,157,19,14.133333333333333,2
Category_Wikipedia_sockpuppets_of_Mahveotm.csv,13,69748.0,9,4,6,3,0,32.30769230769231,134,65,35.53846153846154,24
Category_Wikipedia_sockpuppets_of_Kaisefaisal.csv,355,5180403.0,175,180,48,127,0,41.583098591549295,229,44,16.949295774647887,4
Category_Wikipedia_sockpuppets_of_TictokthePro.csv,106,265241.0,101,5,91,10,0,12.339622641509434,238,30,20.358490566037737,11
Category_Wikipedia_sockpuppets_of_Manyu_Sanghavi.csv,511,4384.0,268,243,82,186,0,43.01761252446184,474,29,8.951076320939334,3
Category_Wikipedia_sockpuppets_of_Cuffthots.csv,99,31837632.0,34,65,32,2,0,57.515151515151516,196,38,30.03030303030303,14
Category_Wikipedia_sockpuppets_of_Bandgjl.csv,109,782.0,29,80,29,0,0,55.43119266055046,211,43,21.10091743119266,4
Category_Wikipedia_sockpuppets_of_Io_Wiki2007.csv,1131,85158188.0,510,621,500,10,0,39.0079575596817,233,64,25.48452696728559,10
Category_Wikipedia_sockpuppets_of_Poeta234.csv,42,1195638.0,22,20,22,0,0,42.04761904761905,241,30,20.952380952380953,18
Category_Wikipedia_sockpuppets_of_Stalvione.csv,614,4311640.0,200,414,165,35,0,44.343648208469055,222,50,17.938110749185668,5
Category_Wikipedia_sockpuppets_of_Jrpr1966.csv,39,959.0,14,25,13,1,0,56.41025641025641,216,26,21.17948717948718,13
Category_Wikipedia_sockpuppets_of_Strababla.csv,40,610506.0,14,26,13,1,0,61.375,142,26,17.375,7
Category_Wikipedia_sockpuppets_of_Elvispress.csv,20,12602.0,9,11,3,6,0,63.1,184,33,15.65,5
Category_Wikipedia_sockpuppets_of_Verjakette.csv,3235,61733436.0,1350,1885,469,881,0,36.49088098918084,249,67,17.056877897990727,4
Category_Wikipedia_sockpuppets_of_Wikiwriter700.csv,3706,20785436.0,1000,2706,500,500,0,55.183756071235834,476,70,14.123583378305451,2
Category_Wikipedia_sockpuppets_of_Edexter603.csv,1,0.0,1,0,1,0,0,0.0,0,13,13.0,13
Category_Wikipedia_sockpuppets_of_Ohno192.csv,18,257288.0,4,14,4,0,17,60.111111111111114,92,53,44.22222222222222,23
Category_Wikipedia_sockpuppets_of_777lohith.csv,131,15545113.0,87,44,78,9,0,22.85496183206107,207,20,13.435114503816793,10
Category_Wikipedia_sockpuppets_of_Rahibsaleem.csv,1405,56298456.0,536,869,311,225,0,43.20284697508897,255,79,17.451245551601424,3
Category_Wikipedia_sockpuppets_of_Scotty2fatty.csv,20,1880.0,11,9,4,7,0,44.25,112,35,35.0,35
Category_Wikipedia_sockpuppets_of_Nicesunnyday19.csv,163,71988626.0,65,98,60,5,0,53.331288343558285,322,53,19.12269938650307,7
Category_Wikipedia_sockpuppets_of_Pswank91.csv,58,1526950.0,21,37,18,3,0,58.60344827586207,478,34,22.103448275862068,14
Category_Wikipedia_sockpuppets_of_Luibsasocer.csv,402,110413513.0,132,270,72,60,0,36.885572139303484,211,34,17.902985074626866,8
Category_Wikipedia_sockpuppets_of_Joefunkstin.csv,5,383.0,4,1,2,2,4,58.6,152,18,18.0,18
Category_Wikipedia_sockpuppets_of_Bps27.csv,161,109632207.0,52,109,48,4,0,44.84472049689441,255,42,15.192546583850932,6
Category_Wikipedia_sockpuppets_of_Á±≥Ë®ò123.csv,1447,141051942.0,379,1068,108,271,0,40.514858327574295,441,49,21.352453351762268,3
Category_Wikipedia_sockpuppets_of_Thejunner.csv,59,389266.0,25,34,20,5,0,50.88135593220339,199,49,19.74576271186441,7
Category_Wikipedia_sockpuppets_of_Wiki-senetor.csv,3703,85700833.0,1337,2366,500,837,0,44.274102079395085,264,67,21.166351606805293,4
Category_Wikipedia_sockpuppets_of_Qaseen.csv,46,1064589.0,16,30,11,5,0,46.56521739130435,222,33,22.152173913043477,11
Category_Wikipedia_sockpuppets_of_Shibumi2.csv,1481,31111347.0,531,950,500,31,0,38.64753544902093,218,71,23.282916948008104,7
Category_Wikipedia_sockpuppets_of_Scamperson.csv,427,201225165.0,135,292,98,37,0,49.65573770491803,251,30,19.39110070257611,11
Category_Wikipedia_sockpuppets_of_Kanojiaakhbaar.csv,51,14086500.0,21,30,10,11,0,41.15686274509804,241,70,16.58823529411765,13
Category_Wikipedia_sockpuppets_of_Hiwhispees.csv,656,41917252.0,175,481,96,79,0,34.4969512195122,214,53,15.823170731707316,4
Category_Wikipedia_sockpuppets_of_Karmaisking.csv,9142,519539103.0,3593,5549,500,3093,0,50.08696127761978,500,72,22.64526361846423,2
Category_Wikipedia_sockpuppets_of_RogerRabbit617.csv,6,529888.0,2,4,1,1,0,31.333333333333332,66,26,25.0,24
Category_Wikipedia_sockpuppets_of_CynthiaSteele.csv,50,20652300.0,15,35,10,5,0,55.82,229,37,22.8,21
Category_Wikipedia_sockpuppets_of_Syopsis.csv,834,11868212.0,258,576,231,27,0,60.86330935251799,316,72,28.747002398081534,5
Category_Wikipedia_sockpuppets_of_Kajal1234asd.csv,72,5057174.0,23,49,18,5,0,45.125,197,31,12.777777777777779,3
Category_Wikipedia_sockpuppets_of_Satish_Raman_Nair.csv,1453,7542891.0,567,886,203,364,0,39.08534067446662,395,64,18.479008947006193,5
Category_Wikipedia_sockpuppets_of_Er.ajeet.csv,46,97374.0,22,24,12,10,10,49.32608695652174,126,45,28.043478260869566,21
Category_Wikipedia_sockpuppets_of_Hilaryburt14.csv,88,61776559.0,24,64,9,15,0,56.47727272727273,230,37,16.943181818181817,7
Category_Wikipedia_sockpuppets_of_Mynameisstanley.csv,5878,64620965.0,2086,3792,500,1586,0,48.303334467505955,255,77,17.02943177951684,4
Category_Wikipedia_sockpuppets_of_Crusader55.csv,39,18430765.0,25,14,10,15,0,34.35897435897436,196,49,17.256410256410255,14
Category_Wikipedia_sockpuppets_of_‡≤é‡≤®‡≥ç_‡≤Ø‡≥Å_‡≤Æ‡≤π‡≥á‡≤®‡≥ç.csv,55,112930896.0,11,44,10,1,0,41.70909090909091,389,53,19.4,13
Category_Wikipedia_sockpuppets_of_Rachel_McLeod.csv,467,8640325.0,159,308,62,97,0,19.657387580299787,189,48,14.738758029978587,3
Category_Wikipedia_sockpuppets_of_Sonny_Solina.csv,275,24765180.0,125,150,68,57,0,40.39272727272727,297,40,21.232727272727274,5
Category_Wikipedia_sockpuppets_of_PrashantSahu1177.csv,1225,7930724.0,480,745,402,78,0,43.53469387755102,496,59,29.01061224489796,9
Category_Wikipedia_sockpuppets_of_Songgook123.csv,283,13939663.0,118,165,84,34,0,47.58657243816254,255,47,8.685512367491166,4
Category_Wikipedia_sockpuppets_of_Borfali.csv,49,4700200.0,21,28,16,5,0,53.69387755102041,211,20,14.26530612244898,12
Category_Wikipedia_sockpuppets_of_Verified_unique_facts_usa.csv,49,1239624.0,19,30,11,8,0,54.83673469387755,238,30,20.836734693877553,16
Category_Wikipedia_sockpuppets_of_Morgan_Rhys_(footballer).csv,170,74123447.0,42,128,35,7,0,39.6764705882353,212,45,20.988235294117647,8
Category_Wikipedia_sockpuppets_of_JeremyChinn.csv,8,36147.0,6,2,5,1,6,46.0,124,16,16.0,16
Category_Wikipedia_sockpuppets_of_Dan342432432.csv,211,8022274.0,69,142,23,46,0,38.33175355450237,494,42,21.701421800947866,6
Category_Wikipedia_sockpuppets_of_Stevanpesic.csv,103,12206085.0,47,56,35,12,0,60.86407766990291,444,42,20.475728155339805,6
Category_Wikipedia_sockpuppets_of_Anconst2332.csv,18,2330929.0,6,12,2,4,0,65.61111111111111,207,29,24.5,16
Category_Wikipedia_sockpuppets_of_Belbrabas.csv,669,19922347.0,249,420,144,105,0,53.813153961136024,410,72,25.484304932735427,5
Category_Wikipedia_sockpuppets_of_Historiƒçar.csv,5422,122313130.0,2056,3366,500,1556,0,41.71670970121726,255,78,20.64312061969753,4
Category_Wikipedia_sockpuppets_of_Xxjennybrownsxx.csv,70,26956500.0,14,56,6,8,0,56.98571428571429,225,25,15.028571428571428,6
Category_Wikipedia_sockpuppets_of_B-Objective.csv,76,19671.0,27,49,14,13,0,50.53947368421053,192,62,31.31578947368421,12
Category_Wikipedia_sockpuppets_of_AhmdAsjad.csv,320,19192971.0,96,224,77,19,0,43.25,279,53,22.51875,8
Category_Wikipedia_sockpuppets_of_MiamiDolphins3.csv,8351,345081302.0,2984,5367,500,2484,0,42.982277571548316,255,75,22.02227278170279,2
Category_Wikipedia_sockpuppets_of_GM25LIVE.csv,2014,292547471.0,575,1439,230,345,0,44.14349553128103,263,79,20.020357497517377,3
Category_Wikipedia_sockpuppets_of_Tannerwell007.csv,150,1396857.0,41,109,18,23,0,55.94,387,58,18.26,5
Category_Wikipedia_sockpuppets_of_Andiprayono.csv,17,1641681.0,13,4,7,6,0,49.529411764705884,496,29,23.0,16
Category_Wikipedia_sockpuppets_of_FriendRahul.csv,113,982856.0,32,81,29,3,0,52.8141592920354,232,40,13.486725663716815,5
Category_Wikipedia_sockpuppets_of_ChineseMan26.csv,1919,207516545.0,509,1410,500,9,0,41.755080771235015,454,47,16.946847316310578,4
Category_Wikipedia_sockpuppets_of_Peter_Karlsen.csv,2165,1477314.0,610,1555,500,110,0,63.260969976905315,250,76,19.756581986143186,3
Category_Wikipedia_sockpuppets_of_Eskinderk.csv,128,110954313.0,30,98,21,9,0,45.203125,239,38,20.3203125,8
Category_Wikipedia_sockpuppets_of_ToNeverFindTheMets.csv,1814,2803976.0,736,1078,500,236,0,44.19073869900772,495,59,24.668687982359426,3
Category_Wikipedia_sockpuppets_of_Birmal123.csv,142,38091037.0,52,90,17,35,0,55.80281690140845,252,47,18.077464788732396,4
Category_Wikipedia_sockpuppets_of_PINEAPPLEMAN.csv,117,1040667.0,38,79,38,0,0,54.43589743589744,180,46,19.47008547008547,9
Category_Wikipedia_sockpuppets_of_Kashmir2.csv,800,452318517.0,264,536,140,124,0,48.62375,440,52,20.5275,4
Category_Wikipedia_sockpuppets_of_Rabbi_Saltzman.csv,16,1050502.0,6,10,3,3,7,161.8125,461,31,23.25,21
Category_Wikipedia_sockpuppets_of_Jimisdead69.csv,8,194481.0,6,2,6,0,0,75.0,226,16,14.125,13
Category_Wikipedia_sockpuppets_of_Bstnetnocn.csv,22,2116.0,9,13,5,4,12,97.68181818181819,218,32,16.727272727272727,5
Category_Wikipedia_sockpuppets_of_1985mctg.csv,99,7569504.0,53,46,25,28,0,42.83838383838384,417,21,14.212121212121213,6
Category_Wikipedia_sockpuppets_of_Matlatos.csv,11,1333.0,7,4,3,4,0,19.454545454545453,105,14,9.909090909090908,9
Category_Wikipedia_sockpuppets_of_FishMara.csv,154,60961586.0,57,97,30,27,0,48.54545454545455,356,28,16.714285714285715,14
Category_Wikipedia_sockpuppets_of_Marybangbang.csv,24,1721133.0,8,16,5,3,0,36.041666666666664,188,41,19.875,8
Category_Wikipedia_sockpuppets_of_Seoperfect.csv,3,1977.0,2,1,1,1,29,63.666666666666664,133,23,23.0,23
Category_Wikipedia_sockpuppets_of_XXX8906.csv,1715,137867820.0,513,1202,500,13,0,55.55801749271137,304,54,18.211078717201165,5
Category_Wikipedia_sockpuppets_of_Blockuser22.csv,85,3969863.0,33,52,14,19,0,53.576470588235296,215,31,16.96470588235294,8
Category_Wikipedia_sockpuppets_of_–ö–∞—Ç–µ—Ä–∏–Ω–∞_–ñ–∞–¥–∞–Ω.csv,18,43930.0,8,10,6,2,0,56.77777777777778,236,33,17.0,10
Category_Wikipedia_sockpuppets_of_Milhouseisamemenaw.csv,8,312.0,4,4,4,0,0,25.875,114,28,23.25,15
Category_Wikipedia_sockpuppets_of_Khalidgaur.csv,470,175682990.0,113,357,113,0,0,51.4531914893617,239,49,18.568085106382977,5
Category_Wikipedia_sockpuppets_of_Mike78040.csv,583,2851029.0,191,392,133,58,0,47.6483704974271,204,55,23.197255574614065,7
Category_Wikipedia_sockpuppets_of_WKS_≈ölƒÖsk_Wroc≈Çaw.csv,1323,108414086.0,356,967,267,89,0,43.512471655328795,252,49,12.879818594104309,4
Category_Wikipedia_sockpuppets_of_2021biu.csv,63,18943020.0,27,36,13,14,0,41.03174603174603,239,45,22.142857142857142,13
Category_Wikipedia_sockpuppets_of_98E.csv,8695,54222257.0,2906,5789,500,2406,0,34.580103507763084,263,88,20.799654974123058,1
Category_Wikipedia_sockpuppets_of_Sanju_Vishnudas.csv,50,780058.0,26,24,24,2,0,31.1,196,45,20.26,10
Category_Wikipedia_sockpuppets_of_Muhammad_boboev.csv,131,9009031.0,60,71,56,4,0,48.81679389312977,336,48,30.946564885496183,10
Category_Wikipedia_sockpuppets_of_HwalterHwhite.csv,61,9159380.0,21,40,12,9,0,48.540983606557376,313,49,19.540983606557376,5
Category_Wikipedia_sockpuppets_of_Seebabhatia.csv,9,226166.0,7,2,4,3,0,64.44444444444444,196,47,27.11111111111111,18
Category_Wikipedia_sockpuppets_of_Fica_na_753_slash_75.csv,18,2536.0,8,10,3,5,0,46.22222222222222,137,25,17.444444444444443,12
Category_Wikipedia_sockpuppets_of_BiKaz.csv,837,9082069.0,214,623,166,48,0,49.365591397849464,249,37,15.158900836320191,4
Category_Wikipedia_sockpuppets_of_Royalmate1.csv,2455,84334390.0,751,1704,500,251,0,43.71160896130346,255,90,25.272505091649695,4
Category_Wikipedia_sockpuppets_of_Dragonball1986.csv,3397,20014335.0,1000,2397,500,500,0,33.876067118045334,200,48,20.840741831027376,3
Category_Wikipedia_sockpuppets_of_RhinoDino1414.csv,330,16306800.0,115,215,24,91,0,33.78181818181818,306,37,20.669696969696968,8
Category_Wikipedia_sockpuppets_of_UtherSB.csv,494,114154320.0,202,292,124,78,0,58.28137651821862,492,40,22.036437246963562,8
Category_Wikipedia_sockpuppets_of_MaranoFan.csv,2113,249679002.0,889,1224,500,389,0,46.87032654992901,513,95,24.62375769048746,4
Category_Wikipedia_sockpuppets_of_Gavin_Cleaveland.csv,73,65130875.0,19,54,9,10,0,54.73972602739726,276,29,13.876712328767123,4
Category_Wikipedia_sockpuppets_of_Sivaakumarr.csv,15,5507082.0,4,11,3,1,0,55.06666666666667,195,21,17.6,17
Category_Wikipedia_sockpuppets_of_Marcolacson.csv,2301,105921602.0,648,1653,500,148,0,33.67970447631465,516,56,21.651890482398958,4
Category_Wikipedia_sockpuppets_of_Jbottisti.csv,803,11500621.0,326,477,293,33,0,24.009962640099626,199,46,23.05977584059776,5
Category_Wikipedia_sockpuppets_of_Stardussst.csv,109,4488459.0,63,46,14,49,0,64.18348623853211,192,17,13.669724770642201,10
Category_Wikipedia_sockpuppets_of_AnonymousIndiaz.csv,4123,37601674.0,1397,2726,500,897,0,42.905651224836284,495,63,22.029105020616058,2
Category_Wikipedia_sockpuppets_of_Amyxcell.csv,93,76166882.0,31,62,20,11,0,46.17204301075269,237,31,17.462365591397848,12
Category_Wikipedia_sockpuppets_of_Punjabier.csv,3803,35830896.0,1448,2355,500,948,0,47.205364186168815,500,57,17.46989219037602,4
Category_Wikipedia_sockpuppets_of_Rochester3000.csv,572,31184045.0,170,402,153,17,0,60.54545454545455,254,49,20.136363636363637,9
Category_Wikipedia_sockpuppets_of_DileepKS69.csv,2114,269305720.0,602,1512,500,102,0,50.99763481551561,255,50,21.97445600756859,5
Category_Wikipedia_sockpuppets_of_Remember_Polish_Heroes.csv,77,7629.0,22,55,9,13,0,68.59740259740259,271,78,24.4025974025974,11
Category_Wikipedia_sockpuppets_of_Aoife.brauders.csv,16,3799.0,11,5,9,2,0,47.25,196,27,15.375,13
Category_Wikipedia_sockpuppets_of_Metron.csv,5483,239490505.0,1350,4133,500,850,0,47.95349261353274,463,58,15.997446653291993,1
Category_Wikipedia_sockpuppets_of_DebbyBree.csv,241,2729616.0,64,177,43,21,0,41.26970954356847,247,40,11.929460580912863,4
Category_Wikipedia_sockpuppets_of_Filmstreetster.csv,1,0.0,1,0,1,0,28,28.0,28,59,59.0,59
Category_Wikipedia_sockpuppets_of_Matcheeks.csv,106,40660727.0,38,68,38,0,0,57.65094339622642,432,47,19.650943396226417,9
Category_Wikipedia_sockpuppets_of_Johnjohnjames.csv,2050,73037154.0,727,1323,500,227,0,55.80975609756098,255,58,28.738048780487805,5
Category_Wikipedia_sockpuppets_of_FacebookVN.csv,25,583120.0,6,19,3,3,0,68.44,236,58,28.96,9
Category_Wikipedia_sockpuppets_of_GoJettersXuli2022.csv,201,3549682.0,65,136,47,18,0,49.343283582089555,411,51,21.592039800995025,10
Category_Wikipedia_sockpuppets_of_Paisabazaar.csv,1,0.0,1,0,1,0,36,36.0,36,21,21.0,21
Category_Wikipedia_sockpuppets_of_Cinnamon123.csv,1,0.0,1,0,1,0,40,40.0,40,9,9.0,9
Category_Wikipedia_sockpuppets_of_Anuchak.csv,327,1990022.0,127,200,33,94,0,42.837920489296636,245,58,19.10091743119266,9
Category_Wikipedia_sockpuppets_of_Vermapriya1986.csv,516,41944219.0,252,264,176,76,0,33.85271317829457,248,51,19.203488372093023,5
Category_Wikipedia_sockpuppets_of_Devout_Christian.csv,780,6815377.0,187,593,62,125,0,45.78076923076923,208,61,16.176923076923078,3
Category_Wikipedia_sockpuppets_of_Newstormer.csv,513,6488045.0,155,358,155,0,0,45.538011695906434,250,58,15.461988304093568,4
Category_Wikipedia_sockpuppets_of_Tile_join.csv,1454,259976878.0,463,991,34,429,0,40.19876203576341,255,63,17.21733149931224,4
Category_Wikipedia_sockpuppets_of_CREG7898.csv,925,45148600.0,357,568,287,70,0,40.67567567567568,493,48,19.93081081081081,5
Category_Wikipedia_sockpuppets_of_Mukti_Subedi.csv,63,2255948.0,19,44,11,8,0,39.3968253968254,161,52,20.952380952380953,11
Category_Wikipedia_sockpuppets_of_NoNDeSCRiPT.csv,1278,115002726.0,454,824,228,226,0,63.056338028169016,454,77,15.8716744913928,3
Category_Wikipedia_sockpuppets_of_Yoked_Apparel.csv,6,10767259.0,5,1,4,1,0,29.0,76,23,16.333333333333332,13
Category_Wikipedia_sockpuppets_of_Lehol.csv,877,41898103.0,239,638,151,88,0,69.29190421892817,500,50,19.15963511972634,4
Category_Wikipedia_sockpuppets_of_YOWASUP6767.csv,21,32270584.0,8,13,6,2,0,61.285714285714285,191,36,21.285714285714285,7
Category_Wikipedia_sockpuppets_of_MatthewCook04.csv,26,2638907.0,9,17,7,2,0,60.15384615384615,228,53,30.153846153846153,14
Category_Wikipedia_sockpuppets_of_Mccain4pres.csv,19,194595.0,10,9,6,4,0,51.73684210526316,133,16,12.210526315789474,12
Category_Wikipedia_sockpuppets_of_Mitchronson.csv,74,500767.0,35,39,27,8,0,31.93243243243243,199,77,45.7972972972973,16
Category_Wikipedia_sockpuppets_of_Jo√£o_Victor23567.csv,5,110636.0,2,3,2,0,0,36.6,167,24,21.2,17
Category_Wikipedia_sockpuppets_of_Lass-Lass.csv,539,28089493.0,189,350,43,146,0,44.25974025974026,515,49,18.625231910946198,4
Category_Wikipedia_sockpuppets_of_Rockypedia.csv,11367,271737699.0,3323,8044,500,2823,0,52.75305709509985,470,106,19.596287498900324,3
Category_Wikipedia_sockpuppets_of_Rishika.dhanawade.csv,2920,45810484.0,1136,1784,500,636,0,38.88013698630137,255,76,16.644520547945206,3
Category_Wikipedia_sockpuppets_of_Janine_Thompson.csv,634,154079003.0,207,427,125,82,0,47.290220820189276,249,52,14.59621451104101,8
Category_Wikipedia_sockpuppets_of_Defoxjuju.csv,22,24742.0,15,7,9,6,2,27.545454545454547,172,20,16.227272727272727,15
Category_Wikipedia_sockpuppets_of_LindaHoffman.csv,42,595936.0,32,10,12,20,0,35.476190476190474,220,22,12.380952380952381,8
Category_Wikipedia_sockpuppets_of_Delancray.csv,70,1653093.0,28,42,15,13,0,54.642857142857146,248,38,20.02857142857143,10
Category_Wikipedia_sockpuppets_of_Bobby.jennings.csv,107,175207479.0,30,77,25,5,0,51.8411214953271,223,50,9.14018691588785,3
Category_Wikipedia_sockpuppets_of_TheManWhoLaughs.csv,2977,4756852.0,1012,1965,472,540,0,31.153846153846153,213,81,22.051058112193484,5
Category_Wikipedia_sockpuppets_of_Sahilangh.csv,1379,459237.0,560,819,500,60,0,23.142857142857142,496,46,17.087019579405368,5
Category_Wikipedia_sockpuppets_of_LoggoL.csv,2960,65599740.0,1140,1820,500,640,0,31.32702702702703,363,47,27.090878378378378,3
Category_Wikipedia_sockpuppets_of_Jing13.csv,1092,113717727.0,483,609,363,120,0,34.493589743589745,242,71,15.050366300366301,4
Category_Wikipedia_sockpuppets_of_Dari_Feitosa.csv,407,44232162.0,139,268,48,91,0,35.57985257985258,235,57,19.304668304668304,6
Category_Wikipedia_sockpuppets_of_Jetson2012.csv,442,61479210.0,111,331,80,31,0,33.210407239819006,250,48,22.88914027149321,7
Category_Wikipedia_sockpuppets_of_Deejayamit.csv,109,11174301.0,40,69,29,11,0,45.81651376146789,255,43,20.137614678899084,6
Category_Wikipedia_sockpuppets_of_Sumedh_Tayade.csv,3032,2540435.0,910,2122,500,410,0,36.33905013192612,255,67,13.988786279683378,3
Category_Wikipedia_sockpuppets_of_Trust_on_ALLAH.csv,1228,271647642.0,321,907,233,88,0,49.093648208469055,255,47,22.784201954397393,4
Category_Wikipedia_sockpuppets_of_Constantprogress.csv,420,80259401.0,112,308,63,49,0,52.121428571428574,255,47,18.016666666666666,3
Category_Wikipedia_sockpuppets_of_ExcuseMeNYC.csv,58,2082275.0,28,30,25,3,0,48.91379310344828,254,28,23.413793103448278,18
Category_Wikipedia_sockpuppets_of_Thecorrector21.csv,885,23589552.0,545,340,500,45,0,38.57401129943503,500,50,28.494915254237288,11
Category_Wikipedia_sockpuppets_of_Aalugobi.csv,55,162021.0,40,15,34,6,13,97.10909090909091,255,24,19.327272727272728,15
Category_Wikipedia_sockpuppets_of_Bhernyy.csv,263,52667400.0,99,164,98,1,0,46.80608365019011,376,60,18.228136882129277,6
Category_Wikipedia_sockpuppets_of_Alpayberg2.csv,2,17220.0,2,0,2,0,28,40.0,52,20,20.0,20
Category_Wikipedia_sockpuppets_of_AntiBFA.csv,4,69845.0,3,1,2,1,0,11.5,43,20,20.0,20
Category_Wikipedia_sockpuppets_of_Leopold_the_69th.csv,15,1752.0,7,8,6,1,0,35.2,189,9,7.933333333333334,6
Category_Wikipedia_sockpuppets_of_Krizpo.csv,1760,56666726.0,594,1166,500,94,0,44.44886363636363,255,36,16.709659090909092,4
Category_Wikipedia_sockpuppets_of_O.Turani.csv,424,9453838.0,147,277,80,67,0,47.43867924528302,255,50,16.757075471698112,4
Category_Wikipedia_sockpuppets_of_Cartsnoyes.csv,165,1755007.0,52,113,20,32,0,55.84848484848485,256,49,16.69090909090909,8
Category_Wikipedia_sockpuppets_of_MRivera25.csv,624,32396437.0,185,439,99,86,0,44.71153846153846,255,39,18.876602564102566,6
Category_Wikipedia_sockpuppets_of_Alicesmeraldo.csv,110,1326713.0,51,59,19,32,0,45.99090909090909,412,27,14.363636363636363,6
Category_Wikipedia_sockpuppets_of_InstantSnapFeedback.csv,158,1845098.0,49,109,49,0,0,58.79113924050633,205,51,42.81645569620253,11
Category_Wikipedia_sockpuppets_of_SamRathbone.csv,2270,104595257.0,619,1651,363,256,0,48.033480176211455,417,51,19.771806167400882,4
Category_Wikipedia_sockpuppets_of_LouisPhilippeCharles.csv,8675,453478429.0,2898,5777,500,2398,0,45.96103746397694,494,77,28.5485878962536,4
Category_Wikipedia_sockpuppets_of_OskarDirlewanger1488.csv,23,3474.0,15,8,9,6,0,62.130434782608695,201,17,17.0,17
Category_Wikipedia_sockpuppets_of_Anakha6.csv,59,165322.0,18,41,16,2,0,28.47457627118644,175,44,15.033898305084746,3
Category_Wikipedia_sockpuppets_of_Volkan_of_Sarek.csv,54,113402.0,35,19,23,12,0,53.68518518518518,248,35,32.092592592592595,19
Category_Wikipedia_sockpuppets_of_Omniposcent.csv,720,42424945.0,301,419,231,70,0,36.8875,214,27,18.804166666666667,12
Category_Wikipedia_sockpuppets_of_Soldier_stories.csv,2109,57406061.0,810,1299,500,310,0,41.93361782835467,358,80,18.598387861545756,4
Category_Wikipedia_sockpuppets_of_Bxpop96.csv,164,1209945.0,46,118,33,13,0,32.957317073170735,214,37,21.0,9
Category_Wikipedia_sockpuppets_of_Jonas_Poole.csv,9105,161593365.0,3629,5476,500,3129,0,52.25853926414058,255,69,18.101592531576056,3
Category_Wikipedia_sockpuppets_of_Zamondt.csv,130,744908.0,39,91,22,17,0,55.8,248,29,13.923076923076923,4
Category_Wikipedia_sockpuppets_of_Enviroknot.csv,7079,267180106.0,2059,5020,500,1559,0,45.176719875688654,255,80,22.738098601497388,3
Category_Wikipedia_sockpuppets_of_Ravi_Vasanwar.csv,47,117825788.0,18,29,16,2,0,42.51063829787234,226,24,17.106382978723403,8
Category_Wikipedia_sockpuppets_of_Khawarsohail.csv,22,98110.0,15,7,11,4,0,33.54545454545455,158,30,11.818181818181818,10
Category_Wikipedia_sockpuppets_of_DavId_Troia.csv,27,31719.0,14,13,11,3,0,61.44444444444444,251,49,15.666666666666666,9
Category_Wikipedia_sockpuppets_of_ARTLIST.csv,20,104134.0,12,8,9,3,0,42.65,131,23,14.25,9
Category_Wikipedia_sockpuppets_of_Sustainable_Richard.csv,121,24888245.0,29,92,11,18,0,46.768595041322314,259,27,13.942148760330578,4
Category_Wikipedia_sockpuppets_of_Vicky1728.csv,14,257794.0,11,3,6,5,0,38.57142857142857,157,19,13.0,12
Category_Wikipedia_sockpuppets_of_RabbitFanon2021.csv,593,3168941.0,200,393,157,43,0,51.4468802698145,415,60,22.2681281618887,7
Category_Wikipedia_sockpuppets_of_Annewsha_Chakraborty.csv,603,65536898.0,217,386,109,108,0,30.003316749585405,283,48,18.117744610281925,10
Category_Wikipedia_sockpuppets_of_Cossde.csv,3310,472189781.0,1000,2310,500,500,0,53.26586102719033,496,76,28.962537764350454,3
Category_Wikipedia_sockpuppets_of_Brucejenner.csv,5399,145740096.0,1576,3823,133,1443,0,56.436191887386556,255,84,21.092424523059826,4
Category_Wikipedia_sockpuppets_of_Filmsims13.csv,1,0.0,1,0,1,0,22,22.0,22,15,15.0,15
Category_Wikipedia_sockpuppets_of_Jack_welch76.csv,42,4330297.0,15,27,3,12,0,40.45238095238095,203,20,9.952380952380953,6
Category_Wikipedia_sockpuppets_of_RotarenegEmem.csv,1356,89821155.0,289,1067,177,112,0,65.77802359882006,472,50,13.926991150442477,3
Category_Wikipedia_sockpuppets_of_Poindextero.csv,6396,12748689.0,1894,4502,500,1394,0,43.10631644777986,500,86,21.517979987492183,2
Category_Wikipedia_sockpuppets_of_Ohiogoeshard.csv,1,0.0,1,0,1,0,12,12.0,12,24,24.0,24
Category_Wikipedia_sockpuppets_of_BudhadityaBhattacharyya.csv,215,266149287.0,87,128,64,23,0,42.68372093023256,289,67,21.209302325581394,11
Category_Wikipedia_sockpuppets_of_Cosmos416.csv,1622,15341649.0,532,1090,500,32,0,47.96979038224414,250,54,18.019112207151665,4
Category_Wikipedia_sockpuppets_of_Pee_ef_pee.csv,235,63761506.0,47,188,33,14,0,59.03404255319149,310,38,17.472340425531915,6
Category_Wikipedia_sockpuppets_of_Bennet43.csv,10051,86448832.0,3593,6458,500,3093,0,64.65237289821908,514,182,21.550691473485227,4
Category_Wikipedia_sockpuppets_of_Sledgehog0.csv,19,389.0,6,13,6,0,0,51.578947368421055,169,31,17.68421052631579,3
Category_Wikipedia_sockpuppets_of_Donyi_Taga.csv,1985,65733076.0,970,1015,419,551,0,32.69319899244333,255,76,21.577833753148614,5
Category_Wikipedia_sockpuppets_of_Betfairmole.csv,284,30088488.0,126,158,48,78,0,44.88380281690141,251,47,13.211267605633802,6
Category_Wikipedia_sockpuppets_of_Nithind119.csv,24,7075400.0,7,17,4,3,0,43.833333333333336,223,23,19.75,7
Category_Wikipedia_sockpuppets_of_Mediasurf.csv,40,60083681.0,14,26,14,0,0,39.175,196,27,19.7,15
Category_Wikipedia_sockpuppets_of_Avery_917.csv,435,98253320.0,164,271,122,42,0,49.98620689655172,496,39,20.98390804597701,2
Category_Wikipedia_sockpuppets_of_Legalhistory.csv,47,3893421.0,21,26,11,10,0,64.34042553191489,248,48,17.595744680851062,11
Category_Wikipedia_sockpuppets_of_Hasdie_hasnan.csv,86,209723167.0,33,53,26,7,0,39.03488372093023,200,45,21.86046511627907,15
Category_Wikipedia_sockpuppets_of_Mckburton.csv,2273,17009897.0,649,1624,326,323,0,50.77738671359437,255,80,16.468103827540695,3
Category_Wikipedia_sockpuppets_of_Ioifofrfrre.csv,15,1268.0,9,6,6,3,0,96.53333333333333,214,18,10.2,9
Category_Wikipedia_sockpuppets_of_Timon_Davidson_XXX.csv,38,7739.0,14,24,6,8,0,52.3421052631579,200,54,44.0,18
Category_Wikipedia_sockpuppets_of_Fclass.csv,2770,29531928.0,845,1925,500,345,0,36.33321299638989,250,71,20.221660649819494,4
Category_Wikipedia_sockpuppets_of_Shawn_Teller.csv,1318,4498062.0,520,798,500,20,0,60.35204855842185,444,100,35.640364188163886,4
Category_Wikipedia_sockpuppets_of_Iiooio.csv,104,2636648.0,31,73,7,24,0,58.96153846153846,271,47,24.692307692307693,7
Category_Wikipedia_sockpuppets_of_Civility_Enforcer.csv,2461,18318607.0,791,1670,500,291,0,39.659081674116216,246,50,20.340511986997157,5
Category_Wikipedia_sockpuppets_of_GeorgeBP.csv,532,6130581.0,166,366,137,29,0,41.60338345864662,199,44,19.76127819548872,4
Category_Wikipedia_sockpuppets_of_Mywayyy.csv,1596,89423624.0,380,1216,154,226,0,40.07080200501253,209,49,13.388471177944862,3
Category_Wikipedia_sockpuppets_of_TyTyKKWIki.csv,76,4075714.0,35,41,33,2,0,57.71052631578947,255,25,16.43421052631579,10
Category_Wikipedia_sockpuppets_of_Cdfi.csv,986,206265025.0,397,589,269,128,0,60.26166328600406,494,50,16.79817444219067,5
Category_Wikipedia_sockpuppets_of_Jeano_BK.csv,81,59008152.0,50,31,22,28,0,41.06172839506173,225,21,15.0,13
Category_Wikipedia_sockpuppets_of_Khalsaburg.csv,649,37142605.0,270,379,270,0,0,44.71340523882897,210,64,19.622496147919875,3
Category_Wikipedia_sockpuppets_of_Poempatisserie.csv,7,1328258.0,4,3,3,1,0,68.57142857142857,204,28,23.0,9
Category_Wikipedia_sockpuppets_of_Shouzab_Alle_Saimi.csv,5,181810.0,3,2,2,1,0,0.0,0,22,22.0,22
Category_Wikipedia_sockpuppets_of_Archivesharer.csv,327,63895811.0,112,215,75,37,0,37.81957186544342,184,62,38.269113149847094,15
Category_Wikipedia_sockpuppets_of_Namllits2002.csv,95,85888743.0,25,70,14,11,0,48.38947368421053,187,49,24.13684210526316,22
Category_Wikipedia_sockpuppets_of_Emiliogogo.csv,439,54897691.0,114,325,62,52,0,47.72665148063781,423,45,16.863325740318906,6
Category_Wikipedia_sockpuppets_of_Adarshrathor.csv,23,37086754.0,21,2,11,10,0,65.69565217391305,474,22,20.73913043478261,13
Category_Wikipedia_sockpuppets_of_Johnson23p.csv,149,44232637.0,38,111,37,1,0,65.84563758389261,252,47,19.550335570469798,5
Category_Wikipedia_sockpuppets_of_Subzzee.csv,1598,375386899.0,552,1046,500,52,0,31.518147684605758,247,53,17.966207759699625,7
Category_Wikipedia_sockpuppets_of_Hamsey75.csv,21,7885028.0,15,6,13,2,0,31.19047619047619,234,29,22.904761904761905,18
Category_Wikipedia_sockpuppets_of_Spider_2200.csv,881,3206456.0,350,531,255,95,0,35.541430192962544,235,50,14.062429057888762,4
Category_Wikipedia_sockpuppets_of_Jakeandtd2.csv,4,329.0,2,2,2,0,0,86.5,172,20,15.5,11
Category_Wikipedia_sockpuppets_of_Profile101.csv,4199,33348881.0,1583,2616,500,1083,0,44.959752321981426,255,67,22.912836389616576,3
Category_Wikipedia_sockpuppets_of_Artin_Mehraban.csv,4476,41199441.0,1428,3048,500,928,0,43.78731009830206,255,64,17.274575513851655,3
Category_Wikipedia_sockpuppets_of_Pwok.csv,524,47606729.0,247,277,199,48,0,34.51526717557252,199,55,26.39503816793893,9
Category_Wikipedia_sockpuppets_of_Cartman810.csv,2256,91448436.0,983,1273,500,483,0,35.05452127659574,255,56,26.589982269503547,8
Category_Wikipedia_sockpuppets_of_AldermanJimGardiner.csv,45,1932160.0,19,26,17,2,0,53.37777777777778,220,42,36.91111111111111,20
Category_Wikipedia_sockpuppets_of_Megawave111.csv,70,1273135.0,30,40,28,2,0,78.72857142857143,227,28,12.428571428571429,5
Category_Wikipedia_sockpuppets_of_Newcomer1.csv,444,13728067.0,169,275,73,96,0,61.88963963963964,255,57,31.33783783783784,5
Category_Wikipedia_sockpuppets_of_Crakkerjakk.csv,2097,33017686.0,660,1437,500,160,0,58.43633762517883,264,89,22.405817835002384,2
Category_Wikipedia_sockpuppets_of_Ghughes15.csv,14,31340.0,9,5,9,0,0,24.285714285714285,164,21,21.0,21
Category_Wikipedia_sockpuppets_of_Mahammad_Waqar.csv,42,116248.0,18,24,10,8,0,51.95238095238095,415,21,13.904761904761905,10
Category_Wikipedia_sockpuppets_of_Scottgramble.csv,121,3501522.0,37,84,25,12,0,39.46280991735537,155,26,20.14876033057851,14
Category_Wikipedia_sockpuppets_of_Bioplus.csv,464,16807156.0,163,301,161,2,0,39.82543103448276,238,54,21.329741379310345,11
Category_Wikipedia_sockpuppets_of_Artful-dodger-brown.csv,135,27103391.0,59,76,34,25,0,35.82962962962963,273,28,16.362962962962964,6
Category_Wikipedia_sockpuppets_of_SansBias.csv,46,1317049.0,17,29,13,4,0,69.02173913043478,244,40,22.782608695652176,17
Category_Wikipedia_sockpuppets_of_Pank851988.csv,104,91631060.0,32,72,12,20,0,39.84615384615385,255,24,16.317307692307693,6
Category_Wikipedia_sockpuppets_of_Abdulpreys.csv,281,21679064.0,85,196,76,9,0,55.00355871886121,315,111,29.060498220640568,5
Category_Wikipedia_sockpuppets_of_A_kind_soul.csv,78,59459841.0,29,49,11,18,0,49.91025641025641,196,36,19.628205128205128,13
Category_Wikipedia_sockpuppets_of_Theduinoelegy.csv,729,88255802.0,256,473,217,39,0,57.67901234567901,251,47,19.506172839506174,7
Category_Wikipedia_sockpuppets_of_Risto_hot_sir.csv,6221,155862730.0,1307,4914,500,807,0,48.497347693296895,497,62,15.484327278572577,3
Category_Wikipedia_sockpuppets_of_Copperchair.csv,13852,82859590.0,3894,9958,500,3394,0,28.74761767253826,250,78,21.0399942246607,3
Category_Wikipedia_sockpuppets_of_WizardofWestport.csv,15,2162270.0,10,5,4,6,0,30.933333333333334,196,26,21.933333333333334,20
Category_Wikipedia_sockpuppets_of_Jacknnov.csv,13,172074.0,12,1,7,5,0,5.461538461538462,45,16,14.615384615384615,7
Category_Wikipedia_sockpuppets_of_Mr._Pekka_Stranker.csv,1078,6543806.0,478,600,476,2,0,60.11038961038961,444,63,24.532467532467532,11
Category_Wikipedia_sockpuppets_of_Jemima_West.csv,218,110660354.0,60,158,21,39,0,41.78440366972477,255,44,22.142201834862384,11
Category_Wikipedia_sockpuppets_of_Sofia_Gibson.csv,150,54726904.0,45,105,38,7,0,50.266666666666666,289,63,23.14666666666667,6
Category_Wikipedia_sockpuppets_of_Matchstik.csv,58,83277772.0,15,43,8,7,0,40.46551724137931,219,36,22.517241379310345,16
Category_Wikipedia_sockpuppets_of_Therock40756.csv,3929,210266795.0,998,2931,500,498,0,52.13311275133622,250,79,18.394247900229065,4
Category_Wikipedia_sockpuppets_of_BandBlue2020.csv,2113,71883666.0,593,1520,311,282,0,41.4230951254141,395,62,20.671083767155704,4
Category_Wikipedia_sockpuppets_of_VJ-Yugo.csv,3114,288804999.0,1079,2035,225,854,0,39.678869621066156,329,92,24.570327552986512,4
Category_Wikipedia_sockpuppets_of_Kendalljr2404.csv,261,52144640.0,66,195,16,50,0,42.68199233716475,254,55,23.306513409961685,3
Category_Wikipedia_sockpuppets_of_Spectre7277.csv,677,165603858.0,190,487,174,16,0,40.73559822747415,238,47,16.843426883308716,7
Category_Wikipedia_sockpuppets_of_ElshadK.csv,1668,24650352.0,595,1073,493,102,0,56.59652278177458,422,76,30.443645083932854,5
Category_Wikipedia_sockpuppets_of_Everyone_calls_me_Lol.csv,1629,55744687.0,578,1051,493,85,0,38.07550644567219,272,68,21.737262124002456,6
Category_Wikipedia_sockpuppets_of_Binit14.csv,277,2939239.0,107,170,98,9,0,43.44043321299639,224,50,21.133574007220215,6
Category_Wikipedia_sockpuppets_of_Ericisafacinass.csv,114,1058742.0,57,57,43,14,0,47.46491228070175,237,45,16.842105263157894,4
Category_Wikipedia_sockpuppets_of_Tanki8858.csv,14,116573.0,12,2,12,0,0,13.928571428571429,25,19,19.0,19
Category_Wikipedia_sockpuppets_of_Charismamata.csv,549,1860717.0,179,370,133,46,0,55.87431693989071,438,69,19.56648451730419,5
Category_Wikipedia_sockpuppets_of_Wikikuuj.csv,188,17112860.0,62,126,49,13,0,51.223404255319146,500,40,17.622340425531913,6
Category_Wikipedia_sockpuppets_of_Tcanb.csv,40,1016908.0,29,11,27,2,0,50.925,210,13,9.0,8
Category_Wikipedia_sockpuppets_of_Fairchristabelle.csv,876,28683758.0,500,376,486,14,0,43.538812785388124,251,68,21.463470319634702,4
Category_Wikipedia_sockpuppets_of_„Ç¢„Ç§„Éí„Éû„É≥.csv,24,7165632.0,16,8,11,5,0,65.95833333333333,500,32,19.208333333333332,10
Category_Wikipedia_sockpuppets_of_Fc.alpha.afghan.csv,25,71322.0,15,10,8,7,0,36.44,166,37,28.8,20
Category_Wikipedia_sockpuppets_of_Bruce2366.csv,941,10201750.0,400,541,116,284,0,44.24442082890542,254,51,15.124335812964931,3
Category_Wikipedia_sockpuppets_of_Banda12345.csv,1149,24937673.0,527,622,500,27,0,26.79373368146214,257,47,23.87380330722367,8
Category_Wikipedia_sockpuppets_of_ShaggyAnimate.csv,429,11488659.0,149,280,88,61,0,41.463869463869464,308,23,5.452214452214452,4
Category_Wikipedia_sockpuppets_of_BuntyPathak.csv,22,84494.0,13,9,13,0,0,49.5,196,25,14.454545454545455,10
Category_Wikipedia_sockpuppets_of_Shrik88music.csv,7347,169901448.0,2361,4986,500,1861,0,39.53804273853274,255,68,16.811623792023955,4
Category_Wikipedia_sockpuppets_of_Amarjeetpardeep.csv,1009,67302253.0,366,643,74,292,0,37.67591674925669,494,48,16.994053518334987,6
Category_Wikipedia_sockpuppets_of_Apokaradokia.csv,121,4415122.0,64,57,32,32,0,47.768595041322314,220,33,18.801652892561982,12
Category_Wikipedia_sockpuppets_of_MoyaiViper.csv,394,27914269.0,121,273,82,39,0,49.692893401015226,330,111,29.84771573604061,9
Category_Wikipedia_sockpuppets_of_Synthpope.csv,413,164104929.0,138,275,98,40,0,41.06537530266344,252,18,13.888619854721549,10
Category_Wikipedia_sockpuppets_of_Edinburghgeo.csv,585,144170109.0,181,404,44,137,0,51.0974358974359,254,56,22.456410256410255,2
Category_Wikipedia_sockpuppets_of_Hophatcat.csv,30,676633.0,25,5,25,0,0,10.566666666666666,147,19,17.833333333333332,12
Category_Wikipedia_sockpuppets_of_Poooooooopascoopa.csv,12,1716.0,8,4,5,3,4,136.75,255,28,15.416666666666666,12
Category_Wikipedia_sockpuppets_of_Picker78.csv,2067,138783699.0,667,1400,500,167,0,40.256410256410255,255,41,18.39283986453798,4
Category_Wikipedia_sockpuppets_of_Bikram_Jit_Sinha..csv,35,35803756.0,14,21,6,8,0,49.8,196,34,14.628571428571428,6
Category_Wikipedia_sockpuppets_of_Stephenaidoo.csv,85,115071941.0,23,62,16,7,0,46.15294117647059,186,46,21.71764705882353,5
Category_Wikipedia_sockpuppets_of_Jackaustin1987.csv,139,1374845.0,56,83,44,12,0,61.32374100719424,255,50,18.72661870503597,4
Category_Wikipedia_sockpuppets_of_Durro_Gjeloshi.csv,646,116666919.0,190,456,143,47,0,41.57120743034056,232,71,16.794117647058822,5
Category_Wikipedia_sockpuppets_of_Marxistman.csv,57,5572420.0,27,30,24,3,0,31.63157894736842,178,46,24.70175438596491,13
Category_Wikipedia_sockpuppets_of_SotosfromGreece.csv,1730,22294688.0,583,1147,500,83,0,51.03699421965318,255,57,17.550867052023122,5
Category_Wikipedia_sockpuppets_of_SoccerDude83.csv,18,69560690.0,6,12,3,3,0,58.111111111111114,151,31,19.0,3
Category_Wikipedia_sockpuppets_of_Sucksalt.csv,1,0.0,1,0,1,0,0,0.0,0,8,8.0,8
Category_Wikipedia_sockpuppets_of_IndieTVIndustryInsider.csv,22,1196979.0,15,7,12,3,0,96.9090909090909,244,22,11.954545454545455,9
Category_Wikipedia_sockpuppets_of_Mockumentary1.csv,27,1402187.0,22,5,21,1,0,21.185185185185187,75,22,15.333333333333334,12
Category_Wikipedia_sockpuppets_of_SyrianObserver2015.csv,473,9157427.0,171,302,166,5,0,63.264270613107826,255,76,43.72938689217759,11
Category_Wikipedia_sockpuppets_of_Jimjim300.csv,422,17724734.0,155,267,84,71,0,44.334123222748815,238,43,15.556872037914692,3
Category_Wikipedia_sockpuppets_of_MarkStreet.csv,344,2439654.0,158,186,156,2,0,29.593023255813954,133,32,18.273255813953487,10
Category_Wikipedia_sockpuppets_of_Amlomat372.csv,43,1416551.0,33,10,22,11,5,41.13953488372093,223,33,33.0,33
Category_Wikipedia_sockpuppets_of_Charmedfan17.csv,128,12855548.0,37,91,10,27,0,51.1640625,248,61,16.09375,7
Category_Wikipedia_sockpuppets_of_Saadsalman37.csv,118,29522014.0,29,89,29,0,0,62.19491525423729,254,74,18.66949152542373,7
Category_Wikipedia_sockpuppets_of_Niama13.csv,29,200641.0,16,13,6,10,0,35.06896551724138,199,21,20.79310344827586,20
Category_Wikipedia_sockpuppets_of_SillyPotatoe.csv,932,24344293.0,314,618,289,25,0,48.80901287553648,255,63,22.563304721030043,6
Category_Wikipedia_sockpuppets_of_Fresh2dethsts.csv,81,1274516.0,44,37,42,2,0,32.75308641975309,199,32,21.493827160493826,18
Category_Wikipedia_sockpuppets_of_Peckduck.csv,24,101256.0,7,17,7,0,0,63.916666666666664,198,21,10.5,6
Category_Wikipedia_sockpuppets_of_AbioScientistGenesis.csv,552,10184497.0,203,349,63,140,0,62.23913043478261,254,64,21.019927536231883,6
Category_Wikipedia_sockpuppets_of_Militaryfactchecker.csv,1676,7394486.0,708,968,500,208,0,48.90035799522673,346,95,33.152147971360385,9
Category_Wikipedia_sockpuppets_of_Christian2941.csv,14886,207729264.0,4341,10545,339,4002,0,32.098414617761655,255,71,17.189506919252988,3
Category_Wikipedia_sockpuppets_of_Cloverbeatme!!.csv,228,4219229.0,73,155,73,0,0,33.776315789473685,225,51,19.13157894736842,6
Category_Wikipedia_sockpuppets_of_Pazyryk5644.csv,29,2177965.0,13,16,9,4,0,31.75862068965517,128,23,18.724137931034484,15
Category_Wikipedia_sockpuppets_of_LewisWright444.csv,28,5020405.0,11,17,11,0,0,68.71428571428571,230,50,34.785714285714285,24
Category_Wikipedia_sockpuppets_of_591J.csv,208,57539518.0,71,137,66,5,0,53.88461538461539,241,50,17.20673076923077,11
Category_Wikipedia_sockpuppets_of_Subhanmia.csv,278,182127140.0,105,173,95,10,0,41.31654676258993,370,32,17.37769784172662,10
Category_Wikipedia_sockpuppets_of_Qkorbit.csv,471,3046264.0,152,319,140,12,0,51.47133757961783,398,46,16.830148619957537,5
Category_Wikipedia_sockpuppets_of_Edday1051.csv,2183,214612676.0,695,1488,500,195,0,40.04351809436555,256,82,18.3957856161246,7
Category_Wikipedia_sockpuppets_of_Dstern1.csv,1568,488565154.0,428,1140,428,0,0,53.42857142857143,486,58,19.45344387755102,6
Category_Wikipedia_sockpuppets_of_TheNewHubris.csv,369,100961634.0,89,280,37,52,0,36.70189701897019,255,54,15.672086720867208,5
Category_Wikipedia_sockpuppets_of_Fly_High_in_the_Sky.csv,2836,33394851.0,1024,1812,379,645,0,43.698871650211565,439,65,23.15937940761636,4
Category_Wikipedia_sockpuppets_of_Jameslovesavril.csv,1072,15131677.0,297,775,135,162,0,48.14832089552239,228,44,17.707089552238806,4
Category_Wikipedia_sockpuppets_of_Marketingguru.csv,12,2521233.0,4,8,3,1,5,53.083333333333336,117,23,14.666666666666666,7
Category_Wikipedia_sockpuppets_of_Ameliastaron12.csv,644,7254080.0,188,456,62,126,0,51.15527950310559,301,29,13.048136645962733,3
Category_Wikipedia_sockpuppets_of_ESE150.csv,566,498665849.0,182,384,75,107,0,45.29681978798587,268,55,24.02296819787986,7
Category_Wikipedia_sockpuppets_of_Regulaminer.csv,9,61563.0,4,5,3,1,0,37.44444444444444,174,18,16.11111111111111,13
Category_Wikipedia_sockpuppets_of_Jayakumar_vj.csv,18,126275668.0,17,1,12,5,0,21.944444444444443,196,17,11.666666666666666,11
Category_Wikipedia_sockpuppets_of_Elian_Justin.csv,184,2258821.0,62,122,26,36,0,56.42934782608695,225,56,22.880434782608695,4
Category_Wikipedia_sockpuppets_of_WoldoKid.csv,6,367.0,3,3,3,0,0,89.83333333333333,203,30,25.0,15
Category_Wikipedia_sockpuppets_of_Adrian_Fletcher.csv,1488,8421666.0,541,947,291,250,0,39.409274193548384,244,63,22.04233870967742,5
Category_Wikipedia_sockpuppets_of_Manu31415.csv,395,282964200.0,141,254,132,9,0,58.24810126582278,284,64,25.10379746835443,4
Category_Wikipedia_sockpuppets_of_Smagzine.csv,115,61541448.0,39,76,13,26,0,51.48695652173913,222,53,19.339130434782607,3
Category_Wikipedia_sockpuppets_of_F-16_Viper.csv,3357,158029896.0,964,2393,410,554,0,54.32171581769437,261,54,23.092046470062556,4
Category_Wikipedia_sockpuppets_of_Warmanuser.csv,878,16088651.0,217,661,34,183,0,48.56378132118451,494,41,15.562642369020502,3
Category_Wikipedia_sockpuppets_of_Zgshockz.csv,6,64055.0,5,1,3,2,16,50.5,217,18,18.0,18
Category_Wikipedia_sockpuppets_of_Mecha_Bieber.csv,807,34169063.0,299,508,186,113,0,47.75712515489467,255,93,21.9454770755886,3
Category_Wikipedia_sockpuppets_of_Niqabu.csv,3030,24678953.0,994,2036,500,494,0,47.5937293729373,453,60,20.45907590759076,3
Category_Wikipedia_sockpuppets_of_Tvuds.csv,945,19425059.0,367,578,25,342,0,40.024338624338625,400,56,26.84973544973545,10
Category_Wikipedia_sockpuppets_of_Iamafanofpizza.csv,230,999409.0,78,152,74,4,0,66.74782608695652,254,34,17.18695652173913,5
Category_Wikipedia_sockpuppets_of_Cobbyannor.csv,115,190356493.0,35,80,28,7,0,63.8,499,54,25.765217391304347,10
Category_Wikipedia_sockpuppets_of_Lonwolve.csv,1467,538197184.0,436,1031,229,207,0,61.80640763462849,440,57,20.10565780504431,3
Category_Wikipedia_sockpuppets_of_FreeatlastChitchat.csv,4061,134313160.0,1500,2561,500,1000,0,68.95838463432652,405,105,31.09480423541,5
Category_Wikipedia_sockpuppets_of_07Ziad.csv,48,3900730.0,16,32,16,0,0,51.9375,321,61,25.833333333333332,7
Category_Wikipedia_sockpuppets_of_Carbomarx.csv,553,1445888.0,152,401,56,96,0,64.30922242314648,500,41,16.55515370705244,5
Category_Wikipedia_sockpuppets_of_Odwane.csv,12,9940138.0,4,8,4,0,0,36.666666666666664,122,46,28.666666666666668,5
Category_Wikipedia_sockpuppets_of_Gbhundar.csv,76,35270593.0,50,26,43,7,0,38.73684210526316,247,41,24.644736842105264,13
Category_Wikipedia_sockpuppets_of_WJH1992.csv,7504,460626396.0,1795,5709,500,1295,0,37.86660447761194,322,65,14.111673773987206,3
Category_Wikipedia_sockpuppets_of_Khogendrarupini.csv,17,346120.0,8,9,4,4,0,30.352941176470587,95,53,40.294117647058826,21
Category_Wikipedia_sockpuppets_of_Tertulius.csv,1717,141841945.0,621,1096,500,121,0,39.445544554455445,259,61,15.177052999417588,4
Category_Wikipedia_sockpuppets_of_Vishwanatha_Badikana.csv,479,322785068.0,176,303,156,20,0,42.44050104384134,496,49,18.346555323590813,5
Category_Wikipedia_sockpuppets_of_Herpes1234.csv,3,2508614.0,2,1,1,1,48,110.0,224,9,9.0,9
Category_Wikipedia_sockpuppets_of_Tylene_Rose.csv,53,1078174.0,18,35,9,9,0,47.79245283018868,169,43,22.58490566037736,12
Category_Wikipedia_sockpuppets_of_Alexanderwasgreat.csv,5,67949.0,4,1,4,0,0,22.8,114,15,15.0,15
Category_Wikipedia_sockpuppets_of_Arbdrahim.csv,42,171214.0,19,23,19,0,0,33.61904761904762,124,39,24.785714285714285,13
Category_Wikipedia_sockpuppets_of_Grapezxd.csv,11,1618.0,7,4,6,1,35,91.36363636363636,213,8,8.0,8
Category_Wikipedia_sockpuppets_of_Rainbow_Contest.csv,3,389.0,2,1,2,0,26,29.333333333333332,31,29,15.0,8
Category_Wikipedia_sockpuppets_of_Bembo_Bold.csv,384,403607876.0,97,287,86,11,0,55.1171875,248,62,20.734375,5
Category_Wikipedia_sockpuppets_of_BonGens.csv,518,48032868.0,127,391,84,43,0,39.63899613899614,220,61,18.71814671814672,3
Category_Wikipedia_sockpuppets_of_Sharifsadik.csv,124,258243864.0,47,77,47,0,0,20.330645161290324,146,39,20.330645161290324,8
Category_Wikipedia_sockpuppets_of_Farooqdxb.csv,18,2726447.0,11,7,6,5,0,53.77777777777778,256,13,13.0,13
Category_Wikipedia_sockpuppets_of_Iloveturtles41.csv,47,855053.0,15,32,12,3,0,51.659574468085104,201,33,16.382978723404257,4
"Category_Wikipedia_sockpuppets_of_Camillo_Ricordi,_M.D..csv",41,3387994.0,18,23,9,9,0,36.34146341463415,158,23,19.48780487804878,15
Category_Wikipedia_sockpuppets_of_Darcruz_iyari.csv,25,11926440.0,8,17,5,3,0,37.28,123,34,23.12,9
Category_Wikipedia_sockpuppets_of_InsideratThames.csv,3,374099.0,2,1,1,1,0,11.0,33,20,20.0,20
Category_Wikipedia_sockpuppets_of_Jackosn7775.csv,144,26507802.0,49,95,42,7,0,46.05555555555556,224,49,25.79861111111111,6
Category_Wikipedia_sockpuppets_of_The_Professor_M.csv,7,431.0,3,4,3,0,19,81.71428571428571,169,30,20.0,16
Category_Wikipedia_sockpuppets_of_GoneGetOneForm.csv,727,8574387.0,203,524,40,163,0,61.672627235213206,320,30,10.039889958734525,3
Category_Wikipedia_sockpuppets_of_TruthCrusader.csv,1474,51204642.0,501,973,500,1,0,37.30800542740841,201,107,27.439620081411125,4
Category_Wikipedia_sockpuppets_of_JackMack67.csv,24,71225.0,14,10,12,2,0,54.625,195,34,18.291666666666668,3
Category_Wikipedia_sockpuppets_of_Mathaing_Anyor.csv,14,948287.0,4,10,2,2,0,44.214285714285715,115,41,27.642857142857142,10
Category_Wikipedia_sockpuppets_of_Viralvilla.csv,39,49647351.0,10,29,9,1,0,57.07692307692308,224,20,7.6923076923076925,5
Category_Wikipedia_sockpuppets_of_Amar_Singh_Okk.csv,783,21275079.0,273,510,160,113,0,49.12899106002554,272,30,10.268199233716475,7
Category_Wikipedia_sockpuppets_of_MidnightBlueMan.csv,3850,506233564.0,1086,2764,500,586,0,55.96779220779221,497,69,23.39766233766234,3
Category_Wikipedia_sockpuppets_of_Nbckfkh.csv,228,33548133.0,87,141,29,58,0,41.37280701754386,274,50,19.609649122807017,4
Category_Wikipedia_sockpuppets_of_Eh_Doh.csv,1651,46657325.0,829,822,230,599,0,35.8885523924894,259,53,21.419745608721986,4
Category_Wikipedia_sockpuppets_of_Lhistoire.csv,65,745153.0,28,37,23,5,0,74.13846153846154,225,36,16.107692307692307,4
Category_Wikipedia_sockpuppets_of_Arniep.csv,4446,58613617.0,1033,3413,500,533,0,39.47300944669366,237,55,16.418803418803417,3
Category_Wikipedia_sockpuppets_of_MalteseFlamingo.csv,95,34363427.0,27,68,21,6,0,33.94736842105263,255,34,19.810526315789474,3
Category_Wikipedia_sockpuppets_of_Antonypricefashion.csv,257,3977237.0,148,109,92,56,0,32.12451361867704,235,41,19.622568093385215,12
Category_Wikipedia_sockpuppets_of_BigMattyO.csv,1734,401787096.0,599,1135,500,99,0,55.06632064590542,497,53,14.713379469434832,2
Category_Wikipedia_sockpuppets_of_Mr._Curious_Man.csv,248,17839722.0,76,172,44,32,0,50.37903225806452,255,61,24.129032258064516,11
Category_Wikipedia_sockpuppets_of_Nasteewun.csv,128,24732259.0,56,72,42,14,0,55.875,480,34,21.296875,8
Category_Wikipedia_sockpuppets_of_Joebutchwiki.csv,59,147075752.0,21,38,19,2,0,63.559322033898304,251,22,14.932203389830509,14
Category_Wikipedia_sockpuppets_of_JWJustinianotheGreat.csv,154,7021525.0,46,108,13,33,0,68.28571428571429,396,73,20.954545454545453,4
Category_Wikipedia_sockpuppets_of_Ajibawls.csv,16,5418651.0,9,7,6,3,0,33.1875,174,31,27.0625,22
Category_Wikipedia_sockpuppets_of_Fatevan1.csv,137,14949111.0,29,108,10,19,0,42.57664233576642,199,33,15.299270072992702,3
Category_Wikipedia_sockpuppets_of_BusinessBird.csv,8,937.0,5,3,4,1,0,58.875,207,20,20.0,20
Category_Wikipedia_sockpuppets_of_Ghoyt98.csv,3,3975.0,3,0,3,0,0,2.3333333333333335,7,17,17.0,17
Category_Wikipedia_sockpuppets_of_DailyWikiHelp.csv,1941,5788204.0,686,1255,318,368,0,41.183925811437405,250,74,20.213292117465222,3
Category_Wikipedia_sockpuppets_of_Gamer10101.csv,166,61195072.0,61,105,61,0,0,43.13855421686747,238,25,16.63855421686747,3
Category_Wikipedia_sockpuppets_of_Elavarasan.p.csv,44,3679.0,13,31,9,4,0,53.18181818181818,202,43,29.704545454545453,12
Category_Wikipedia_sockpuppets_of_Couilles.csv,76,1206784.0,19,57,11,8,0,47.171052631578945,166,28,13.013157894736842,3
Category_Wikipedia_sockpuppets_of_Dorama285.csv,1453,9916826.0,569,884,500,69,0,46.07570543702684,365,85,28.81899518238128,6
Category_Wikipedia_sockpuppets_of_Kendrajordan.csv,136,2074881.0,41,95,34,7,0,44.94117647058823,238,36,13.110294117647058,5
Category_Wikipedia_sockpuppets_of_SidneyDizon.csv,18,6415480.0,14,4,14,0,0,28.833333333333332,262,13,13.0,13
Category_Wikipedia_sockpuppets_of_COLTashrif1499.csv,1969,9347921.0,665,1304,500,165,0,35.73031995937024,500,50,17.73336719146775,5
Category_Wikipedia_sockpuppets_of_JakeTheDog101010134.csv,14,1330.0,5,9,5,0,0,60.07142857142857,163,24,17.571428571428573,12
Category_Wikipedia_sockpuppets_of_Drfazeelaabbasiofficial.csv,10,4895794.0,3,7,2,1,10,80.0,207,23,19.5,16
Category_Wikipedia_sockpuppets_of_Puneetsinghbb.csv,197,78778758.0,91,106,79,12,0,36.95939086294416,197,34,24.67005076142132,14
Category_Wikipedia_sockpuppets_of_Mr.chinmayroy.csv,59,20146779.0,17,42,13,4,0,47.23728813559322,189,53,32.45762711864407,16
Category_Wikipedia_sockpuppets_of_CinemaProductions.csv,1,0.0,1,0,1,0,0,0.0,0,20,20.0,20
Category_Wikipedia_sockpuppets_of_Meegvun.csv,57,270446.0,24,33,14,10,0,32.36842105263158,116,63,47.666666666666664,12
Category_Wikipedia_sockpuppets_of_Realizehow.csv,123,11733802.0,56,67,50,6,0,37.609756097560975,247,32,19.67479674796748,11
Category_Wikipedia_sockpuppets_of_Sdg100.csv,2334,15454438.0,713,1621,500,213,0,44.455441302485006,437,57,21.29005998286204,3
Category_Wikipedia_sockpuppets_of_Jenos450.csv,906,22413620.0,303,603,249,54,0,58.16777041942605,467,43,18.431567328918323,5
Category_Wikipedia_sockpuppets_of_LisaSandford.csv,22766,78734239.0,5319,17447,500,4819,0,41.8443731880875,250,74,16.208029517701835,3
Category_Wikipedia_sockpuppets_of_The_Mathworld_Sock.csv,109,266207.0,69,40,28,41,0,31.862385321100916,163,45,24.559633027522935,11
Category_Wikipedia_sockpuppets_of_Alekisok.csv,12,29295344.0,8,4,4,4,0,55.083333333333336,245,26,19.5,18
Category_Wikipedia_sockpuppets_of_TheTimesAreAChanging.csv,2418,232401641.0,504,1914,500,4,0,78.04011579818031,500,88,22.28205128205128,5
Category_Wikipedia_sockpuppets_of_RaePageantEnthusiast.csv,21,312391.0,9,12,8,1,0,26.285714285714285,71,25,23.142857142857142,9
Category_Wikipedia_sockpuppets_of_Kapol9999.csv,60,873286.0,25,35,6,19,0,70.86666666666666,280,54,19.4,11
Category_Wikipedia_sockpuppets_of_HappyTreeFriendsYesCuriousGeorgeNo.csv,92,14383877.0,21,71,12,9,0,52.95652173913044,235,36,17.42391304347826,5
Category_Wikipedia_sockpuppets_of_MalikPeters.csv,137,2335238.0,43,94,14,29,0,39.59124087591241,196,47,22.963503649635037,16
Category_Wikipedia_sockpuppets_of_Echo2019a.csv,320,122520127.0,133,187,125,8,0,47.0875,496,50,16.6875,5
Category_Wikipedia_sockpuppets_of_FGNE.csv,55,2036238.0,35,20,18,17,0,44.96363636363636,213,35,18.836363636363636,9
Category_Wikipedia_sockpuppets_of_Yasis.csv,2350,106205769.0,500,1850,500,0,0,32.86595744680851,236,63,19.68212765957447,3
Category_Wikipedia_sockpuppets_of_Kenrickngatasha.csv,2427,92074427.0,895,1532,500,395,0,34.801812937783275,316,78,23.630407911001235,3
Category_Wikipedia_sockpuppets_of_Gerry_Boh√≥rquez.csv,521,14775090.0,128,393,119,9,0,37.092130518234164,496,32,16.610364683301345,4
Category_Wikipedia_sockpuppets_of_Pramit4isb.csv,49,9759765.0,13,36,6,7,0,57.224489795918366,208,26,22.0,15
Category_Wikipedia_sockpuppets_of_Ganeshhingmire.csv,12,270292.0,12,0,12,0,0,35.916666666666664,196,27,26.333333333333332,19
Category_Wikipedia_sockpuppets_of_Yourname.csv,2777,83064162.0,1301,1476,500,801,0,55.50270075621174,249,63,22.7144400432121,4
Category_Wikipedia_sockpuppets_of_Extreme_Baller.csv,355,13526511.0,89,266,31,58,0,48.91549295774648,201,50,17.861971830985915,5
Category_Wikipedia_sockpuppets_of_Sdgovt.csv,117,787926.0,75,42,25,50,0,39.63247863247863,196,40,22.316239316239315,10
Category_Wikipedia_sockpuppets_of_Swagsevo.csv,392,192517394.0,132,260,91,41,0,53.83673469387755,324,41,16.864795918367346,9
Category_Wikipedia_sockpuppets_of_DLA9999.csv,65,10381485.0,55,10,41,14,0,29.815384615384616,142,17,13.0,12
Category_Wikipedia_sockpuppets_of_Cgx8253.csv,3391,79863175.0,1132,2259,500,632,0,44.884104983780595,500,66,16.841049837805958,3
Category_Wikipedia_sockpuppets_of_Sbambling.csv,8,21054.0,7,1,7,0,0,28.125,185,20,20.0,20
Category_Wikipedia_sockpuppets_of_Wikimaster84.csv,68,6131530.0,14,54,7,7,0,49.911764705882355,199,42,28.764705882352942,9
Category_Wikipedia_sockpuppets_of_Youngblake123.csv,20,2291.0,10,10,10,0,13,40.1,141,18,12.35,8
Category_Wikipedia_sockpuppets_of_Rohitmishra01.csv,971,13991788.0,399,572,210,189,0,40.558187435633364,376,53,28.938208032955714,5
Category_Wikipedia_sockpuppets_of_LibraD89.csv,59,4415060.0,23,36,18,5,0,38.83050847457627,168,47,24.220338983050848,13
Category_Wikipedia_sockpuppets_of_Taimurijaz97.csv,1982,5354815.0,791,1191,500,291,0,53.78557013118063,255,89,34.31231079717457,4
Category_Wikipedia_sockpuppets_of_Kamenaua.csv,137,10031675.0,35,102,28,7,0,40.07299270072993,200,47,21.817518248175183,6
Category_Wikipedia_sockpuppets_of_Patmosko12.csv,162,77904981.0,77,85,49,28,0,42.44444444444444,244,51,22.90740740740741,13
Category_Wikipedia_sockpuppets_of_Ptoone.csv,300,172656541.0,65,235,63,2,0,39.42666666666667,229,36,24.84,11
Category_Wikipedia_sockpuppets_of_Kyladcarter.csv,120,84036694.0,34,86,23,11,0,44.06666666666667,241,43,22.366666666666667,11
Category_Wikipedia_sockpuppets_of_HungarianMedic.csv,34,2995.0,19,15,8,11,0,28.029411764705884,132,40,22.058823529411764,12
Category_Wikipedia_sockpuppets_of_Serg_Prym.csv,39,599654.0,20,19,10,10,0,42.53846153846154,270,34,20.94871794871795,7
Category_Wikipedia_sockpuppets_of_CaptainLouie.csv,12,20068.0,7,5,6,1,16,110.16666666666667,179,14,10.5,6
Category_Wikipedia_sockpuppets_of_1917_Darwin.csv,300,8428246.0,105,195,65,40,0,56.74333333333333,250,42,16.57,5
Category_Wikipedia_sockpuppets_of_Circusofdeath.csv,20,2900947.0,10,10,7,3,0,80.45,178,25,12.1,6
Category_Wikipedia_sockpuppets_of_Shaneking561.csv,18,29628.0,7,11,5,2,0,73.38888888888889,192,35,22.72222222222222,17
Category_Wikipedia_sockpuppets_of_Mikemikev.csv,5507,348106835.0,1832,3675,500,1332,0,54.428727074632285,498,96,27.84401670601053,3
Category_Wikipedia_sockpuppets_of_Gonzales_John.csv,3868,30768985.0,1184,2684,500,684,0,58.31592554291623,255,57,14.539555325749742,3
Category_Wikipedia_sockpuppets_of_Biancasuarez.csv,3715,65013154.0,1087,2628,374,713,0,38.14616419919246,495,59,19.9835800807537,8
Category_Wikipedia_sockpuppets_of_Cultology.csv,10,75218.0,5,5,4,1,0,48.2,178,25,20.6,14
Category_Wikipedia_sockpuppets_of_SwissArmyGuy.csv,7688,133667573.0,1915,5773,500,1415,0,54.68275234131114,511,88,21.462148803329864,3
Category_Wikipedia_sockpuppets_of_Commissioner_Gordon.csv,468,5923999.0,174,294,159,15,0,62.1474358974359,255,55,27.944444444444443,14
Category_Wikipedia_sockpuppets_of_Kobilsisgay.csv,3,649.0,2,1,1,1,12,57.666666666666664,149,7,7.0,7
Category_Wikipedia_sockpuppets_of_MyraBrady.csv,32,392523.0,14,18,9,5,0,40.25,172,42,32.5625,19
Category_Wikipedia_sockpuppets_of_Matthew_Winter.csv,573,43287746.0,187,386,96,91,0,41.181500872600346,243,57,20.267015706806284,2
Category_Wikipedia_sockpuppets_of_Stickymun34.csv,54,5615348.0,32,22,15,17,0,25.666666666666668,213,30,18.59259259259259,11
Category_Wikipedia_sockpuppets_of_Amir'khan12.csv,1456,143358057.0,429,1027,69,360,0,42.5885989010989,395,51,15.914835164835164,6
Category_Wikipedia_sockpuppets_of_Sachinrangda.csv,43,3210332.0,30,13,9,21,0,80.30232558139535,195,24,23.093023255813954,23
Category_Wikipedia_sockpuppets_of_Tainted_Ice.csv,25,23364825.0,14,11,12,2,0,32.36,187,23,20.6,13
Category_Wikipedia_sockpuppets_of_Seraphim_System.csv,6685,71738530.0,1708,4977,500,1208,0,55.79132385938669,500,78,15.437995512341063,2
Category_Wikipedia_sockpuppets_of_Alvandria.csv,4298,9510098.0,1495,2803,500,995,0,42.644253140995815,265,70,20.233131689157748,3
Category_Wikipedia_sockpuppets_of_Abonsap1.csv,547,156051835.0,192,355,82,110,0,54.29067641681901,406,61,25.53016453382084,9
Category_Wikipedia_sockpuppets_of_Jordanene7.csv,3228,135313485.0,714,2514,168,546,0,47.8822800495663,500,69,19.778500619578686,3
Category_Wikipedia_sockpuppets_of_ChristianBk.csv,1324,99453304.0,340,984,329,11,0,50.04607250755287,201,57,20.380664652567976,3
Category_Wikipedia_sockpuppets_of_Shewasafairy.csv,1904,2066945.0,1000,904,500,500,0,72.60189075630252,497,76,28.5,4
Category_Wikipedia_sockpuppets_of_Dbzsamuele.csv,1242,70977512.0,530,712,500,30,0,30.219806763285025,207,50,16.400161030595815,3
Category_Wikipedia_sockpuppets_of_Gandavien.csv,7,15919.0,4,3,4,0,0,15.0,41,19,19.0,19
Category_Wikipedia_sockpuppets_of_Wikiemirati.csv,2657,38815611.0,854,1803,500,354,0,53.59766654121189,497,97,24.225065863756114,4
Category_Wikipedia_sockpuppets_of_Konguhead.csv,271,68275264.0,101,170,64,37,0,66.84132841328413,453,51,13.214022140221402,7
Category_Wikipedia_sockpuppets_of_Iamsandhujatt.csv,188,17125019.0,66,122,16,50,0,41.68617021276596,241,34,19.44148936170213,5
Category_Wikipedia_sockpuppets_of_Deterence.csv,1551,6044287.0,521,1030,500,21,0,43.10831721470019,243,92,33.49129593810445,10
Category_Wikipedia_sockpuppets_of_Rhoda_mano.csv,46,38321193.0,31,15,29,2,0,30.108695652173914,255,26,25.347826086956523,20
Category_Wikipedia_sockpuppets_of_HansF√ºller.csv,192,13407365.0,65,127,29,36,0,60.630208333333336,311,47,17.015625,4
Category_Wikipedia_sockpuppets_of_Pug_of_the_day.csv,3213,149177356.0,1239,1974,500,739,0,57.45222533457827,496,69,19.345160286336757,4
Category_Wikipedia_sockpuppets_of_PicassoPlent.csv,1206,617444.0,344,862,249,95,0,73.86567164179104,497,54,22.16169154228856,5
Category_Wikipedia_sockpuppets_of_X-static.csv,204,148675423.0,75,129,63,12,0,36.40686274509804,255,42,17.372549019607842,6
Category_Wikipedia_sockpuppets_of_·Éí·Éò·Éù·É†·Éí·Éò172.csv,1395,32322590.0,613,782,227,386,0,34.83512544802868,500,54,27.810752688172045,3
Category_Wikipedia_sockpuppets_of_Maruf_Zamann.csv,138,4803420.0,54,84,25,29,0,29.797101449275363,494,52,18.73913043478261,5
Category_Wikipedia_sockpuppets_of_Newsfeed013.csv,143,10427150.0,74,69,62,12,0,36.6013986013986,177,34,26.615384615384617,16
Category_Wikipedia_sockpuppets_of_JP_Youtube.csv,84,1390853.0,34,50,18,16,0,39.916666666666664,188,27,13.773809523809524,4
Category_Wikipedia_sockpuppets_of_TJ9295.csv,189,3979575.0,93,96,54,39,0,36.95238095238095,289,46,24.3015873015873,8
Category_Wikipedia_sockpuppets_of_Gramjames.csv,5,37880.0,3,2,3,0,0,21.2,34,25,20.2,17
Category_Wikipedia_sockpuppets_of_LindaPaul.csv,45,901277.0,20,25,20,0,0,51.86666666666667,255,53,20.2,13
Category_Wikipedia_sockpuppets_of_Heili_M..csv,87,33906476.0,32,55,25,7,0,29.160919540229884,179,59,20.39080459770115,10
Category_Wikipedia_sockpuppets_of_Error_365.csv,235,9745357.0,138,97,126,12,0,36.38723404255319,255,51,17.927659574468084,14
Category_Wikipedia_sockpuppets_of_Kevorkmail.csv,1666,34640252.0,635,1031,500,135,0,38.47779111644658,247,63,16.509603841536613,4
Category_Wikipedia_sockpuppets_of_Priya_jain1002001.csv,41,1105074.0,18,23,15,3,0,55.170731707317074,229,27,9.560975609756097,5
Category_Wikipedia_sockpuppets_of_Ioanna.hearts.you.csv,100,84696121.0,27,73,19,8,0,48.1,255,27,11.03,9
Category_Wikipedia_sockpuppets_of_Fanoftheworld.csv,5440,263404364.0,1968,3472,500,1468,0,43.15606617647059,519,72,20.977757352941175,3
Category_Wikipedia_sockpuppets_of_Cyclebiker.csv,13,5429967.0,3,10,2,1,0,50.0,182,13,11.461538461538462,8
Category_Wikipedia_sockpuppets_of_Aaroncrick.csv,1757,476797448.0,516,1241,500,16,0,53.304496300512234,500,111,19.796812749003983,5
Category_Wikipedia_sockpuppets_of_Michaellko.csv,1318,154706125.0,725,593,500,225,0,39.18437025796661,255,51,22.84370257966616,7
Category_Wikipedia_sockpuppets_of_Sharkguy05.csv,74,31426.0,46,28,46,0,0,45.810810810810814,391,59,31.22972972972973,17
Category_Wikipedia_sockpuppets_of_Mikskellman.csv,20,184031.0,13,7,6,7,0,37.7,72,46,22.95,6
Category_Wikipedia_sockpuppets_of_George_Hammer_3.csv,72,6572204.0,25,47,23,2,0,46.65277777777778,196,53,28.76388888888889,6
Category_Wikipedia_sockpuppets_of_CIyde.csv,379,64802217.0,88,291,30,58,0,50.598944591029024,200,63,16.852242744063325,5
Category_Wikipedia_sockpuppets_of_Warning_Man09.csv,75,7610588.0,53,22,53,0,0,52.04,196,58,23.08,14
Category_Wikipedia_sockpuppets_of_LaneFrost00.csv,1006,28536181.0,649,357,500,149,0,31.634194831013918,496,51,20.430417495029822,9
Category_Wikipedia_sockpuppets_of_Pantazis_Jr..csv,14,3596546.0,8,6,4,4,0,57.214285714285715,196,37,27.785714285714285,22
Category_Wikipedia_sockpuppets_of_Blocksoftruth.csv,13,10115.0,12,1,9,3,0,0.0,0,11,11.0,11
Category_Wikipedia_sockpuppets_of_B_therian.csv,9,520.0,5,4,3,2,0,63.0,220,14,14.0,14
Category_Wikipedia_sockpuppets_of_HaroonJamil95.csv,1,0.0,1,0,1,0,0,0.0,0,23,23.0,23
Category_Wikipedia_sockpuppets_of_Brian_G._Crawford.csv,2273,17263146.0,798,1475,500,298,0,29.44918609766828,200,107,27.094588649362077,3
Category_Wikipedia_sockpuppets_of_Shahid.ki.mom.ka.yar.csv,220,263677.0,70,150,19,51,0,69.36363636363636,200,40,14.059090909090909,4
Category_Wikipedia_sockpuppets_of_Bambifan101.csv,22471,452562703.0,6313,16158,500,5813,0,43.64020292821859,498,167,21.8840728049486,2
Category_Wikipedia_sockpuppets_of_Rachelmears.csv,19,604250.0,8,11,5,3,0,62.26315789473684,151,59,20.789473684210527,10
Category_Wikipedia_sockpuppets_of_Gatomasgordo.csv,1211,356591110.0,508,703,500,8,0,48.62180016515276,255,62,21.813377374071017,7
Category_Wikipedia_sockpuppets_of_Frost_joyce.csv,2326,282267992.0,878,1448,447,431,0,54.81685296646604,358,75,20.879191745485812,4
Category_Wikipedia_sockpuppets_of_Sibbu_Suryan.csv,33,4608565.0,13,20,9,4,0,38.696969696969695,196,30,22.151515151515152,20
Category_Wikipedia_sockpuppets_of_Jacurek.csv,2520,100992476.0,745,1775,500,245,0,45.805952380952384,250,73,21.889285714285716,4
Category_Wikipedia_sockpuppets_of_PapaJeckloy.csv,1515,3823979.0,618,897,500,118,0,33.8046204620462,255,102,27.908250825082508,4
Category_Wikipedia_sockpuppets_of_Bernie_Sama.csv,108,283763.0,45,63,32,13,0,42.092592592592595,444,30,18.12037037037037,6
Category_Wikipedia_sockpuppets_of_Lokicat3345.csv,1265,28932009.0,652,613,157,495,0,45.92094861660079,455,96,32.47826086956522,8
Category_Wikipedia_sockpuppets_of_Adam_Knapp_47.csv,2,0.0,1,1,1,0,49,49.0,49,17,17.0,17
Category_Wikipedia_sockpuppets_of_LumpiElefant.csv,1620,47699169.0,512,1108,288,224,0,40.13333333333333,500,60,21.940123456790122,3
Category_Wikipedia_sockpuppets_of_Richardbrason.csv,60,22760526.0,32,28,20,12,0,66.93333333333334,250,37,18.066666666666666,8
Category_Wikipedia_sockpuppets_of_BLPEnforcer.csv,42,1843400.0,16,26,6,10,0,59.5,192,55,51.88095238095238,26
Category_Wikipedia_sockpuppets_of_Van_de_Kemp.csv,590,12709287.0,158,432,108,50,0,50.18135593220339,250,54,16.791525423728814,2
Category_Wikipedia_sockpuppets_of_MuchoNucho.csv,110,2484957.0,46,64,44,2,0,60.10909090909091,280,34,20.463636363636365,6
Category_Wikipedia_sockpuppets_of_Sathish_Kathiravan.csv,2261,5700701.0,882,1379,500,382,0,29.12516585581601,500,43,14.538699690402476,5
Category_Wikipedia_sockpuppets_of_Johnlewisskirt.csv,71,49862496.0,19,52,6,13,0,48.57746478873239,235,31,16.56338028169014,13
Category_Wikipedia_sockpuppets_of_Riejd129.csv,97,2277080.0,38,59,17,21,0,54.670103092783506,229,29,17.4020618556701,14
Category_Wikipedia_sockpuppets_of_West1806.csv,105,17429909.0,58,47,48,10,0,74.17142857142858,248,44,15.40952380952381,9
Category_Wikipedia_sockpuppets_of_Sumantmeena7.csv,127,3542367.0,37,90,17,20,0,59.77952755905512,239,30,16.976377952755904,6
Category_Wikipedia_sockpuppets_of_Dxyx20.csv,3,2000.0,2,1,2,0,0,16.666666666666668,28,27,25.666666666666668,23
Category_Wikipedia_sockpuppets_of_Sidhu_gali.csv,139,949910.0,54,85,25,29,0,55.0,346,37,14.266187050359711,6
Category_Wikipedia_sockpuppets_of_Salah44.csv,976,122435483.0,396,580,334,62,0,34.556352459016395,244,64,21.4375,7
Category_Wikipedia_sockpuppets_of_WikipediaMaster432.csv,13,1466347.0,8,5,2,6,0,32.61538461538461,145,48,42.15384615384615,10
Category_Wikipedia_sockpuppets_of_Novonium.csv,1754,160106120.0,636,1118,500,136,0,57.2594070695553,255,67,18.266818700114026,4
Category_Wikipedia_sockpuppets_of_DashingDark.csv,78,178498.0,44,34,34,10,0,44.76923076923077,371,30,22.192307692307693,17
Category_Wikipedia_sockpuppets_of_Dy11111.csv,140,6650945.0,57,83,55,2,0,50.68571428571428,247,52,22.507142857142856,3
Category_Wikipedia_sockpuppets_of_HarveyTeenager.csv,501,126748143.0,127,374,93,34,0,41.17964071856287,291,50,24.29940119760479,10
Category_Wikipedia_sockpuppets_of_Asgardian.csv,4544,510895523.0,1276,3268,500,776,0,48.498019366197184,389,62,20.432658450704224,5
Category_Wikipedia_sockpuppets_of_DuncanWeir.csv,480,382483247.0,109,371,103,6,0,44.83541666666667,255,57,14.435416666666667,7
Category_Wikipedia_sockpuppets_of_TagSmallPig.csv,103,434287.0,41,62,41,0,0,28.446601941747574,105,34,26.553398058252426,7
Category_Wikipedia_sockpuppets_of_Arthurlawrence1.csv,207,167306887.0,58,149,29,29,0,45.68599033816425,208,54,18.11111111111111,8
Category_Wikipedia_sockpuppets_of_Benfica20.csv,17,1064272.0,12,5,11,1,0,72.05882352941177,157,13,13.0,13
Category_Wikipedia_sockpuppets_of_I_am_Jewish_1998.csv,2772,37632906.0,708,2064,56,652,0,53.46103896103896,500,59,18.57864357864358,6
Category_Wikipedia_sockpuppets_of_Marxistfounder.csv,3811,365737932.0,883,2928,500,383,0,41.0356861716085,448,64,21.591445814746784,3
Category_Wikipedia_sockpuppets_of_OuijaBoardOuijaBoard.csv,497,8636771.0,114,383,52,62,0,40.74647887323944,204,61,20.55533199195171,3
Category_Wikipedia_sockpuppets_of_TonkarLike.csv,2188,2000334.0,766,1422,500,266,0,43.07815356489945,646,57,19.092778793418645,4
Category_Wikipedia_sockpuppets_of_Eickman.csv,857,1981725.0,503,354,500,3,0,48.890315052508754,198,49,26.102683780630105,14
Category_Wikipedia_sockpuppets_of_Krushna_hari.csv,10,127344.0,6,4,4,2,0,37.6,183,17,13.7,6
Category_Wikipedia_sockpuppets_of_BabyJackJack.csv,3,143.0,3,0,3,0,13,17.0,25,22,22.0,22
Category_Wikipedia_sockpuppets_of_Pmn09.csv,78,72321538.0,30,48,19,11,0,54.57692307692308,249,44,17.064102564102566,5
Category_Wikipedia_sockpuppets_of_Croonerman.csv,303,348474647.0,90,213,72,18,0,46.94059405940594,255,52,19.488448844884488,7
Category_Wikipedia_sockpuppets_of_Faster2010.csv,2306,161494137.0,568,1738,500,68,0,42.39071986123157,255,56,21.534258456201215,3
Category_Wikipedia_sockpuppets_of_Fabrical_Synthesis.csv,373,5562691.0,115,258,81,34,0,59.016085790884716,463,54,22.72922252010724,3
Category_Wikipedia_sockpuppets_of_Atikurrahmanmahi2.csv,7,3456653.0,3,4,2,1,6,58.142857142857146,194,21,14.571428571428571,6
Category_Wikipedia_sockpuppets_of_Wikieditorlove.csv,77,32502288.0,29,48,15,14,0,44.37662337662338,196,41,21.857142857142858,14
Category_Wikipedia_sockpuppets_of_Mousumiwebstep.csv,149,10542332.0,59,90,41,18,0,64.97315436241611,255,31,19.34228187919463,8
Category_Wikipedia_sockpuppets_of_Naidu1234.csv,220,25958706.0,88,132,35,53,0,57.96818181818182,254,40,16.12727272727273,5
Category_Wikipedia_sockpuppets_of_For_Our_Nation's_Honor.csv,59,1673166.0,18,41,5,13,0,40.0,165,35,18.864406779661017,9
Category_Wikipedia_sockpuppets_of_Rotnoz.csv,13,55853.0,11,2,6,5,0,23.0,139,20,20.0,20
Category_Wikipedia_sockpuppets_of_Threefrgy.csv,616,29828311.0,180,436,180,0,0,65.54220779220779,499,46,20.092532467532468,5
Category_Wikipedia_sockpuppets_of_MutterErde.csv,2040,140921113.0,540,1500,500,40,0,35.537254901960786,238,79,18.901470588235295,3
Category_Wikipedia_sockpuppets_of_Broz_Nice.csv,5,15013821.0,3,2,2,1,36,63.0,136,22,19.6,19
Category_Wikipedia_sockpuppets_of_SAINTE_NOUR.csv,18,782771.0,14,4,10,4,7,22.833333333333332,60,28,21.0,16
Category_Wikipedia_sockpuppets_of_Geography86.csv,2660,1839720.0,942,1718,500,442,0,34.55676691729323,500,38,14.280075187969924,4
Category_Wikipedia_sockpuppets_of_The_Slavic_Serf.csv,2627,1614954.0,1036,1591,500,536,0,28.51884278644842,391,61,15.914350970688998,3
Category_Wikipedia_sockpuppets_of_Jedamusic.csv,24,77196.0,9,15,6,3,0,58.666666666666664,199,48,19.625,17
Category_Wikipedia_sockpuppets_of_Therachelyoon.csv,14,61823.0,5,9,3,2,0,29.071428571428573,116,46,35.92857142857143,21
Category_Wikipedia_sockpuppets_of_Rtjfan.csv,5928,114848654.0,2341,3587,500,1841,0,35.25944669365722,410,53,16.225371120107962,3
Category_Wikipedia_sockpuppets_of_Bigtothebone.csv,63,817986.0,31,32,27,4,0,80.47619047619048,196,18,13.523809523809524,11
Category_Wikipedia_sockpuppets_of_Dinushan_w77.csv,27,869093.0,14,13,4,10,0,58.629629629629626,196,58,39.407407407407405,15
Category_Wikipedia_sockpuppets_of_The_Pluton.csv,44,3213487.0,12,32,11,1,0,48.02272727272727,199,47,31.477272727272727,14
Category_Wikipedia_sockpuppets_of_Boomclap.csv,32,1920870.0,12,20,12,0,0,51.75,255,21,16.5625,11
Category_Wikipedia_sockpuppets_of_ControItheDogs.csv,169,83533.0,84,85,35,49,0,64.14792899408285,255,54,24.37869822485207,18
Category_Wikipedia_sockpuppets_of_Moheen_Reeyad.csv,993,14402028.0,522,471,500,22,0,45.02114803625378,255,67,24.209466263846927,5
Category_Wikipedia_sockpuppets_of_S426165.csv,23,81341.0,17,6,14,3,0,50.78260869565217,201,19,18.652173913043477,17
Category_Wikipedia_sockpuppets_of_Neoindia.csv,345,14771240.0,69,276,62,7,0,33.04347826086956,193,51,18.391304347826086,4
Category_Wikipedia_sockpuppets_of_Mili977.csv,1253,54775845.0,531,722,500,31,0,51.472466081404626,468,42,10.529130087789305,4
Category_Wikipedia_sockpuppets_of_Hobbes795.csv,112,4318080.0,36,76,26,10,0,39.5,195,25,12.116071428571429,3
Category_Wikipedia_sockpuppets_of_Nixer.csv,3014,14851087.0,1014,2000,500,514,0,30.66688785666888,205,95,22.65129396151294,5
Category_Wikipedia_sockpuppets_of_Lipgon.csv,216,1135454.0,103,113,7,96,0,53.61574074074074,232,28,16.26388888888889,5
Category_Wikipedia_sockpuppets_of_International_Dalit_Solidarity_Network.csv,70,16495.0,35,35,18,17,0,29.771428571428572,198,34,14.428571428571429,5
Category_Wikipedia_sockpuppets_of_Dorpixol.csv,99,3405301.0,35,64,17,18,0,82.14141414141415,304,29,21.515151515151516,14
Category_Wikipedia_sockpuppets_of_Reubenthum.csv,27,10551531.0,18,9,11,7,0,44.2962962962963,188,20,12.11111111111111,9
Category_Wikipedia_sockpuppets_of_SBRaps.csv,148,6378173.0,48,100,10,38,0,32.91216216216216,255,68,28.35810810810811,10
Category_Wikipedia_sockpuppets_of_31415.csv,44,1038273.0,20,24,18,2,0,37.75,198,17,14.204545454545455,10
Category_Wikipedia_sockpuppets_of_K√∂lnerDompfaff.csv,125,2437353.0,70,55,62,8,0,38.6,217,17,12.256,6
Category_Wikipedia_sockpuppets_of_SeaScuirtsFaDina.4.csv,4,92029.0,2,2,1,1,0,112.5,196,28,24.5,21
Category_Wikipedia_sockpuppets_of_Thelegendaryb.csv,835,10697234.0,213,622,133,80,0,44.33652694610778,370,40,14.402395209580838,5
Category_Wikipedia_sockpuppets_of_Gilabrand.csv,5155,417823870.0,1533,3622,500,1033,0,49.00349175557711,492,78,17.286517943743938,3
Category_Wikipedia_sockpuppets_of_Osmanmisri.csv,27,2913734.0,10,17,6,4,0,84.96296296296296,196,31,17.48148148148148,9
Category_Wikipedia_sockpuppets_of_Bleek25.csv,1116,11540749.0,302,814,302,0,0,40.034946236559136,248,83,20.983870967741936,8
Category_Wikipedia_sockpuppets_of_Phil_A._Fry.csv,3939,184980833.0,813,3126,500,313,0,54.373698908352374,500,45,14.45976136075146,3
Category_Wikipedia_sockpuppets_of_AMenaceTrey05.csv,6,230089.0,4,2,2,2,0,66.66666666666667,157,23,23.0,23
Category_Wikipedia_sockpuppets_of_MWS.csv,965,421042501.0,288,677,259,29,0,42.47150259067357,255,69,18.735751295336787,3
Category_Wikipedia_sockpuppets_of_Pichu8boy.csv,2024,282892364.0,513,1511,500,13,0,39.330533596837945,258,62,21.17094861660079,4
Category_Wikipedia_sockpuppets_of_Writerlauren.csv,309,82077190.0,76,233,70,6,0,52.48543689320388,228,51,24.06148867313916,6
Category_Wikipedia_sockpuppets_of_Ivan_evlogiev.csv,451,27756658.0,143,308,121,22,0,60.63414634146341,446,54,25.03769401330377,5
Category_Wikipedia_sockpuppets_of_Tyjvi.csv,33,47108365.0,7,26,7,0,0,60.03030303030303,212,29,17.454545454545453,7
Category_Wikipedia_sockpuppets_of_Kosmo7895.csv,394,1703857.0,221,173,193,28,0,23.720812182741117,199,55,17.076142131979694,8
Category_Wikipedia_sockpuppets_of_Lexorandi81.csv,208,347345216.0,59,149,56,3,0,49.0625,234,60,20.341346153846153,8
Category_Wikipedia_sockpuppets_of_PetrusdictusA.csv,264,123391412.0,72,192,70,2,0,47.63257575757576,321,46,18.428030303030305,5
Category_Wikipedia_sockpuppets_of_Helpthesouls.csv,154,8544842.0,69,85,34,35,0,44.68181818181818,230,57,23.792207792207794,13
Category_Wikipedia_sockpuppets_of_Wizzard12345.csv,18,6293606.0,12,6,11,1,0,39.5,186,14,14.0,14
Category_Wikipedia_sockpuppets_of_Pilatesolvez.csv,7,441627.0,6,1,5,1,0,28.428571428571427,161,12,11.142857142857142,11
Category_Wikipedia_sockpuppets_of_Migraine69.csv,32,2609535.0,14,18,10,4,0,39.8125,191,22,13.78125,7
Category_Wikipedia_sockpuppets_of_OmegaMS.csv,366,15735017.0,138,228,75,63,0,35.03005464480874,242,66,20.94808743169399,5
Category_Wikipedia_sockpuppets_of_Beggin'for.csv,107,3138864.0,42,65,13,29,0,52.00934579439252,220,43,20.177570093457945,10
Category_Wikipedia_sockpuppets_of_Fittnessdocs283.csv,1316,4299240.0,409,907,260,149,0,44.05775075987842,425,54,24.63373860182371,3
Category_Wikipedia_sockpuppets_of_Ty45674.csv,1241,14912025.0,409,832,239,170,0,39.90088638195004,255,58,21.07896857373086,5
Category_Wikipedia_sockpuppets_of_Tagus100.csv,20,1705.0,13,7,8,5,0,38.75,128,14,12.65,5
Category_Wikipedia_sockpuppets_of_Samira819.csv,1451,35025114.0,466,985,137,329,0,58.2184700206754,500,40,18.79669193659545,4
Category_Wikipedia_sockpuppets_of_Pro3999.csv,378,5579945.0,88,290,86,2,0,50.66931216931217,288,46,16.267195767195766,4
Category_Wikipedia_sockpuppets_of_Keagonsu.csv,21,1990315.0,9,12,5,4,20,78.19047619047619,201,53,48.42857142857143,23
Category_Wikipedia_sockpuppets_of_Neverenough5.csv,125,3009295.0,40,85,36,4,0,39.848,219,28,17.008,4
Category_Wikipedia_sockpuppets_of_Tokolosheman.csv,2272,276238005.0,1134,1138,500,634,0,38.28301056338028,495,41,19.100792253521128,4
Category_Wikipedia_sockpuppets_of_Contest1.csv,10,553.0,5,5,3,2,0,60.4,144,6,6.0,6
Category_Wikipedia_sockpuppets_of_Pkraja1234.csv,5248,41896721.0,1082,4166,500,582,0,61.31478658536585,456,63,19.71017530487805,3
Category_Wikipedia_sockpuppets_of_Wallamoose.csv,2769,1708811.0,984,1785,500,484,0,41.62838569880823,255,83,22.283134705669916,3
Category_Wikipedia_sockpuppets_of_PillCosby.csv,1,0.0,1,0,1,0,0,0.0,0,8,8.0,8
Category_Wikipedia_sockpuppets_of_A67.csv,737,1634141.0,374,363,334,40,0,20.53731343283582,199,48,26.19674355495251,11
Category_Wikipedia_sockpuppets_of_Burntbacon.csv,442,339646924.0,165,277,160,5,0,46.86199095022624,254,57,15.558823529411764,4
Category_Wikipedia_sockpuppets_of_Mishra18Hex.csv,311,4343649.0,135,176,104,31,0,43.89710610932476,496,47,23.376205787781352,10
Category_Wikipedia_sockpuppets_of_Opensource4ever.csv,36,248595.0,16,20,8,8,0,64.69444444444444,184,32,17.444444444444443,14
Category_Wikipedia_sockpuppets_of_Sorrywrongnumber.csv,1402,137759190.0,479,923,206,273,0,33.549215406562055,220,64,19.910128388017117,5
Category_Wikipedia_sockpuppets_of_Dakewann.csv,27,20247722.0,11,16,5,6,0,47.18518518518518,281,23,15.777777777777779,10
Category_Wikipedia_sockpuppets_of_Ninety9.csv,89,7183505.0,38,51,38,0,0,19.573033707865168,177,44,37.31460674157304,17
Category_Wikipedia_sockpuppets_of_Battistin72.csv,200,114548360.0,65,135,28,37,0,49.59,253,73,17.885,9
Category_Wikipedia_sockpuppets_of_Christopher_Wells_I.csv,591,22285457.0,238,353,185,53,0,34.45346869712352,313,38,12.829103214890017,5
Category_Wikipedia_sockpuppets_of_Thatwasreal.csv,2702,49032655.0,653,2049,210,443,0,45.4641006661732,427,68,16.195780903034787,4
Category_Wikipedia_sockpuppets_of_Freewayguy.csv,1192,9603748.0,500,692,500,0,0,36.11577181208054,200,57,25.924496644295303,5
Category_Wikipedia_sockpuppets_of_Jigzmoto.csv,1915,15645844.0,747,1168,500,247,0,30.914882506527416,255,55,16.0621409921671,4
Category_Wikipedia_sockpuppets_of_Gareth1893.csv,355,366152553.0,114,241,112,2,0,69.79154929577464,499,43,16.72676056338028,4
Category_Wikipedia_sockpuppets_of_David_Beals.csv,5447,463693833.0,1624,3823,183,1441,0,59.2673031026253,499,54,19.013401872590418,3
Category_Wikipedia_sockpuppets_of_√ÜCE.csv,613,794590.0,230,383,222,8,0,52.492659053833606,321,59,21.00815660685155,3
Category_Wikipedia_sockpuppets_of_Witaveli.csv,102,862686.0,74,28,41,33,0,22.5,194,34,30.00980392156863,3
Category_Wikipedia_sockpuppets_of_AtticComedian.csv,36,1682304.0,15,21,15,0,0,41.55555555555556,198,27,21.75,15
Category_Wikipedia_sockpuppets_of_Qaxzaaa.csv,58,1125971.0,19,39,11,8,0,41.51724137931034,195,38,25.120689655172413,4
Category_Wikipedia_sockpuppets_of_Dejure24.csv,327,5463064.0,186,141,115,71,0,43.38532110091743,255,29,23.31192660550459,14
Category_Wikipedia_sockpuppets_of_Editor_of_Wikis.csv,461,6388463.0,129,332,66,63,0,53.66160520607375,255,47,18.629067245119305,4
Category_Wikipedia_sockpuppets_of_Zabranos.csv,1385,5484280.0,515,870,500,15,0,53.07075812274368,255,61,16.052707581227438,3
Category_Wikipedia_sockpuppets_of_Akash3141.csv,748,35263349.0,315,433,309,6,0,54.663101604278076,255,54,16.21524064171123,4
Category_Wikipedia_sockpuppets_of_NagalimNE.csv,20153,102095347.0,7924,12229,500,7424,0,43.26154914901007,500,76,18.511239021485636,3
Category_Wikipedia_sockpuppets_of_N92413.csv,154,23334857.0,61,93,33,28,0,44.15584415584416,231,62,19.766233766233768,11
Category_Wikipedia_sockpuppets_of_Lancsalot.csv,1826,44057539.0,518,1308,500,18,0,32.01040525739321,200,68,17.379518072289155,4
Category_Wikipedia_sockpuppets_of_Kirbym123.csv,18,452001.0,14,4,13,1,0,36.333333333333336,199,24,21.0,15
Category_Wikipedia_sockpuppets_of_Vibhas_Kashyap.csv,1629,30680662.0,553,1076,388,165,0,21.658686310620013,255,44,22.152854511970535,6
Category_Wikipedia_sockpuppets_of_Mafaz729.csv,20,66869543.0,5,15,4,1,0,65.45,170,52,26.85,8
Category_Wikipedia_sockpuppets_of_Googler459.csv,1686,122496409.0,567,1119,196,371,0,36.11032028469751,217,54,22.51423487544484,3
Category_Wikipedia_sockpuppets_of_WowWashington.csv,12,3799204.0,7,5,6,1,0,37.916666666666664,194,23,16.0,11
Category_Wikipedia_sockpuppets_of_GIRDMAN.csv,113,22893697.0,33,80,29,4,0,40.05309734513274,213,46,13.743362831858407,5
Category_Wikipedia_sockpuppets_of_Sutton12.csv,1728,9422528.0,818,910,500,318,0,45.104166666666664,334,38,16.15451388888889,6
Category_Wikipedia_sockpuppets_of_Tomend123.csv,1029,32554774.0,344,685,277,67,0,42.43828960155491,374,53,20.08843537414966,6
Category_Wikipedia_sockpuppets_of_Ain_soph.csv,319,14947932.0,124,195,70,54,0,46.48275862068966,253,48,21.094043887147336,5
Category_Wikipedia_sockpuppets_of_El_Menor_Mc.csv,212,129438167.0,62,150,18,44,0,46.58018867924528,255,43,16.382075471698112,6
Category_Wikipedia_sockpuppets_of_J.J.Portman.csv,307,35256920.0,112,195,112,0,0,40.34527687296417,496,29,14.674267100977199,5
Category_Wikipedia_sockpuppets_of_J_McCal.csv,174,130995657.0,64,110,44,20,0,47.93103448275862,390,60,30.04597701149425,10
Category_Wikipedia_sockpuppets_of_Fcburns.csv,462,42427159.0,134,328,38,96,0,44.43939393939394,228,31,18.413419913419915,6
Category_Wikipedia_sockpuppets_of_Jackohio.csv,14,58272.0,7,7,4,3,0,67.71428571428571,149,18,11.928571428571429,6
Category_Wikipedia_sockpuppets_of_Kismet1982.csv,760,151793101.0,191,569,76,115,0,57.325,319,44,15.435526315789474,5
Category_Wikipedia_sockpuppets_of_Editorkabaap.csv,669,46459850.0,233,436,106,127,0,39.89237668161435,250,64,21.053811659192824,6
Category_Wikipedia_sockpuppets_of_Kianooshbr.csv,30,837.0,13,17,6,7,0,55.5,193,34,17.433333333333334,10
Category_Wikipedia_sockpuppets_of_Vond1926.csv,47,1559707.0,19,28,10,9,0,64.85106382978724,212,24,15.74468085106383,5
Category_Wikipedia_sockpuppets_of_Slagjan2000.csv,641,22632430.0,149,492,111,38,0,37.499219968798755,263,27,19.09984399375975,7
Category_Wikipedia_sockpuppets_of_Yyyttteeee.csv,52,8802137.0,16,36,11,5,0,46.11538461538461,204,39,22.307692307692307,8
Category_Wikipedia_sockpuppets_of_Pakhtun_Tanoli.csv,562,193971437.0,181,381,104,77,0,47.59252669039146,245,38,11.613879003558718,6
Category_Wikipedia_sockpuppets_of_Noncepecks.csv,146,101888.0,52,94,40,12,0,30.15068493150685,196,62,18.794520547945204,4
Category_Wikipedia_sockpuppets_of_Madman_C.csv,2,0.0,1,1,1,0,199,199.0,199,18,18.0,18
Category_Wikipedia_sockpuppets_of_Josiefoxx76.csv,31,1529291.0,10,21,4,6,0,57.193548387096776,249,39,11.580645161290322,5
Category_Wikipedia_sockpuppets_of_Pikipaki2222.csv,168,9150342.0,58,110,57,1,0,37.833333333333336,255,62,36.095238095238095,20
Category_Wikipedia_sockpuppets_of_Bir_biswas.csv,27,1153895.0,7,20,4,3,0,40.44444444444444,483,53,36.111111111111114,11
Category_Wikipedia_sockpuppets_of_Indguyintx.csv,1720,33771917.0,468,1252,225,243,0,34.14883720930233,263,47,16.56046511627907,4
Category_Wikipedia_sockpuppets_of_Cvhr.csv,254,20852523.0,110,144,39,71,0,36.6496062992126,215,41,20.6496062992126,9
Category_Wikipedia_sockpuppets_of_Verdict.csv,4828,33479925.0,1829,2999,500,1329,0,31.655136702568353,250,57,15.206503728251864,6
Category_Wikipedia_sockpuppets_of_Guhhyyg.csv,293,13409883.0,103,190,57,46,0,47.358361774744026,297,50,17.146757679180887,5
Category_Wikipedia_sockpuppets_of_Bamanh27.csv,1850,418344582.0,696,1154,500,196,0,50.788648648648646,395,62,19.34,3
Category_Wikipedia_sockpuppets_of_Royalist_Lady.csv,115,153002212.0,25,90,15,10,0,49.52173913043478,248,62,28.06086956521739,7
Category_Wikipedia_sockpuppets_of_Bahadorgh24.csv,86,6968778.0,38,48,25,13,0,48.22093023255814,346,53,28.290697674418606,7
Category_Wikipedia_sockpuppets_of_Tarih√ßigenc1.csv,93,18060306.0,30,63,24,6,0,45.72043010752688,207,31,18.946236559139784,8
Category_Wikipedia_sockpuppets_of_Stoneboy3.csv,390,7154852.0,78,312,32,46,0,35.864102564102566,201,47,17.733333333333334,5
Category_Wikipedia_sockpuppets_of_YoungboyTre1618.csv,433,30520784.0,128,305,103,25,0,39.68129330254042,356,53,21.364896073903,7
Category_Wikipedia_sockpuppets_of_Abhibabamishra.csv,157,188685162.0,41,116,21,20,0,56.732484076433124,255,93,22.656050955414013,10
Category_Wikipedia_sockpuppets_of_KMB_Bus_fan.csv,206,298932942.0,57,149,39,18,0,44.019417475728154,273,58,15.951456310679612,4
Category_Wikipedia_sockpuppets_of_PAustin4thApril1980.csv,4088,661761535.0,970,3118,500,470,0,43.1320939334638,514,79,18.314334637964777,3
Category_Wikipedia_sockpuppets_of_Josefritz.csv,1608,203818847.0,406,1202,302,104,0,46.18905472636816,249,45,13.742537313432836,3
Category_Wikipedia_sockpuppets_of_Darlapayne200313.csv,42,2609780.0,25,17,15,10,0,37.69047619047619,207,38,27.238095238095237,19
Category_Wikipedia_sockpuppets_of_JeanLatore.csv,1666,65817811.0,533,1133,500,33,0,37.81812725090036,230,79,26.482593037214887,4
Category_Wikipedia_sockpuppets_of_Drastamat.csv,60,28475.0,39,21,14,25,0,20.4,199,50,20.233333333333334,14
Category_Wikipedia_sockpuppets_of_Massimo_Chiacchio_1997.csv,692,30640562.0,219,473,99,120,0,35.73554913294798,254,66,15.622832369942197,7
Category_Wikipedia_sockpuppets_of_Jjk82.csv,625,2638289.0,244,381,230,14,0,41.472,216,38,12.624,5
Category_Wikipedia_sockpuppets_of_Willsonsmith.csv,93,600170.0,33,60,17,16,0,57.03225806451613,211,35,15.193548387096774,4
Category_Wikipedia_sockpuppets_of_Shanu-t-thankachan.csv,250,93963682.0,75,175,75,0,0,46.312,272,53,17.8,4
Category_Wikipedia_sockpuppets_of_Firewho.csv,534,19787588.0,150,384,16,134,0,52.10674157303371,372,37,15.700374531835205,5
Category_Wikipedia_sockpuppets_of_Masoom262.csv,24,44485587.0,6,18,3,3,0,60.416666666666664,234,26,15.791666666666666,5
Category_Wikipedia_sockpuppets_of_Oiram.jef.csv,1,0.0,1,0,1,0,31,31.0,31,15,15.0,15
Category_Wikipedia_sockpuppets_of_SMUTSS.csv,1589,5325034.0,794,795,143,651,0,30.07363121460038,495,53,22.94776589049717,9
Category_Wikipedia_sockpuppets_of_AFolkSingersBeard.csv,1143,16103603.0,336,807,122,214,0,54.25721784776903,250,95,24.593175853018373,5
Category_Wikipedia_sockpuppets_of_Mainarwalker.csv,338,101069861.0,129,209,126,3,0,37.15384615384615,382,44,16.698224852071007,5
Category_Wikipedia_sockpuppets_of_FuzzyJeffrey.csv,112,147226.0,58,54,34,24,0,65.55357142857143,284,38,19.383928571428573,11
Category_Wikipedia_sockpuppets_of_Kurt_Leyman.csv,3530,616457933.0,748,2782,500,248,0,48.20226628895184,500,63,17.486118980169973,2
Category_Wikipedia_sockpuppets_of_27bchao.csv,206,60261133.0,73,133,43,30,0,50.83495145631068,219,47,26.349514563106798,10
Category_Wikipedia_sockpuppets_of_Bionoetics.csv,162,2617341.0,53,109,10,43,0,63.27777777777778,433,33,19.24074074074074,4
Category_Wikipedia_sockpuppets_of_Ice9Tea.csv,1395,25044961.0,498,897,367,131,0,49.03727598566308,230,72,15.622222222222222,4
Category_Wikipedia_sockpuppets_of_Toyko.csv,43,68938.0,11,32,11,0,0,38.13953488372093,183,36,19.372093023255815,5
Category_Wikipedia_sockpuppets_of_LuckyAries.csv,1729,10693602.0,610,1119,500,110,0,30.200115673799885,262,55,13.760555234239444,3
Category_Wikipedia_sockpuppets_of_Keywan_faramarzi.csv,448,79562994.0,228,220,118,110,0,39.94419642857143,305,62,34.20982142857143,13
Category_Wikipedia_sockpuppets_of_Carlalune.csv,972,384448320.0,398,574,325,73,0,43.13477366255144,273,75,20.087448559670783,5
Category_Wikipedia_sockpuppets_of_BufoMarinusHughes.csv,82,5357214.0,21,61,15,6,0,54.34146341463415,204,36,16.48780487804878,7
Category_Wikipedia_sockpuppets_of_Jellington.csv,374,45201292.0,119,255,12,107,0,60.51069518716577,500,43,18.72994652406417,4
Category_Wikipedia_sockpuppets_of_Buevell.csv,1306,12551973.0,480,826,246,234,0,40.90811638591118,500,65,29.186064318529862,13
Category_Wikipedia_sockpuppets_of_Noor978.csv,6,159708.0,6,0,6,0,0,115.33333333333333,496,22,20.5,19
Category_Wikipedia_sockpuppets_of_Bagleyt.csv,83,17960780.0,24,59,14,10,0,39.06024096385542,197,22,13.144578313253012,7
Category_Wikipedia_sockpuppets_of_Lou_Sander.csv,2948,533962076.0,917,2031,500,417,0,47.45522388059702,255,82,21.080393487109905,3
Category_Wikipedia_sockpuppets_of_JackinMD.csv,246,85583791.0,85,161,82,3,0,62.46341463414634,254,51,22.341463414634145,13
Category_Wikipedia_sockpuppets_of_Film_Fan.csv,2358,191666935.0,863,1495,500,363,0,55.050042408821035,376,77,23.050042408821035,2
Category_Wikipedia_sockpuppets_of_Bradgd.csv,1160,39360164.0,417,743,78,339,0,46.067241379310346,367,62,16.736206896551725,4
Category_Wikipedia_sockpuppets_of_Bwagstaff1996.csv,1,0.0,1,0,1,0,0,0.0,0,13,13.0,13
Category_Wikipedia_sockpuppets_of_MagnoliaMenace.csv,89,17568204.0,34,55,29,5,0,60.258426966292134,306,37,18.471910112359552,9
Category_Wikipedia_sockpuppets_of_Brijesh437.csv,18,85820.0,16,2,11,5,0,22.055555555555557,131,14,14.0,14
Category_Wikipedia_sockpuppets_of_Benjiboi.csv,9132,151972227.0,3035,6097,500,2535,0,50.046539640823475,261,123,25.727332457293034,3
Category_Wikipedia_sockpuppets_of_Cyber_Lopez.csv,480,12171095.0,146,334,106,40,0,17.7125,200,47,22.595833333333335,11
Category_Wikipedia_sockpuppets_of_IExistToHelp.csv,1426,48674064.0,532,894,500,32,0,59.845021037868165,255,69,24.368162692847125,4
Category_Wikipedia_sockpuppets_of_Keithmonti.csv,201,38631926.0,57,144,47,10,0,43.33830845771144,199,48,22.671641791044777,5
Category_Wikipedia_sockpuppets_of_Ghostrider51.csv,383,386740411.0,142,241,133,9,0,42.161879895561356,370,65,20.242819843342037,9
Category_Wikipedia_sockpuppets_of_Proysen6.csv,11,3527073.0,8,3,8,0,0,18.545454545454547,122,18,17.727272727272727,17
Category_Wikipedia_sockpuppets_of_Frangaspar.csv,91,365842.0,42,49,13,29,0,37.10989010989011,196,49,32.252747252747255,17
Category_Wikipedia_sockpuppets_of_Orlaw66.csv,333,25653865.0,115,218,30,85,0,54.447447447447445,258,65,22.1981981981982,3
Category_Wikipedia_sockpuppets_of_Whiskeymouth.csv,1232,40485372.0,419,813,410,9,0,48.818993506493506,255,71,21.569805194805195,2
Category_Wikipedia_sockpuppets_of_Jackstarrzz.csv,1499,119411047.0,544,955,500,44,0,41.86057371581054,413,67,27.643095396931287,8
Category_Wikipedia_sockpuppets_of_Russianmathtutors.csv,31,984389.0,24,7,15,9,0,50.096774193548384,121,29,21.967741935483872,16
Category_Wikipedia_sockpuppets_of_Silambusaravanan.csv,5,3817674.0,4,1,3,1,0,64.4,114,29,24.8,21
Category_Wikipedia_sockpuppets_of_Smeagain.csv,193,847781.0,82,111,56,26,0,29.689119170984455,199,44,19.352331606217618,4
Category_Wikipedia_sockpuppets_of_Wikilaj.csv,191,25833946.0,78,113,71,7,0,76.17277486910994,255,51,25.083769633507853,13
Category_Wikipedia_sockpuppets_of_Linker2000.csv,26,615446.0,13,13,9,4,0,46.42307692307692,142,42,14.923076923076923,5
Category_Wikipedia_sockpuppets_of_UsmanWiki540.csv,525,2676090.0,151,374,67,84,0,58.521904761904764,355,51,18.81904761904762,5
Category_Wikipedia_sockpuppets_of_Gaeltober.csv,867,4967630.0,288,579,254,34,0,55.49942329873126,480,54,17.426758938869664,6
Category_Wikipedia_sockpuppets_of_Pezzy.csv,433,113732772.0,150,283,76,74,0,46.48498845265589,216,41,17.836027713625867,6
Category_Wikipedia_sockpuppets_of_Daniel10.csv,1442,15394065.0,628,814,500,128,0,27.34119278779473,200,86,22.606796116504853,3
Category_Wikipedia_sockpuppets_of_Yugvijay_Tiwari.csv,128,16489794.0,43,85,41,2,0,37.484375,230,41,20.109375,8
Category_Wikipedia_sockpuppets_of_BedrockPerson.csv,5717,117601241.0,1558,4159,500,1058,0,53.61868112646493,500,74,15.513206227042154,1
Category_Wikipedia_sockpuppets_of_Iceage_101.csv,1376,36374979.0,331,1045,203,128,0,54.64462209302326,417,38,25.296511627906977,5
Category_Wikipedia_sockpuppets_of_Kwilliams99.csv,41,10349346.0,19,22,18,1,0,48.09756097560975,159,64,20.048780487804876,11
Category_Wikipedia_sockpuppets_of_Xayahrainie43.csv,2648,128756535.0,867,1781,500,367,0,49.52870090634441,388,74,18.962235649546827,2
Category_Wikipedia_sockpuppets_of_Phoenix_and_Winslow.csv,1599,169218616.0,557,1042,500,57,0,55.80675422138837,333,111,28.696685428392744,4
Category_Wikipedia_sockpuppets_of_Kipperfield.csv,30804,379107282.0,8369,22435,500,7869,0,38.86693286586158,500,77,17.890825866770548,3
Category_Wikipedia_sockpuppets_of_BlueD954.csv,2998,40412005.0,1008,1990,500,508,0,47.35957304869913,482,88,27.55503669112742,5
Category_Wikipedia_sockpuppets_of_John_bkb_Stephenson.csv,15,58794521.0,6,9,5,1,0,36.46666666666667,172,29,19.066666666666666,8
Category_Wikipedia_sockpuppets_of_Kalasa_Saab.csv,12,120836723.0,7,5,5,2,0,37.833333333333336,129,29,11.083333333333334,8
Category_Wikipedia_sockpuppets_of_Smajedul.csv,503,50245524.0,199,304,112,87,0,35.737574552683895,500,47,23.73956262425447,6
Category_Wikipedia_sockpuppets_of_Who_R_U.csv,35,1666.0,11,24,11,0,0,91.14285714285714,246,15,10.542857142857143,9
Category_Wikipedia_sockpuppets_of_Uuuiii.csv,15,2072.0,6,9,3,3,0,69.13333333333334,200,23,15.866666666666667,8
Category_Wikipedia_sockpuppets_of_Alanpopo123.csv,505,8575570.0,183,322,161,22,0,48.689108910891086,255,52,20.073267326732672,10
Category_Wikipedia_sockpuppets_of_Bauer-3.csv,23,4326.0,12,11,6,6,0,19.652173913043477,120,28,22.347826086956523,15
Category_Wikipedia_sockpuppets_of_Pricer1980.csv,1846,19448362.0,541,1305,500,41,0,26.60346695557963,251,58,22.288732394366196,5
Category_Wikipedia_sockpuppets_of_Benmols2.csv,515,59150766.0,227,288,102,125,0,40.15922330097087,221,60,22.122330097087378,8
Category_Wikipedia_sockpuppets_of_Trugglepumper1.csv,13,1895020.0,3,10,2,1,0,78.76923076923077,199,15,13.307692307692308,11
Category_Wikipedia_sockpuppets_of_Soccermeko.csv,4570,219777458.0,1558,3012,500,1058,0,37.88818380743982,255,82,19.222757111597375,3
Category_Wikipedia_sockpuppets_of_Clint_Micho.csv,72,5617225.0,28,44,25,3,0,45.65277777777778,221,16,11.541666666666666,7
Category_Wikipedia_sockpuppets_of_Br808.csv,158,1382235.0,48,110,27,21,0,48.0253164556962,196,46,19.626582278481013,5
Category_Wikipedia_sockpuppets_of_Duynguyen007.csv,1482,197879827.0,339,1143,221,118,0,43.32523616734143,312,56,19.921727395411605,4
Category_Wikipedia_sockpuppets_of_Jjbenedict6.csv,224,8844570.0,99,125,59,40,0,34.620535714285715,315,46,32.861607142857146,11
Category_Wikipedia_sockpuppets_of_Thdang2023.csv,69,925998.0,29,40,15,14,0,64.8695652173913,496,45,18.579710144927535,3
Category_Wikipedia_sockpuppets_of_Mujeerkhan.csv,1363,50670090.0,492,871,385,107,0,27.27806309611152,199,74,14.242846661775495,4
Category_Wikipedia_sockpuppets_of_Princeromuald.csv,851,79123912.0,299,552,209,90,0,54.889541715628674,499,43,14.502937720329024,3
Category_Wikipedia_sockpuppets_of_Olivermardlin.csv,275,233699194.0,61,214,25,36,0,53.09090909090909,323,50,16.08,7
Category_Wikipedia_sockpuppets_of_Rowde.csv,5878,157076305.0,1835,4043,500,1335,0,39.57400476352501,500,83,22.71197686287853,6
Category_Wikipedia_sockpuppets_of_Ojanapothik.csv,95,59816421.0,37,58,23,14,0,54.6,251,28,14.863157894736842,7
Category_Wikipedia_sockpuppets_of_Bowser_Koopa.csv,165,33925015.0,44,121,19,25,0,53.41818181818182,212,36,18.181818181818183,5
Category_Wikipedia_sockpuppets_of_Iptesh_Kumar_Meher.csv,1766,67450801.0,782,984,457,325,0,34.73103057757644,496,54,12.97281993204983,6
Category_Wikipedia_sockpuppets_of_Polygamistx4.csv,176,3004100.0,63,113,32,31,0,46.97727272727273,181,42,19.301136363636363,10
Category_Wikipedia_sockpuppets_of_Omahagop18.csv,185,2243875.0,62,123,45,17,0,69.51891891891891,255,56,20.54054054054054,7
Category_Wikipedia_sockpuppets_of_Sonam_R_Thakur.csv,97,7776718.0,24,73,22,2,0,49.92783505154639,254,53,23.237113402061855,8
Category_Wikipedia_sockpuppets_of_Kiko4564.csv,4113,251139433.0,1350,2763,500,850,0,56.7235594456601,299,93,23.864089472404572,4
Category_Wikipedia_sockpuppets_of_The_King_of_Clay.csv,870,16629009.0,243,627,240,3,0,25.337931034482757,200,78,19.919540229885058,3
Category_Wikipedia_sockpuppets_of_Fuadorko.csv,388,200328538.0,106,282,53,53,0,55.70360824742268,255,50,23.02061855670103,12
Category_Wikipedia_sockpuppets_of_DB_Dilan_Brechero.csv,2484,177396651.0,807,1677,218,589,0,42.16304347826087,359,55,15.19927536231884,3
Category_Wikipedia_sockpuppets_of_Danielbeddome.csv,482,1295915.0,217,265,125,92,0,35.52074688796681,243,41,20.676348547717843,7
Category_Wikipedia_sockpuppets_of_EditMonkey.csv,918,12810169.0,356,562,355,1,0,37.63834422657952,249,63,23.264705882352942,6
Category_Wikipedia_sockpuppets_of_Casaponda2.csv,100,17279657.0,52,48,36,16,0,43.94,328,35,10.79,9
Category_Wikipedia_sockpuppets_of_Soccer_Refereeing.csv,1676,39570843.0,833,843,150,683,0,29.567422434367543,369,42,17.78579952267303,5
Category_Wikipedia_sockpuppets_of_Achumichi.csv,1288,354496039.0,491,797,395,96,0,45.44798136645963,488,57,23.94254658385093,4
Category_Wikipedia_sockpuppets_of_Magic8ball-online22345.csv,8,852717.0,6,2,5,1,0,85.75,296,12,10.5,6
Category_Wikipedia_sockpuppets_of_Mythpage88.csv,2200,16353828.0,750,1450,500,250,0,49.16681818181818,255,72,19.675,2
Category_Wikipedia_sockpuppets_of_Visnusen.csv,1501,10126398.0,434,1067,225,209,0,36.209193870752834,250,41,16.746169220519654,4
Category_Wikipedia_sockpuppets_of_PoolGuy.csv,1842,79221632.0,733,1109,308,425,0,27.69598262757872,250,65,23.251900108577633,4
Category_Wikipedia_sockpuppets_of_Klermodalwonfeyz.csv,1822,125544024.0,506,1316,500,6,0,55.2019758507135,500,47,17.628979143798023,3
Category_Wikipedia_sockpuppets_of_Agirard123.csv,15,125095.0,12,3,11,1,0,23.2,148,15,15.0,15
Category_Wikipedia_sockpuppets_of_HungryHippo1984.csv,53,66920.0,15,38,15,0,0,64.88679245283019,244,22,13.471698113207546,11
Category_Wikipedia_sockpuppets_of_Hjjxuxhwh.csv,3,119.0,2,1,2,0,14,73.33333333333333,184,21,21.0,21
Category_Wikipedia_sockpuppets_of_Ustarden.csv,374,10579584.0,130,244,67,63,0,52.467914438502675,493,52,18.75668449197861,5
Category_Wikipedia_sockpuppets_of_Poopsoiw.csv,5,436.0,3,2,3,0,0,40.4,125,21,12.0,6
Category_Wikipedia_sockpuppets_of_Thjtjryjtyjtyj.csv,20,331501.0,16,4,8,8,1,42.05,142,22,12.2,10
Category_Wikipedia_sockpuppets_of_Thachx.csv,142,138936648.0,41,101,37,4,0,50.605633802816904,229,29,16.47887323943662,8
Category_Wikipedia_sockpuppets_of_Cirt.csv,2513,78462751.0,1000,1513,500,500,0,76.78909669717468,518,90,31.701551929964186,7
Category_Wikipedia_sockpuppets_of_DarwinQowin381.csv,47,19987.0,20,27,12,8,0,68.93617021276596,360,35,24.53191489361702,18
Category_Wikipedia_sockpuppets_of_Gauravjains.vrps.csv,122,209759412.0,41,81,41,0,0,38.99180327868852,230,27,15.163934426229508,12
Category_Wikipedia_sockpuppets_of_Muslimah_Limah.csv,570,1255856.0,159,411,153,6,0,34.80350877192983,497,71,21.135087719298244,6
Category_Wikipedia_sockpuppets_of_Coldstreamer20.csv,4826,125232877.0,1795,3031,500,1295,0,47.73000414421882,496,115,28.764608371322005,4
Category_Wikipedia_sockpuppets_of_Abdulwahab_Mohammed_Azzam.csv,75,10442188.0,20,55,18,2,0,73.29333333333334,253,35,12.226666666666667,4
Category_Wikipedia_sockpuppets_of_Robert_Warren.csv,1339,79330468.0,584,755,500,84,0,49.62733383121733,251,96,23.12994772218073,9
Category_Wikipedia_sockpuppets_of_Suprime_Rapper.csv,183,5720974.0,84,99,39,45,0,43.65573770491803,225,121,25.92349726775956,10
Category_Wikipedia_sockpuppets_of_Asdfjkl;123567.csv,44,2076846.0,25,19,12,13,0,42.70454545454545,198,26,16.568181818181817,10
Category_Wikipedia_sockpuppets_of_Wikibot2022.csv,8,18830.0,5,3,4,1,0,84.75,496,21,14.0,13
Category_Wikipedia_sockpuppets_of_LucasLovesTacos.csv,12,9495416.0,4,8,4,0,0,22.5,105,28,26.333333333333332,20
Category_Wikipedia_sockpuppets_of_Dandickaufan.csv,25,859488.0,9,16,5,4,0,68.44,227,19,15.64,13
Category_Wikipedia_sockpuppets_of_Abdir143.csv,436,6403277.0,140,296,64,76,0,39.62614678899082,335,29,10.412844036697248,5
Category_Wikipedia_sockpuppets_of_Nickfedrigo.csv,77,120781.0,39,38,23,16,0,23.571428571428573,127,47,22.7012987012987,16
Category_Wikipedia_sockpuppets_of_OyalepA.csv,32,2202758.0,16,16,6,10,0,39.09375,225,58,16.78125,10
Category_Wikipedia_sockpuppets_of_Binamra_Deb.csv,2402,72585337.0,876,1526,500,376,0,43.46169858451291,395,65,17.35512073272273,4
Category_Wikipedia_sockpuppets_of_Magnatyrannus.csv,3094,67321695.0,1020,2074,500,520,0,56.40045248868778,496,89,19.797026502908857,2
Category_Wikipedia_sockpuppets_of_Anchor4E.csv,71,52266563.0,21,50,1,20,0,43.67605633802817,249,27,15.830985915492958,6
Category_Wikipedia_sockpuppets_of_Warriorx900.csv,98,1921813.0,92,6,60,32,0,41.88775510204081,198,21,19.6734693877551,11
Category_Wikipedia_sockpuppets_of_Makro.csv,1313,279553777.0,510,803,500,10,0,44.01980198019802,320,61,29.146230007616147,7
Category_Wikipedia_sockpuppets_of_Prince-Ifoh.csv,200,38261990.0,115,85,113,2,0,28.295,226,31,18.805,12
Category_Wikipedia_sockpuppets_of_Hangyakuzero.csv,28,5551.0,10,18,7,3,0,38.92857142857143,140,26,18.142857142857142,11
Category_Wikipedia_sockpuppets_of_Bobbytwoshoesdylan1293.csv,22,3643747.0,10,12,6,4,0,63.5,237,32,19.727272727272727,10
Category_Wikipedia_sockpuppets_of_Chamantha10.csv,118,2664741.0,43,75,35,8,0,44.389830508474574,255,31,19.110169491525422,6
Category_Wikipedia_sockpuppets_of_Yoman63636.csv,400,5427694.0,138,262,99,39,0,46.265,255,50,19.715,4
Category_Wikipedia_sockpuppets_of_Punnas648.csv,126,16282516.0,43,83,34,9,0,66.25396825396825,296,52,18.634920634920636,6
Category_Wikipedia_sockpuppets_of_Acoma_Magic.csv,4429,138285958.0,1185,3244,500,685,0,60.82163016482276,255,68,22.771280198690448,3
Category_Wikipedia_sockpuppets_of_Stopping_your_vandalism.csv,104,934059.0,41,63,23,18,0,30.673076923076923,166,47,19.33653846153846,4
Category_Wikipedia_sockpuppets_of_Tha√Øs_Alexandrina.csv,289,24952210.0,78,211,65,13,0,44.865051903114185,199,43,29.214532871972317,10
Category_Wikipedia_sockpuppets_of_HRKent444.csv,129,17793737.0,43,86,43,0,0,70.01550387596899,403,54,22.72093023255814,6
Category_Wikipedia_sockpuppets_of_TheSethMovieChannel.csv,514,18834751.0,128,386,71,57,0,42.55058365758755,227,54,23.311284046692606,4
Category_Wikipedia_sockpuppets_of_Nickb410.csv,16,88894.0,11,5,11,0,0,45.25,202,22,16.625,9
Category_Wikipedia_sockpuppets_of_Inoknowone.csv,14,2189272.0,4,10,2,2,0,37.42857142857143,126,25,16.214285714285715,12
Category_Wikipedia_sockpuppets_of_Bscbooks.csv,16,376202.0,7,9,4,3,0,37.0,109,19,13.4375,5
Category_Wikipedia_sockpuppets_of_BrookeWealthGbl.csv,6,61856.0,3,3,2,1,0,63.0,196,26,23.5,23
Category_Wikipedia_sockpuppets_of_Tiseptiko.csv,2564,89528381.0,1030,1534,500,530,0,34.8198127925117,255,95,23.296021840873635,5
Category_Wikipedia_sockpuppets_of_HoshiNoKaabii2000.csv,1729,68668955.0,503,1226,143,360,0,48.282822440717176,254,61,20.844418739155582,3
Category_Wikipedia_sockpuppets_of_CSFP.csv,673,25015946.0,548,125,500,48,0,29.916790490341754,233,37,19.448736998514114,6
Category_Wikipedia_sockpuppets_of_$hawn2004.csv,75,3939714.0,32,43,16,16,0,57.29333333333334,255,28,15.813333333333333,9
Category_Wikipedia_sockpuppets_of_Radioinfoguy.csv,406,42540299.0,118,288,90,28,0,35.99753694581281,250,76,23.06896551724138,4
Category_Wikipedia_sockpuppets_of_Ekpestar.csv,110,13821757.0,42,68,21,21,0,47.77272727272727,134,53,27.736363636363638,10
Category_Wikipedia_sockpuppets_of_Mark_Maglasang.csv,9912,46628961.0,2812,7100,500,2312,0,52.6406376109766,500,74,17.476594027441486,3
Category_Wikipedia_sockpuppets_of_Herbalscience.csv,99,29531124.0,34,65,20,14,0,56.474747474747474,221,23,17.464646464646464,15
Category_Wikipedia_sockpuppets_of_AK_Entertainments.csv,12,2611.0,4,8,2,2,0,47.666666666666664,193,14,12.333333333333334,12
Category_Wikipedia_sockpuppets_of_Draftydoor.csv,590,14246968.0,118,472,98,20,0,52.95084745762712,236,56,25.161016949152543,3
Category_Wikipedia_sockpuppets_of_Oiwelewutrfu.csv,15,620349.0,6,9,3,3,0,68.06666666666666,235,27,15.266666666666667,5
Category_Wikipedia_sockpuppets_of_ScholarM.csv,1524,106580460.0,532,992,500,32,0,60.90419947506562,487,69,20.456036745406823,5
Category_Wikipedia_sockpuppets_of_Wstew82.csv,17,527768.0,6,11,4,2,0,49.64705882352941,118,58,33.64705882352941,18
Category_Wikipedia_sockpuppets_of_Russellsd.csv,40,9072450.0,14,26,9,5,0,57.3,232,40,21.925,10
Category_Wikipedia_sockpuppets_of_Nicekang2020.csv,79,706876.0,56,23,46,10,0,23.0126582278481,192,22,17.189873417721518,9
Category_Wikipedia_sockpuppets_of_Kliff93.csv,230,6466075.0,101,129,55,46,0,47.26521739130435,251,74,28.721739130434784,12
Category_Wikipedia_sockpuppets_of_Anonymous453434567.csv,259,66267150.0,102,157,100,2,0,50.83783783783784,302,39,22.18918918918919,13
Category_Wikipedia_sockpuppets_of_EditorInChiefSD.csv,191,516295.0,80,111,48,32,0,52.654450261780106,255,37,23.952879581151834,19
Category_Wikipedia_sockpuppets_of_Proverealbiharhistory.csv,648,7268526.0,250,398,245,5,0,40.68981481481482,495,62,20.47530864197531,5
Category_Wikipedia_sockpuppets_of_Jkomlos.csv,843,475659665.0,204,639,146,58,0,51.31553973902729,505,69,18.110320284697508,7
Category_Wikipedia_sockpuppets_of_HexaChord.csv,2881,175538979.0,1075,1806,500,575,0,53.20548420687261,262,91,26.748004165220408,3
"Category_Wikipedia_sockpuppets_of_Trixtar,_The_MC.csv",2415,44093424.0,978,1437,500,478,0,36.10351966873706,255,56,14.906418219461697,3
Category_Wikipedia_sockpuppets_of_Bobbyt91.csv,45,73623.0,21,24,17,4,0,40.68888888888889,175,22,10.444444444444445,2
Category_Wikipedia_sockpuppets_of_Fukenbitch25.csv,42,10603.0,14,28,8,6,0,37.357142857142854,184,19,14.857142857142858,3
Category_Wikipedia_sockpuppets_of_Manyoungstop.csv,15,12427707.0,6,9,5,1,0,49.6,235,20,13.733333333333333,6
Category_Wikipedia_sockpuppets_of_Baloon119.csv,60,256367.0,50,10,49,1,0,21.716666666666665,255,19,10.9,10
Category_Wikipedia_sockpuppets_of_Sidneyandrewsmancini.csv,1178,3703180.0,247,931,79,168,0,36.88709677419355,229,40,17.000848896434636,8
Category_Wikipedia_sockpuppets_of_RichSatan.csv,272,20088798.0,87,185,67,20,0,45.93014705882353,211,45,17.52573529411765,6
Category_Wikipedia_sockpuppets_of_Oompajoompa.csv,73,6211298.0,18,55,15,3,0,41.02739726027397,226,32,21.205479452054796,10
Category_Wikipedia_sockpuppets_of_Alanconsebido.csv,3123,75424391.0,1181,1942,339,842,0,39.35350624399616,500,65,28.891770733269293,4
Category_Wikipedia_sockpuppets_of_Everyone_Calls_me_Lol.csv,9,30595052.0,5,4,5,0,0,39.22222222222222,115,22,22.0,22
Category_Wikipedia_sockpuppets_of_Usjewishresearchfoundation.csv,33,371227.0,14,19,11,3,1,67.81818181818181,167,25,15.606060606060606,11
Category_Wikipedia_sockpuppets_of_Bambenekcd1.csv,309,603992.0,85,224,25,60,0,57.93851132686084,252,63,20.359223300970875,8
Category_Wikipedia_sockpuppets_of_OttawaGuy.csv,89,25357201.0,30,59,27,3,0,35.50561797752809,211,34,17.39325842696629,6
Category_Wikipedia_sockpuppets_of_Keep_On_Running_(Atif_Zinachi_Song).csv,98,10303202.0,92,6,49,43,0,10.795918367346939,196,45,28.163265306122447,15
Category_Wikipedia_sockpuppets_of_Michaelgriffiths.csv,983,65665836.0,388,595,356,32,0,43.28077314343845,293,32,15.25940996948118,5
Category_Wikipedia_sockpuppets_of_Ajaxverifier.csv,24,197993.0,11,13,7,4,13,68.29166666666667,255,18,11.333333333333334,8
Category_Wikipedia_sockpuppets_of_King_Genovese.csv,1704,39584863.0,648,1056,195,453,0,42.75,255,59,19.703051643192488,7
Category_Wikipedia_sockpuppets_of_Talikarni.csv,77,127020619.0,19,58,8,11,0,54.857142857142854,219,47,16.376623376623378,6
Category_Wikipedia_sockpuppets_of_TurokSwe.csv,1600,124454430.0,521,1079,500,21,0,37.815,321,96,25.059375,5
Category_Wikipedia_sockpuppets_of_Greekboy12345er6.csv,3104,307682086.0,1109,1995,500,609,0,42.13240979381443,374,97,29.484536082474225,5
Category_Wikipedia_sockpuppets_of_Nfsprostreet22.csv,2851,68206353.0,740,2111,500,240,0,33.98877586811645,255,60,15.113995089442302,4
Category_Wikipedia_sockpuppets_of_Niko_the_Biko.csv,353,67639673.0,149,204,41,108,0,37.422096317280456,296,49,15.960339943342776,4
Category_Wikipedia_sockpuppets_of_IloveAFD.csv,75,507320.0,37,38,37,0,0,34.653333333333336,127,64,41.76,21
Category_Wikipedia_sockpuppets_of_Himboy484wikidude.csv,59,1407413.0,25,34,24,1,0,47.271186440677965,199,33,18.11864406779661,4
Category_Wikipedia_sockpuppets_of_Mujib10.csv,1251,71855963.0,559,692,500,59,0,45.29416466826539,500,48,15.184652278177458,4
Category_Wikipedia_sockpuppets_of_Jacobfeliciano.csv,528,15127254.0,159,369,61,98,0,43.77840909090909,255,48,15.443181818181818,3
Category_Wikipedia_sockpuppets_of_Ilikehorses123457.csv,362,11017157.0,123,239,55,68,0,49.74585635359116,320,33,18.027624309392266,4
Category_Wikipedia_sockpuppets_of_Subhransupanda.csv,72,354655880.0,17,55,17,0,0,59.90277777777778,216,29,20.63888888888889,7
Category_Wikipedia_sockpuppets_of_BFDIFan707.csv,7480,93748194.0,2243,5237,500,1743,0,42.48903743315508,496,100,17.81764705882353,3
Category_Wikipedia_sockpuppets_of_Lior_the_swimmer.csv,596,57398643.0,226,370,131,95,0,40.011744966442954,376,48,21.161073825503355,4
Category_Wikipedia_sockpuppets_of_Smithywestface.csv,24,884.0,10,14,9,1,0,40.083333333333336,149,23,17.291666666666668,14
Category_Wikipedia_sockpuppets_of_KHOU.csv,5,7054.0,4,1,3,1,0,19.0,95,4,4.0,4
Category_Wikipedia_sockpuppets_of_Ahleghalam.csv,2,4626.0,2,0,2,0,22,22.0,22,20,20.0,20
Category_Wikipedia_sockpuppets_of_Scott_Sullivan_1997.csv,3522,71806570.0,832,2690,500,332,0,47.258659852356615,414,80,21.961669505962522,4
Category_Wikipedia_sockpuppets_of_Pka123.csv,135,22027294.0,52,83,13,39,0,42.074074074074076,207,72,20.177777777777777,7
Category_Wikipedia_sockpuppets_of_WillShowU.csv,1070,16081697.0,394,676,183,211,0,40.2588785046729,255,33,15.974766355140186,4
Category_Wikipedia_sockpuppets_of_MadhaviKarr.csv,4,57704.0,3,1,2,1,12,57.25,157,12,12.0,12
Category_Wikipedia_sockpuppets_of_Sreejish_Lal.csv,7,511815.0,6,1,6,0,0,28.571428571428573,37,22,22.0,22
Category_Wikipedia_sockpuppets_of_XiaoAlatus.csv,105,2160388.0,43,62,19,24,0,62.352380952380955,436,44,16.438095238095237,4
Category_Wikipedia_sockpuppets_of_Mrzinn138.csv,100,97326.0,35,65,31,4,0,40.44,227,45,25.26,10
Category_Wikipedia_sockpuppets_of_–ú–∞–¥–∏–Ω–∞_–û–º–∞—Ä–æ–≤–∞.csv,252,2686710.0,79,173,27,52,0,56.48015873015873,258,85,26.642857142857142,10
Category_Wikipedia_sockpuppets_of_Redlightgreenlight.csv,25,2773117.0,15,10,15,0,0,18.68,205,28,8.8,8
Category_Wikipedia_sockpuppets_of_Ajani_jjacobs.csv,176,1993233.0,45,131,20,25,0,50.11363636363637,246,44,16.664772727272727,6
Category_Wikipedia_sockpuppets_of_Dr_Spam_(MD).csv,669,54321935.0,170,499,166,4,0,31.90881913303438,255,43,20.985052316890883,4
Category_Wikipedia_sockpuppets_of_JudeBob123.csv,1029,23660284.0,338,691,328,10,0,46.11175898931001,255,102,22.037900874635568,4
Category_Wikipedia_sockpuppets_of_Catherinelie.csv,32,341315.0,26,6,25,1,0,47.15625,251,11,11.0,11
Category_Wikipedia_sockpuppets_of_∆èz…ôrb…ôy…ônil…ôri.csv,2266,58704286.0,740,1526,131,609,0,59.30759046778464,426,50,17.153133274492497,4
Category_Wikipedia_sockpuppets_of_Y2Kfreak.csv,786,14248806.0,302,484,139,163,0,30.856234096692113,217,53,20.291348600508904,3
Category_Wikipedia_sockpuppets_of_AkashNandaEdit.csv,53,29032092.0,16,37,12,4,0,39.75471698113208,234,27,17.943396226415093,9
Category_Wikipedia_sockpuppets_of_MMW_world.csv,352,23372176.0,130,222,35,95,0,45.77840909090909,496,63,18.019886363636363,4
Category_Wikipedia_sockpuppets_of_Gbaspman.csv,106,30243846.0,39,67,15,24,0,51.009433962264154,210,41,12.584905660377359,9
Category_Wikipedia_sockpuppets_of_Matambaclifford.csv,188,100461306.0,59,129,41,18,0,53.12765957446808,270,48,18.6968085106383,6
Category_Wikipedia_sockpuppets_of_Lowlihao.csv,3581,39734489.0,1324,2257,500,824,0,34.84780787489528,255,69,17.7950293214186,3
Category_Wikipedia_sockpuppets_of_Bloodnexus.csv,2,296.0,2,0,2,0,17,17.0,17,13,13.0,13
Category_Wikipedia_sockpuppets_of_Sathee_yaa.csv,30,2256309.0,13,17,10,3,0,73.0,230,34,22.9,6
Category_Wikipedia_sockpuppets_of_Truth1230.csv,19,4421787.0,16,3,6,10,0,189.26315789473685,500,21,15.736842105263158,14
Category_Wikipedia_sockpuppets_of_Iranzamin-Iranzamin.csv,1177,10618463.0,378,799,244,134,0,49.30246389124894,255,55,22.861512319456246,5
Category_Wikipedia_sockpuppets_of_VarunKJ.csv,198,59792314.0,57,141,49,8,0,59.77272727272727,387,72,22.328282828282827,9
Category_Wikipedia_sockpuppets_of_7alawa_el3antbly.csv,439,10740259.0,130,309,82,48,0,38.22551252847381,255,31,11.813211845102506,6
Category_Wikipedia_sockpuppets_of_Apollo_The_Logician.csv,8042,93537805.0,2765,5277,500,2265,0,53.12360109425516,500,83,23.45821934842079,3
Category_Wikipedia_sockpuppets_of_Diplogy.csv,69,56112444.0,14,55,9,5,0,38.53623188405797,240,39,18.869565217391305,12
Category_Wikipedia_sockpuppets_of_Ljpires.csv,28,77188.0,9,19,7,2,0,92.42857142857143,264,43,11.464285714285714,3
Category_Wikipedia_sockpuppets_of_Plackin_Paulie.csv,40,1420216.0,28,12,8,20,0,83.325,205,30,19.075,11
Category_Wikipedia_sockpuppets_of_PoliticoSearch.csv,36,21352.0,17,19,15,2,0,54.30555555555556,238,47,38.22222222222222,18
Category_Wikipedia_sockpuppets_of_Panderichthys4144.csv,226,4681041.0,126,100,77,49,0,51.623893805309734,255,39,19.539823008849556,8
Category_Wikipedia_sockpuppets_of_Aldin_Blagajcevic.csv,263,44925542.0,66,197,25,41,0,59.39163498098859,308,64,31.479087452471482,5
Category_Wikipedia_sockpuppets_of_Alexmarval2306.csv,116,169107.0,54,62,52,2,0,42.83620689655172,178,24,14.181034482758621,8
Category_Wikipedia_sockpuppets_of_Orkh.csv,1771,39563905.0,413,1358,331,82,0,47.241106719367586,216,47,14.157538114059854,3
Category_Wikipedia_sockpuppets_of_Kminor2.csv,13,1672.0,7,6,7,0,0,77.07692307692308,250,13,13.0,13
Category_Wikipedia_sockpuppets_of_Akramjan.csv,185,116822817.0,37,148,17,20,0,72.55675675675676,236,39,18.36756756756757,6
Category_Wikipedia_sockpuppets_of_Unknown161116.csv,213,30071010.0,90,123,88,2,0,29.5962441314554,255,32,20.093896713615024,7
Category_Wikipedia_sockpuppets_of_Dukisuzuki.csv,504,71994441.0,138,366,114,24,0,62.45436507936508,255,47,21.549603174603174,4
Category_Wikipedia_sockpuppets_of_ElPapiChulo420.csv,52,523854.0,17,35,8,9,0,61.61538461538461,296,25,19.21153846153846,10
Category_Wikipedia_sockpuppets_of_Swikindia.csv,4,5677100.0,2,2,2,0,0,51.0,152,14,14.0,14
Category_Wikipedia_sockpuppets_of_Genericpersonname.csv,202,3366987.0,89,113,46,43,0,46.85643564356435,259,77,51.118811881188115,10
Category_Wikipedia_sockpuppets_of_Supremarguax.csv,52,12425680.0,34,18,30,4,0,38.75,195,47,21.73076923076923,13
Category_Wikipedia_sockpuppets_of_Foiegrasmama.csv,102,484347.0,42,60,10,32,0,38.30392156862745,261,31,18.95098039215686,12
Category_Wikipedia_sockpuppets_of_Krisdegioia.csv,325,27347511.0,103,222,53,50,0,47.356923076923074,233,70,24.273846153846154,9
Category_Wikipedia_sockpuppets_of_Justme78783.csv,188,2789118.0,74,114,39,35,0,59.3936170212766,255,47,12.601063829787234,5
Category_Wikipedia_sockpuppets_of_Broadames333.csv,7,2513520.0,5,2,3,2,0,31.285714285714285,103,17,17.0,17
Category_Wikipedia_sockpuppets_of_Biplab_(Rapper).csv,97,17684812.0,43,54,29,14,0,46.649484536082475,234,15,9.494845360824742,5
Category_Wikipedia_sockpuppets_of_Volunteermedia.csv,4,2472.0,3,1,3,0,0,17.5,54,14,13.75,13
Category_Wikipedia_sockpuppets_of_Prince_Shobuz.csv,5361,145000089.0,1991,3370,500,1491,0,30.493005036373813,422,47,16.12908039544861,3
Category_Wikipedia_sockpuppets_of_Carolhlloyd.csv,24,525114.0,18,6,10,8,0,50.333333333333336,236,22,22.0,22
Category_Wikipedia_sockpuppets_of_Alexandra_Daddario_Fan.csv,1113,136440142.0,313,800,209,104,0,42.02336028751123,333,47,21.505840071877806,6
Category_Wikipedia_sockpuppets_of_Cyphoidlonic.csv,184,4761621.0,55,129,48,7,0,42.07608695652174,252,51,23.35326086956522,8
Category_Wikipedia_sockpuppets_of_Unbordel.csv,62,106617.0,30,32,27,3,0,27.806451612903224,151,74,40.46774193548387,9
Category_Wikipedia_sockpuppets_of_BioHack9781.csv,1591,348020451.0,534,1057,292,242,0,41.456316781898174,500,74,28.40791954745443,6
Category_Wikipedia_sockpuppets_of_ChuchoVCJMuzik.csv,1418,70977100.0,500,918,500,0,0,45.25952045133992,496,62,18.15373765867419,5
Category_Wikipedia_sockpuppets_of_Ymwlch.csv,25,950498.0,9,16,2,7,7,67.4,194,19,9.4,7
Category_Wikipedia_sockpuppets_of_Edipedia.csv,3376,17802635.0,1244,2132,500,744,0,26.773104265402843,224,66,16.88388625592417,3
Category_Wikipedia_sockpuppets_of_Bugmenot123123123.csv,1521,328567137.0,620,901,272,348,0,48.52728468113084,255,75,29.933596318211702,10
Category_Wikipedia_sockpuppets_of_Kptowhid.csv,17,888943.0,12,5,9,3,12,61.35294117647059,150,24,14.0,12
Category_Wikipedia_sockpuppets_of_JackWilkesMcCarthy.csv,1274,10969223.0,620,654,500,120,0,40.72370486656201,495,51,17.125588697017267,4
Category_Wikipedia_sockpuppets_of_Daniel_Larze.csv,7,21112611.0,3,4,2,1,10,65.85714285714286,119,33,31.571428571428573,23
Category_Wikipedia_sockpuppets_of_Wolf_Cola.csv,1590,50795655.0,582,1008,266,316,0,46.252201257861635,394,54,17.755974842767294,5
Category_Wikipedia_sockpuppets_of_Bingrau.csv,89,120942336.0,31,58,27,4,0,56.0,296,53,28.40449438202247,11
Category_Wikipedia_sockpuppets_of_Nilesh_kmr_2010.csv,393,9910304.0,95,298,19,76,0,45.80916030534351,450,51,21.206106870229007,4
Category_Wikipedia_sockpuppets_of_Ladvinealmeidamec.csv,587,63560128.0,294,293,186,108,0,34.017035775127766,255,78,18.712095400340715,3
Category_Wikipedia_sockpuppets_of_LeandroTelesRocha1983.csv,163,5798080.0,48,115,40,8,0,44.95092024539877,235,49,17.411042944785276,11
Category_Wikipedia_sockpuppets_of_EU_100%.csv,436,4428191.0,206,230,164,42,0,44.11926605504587,179,61,24.03440366972477,10
Category_Wikipedia_sockpuppets_of_Charbelfvkc.csv,248,44502796.0,74,174,46,28,0,39.62903225806452,255,53,17.048387096774192,10
Category_Wikipedia_sockpuppets_of_Shivambangwal.csv,450,51440334.0,155,295,54,101,0,51.91777777777778,496,70,18.517777777777777,4
Category_Wikipedia_sockpuppets_of_Foxhunt99.csv,758,3288700.0,263,495,108,155,0,51.57387862796834,213,54,19.671503957783642,3
Category_Wikipedia_sockpuppets_of_BetterThanSuchAsYou.csv,334,6101137.0,115,219,94,21,0,55.84431137724551,251,35,18.71556886227545,4
Category_Wikipedia_sockpuppets_of_Niyaxm.csv,10,237978.0,6,4,5,1,0,64.6,255,16,16.0,16
Category_Wikipedia_sockpuppets_of_NickSoroka.csv,81,16960888.0,60,21,48,12,0,19.098765432098766,145,58,43.04938271604938,9
Category_Wikipedia_sockpuppets_of_Argol136.csv,76,1219681.0,28,48,13,15,0,47.828947368421055,181,54,23.43421052631579,12
Category_Wikipedia_sockpuppets_of_Matrix17.csv,82,172923.0,31,51,31,0,0,30.75609756097561,184,25,13.426829268292684,6
Category_Wikipedia_sockpuppets_of_Opi9516.csv,124,220320.0,67,57,53,14,0,51.66935483870968,198,86,47.62096774193548,5
Category_Wikipedia_sockpuppets_of_W√∂lffReik.csv,4623,14583492.0,1505,3118,500,1005,0,34.55180618645901,239,92,17.66039368375514,3
Category_Wikipedia_sockpuppets_of_Anmoldhiman0408.csv,18,24553823.0,7,11,4,3,0,48.22222222222222,196,25,14.61111111111111,9
Category_Wikipedia_sockpuppets_of_Brogo13.csv,5455,84040920.0,1292,4163,500,792,0,52.20311640696609,500,69,19.397066911090743,3
Category_Wikipedia_sockpuppets_of_Fajitagate.csv,282,54794207.0,78,204,71,7,0,50.47517730496454,226,20,12.322695035460994,8
Category_Wikipedia_sockpuppets_of_NeWsChOolShOoTeRiNtOwN.csv,1,0.0,1,0,1,0,0,0.0,0,45,45.0,45
Category_Wikipedia_sockpuppets_of_Adamc714.csv,1417,388575664.0,468,949,453,15,0,45.49188426252646,249,88,21.220183486238533,3
Category_Wikipedia_sockpuppets_of_Aggiefan47.csv,1812,72071821.0,524,1288,500,24,0,50.88245033112583,301,40,14.030353200883003,6
Category_Wikipedia_sockpuppets_of_Jovialman.csv,103,46406089.0,41,62,26,15,0,52.737864077669904,134,37,11.805825242718447,6
Category_Wikipedia_sockpuppets_of_Questionable_pulse.csv,17112,14420697.0,7963,9149,500,7463,0,39.77173913043478,259,91,18.226157082748948,3
Category_Wikipedia_sockpuppets_of_Bob_N1C2.csv,1754,61833528.0,515,1239,500,15,0,36.612884834663625,255,45,22.653363740022805,7
Category_Wikipedia_sockpuppets_of_Lachlb.csv,1523,1837972.0,586,937,500,86,0,53.44583059750492,362,65,18.716349310571243,2
Category_Wikipedia_sockpuppets_of_19Akvim.csv,56,432728.0,34,22,19,15,0,34.125,252,26,12.875,5
Category_Wikipedia_sockpuppets_of_Justsugmadique.csv,2912,6116281.0,993,1919,287,706,0,38.47733516483517,373,48,13.857142857142858,3
Category_Wikipedia_sockpuppets_of_Arun_nadar123.csv,222,6694721.0,75,147,11,64,0,38.792792792792795,223,28,12.77027027027027,5
Category_Wikipedia_sockpuppets_of_Norms1107.csv,38,1894298.0,13,25,13,0,0,46.78947368421053,190,19,18.210526315789473,17
Category_Wikipedia_sockpuppets_of_Islamuslim.csv,977,3440940.0,307,670,307,0,0,51.3439099283521,250,70,17.948822927328557,4
Category_Wikipedia_sockpuppets_of_Collingwood26.csv,2834,57243679.0,978,1856,500,478,0,47.55645730416373,255,68,25.558574453069866,4
Category_Wikipedia_sockpuppets_of_Hersheybearsfan.csv,2793,37274914.0,1073,1720,500,573,0,36.38202649480845,263,61,21.572860723236662,4
Category_Wikipedia_sockpuppets_of_Biasprotector.csv,69,1138926.0,17,52,12,5,0,35.05797101449275,125,50,32.36231884057971,14
Category_Wikipedia_sockpuppets_of_Johnblaze_editor.csv,215,4493417.0,72,143,48,24,0,55.776744186046514,496,29,16.013953488372092,4
Category_Wikipedia_sockpuppets_of_Thesouthernhistorian45.csv,2540,100465041.0,534,2006,500,34,0,54.78740157480315,255,50,16.844488188976378,5
Category_Wikipedia_sockpuppets_of_Captamerica76.csv,15,3629466.0,3,12,2,1,6,51.2,169,18,17.733333333333334,16
Category_Wikipedia_sockpuppets_of_BaptistBolt.csv,32,199032.0,19,13,15,4,0,51.0,183,20,18.25,15
Category_Wikipedia_sockpuppets_of_Bullied_in_front_of_a_train.csv,4,231.0,2,2,2,0,16,67.0,173,10,10.0,10
Category_Wikipedia_sockpuppets_of_HasanKh.csv,84,241274.0,48,36,24,24,0,26.857142857142858,253,24,13.94047619047619,9
Category_Wikipedia_sockpuppets_of_Typhoon_Namer_325.csv,91,4058028.0,44,47,34,10,0,47.043956043956044,362,63,26.747252747252748,8
Category_Wikipedia_sockpuppets_of_Lonerphoenix93.csv,726,37845655.0,189,537,146,43,0,37.86914600550964,376,55,22.757575757575758,4
Category_Wikipedia_sockpuppets_of_Fruitsnfruits.csv,45,86882.0,18,27,8,10,0,53.28888888888889,233,19,10.377777777777778,6
Category_Wikipedia_sockpuppets_of_ZOE_KING_518.csv,22,501492.0,7,15,7,0,0,23.0,169,47,32.45454545454545,27
Category_Wikipedia_sockpuppets_of_Joehazelton.csv,1678,211571711.0,681,997,251,430,0,56.98569725864124,249,69,20.45709177592372,9
Category_Wikipedia_sockpuppets_of_Kitkatoff.csv,3,101.0,2,1,2,0,0,11.333333333333334,17,44,44.0,44
Category_Wikipedia_sockpuppets_of_Ammandesignweek.csv,1,0.0,1,0,1,0,58,58.0,58,25,25.0,25
Category_Wikipedia_sockpuppets_of_ArchieHall.csv,611,28944606.0,144,467,126,18,0,36.40261865793781,211,45,15.46644844517185,7
Category_Wikipedia_sockpuppets_of_Armcheeseh.csv,295,743197.0,94,201,52,42,0,40.15593220338983,205,55,16.691525423728812,3
Category_Wikipedia_sockpuppets_of_CASEL2019.csv,8,1613471.0,3,5,2,1,24,77.875,145,51,37.5,15
Category_Wikipedia_sockpuppets_of_BritishSpaniard.csv,2834,13207766.0,923,1911,486,437,0,54.64678899082569,498,76,30.577275935074102,7
Category_Wikipedia_sockpuppets_of_Frankdasilva.csv,46,27707938.0,15,31,13,2,0,33.369565217391305,142,46,27.52173913043478,11
Category_Wikipedia_sockpuppets_of_Monsterbeat.csv,65,477818895.0,24,41,12,12,0,64.44615384615385,211,38,19.046153846153846,12
Category_Wikipedia_sockpuppets_of_EmonyRanger.csv,486,1602631.0,176,310,101,75,0,54.02674897119341,255,52,33.211934156378604,11
Category_Wikipedia_sockpuppets_of_CareAtya.csv,67,31450980.0,21,46,21,0,0,48.40298507462686,240,53,29.65671641791045,8
Category_Wikipedia_sockpuppets_of_IceBrotherhood.csv,2175,41744443.0,618,1557,500,118,0,49.93103448275862,468,72,20.28367816091954,4
Category_Wikipedia_sockpuppets_of_Aiza00.csv,1575,2055572.0,700,875,263,437,0,22.217142857142857,209,67,15.212063492063493,5
Category_Wikipedia_sockpuppets_of_Ghb13245.csv,6,16221.0,4,2,2,2,0,66.0,159,13,13.0,13
Category_Wikipedia_sockpuppets_of_Asclsmo.csv,17,23082.0,12,5,12,0,0,32.11764705882353,176,21,18.058823529411764,17
Category_Wikipedia_sockpuppets_of_Breaker007.csv,2445,15196445.0,896,1549,492,404,0,45.11574642126789,496,61,20.097750511247444,5
Category_Wikipedia_sockpuppets_of_Shhdj_jsgxgkv.csv,46,15434250.0,18,28,15,3,0,75.80434782608695,332,43,25.456521739130434,7
Category_Wikipedia_sockpuppets_of_AffeL.csv,3754,133322072.0,1315,2439,500,815,0,38.61507725093234,255,102,21.179541822056475,2
Category_Wikipedia_sockpuppets_of_Sudhir7777.csv,945,8473240.0,367,578,233,134,0,41.645502645502646,255,63,17.853968253968254,5
Category_Wikipedia_sockpuppets_of_Mahir007.csv,280,6825532.0,126,154,117,9,0,40.253571428571426,255,50,16.925,8
Category_Wikipedia_sockpuppets_of_Benwapner.csv,12,25675.0,8,4,4,4,0,60.416666666666664,241,33,15.5,8
Category_Wikipedia_sockpuppets_of_Russki_Boi.csv,70,487615.0,27,43,18,9,0,54.52857142857143,220,33,12.5,2
Category_Wikipedia_sockpuppets_of_Nailclipper1.csv,107,5874591.0,33,74,8,25,0,48.19626168224299,248,32,14.205607476635514,5
Category_Wikipedia_sockpuppets_of_Ineedtoeditthisarticle.csv,407,40961402.0,133,274,42,91,0,45.45945945945946,231,66,21.395577395577394,4
Category_Wikipedia_sockpuppets_of_MA_Long_(Architect).csv,10,754852.0,7,3,6,1,0,9.1,37,24,23.4,18
Category_Wikipedia_sockpuppets_of_Oriel36.csv,916,92256085.0,410,506,272,138,0,48.786026200873366,228,30,16.496724890829693,9
Category_Wikipedia_sockpuppets_of_Fortresslinux.csv,27,1851062.0,13,14,6,7,0,46.592592592592595,227,46,27.40740740740741,23
Category_Wikipedia_sockpuppets_of_Angelaquency.csv,459,849560.0,203,256,90,113,0,49.910675381263616,234,75,16.869281045751634,4
Category_Wikipedia_sockpuppets_of_Festes.csv,617,162930622.0,201,416,62,139,0,40.72285251215559,233,41,14.837925445705025,6
Category_Wikipedia_sockpuppets_of_ŒëŒΩŒ±œÅœáŒØŒ±.csv,549,4311293.0,154,395,150,4,0,38.44808743169399,199,55,18.0327868852459,4
Category_Wikipedia_sockpuppets_of_Ishq_Hawa_Mein.csv,12364,66294959.0,3447,8917,270,3177,0,49.58694597217729,266,62,15.237706243934001,4
Category_Wikipedia_sockpuppets_of_Nanseera_Tracey.csv,2478,56919363.0,951,1527,497,454,0,45.76715092816788,496,51,16.40314769975787,5
Category_Wikipedia_sockpuppets_of_TheSmartOneForeeever.csv,6,1893.0,3,3,2,1,0,54.666666666666664,187,17,17.0,17
Category_Wikipedia_sockpuppets_of_Valleyside_show.csv,46,4154399.0,24,22,19,5,0,72.1304347826087,241,17,17.0,17
Category_Wikipedia_sockpuppets_of_Jon_Awbrey.csv,9894,125963678.0,3634,6260,500,3134,0,43.62158884172226,250,75,21.098948857893674,3
Category_Wikipedia_sockpuppets_of_Yarasaad.csv,19,3698722.0,9,10,6,3,0,38.526315789473685,127,24,18.157894736842106,13
Category_Wikipedia_sockpuppets_of_SakshiKumar3.csv,16,762141.0,15,1,9,6,0,95.625,382,22,13.875,12
Category_Wikipedia_sockpuppets_of_VAJ_VASANDANI.csv,76,262296.0,20,56,15,5,0,60.1578947368421,209,26,15.223684210526315,4
Category_Wikipedia_sockpuppets_of_Molag_Bal.csv,13719,45675858.0,4653,9066,500,4153,0,42.631532910561994,258,102,21.180844084845834,1
Category_Wikipedia_sockpuppets_of_Aedwards89.csv,1,0.0,1,0,1,0,199,199.0,199,15,15.0,15
Category_Wikipedia_sockpuppets_of_Yasmina-NCW.csv,40,271173.0,35,5,32,3,0,11.5,166,10,10.0,10
Category_Wikipedia_sockpuppets_of_FYE31.csv,2663,22651459.0,954,1709,500,454,0,51.207660533233195,496,61,27.641757416447614,4
Category_Wikipedia_sockpuppets_of_Robindhanwani.csv,35,16317859.0,16,19,14,2,0,42.31428571428572,196,26,20.542857142857144,16
Category_Wikipedia_sockpuppets_of_X_Nilloc_X.csv,259,61044730.0,56,203,53,3,0,59.270270270270274,233,59,30.77992277992278,10
Category_Wikipedia_sockpuppets_of_Dashtshuligkech.csv,96,41304470.0,41,55,22,19,0,72.29166666666667,316,40,20.40625,5
Category_Wikipedia_sockpuppets_of_Finneganw.csv,1419,5221651.0,500,919,500,0,0,36.656095842142356,250,51,21.35588442565187,6
Category_Wikipedia_sockpuppets_of_Ogresss.csv,21,608295.0,11,10,6,5,0,50.19047619047619,159,16,9.571428571428571,7
Category_Wikipedia_sockpuppets_of_Saint_Artjunkie.csv,105,26248218.0,43,62,14,29,0,55.59047619047619,222,19,16.685714285714287,9
Category_Wikipedia_sockpuppets_of_Ameya199.csv,49,260348.0,30,19,16,14,0,74.85714285714286,204,27,15.918367346938776,6
Category_Wikipedia_sockpuppets_of_Monthandme.csv,672,40521661.0,228,444,137,91,0,46.04613095238095,250,54,19.654761904761905,5
Category_Wikipedia_sockpuppets_of_Jayhammers.csv,323,76310787.0,93,230,90,3,0,56.56037151702786,250,37,19.222910216718265,8
Category_Wikipedia_sockpuppets_of_Sussexman.csv,5516,338832686.0,1966,3550,500,1466,0,41.2291515591008,255,74,22.648295866569978,5
Category_Wikipedia_sockpuppets_of_Gareth_Tucker40.3.csv,39,541.0,14,25,9,5,0,52.43589743589744,153,37,22.666666666666668,9
Category_Wikipedia_sockpuppets_of_BalloonBalloon.csv,35,16426.0,34,1,28,6,0,45.57142857142857,125,10,10.0,10
Category_Wikipedia_sockpuppets_of_Charliewolf79.csv,1489,50862936.0,610,879,288,322,0,39.61316319677636,255,49,19.007387508394896,8
Category_Wikipedia_sockpuppets_of_Eltomas2003.csv,3139,195774474.0,875,2264,199,676,0,55.15833067856005,496,107,22.693532972284167,3
Category_Wikipedia_sockpuppets_of_Echigo_mole.csv,4481,128854064.0,1545,2936,154,1391,0,44.905378263780406,254,87,22.576210667261773,3
Category_Wikipedia_sockpuppets_of_Saikano.csv,1688,67721460.0,566,1122,298,268,0,31.571090047393366,255,66,20.975710900473935,4
Category_Wikipedia_sockpuppets_of_Piquefan3.csv,118,45821172.0,24,94,22,2,0,76.67796610169492,256,53,15.483050847457626,9
Category_Wikipedia_sockpuppets_of_Kavindeep.csv,181,9717672.0,103,78,95,8,0,23.569060773480665,241,48,17.43646408839779,10
Category_Wikipedia_sockpuppets_of_Thakur_Sohan_Singh.csv,234,1017441.0,98,136,30,68,0,60.957264957264954,502,20,12.542735042735043,5
Category_Wikipedia_sockpuppets_of_Mir.Mustafa.Ali.csv,60,13810515.0,12,48,2,10,0,55.95,195,17,8.433333333333334,3
Category_Wikipedia_sockpuppets_of_Jacquimunroe.csv,341,391186202.0,100,241,40,60,0,41.36363636363637,255,70,24.451612903225808,6
Category_Wikipedia_sockpuppets_of_LS_C_HIST.csv,2335,28094796.0,987,1348,500,487,0,35.59743040685225,244,70,23.331049250535333,5
Category_Wikipedia_sockpuppets_of_Msa1701.csv,3334,110864760.0,815,2519,500,315,0,37.739652069586086,255,44,16.278044391121774,5
Category_Wikipedia_sockpuppets_of_Eshumaitreyus.csv,299,19170464.0,114,185,98,16,0,77.40468227424749,255,54,24.36454849498328,5
Category_Wikipedia_sockpuppets_of_Lolababy.csv,105,6735650.0,21,84,18,3,0,34.59047619047619,160,49,16.504761904761907,3
Category_Wikipedia_sockpuppets_of_Open_Division.csv,2,0.0,1,1,1,0,0,0.0,0,41,41.0,41
Category_Wikipedia_sockpuppets_of_Rvxnisgay.csv,2,387.0,2,0,1,1,5,18.0,31,29,23.0,17
Category_Wikipedia_sockpuppets_of_Jxzgfczdhsabxuy.csv,7,233.0,4,3,4,0,0,70.14285714285714,196,23,23.0,23
Category_Wikipedia_sockpuppets_of_Ddnile.csv,3623,120622783.0,1164,2459,500,664,0,55.070659674303066,499,66,17.120618272150153,3
Category_Wikipedia_sockpuppets_of_DuskyWeather.csv,2474,80462584.0,743,1731,306,437,0,51.99151172190784,424,84,28.822958771220694,4
Category_Wikipedia_sockpuppets_of_Luckyaudrey.csv,34,1468362.0,16,18,9,7,14,71.58823529411765,149,23,15.205882352941176,4
Category_Wikipedia_sockpuppets_of_Songfo96.csv,178,13740787.0,135,43,130,5,0,22.685393258426966,196,45,21.174157303370787,9
Category_Wikipedia_sockpuppets_of_Addyjuly.csv,51,1119729.0,26,25,26,0,0,24.41176470588235,199,23,11.333333333333334,6
Category_Wikipedia_sockpuppets_of_CalaEdwards.csv,50,290187381.0,13,37,12,1,0,42.68,212,41,21.6,16
Category_Wikipedia_sockpuppets_of_Bk2006.csv,1956,52915193.0,634,1322,500,134,0,35.90644171779141,240,61,19.328220858895705,3
Category_Wikipedia_sockpuppets_of_Nkapoor21.csv,2175,72373054.0,836,1339,351,485,0,39.675862068965515,258,38,16.268045977011493,5
Category_Wikipedia_sockpuppets_of_Social25062.csv,211,48893432.0,68,143,54,14,0,63.976303317535546,265,57,17.990521327014218,6
Category_Wikipedia_sockpuppets_of_Ejoselito57.csv,2107,21308730.0,769,1338,500,269,0,33.13953488372093,254,81,24.891789273849074,4
Category_Wikipedia_sockpuppets_of_Caligvla.csv,1676,86156844.0,502,1174,500,2,0,36.15453460620525,225,54,18.569212410501194,4
Category_Wikipedia_sockpuppets_of_Puggnoxious.csv,151,79665979.0,54,97,19,35,0,44.33112582781457,229,22,12.675496688741722,11
Category_Wikipedia_sockpuppets_of_Dhuliyeyaman.csv,1,0.0,1,0,1,0,51,51.0,51,25,25.0,25
Category_Wikipedia_sockpuppets_of_Blurred_Edge.csv,20,18315336.0,7,13,5,2,0,31.6,219,45,27.65,11
Category_Wikipedia_sockpuppets_of_Alexyflemming.csv,1531,23165536.0,571,960,500,71,0,58.60156760287394,255,69,22.17570215545395,5
Category_Wikipedia_sockpuppets_of_Lovertruck.csv,48,55551020.0,14,34,12,2,0,58.270833333333336,222,35,17.875,1
Category_Wikipedia_sockpuppets_of_Mgravagna.csv,64,28755848.0,26,38,21,5,0,38.953125,315,19,14.703125,14
Category_Wikipedia_sockpuppets_of_DIGIPankaj.csv,44,17869817.0,12,32,9,3,0,69.0909090909091,241,22,11.818181818181818,4
Category_Wikipedia_sockpuppets_of_Steam_Heatsystem.csv,514,11537475.0,179,335,70,109,0,56.340466926070036,449,50,25.30739299610895,6
Category_Wikipedia_sockpuppets_of_PrinceofFrancia.csv,1638,33358256.0,489,1149,325,164,0,53.795482295482294,480,48,15.628205128205128,3
Category_Wikipedia_sockpuppets_of_LimeJello_Pudding.csv,1,0.0,1,0,1,0,0,0.0,0,15,15.0,15
Category_Wikipedia_sockpuppets_of_Jashanburjan.csv,4,394410.0,3,1,3,0,0,16.25,65,22,22.0,22
Category_Wikipedia_sockpuppets_of_Opn800.csv,278,69794665.0,88,190,80,8,0,46.85971223021583,227,68,15.388489208633093,3
Category_Wikipedia_sockpuppets_of_JC1123581321.csv,1,0.0,1,0,1,0,24,24.0,24,19,19.0,19
Category_Wikipedia_sockpuppets_of_Plotagontheanimator2918.csv,63,36981457.0,21,42,19,2,0,40.55555555555556,218,42,26.96825396825397,19
Category_Wikipedia_sockpuppets_of_Kumbha_manoj_kumar_AP_CONGRESS.csv,21,26882296.0,7,14,4,3,0,80.14285714285714,220,40,19.80952380952381,9
Category_Wikipedia_sockpuppets_of_Aflantwo.csv,1299,41723033.0,513,786,306,207,0,52.805234795996924,348,74,22.888375673595075,5
Category_Wikipedia_sockpuppets_of_NicholasSucks.csv,37,1150.0,12,25,10,2,0,53.270270270270274,196,23,10.72972972972973,3
Category_Wikipedia_sockpuppets_of_Abhi.rajesh.csv,1,0.0,1,0,1,0,0,0.0,0,18,18.0,18
Category_Wikipedia_sockpuppets_of_Ross_Fidel.csv,33,3537209.0,10,23,5,5,0,40.39393939393939,196,46,22.818181818181817,14
Category_Wikipedia_sockpuppets_of_123lilbrad.csv,2872,70910639.0,882,1990,426,456,0,44.40285515320334,255,68,20.9216573816156,3
Category_Wikipedia_sockpuppets_of_Shahin_hossain007.csv,22,1119011.0,8,14,5,3,12,73.27272727272727,496,53,38.54545454545455,21
Category_Wikipedia_sockpuppets_of_Rockonaniguana.csv,165,1983704.0,145,20,72,73,0,43.21212121212121,436,12,12.0,12
Category_Wikipedia_sockpuppets_of_Godrog.csv,25,399683.0,18,7,10,8,0,45.24,175,20,16.68,11
Category_Wikipedia_sockpuppets_of_Fredd7271.csv,165,4152183.0,84,81,81,3,0,40.56969696969697,200,31,21.696969696969695,13
Category_Wikipedia_sockpuppets_of_CrystalBlue2012.csv,185,4572508.0,170,15,94,76,0,41.054054054054056,196,36,18.945945945945947,10
Category_Wikipedia_sockpuppets_of_Mission_Q8.csv,200,6137332.0,82,118,38,44,0,75.635,371,46,17.745,6
Category_Wikipedia_sockpuppets_of_CosmicLegg.csv,4371,12345766.0,1476,2895,500,976,0,34.4955387783116,255,59,17.891786776481354,3
Category_Wikipedia_sockpuppets_of_HanzoHattori.csv,8880,115491377.0,2857,6023,500,2357,0,34.02533783783784,250,59,20.043693693693694,4
Category_Wikipedia_sockpuppets_of_Keelelegend.csv,219,289879705.0,50,169,36,14,0,56.23287671232877,254,28,14.835616438356164,10
Category_Wikipedia_sockpuppets_of_8570w.csv,866,129618619.0,502,364,273,229,0,38.14549653579677,275,44,16.889145496535797,6
Category_Wikipedia_sockpuppets_of_Beyoncetan.csv,2747,153362156.0,1043,1704,500,543,0,43.17510010921005,527,88,19.918456497997816,4
Category_Wikipedia_sockpuppets_of_Rex071404.csv,6787,73063911.0,2546,4241,500,2046,0,38.27331663474289,255,90,22.381464564608812,3
Category_Wikipedia_sockpuppets_of_Ridwan97.csv,4245,27333211.0,1233,3012,500,733,0,42.74252061248528,500,56,16.17809187279152,3
Category_Wikipedia_sockpuppets_of_PPP001.csv,3082,22717037.0,1378,1704,500,878,0,36.57689811810513,496,73,28.169046073977935,4
Category_Wikipedia_sockpuppets_of_Jonadabsmith.csv,114,433127.0,52,62,51,1,0,31.95614035087719,194,59,40.166666666666664,10
Category_Wikipedia_sockpuppets_of_Trying_to_ruin_everything_in_wikipedi.csv,2,0.0,1,1,1,0,65,65.0,65,40,40.0,40
Category_Wikipedia_sockpuppets_of_Cupidcobra.csv,438,475479161.0,103,335,103,0,0,49.602739726027394,484,46,18.58675799086758,6
Category_Wikipedia_sockpuppets_of_Mercy11.csv,4490,504032652.0,1361,3129,500,861,0,51.650556792873054,500,82,23.7456570155902,3
Category_Wikipedia_sockpuppets_of_Tontitobebe.csv,164,687382.0,57,107,7,50,0,63.41463414634146,255,45,17.628048780487806,5
Category_Wikipedia_sockpuppets_of_JayyyyMLG666.csv,208,6483523.0,63,145,37,26,0,47.10576923076923,234,29,13.822115384615385,4
Category_Wikipedia_sockpuppets_of_Dwinug.csv,4049,25071985.0,1627,2422,500,1127,0,21.40380340824895,500,58,17.537169671523834,4
Category_Wikipedia_sockpuppets_of_Vasssi.csv,179,1410612.0,77,102,44,33,0,58.23463687150838,300,50,19.251396648044693,4
Category_Wikipedia_sockpuppets_of_Vigilant~enwiki.csv,602,236786612.0,170,432,135,35,0,48.79900332225914,245,62,27.941860465116278,8
Category_Wikipedia_sockpuppets_of_FaheyUSMC.csv,266,45278998.0,92,174,50,42,0,51.454887218045116,216,54,25.43609022556391,14
Category_Wikipedia_sockpuppets_of_RishabhCine.csv,592,4105823.0,213,379,136,77,0,25.54391891891892,245,47,15.653716216216216,6
Category_Wikipedia_sockpuppets_of_Lyhendi.csv,21,2753141.0,8,13,3,5,0,45.666666666666664,129,49,28.047619047619047,13
Category_Wikipedia_sockpuppets_of_Solefaro.csv,126,19121324.0,70,56,11,59,0,48.317460317460316,280,34,17.91269841269841,9
Category_Wikipedia_sockpuppets_of_Risala99.csv,618,116335586.0,374,244,136,238,0,29.001618122977348,205,20,16.83009708737864,9
Category_Wikipedia_sockpuppets_of_Anankiaushdud.csv,323,10160805.0,112,211,99,13,0,39.48297213622291,494,63,20.88544891640867,4
Category_Wikipedia_sockpuppets_of_KendlBoettcher.csv,767,22083357.0,242,525,126,116,0,39.0013037809648,272,47,19.666232073011734,5
Category_Wikipedia_sockpuppets_of_Brightdoju.csv,45,869714.0,31,14,30,1,0,72.75555555555556,246,16,7.8,7
Category_Wikipedia_sockpuppets_of_Ayyanali2100.csv,330,6990968.0,168,162,137,31,0,38.68484848484849,247,49,24.336363636363636,7
Category_Wikipedia_sockpuppets_of_JeremyHidenbergus.csv,606,21374876.0,194,412,125,69,0,45.100660066006604,496,58,22.28877887788779,3
Category_Wikipedia_sockpuppets_of_Riteshmmec.csv,1287,291684559.0,385,902,372,13,0,52.967365967365964,496,65,15.804195804195805,5
Category_Wikipedia_sockpuppets_of_WeAreAllStars.csv,86,170404443.0,37,49,34,3,0,69.38372093023256,264,73,33.593023255813954,11
Category_Wikipedia_sockpuppets_of_Iwantitalllllllll.csv,15,498.0,6,9,6,0,0,49.53333333333333,191,24,15.6,3
Category_Wikipedia_sockpuppets_of_Gaurav.jhala88.csv,1611,218329186.0,437,1174,270,167,0,42.05896958410925,255,51,17.6772191185599,4
Category_Wikipedia_sockpuppets_of_Tester85.csv,2517,1025375.0,1777,740,500,1277,0,17.150973381009138,342,53,21.20699245133095,5
Category_Wikipedia_sockpuppets_of_Tanbircdq.csv,2483,163967944.0,681,1802,500,181,0,51.31574708014499,504,84,18.50785340314136,3
Category_Wikipedia_sockpuppets_of_Plarem.csv,2493,62059568.0,843,1650,500,343,0,46.64139590854392,254,52,23.512234255916567,4
Category_Wikipedia_sockpuppets_of_Gameroffun.csv,708,55308343.0,213,495,199,14,0,48.42090395480226,255,61,19.992937853107346,3
Category_Wikipedia_sockpuppets_of_Zbrink89.csv,33,108208.0,17,16,17,0,0,71.87878787878788,200,31,28.303030303030305,26
Category_Wikipedia_sockpuppets_of_19andy91.csv,1571,84883029.0,481,1090,237,244,0,28.376830044557607,227,44,24.784850413749204,3
Category_Wikipedia_sockpuppets_of_Kmarsus.csv,19,124358350.0,5,14,5,0,0,54.473684210526315,240,47,45.1578947368421,12
Category_Wikipedia_sockpuppets_of_Nate1506.csv,27,86581.0,14,13,5,9,17,120.4074074074074,199,25,18.296296296296298,13
Category_Wikipedia_sockpuppets_of_John_Micle69.csv,8,2120.0,4,4,2,2,0,33.5,94,37,25.0,19
Category_Wikipedia_sockpuppets_of_Davefreak0101.csv,67,680458.0,29,38,15,14,0,73.98507462686567,200,26,20.940298507462686,17
Category_Wikipedia_sockpuppets_of_Eternal_Equinox.csv,1740,8262612.0,531,1209,500,31,0,33.157471264367814,217,72,21.45402298850575,4
Category_Wikipedia_sockpuppets_of_Alitta_Cat.csv,91,64536757.0,31,60,24,7,0,51.79120879120879,209,41,19.64835164835165,13
Category_Wikipedia_sockpuppets_of_Bailey12123.csv,13,13984.0,11,2,9,2,0,32.84615384615385,227,17,17.0,17
Category_Wikipedia_sockpuppets_of_Setano.csv,171,87083366.0,86,85,77,9,0,45.9766081871345,331,63,13.75438596491228,5
Category_Wikipedia_sockpuppets_of_JaismeenBajwa.csv,43,127737.0,36,7,15,21,0,26.302325581395348,196,38,19.488372093023255,15
Category_Wikipedia_sockpuppets_of_Zadok1234.csv,169,4710594.0,45,124,19,26,0,42.25443786982248,382,29,12.792899408284024,5
Category_Wikipedia_sockpuppets_of_Thisbites.csv,1547,3170253.0,579,968,500,79,0,44.187459599224304,249,76,23.2049127343245,2
Category_Wikipedia_sockpuppets_of_Edson_Rosa.csv,4283,111059151.0,1400,2883,500,900,0,27.355825356058837,253,51,14.789633434508522,3
Category_Wikipedia_sockpuppets_of_Veldin963.csv,2276,195487715.0,547,1729,500,47,0,41.731546572934974,250,41,15.943321616871705,3
Category_Wikipedia_sockpuppets_of_Nagjajakol_si_Joel_Reyes_Zobel.csv,37,181411.0,20,17,9,11,0,66.89189189189189,289,44,25.35135135135135,4
Category_Wikipedia_sockpuppets_of_Alextwa.csv,3788,336897521.0,1050,2738,500,550,0,46.37328405491024,496,71,21.42740232312566,6
Category_Wikipedia_sockpuppets_of_Ranleewright.csv,295,43144047.0,84,211,74,10,0,47.83728813559322,204,65,31.735593220338984,12
Category_Wikipedia_sockpuppets_of_Dragonron.csv,2972,279368933.0,982,1990,500,482,0,45.40746971736205,255,71,15.926648721399731,3
Category_Wikipedia_sockpuppets_of_Qwaz123qwaz123qwaz123.csv,75,4419.0,21,54,12,9,0,61.54666666666667,230,30,14.746666666666666,3
Category_Wikipedia_sockpuppets_of_Tristan_langford.csv,114,90400.0,51,63,51,0,0,47.75438596491228,162,31,18.75438596491228,11
Category_Wikipedia_sockpuppets_of_Nihonjimu.csv,416,139471553.0,121,295,60,61,0,55.25240384615385,274,29,14.622596153846153,6
Category_Wikipedia_sockpuppets_of_Th041.csv,33,19086411.0,11,22,9,2,0,50.121212121212125,195,22,6.909090909090909,4
Category_Wikipedia_sockpuppets_of_Buddhafollower.csv,749,15543091.0,255,494,203,52,0,40.10013351134847,250,26,12.240320427236314,4
Category_Wikipedia_sockpuppets_of_Xjakeking.csv,8,788.0,6,2,6,0,0,8.0,32,17,17.0,17
Category_Wikipedia_sockpuppets_of_Ialiabbas.csv,543,74403495.0,228,315,214,14,0,43.09760589318601,255,50,14.508287292817679,4
Category_Wikipedia_sockpuppets_of_PhoenixS15.csv,511,56396879.0,113,398,32,81,0,54.33268101761252,378,47,13.673189823874756,3
Category_Wikipedia_sockpuppets_of_Davion100.csv,60,13597910.0,24,36,11,13,0,40.63333333333333,227,15,15.0,15
Category_Wikipedia_sockpuppets_of_Ladnavfan.csv,346,308796.0,116,230,42,74,0,38.358381502890175,199,70,19.884393063583815,5
Category_Wikipedia_sockpuppets_of_Thewolf12.csv,247,60452022.0,59,188,58,1,0,47.05263157894737,240,41,20.178137651821864,6
Category_Wikipedia_sockpuppets_of_Steelcity95.csv,1073,152727205.0,307,766,230,77,0,38.76607642124883,232,55,26.672879776328053,6
Category_Wikipedia_sockpuppets_of_Skychildandsonofthesun.csv,1283,200212505.0,507,776,487,20,0,42.32112236944661,234,45,19.75526110678098,5
Category_Wikipedia_sockpuppets_of_Pair2011.csv,19,62742671.0,10,9,6,4,0,67.89473684210526,199,20,14.157894736842104,4
Category_Wikipedia_sockpuppets_of_Heffner000.csv,4538,25943380.0,1576,2962,500,1076,0,48.328999559277214,500,68,15.384089907448216,3
Category_Wikipedia_sockpuppets_of_Some1asks.csv,834,3701609.0,346,488,337,9,0,69.71342925659472,256,55,22.503597122302157,5
Category_Wikipedia_sockpuppets_of_FrancisLightHouse.csv,591,104543285.0,224,367,100,124,0,37.11844331641286,255,73,21.56006768189509,8
Category_Wikipedia_sockpuppets_of_Corbettreso.csv,50,151349935.0,10,40,8,2,0,46.2,255,34,15.54,7
Category_Wikipedia_sockpuppets_of_Docgsound.csv,14,37965.0,7,7,6,1,0,33.0,92,19,14.142857142857142,12
Category_Wikipedia_sockpuppets_of_Smilin916.csv,33,12258631.0,22,11,13,9,0,62.303030303030305,237,27,26.90909090909091,24
Category_Wikipedia_sockpuppets_of_Chaurasia_Brahmin.csv,70,33899.0,45,25,45,0,0,9.4,250,18,9.9,9
Category_Wikipedia_sockpuppets_of_Haldir_Marchwarden.csv,1562,2824468.0,513,1049,500,13,0,52.2752880921895,496,65,21.884763124199743,5
Category_Wikipedia_sockpuppets_of_DashaG11.csv,303,34546408.0,109,194,106,3,0,41.33993399339934,196,45,19.32013201320132,7
Category_Wikipedia_sockpuppets_of_Xxxhrxxx.csv,314,1755485.0,109,205,109,0,0,52.78662420382165,498,42,15.01592356687898,4
Category_Wikipedia_sockpuppets_of_DavoidNeverSweat.csv,5,1556.0,3,2,2,1,13,100.6,191,37,24.8,8
Category_Wikipedia_sockpuppets_of_NYCsociety.csv,1,0.0,1,0,1,0,0,0.0,0,16,16.0,16
Category_Wikipedia_sockpuppets_of_Gravitor.csv,2025,20911311.0,1000,1025,500,500,0,42.80543209876543,200,90,33.022716049382716,7
Category_Wikipedia_sockpuppets_of_Srianu1.csv,223,70294047.0,95,128,91,4,0,37.6457399103139,243,21,14.807174887892376,6
Category_Wikipedia_sockpuppets_of_Brice21.csv,1,0.0,1,0,1,0,0,0.0,0,13,13.0,13
Category_Wikipedia_sockpuppets_of_Hdhsakjdahsskds.csv,15,1395264.0,7,8,5,2,0,45.93333333333333,179,40,21.733333333333334,9
Category_Wikipedia_sockpuppets_of_Benji987654.csv,51,15809999.0,17,34,10,7,0,40.568627450980394,229,24,13.411764705882353,8
Category_Wikipedia_sockpuppets_of_BermudaWiki.csv,53,69818787.0,22,31,16,6,0,69.9622641509434,245,28,21.358490566037737,15
Category_Wikipedia_sockpuppets_of_BlueMondo131.csv,350,4671517.0,140,210,24,116,0,48.28,227,54,23.577142857142857,2
Category_Wikipedia_sockpuppets_of_Graduation9650073658.csv,3,1215.0,2,1,2,0,0,51.666666666666664,155,38,36.666666666666664,36
Category_Wikipedia_sockpuppets_of_Manhattan_Samurai.csv,3157,40679443.0,1236,1921,500,736,0,47.77193538169148,224,74,24.203040861577445,6
Category_Wikipedia_sockpuppets_of_Merrill_mahariel.csv,59,1655187.0,42,17,34,8,0,106.7457627118644,466,21,11.033898305084746,9
Category_Wikipedia_sockpuppets_of_Mobyjaws56.csv,974,357512051.0,417,557,374,43,0,43.3870636550308,311,58,19.11806981519507,8
Category_Wikipedia_sockpuppets_of_SSSHUBLI.csv,397,9514100.0,169,228,85,84,0,57.19647355163728,496,59,17.722921914357684,7
Category_Wikipedia_sockpuppets_of_Tahafarooqui.csv,73,44706532.0,25,48,16,9,0,47.28767123287671,204,43,25.45205479452055,17
Category_Wikipedia_sockpuppets_of_AnnSydow.csv,331,222452967.0,104,227,93,11,0,54.404833836858,425,38,13.743202416918429,5
Category_Wikipedia_sockpuppets_of_Burns007.csv,132,5102376.0,35,97,23,12,0,57.333333333333336,200,61,26.53787878787879,5
Category_Wikipedia_sockpuppets_of_GalingPinas.csv,367,2246695.0,188,179,156,32,0,47.60217983651226,243,50,30.39782016348774,13
Category_Wikipedia_sockpuppets_of_Suneye1.csv,2119,147138238.0,697,1422,500,197,0,64.41764983482774,495,78,18.541764983482775,3
Category_Wikipedia_sockpuppets_of_Rtmoreland.csv,315,33077320.0,92,223,70,22,0,52.8984126984127,459,26,14.873015873015873,5
Category_Wikipedia_sockpuppets_of_Javierluman01.csv,83,1497523.0,23,60,19,4,0,47.66265060240964,249,35,17.867469879518072,5
Category_Wikipedia_sockpuppets_of_Tirgil34.csv,10976,266766439.0,2995,7981,500,2495,0,48.627824344023324,500,93,15.833272594752186,3
Category_Wikipedia_sockpuppets_of_Ravi_kumar_sah-sonar.csv,212,85490313.0,57,155,12,45,0,46.924528301886795,250,56,23.566037735849058,6
Category_Wikipedia_sockpuppets_of_PinotEnthusiast.csv,44,76908.0,36,8,19,17,0,29.568181818181817,130,25,17.386363636363637,10
Category_Wikipedia_sockpuppets_of_Tristan.sbry.csv,520,116410479.0,246,274,103,143,0,41.90384615384615,221,58,20.673076923076923,9
Category_Wikipedia_sockpuppets_of_Docococko.csv,144,13110471.0,60,84,23,37,0,41.458333333333336,231,35,21.28472222222222,11
Category_Wikipedia_sockpuppets_of_Oldaqp.csv,395,263234429.0,206,189,169,37,0,29.359493670886074,238,54,22.470886075949366,10
Category_Wikipedia_sockpuppets_of_Thedigitalbiography.csv,86,17054472.0,20,66,17,3,0,50.406976744186046,246,37,16.25581395348837,7
Category_Wikipedia_sockpuppets_of_Anuj11ist.csv,22,1386347.0,13,9,13,0,0,38.45454545454545,166,27,19.636363636363637,13
Category_Wikipedia_sockpuppets_of_Steverci.csv,12974,222670280.0,3408,9566,500,2908,0,45.796670263604135,499,114,19.93949437336211,1
Category_Wikipedia_sockpuppets_of_Sjahwhevej.csv,9,2174.0,7,2,3,4,0,33.0,181,6,4.0,3
Category_Wikipedia_sockpuppets_of_AngeredTrash710.csv,278,5747003.0,117,161,36,81,0,44.410071942446045,339,39,18.672661870503596,3
Category_Wikipedia_sockpuppets_of_Poopdoodykatia.csv,11,899.0,6,5,6,0,3,72.54545454545455,195,8,8.0,8
Category_Wikipedia_sockpuppets_of_Docmohneesh.csv,44,864897.0,18,26,14,4,0,69.97727272727273,230,48,19.34090909090909,8
Category_Wikipedia_sockpuppets_of_Rourlme.csv,408,1409876.0,117,291,36,81,0,43.60294117647059,228,44,16.860294117647058,6
Category_Wikipedia_sockpuppets_of_Sam_Kanzai_Frakfurt.csv,460,16101916.0,107,353,104,3,0,44.92391304347826,255,48,20.1,5
Category_Wikipedia_sockpuppets_of_Freedom_skies.csv,4973,40257475.0,1603,3370,500,1103,0,38.32012869495274,218,84,18.434345465513776,3
Category_Wikipedia_sockpuppets_of_BradManson.csv,17,3116464.0,11,6,7,4,0,50.294117647058826,194,15,11.176470588235293,10
Category_Wikipedia_sockpuppets_of_Petrosianii.csv,553,97598126.0,211,342,124,87,0,46.34719710669078,239,76,24.49728752260398,9
Category_Wikipedia_sockpuppets_of_Harvardclub.csv,315,9802390.0,74,241,21,53,0,52.2031746031746,233,25,14.495238095238095,4
Category_Wikipedia_sockpuppets_of_Samuelhajili.csv,36,6735605.0,10,26,3,7,0,44.97222222222222,170,58,29.88888888888889,13
Category_Wikipedia_sockpuppets_of_Richardparker777.csv,88,528935.0,48,40,30,18,0,50.68181818181818,257,79,22.045454545454547,4
Category_Wikipedia_sockpuppets_of_Pitzzaboy.csv,3272,57273177.0,1303,1969,500,803,0,50.650672371638144,498,75,28.58832518337408,4
Category_Wikipedia_sockpuppets_of_Toomanyyearskodakblack.csv,1361,5357024.0,515,846,500,15,0,46.52608376193975,447,74,22.757531227038942,8
Category_Wikipedia_sockpuppets_of_Dperry25.csv,18,505732.0,7,11,7,0,7,37.333333333333336,102,63,37.5,18
"Category_Wikipedia_sockpuppets_of_T-man,_the_Wise_Scarecrow.csv",5141,24302386.0,1869,3272,500,1369,0,27.288465279128573,243,79,26.07372106594048,4
Category_Wikipedia_sockpuppets_of_Plodditaploddington.csv,26,172982.0,14,12,5,9,0,58.15384615384615,177,29,18.923076923076923,9
Category_Wikipedia_sockpuppets_of_Cambriana.csv,66,931829.0,39,27,25,14,0,67.21212121212122,249,19,10.636363636363637,3
Category_Wikipedia_sockpuppets_of_Wikistudent858.csv,47,98710.0,28,19,21,7,0,74.95744680851064,269,29,20.170212765957448,17
Category_Wikipedia_sockpuppets_of_Murugesan_Vannar.csv,141,44712866.0,59,82,31,28,0,40.60283687943262,255,27,13.191489361702128,5
Category_Wikipedia_sockpuppets_of_Helloready.csv,901,5978623.0,381,520,168,213,0,28.599334073251942,296,36,18.144284128745838,6
Category_Wikipedia_sockpuppets_of_Rajumitwa878.csv,3060,19107088.0,1005,2055,500,505,0,51.06437908496732,500,73,18.268627450980393,3
Category_Wikipedia_sockpuppets_of_Arrowoftime.csv,196,54097518.0,56,140,47,9,0,42.78061224489796,216,54,16.479591836734695,3
Category_Wikipedia_sockpuppets_of_Spyro02.csv,178,38808316.0,62,116,47,15,0,37.168539325842694,200,64,17.353932584269664,7
Category_Wikipedia_sockpuppets_of_MakesTheWikiBetter.csv,730,50122523.0,284,446,207,77,0,52.95068493150685,241,56,17.698630136986303,3
Category_Wikipedia_sockpuppets_of_CelebCitation.csv,38,382253.0,30,8,15,15,0,23.157894736842106,189,26,20.210526315789473,16
Category_Wikipedia_sockpuppets_of_Qwertyuiopasdfgqat.csv,45,257106.0,17,28,11,6,0,49.86666666666667,258,24,12.555555555555555,11
Category_Wikipedia_sockpuppets_of_Shabjul.csv,182,9924339.0,96,86,46,50,0,35.934065934065934,492,62,19.24175824175824,9
Category_Wikipedia_sockpuppets_of_Ijaaz_Ebrahim_Mohammed.csv,40,1987536.0,16,24,14,2,0,33.225,197,43,16.925,11
Category_Wikipedia_sockpuppets_of_Swaglord7.csv,27,1050057.0,8,19,6,2,0,81.92592592592592,228,18,12.296296296296296,6
Category_Wikipedia_sockpuppets_of_NinjaWarrior7755.csv,60,2457741.0,43,17,13,30,0,62.18333333333333,254,39,23.8,15
Category_Wikipedia_sockpuppets_of_Jafiey.csv,67,21632629.0,25,42,9,16,0,52.67164179104478,496,53,22.0,9
Category_Wikipedia_sockpuppets_of_Zombie_Dragon.csv,108,111956.0,30,78,22,8,0,44.611111111111114,231,50,20.287037037037038,7
Category_Wikipedia_sockpuppets_of_Chagogervasio.csv,30,13145440.0,6,24,2,4,0,33.96666666666667,106,53,52.0,23
Category_Wikipedia_sockpuppets_of_Bayberk.csv,52,38342701.0,16,36,10,6,0,45.94230769230769,228,26,16.76923076923077,8
Category_Wikipedia_sockpuppets_of_Hari_Mauryaa.csv,555,100707807.0,181,374,43,138,0,63.53333333333333,496,30,15.899099099099098,5
Category_Wikipedia_sockpuppets_of_God_Condemns_Homosexuality.csv,219,61846677.0,61,158,20,41,0,57.57077625570776,243,70,19.360730593607308,5
Category_Wikipedia_sockpuppets_of_Squidmorey9.csv,21,7182.0,14,7,5,9,0,57.904761904761905,324,21,14.571428571428571,12
Category_Wikipedia_sockpuppets_of_Mark963.csv,2,112.0,2,0,2,0,15,18.5,22,11,11.0,11
Category_Wikipedia_sockpuppets_of_Shannon9077.csv,578,26803310.0,200,378,62,138,0,32.55709342560554,233,57,18.231833910034602,10
Category_Wikipedia_sockpuppets_of_NFSU_Dharwad.csv,26,235698.0,10,16,5,5,0,49.11538461538461,279,45,39.84615384615385,22
Category_Wikipedia_sockpuppets_of_Michael_o'reagan.csv,15,395744.0,7,8,5,2,10,46.86666666666667,151,16,13.666666666666666,9
Category_Wikipedia_sockpuppets_of_Babyyoureallthatiwant.csv,39,1078837.0,19,20,18,1,0,50.256410256410255,168,25,22.307692307692307,16
Category_Wikipedia_sockpuppets_of_Homeboy99.csv,10,1519.0,5,5,5,0,2,58.8,131,17,14.0,12
Category_Wikipedia_sockpuppets_of_Shaiguy333.csv,44,3900650.0,26,18,23,3,0,24.545454545454547,145,56,31.522727272727273,9
Category_Wikipedia_sockpuppets_of_MILES_TRAGER.csv,58,83569.0,38,20,37,1,0,36.03448275862069,229,34,20.982758620689655,9
Category_Wikipedia_sockpuppets_of_EddymiltonEdm2k.csv,69,44988971.0,22,47,18,4,0,49.72463768115942,233,53,29.246376811594203,13
Category_Wikipedia_sockpuppets_of_Ratan_Biswas1.csv,98,89407.0,27,71,13,14,0,64.78571428571429,397,44,19.29591836734694,7
Category_Wikipedia_sockpuppets_of_Quentinwllcs.csv,1526,9847521.0,826,700,396,430,0,28.543250327653997,250,51,20.975753604193972,8
Category_Wikipedia_sockpuppets_of_All_knowledge_is_free_for_all.csv,225,29891000.0,60,165,48,12,0,44.65777777777778,212,39,16.595555555555556,6
Category_Wikipedia_sockpuppets_of_Zia.concord.csv,47,2077340.0,44,3,30,14,0,19.085106382978722,96,13,13.0,13
Category_Wikipedia_sockpuppets_of_Swarupskd.wiki.csv,1479,54947012.0,544,935,500,44,0,36.773495605138606,255,60,19.344151453684923,5
Category_Wikipedia_sockpuppets_of_Leftworks1.csv,632,1006524.0,209,423,30,179,0,54.65822784810127,386,67,16.724683544303797,4
Category_Wikipedia_sockpuppets_of_Seokjin92.csv,221,5224161.0,115,106,103,12,0,33.68325791855204,229,25,9.950226244343892,3
Category_Wikipedia_sockpuppets_of_Ehsonny13.csv,327,41210325.0,106,221,84,22,0,33.32721712538226,246,57,16.535168195718654,3
Category_Wikipedia_sockpuppets_of_Boobies823.csv,17,1852435.0,11,6,6,5,0,62.05882352941177,169,20,17.176470588235293,11
Category_Wikipedia_sockpuppets_of_Anton88be.csv,447,7446684.0,177,270,154,23,0,43.33109619686801,250,23,11.313199105145413,6
Category_Wikipedia_sockpuppets_of_Roughvenboy.csv,177,366577.0,98,79,38,60,0,25.282485875706215,248,41,15.084745762711865,9
Category_Wikipedia_sockpuppets_of_Professional_Bodyguard_Association.csv,13,10932.0,6,7,4,2,14,64.61538461538461,197,28,18.384615384615383,12
Category_Wikipedia_sockpuppets_of_Bot-SK.csv,52,599349.0,18,34,8,10,0,68.6923076923077,244,42,15.673076923076923,6
Category_Wikipedia_sockpuppets_of_TreyMap.csv,3,2360.0,3,0,2,1,42,42.0,42,32,32.0,32
Category_Wikipedia_sockpuppets_of_Asarudeenm91.csv,453,1250990.0,131,322,42,89,0,56.741721854304636,254,52,19.335540838852097,8
Category_Wikipedia_sockpuppets_of_Boxx_Faxx.csv,126,7951332.0,31,95,23,8,0,27.53968253968254,168,74,34.8968253968254,19
Category_Wikipedia_sockpuppets_of_Geoffsmile.csv,59,6696982.0,25,34,24,1,0,28.050847457627118,176,50,18.28813559322034,10
Category_Wikipedia_sockpuppets_of_Mymeyouwiki.csv,103,17344111.0,38,65,26,12,0,54.81553398058252,407,39,19.40776699029126,9
Category_Wikipedia_sockpuppets_of_Bushe124.csv,38,816.0,22,16,21,1,0,36.39473684210526,196,53,43.526315789473685,14
Category_Wikipedia_sockpuppets_of_Semntyrid.csv,103,442482.0,59,44,57,2,0,24.990291262135923,233,38,32.09708737864078,24
Category_Wikipedia_sockpuppets_of_CaptainGio.csv,80,505344.0,27,53,15,12,0,54.4625,168,44,17.225,8
Category_Wikipedia_sockpuppets_of_ANISH_Official.csv,69,8333577.0,21,48,9,12,0,43.81159420289855,195,49,30.159420289855074,5
Category_Wikipedia_sockpuppets_of_Ulyvoei.csv,1104,7123858.0,298,806,200,98,0,57.875,387,49,18.333333333333332,4
Category_Wikipedia_sockpuppets_of_The_Law_Connoisseur.csv,553,112392087.0,144,409,80,64,0,53.43218806509946,320,49,16.5623869801085,4
Category_Wikipedia_sockpuppets_of_Azamishaque.csv,2355,92301857.0,710,1645,268,442,0,37.316348195329084,260,64,19.88365180467091,2
Category_Wikipedia_sockpuppets_of_DisuseKid.csv,20820,269739387.0,6645,14175,500,6145,0,48.17339097022094,500,96,27.23938520653218,3
Category_Wikipedia_sockpuppets_of_Amirshahat.csv,1121,23472064.0,448,673,141,307,0,34.548617305976805,248,66,16.470115967885818,5
Category_Wikipedia_sockpuppets_of_Aankan_Das.csv,1807,74043266.0,590,1217,500,90,0,32.72551189817377,255,75,23.038184836745987,5
Category_Wikipedia_sockpuppets_of_CommanderShinzon.csv,610,7347781.0,228,382,142,86,0,32.81147540983606,255,58,25.968852459016393,9
Category_Wikipedia_sockpuppets_of_Israelbeach.csv,1688,53258854.0,569,1119,273,296,0,35.00414691943128,249,72,21.494075829383885,4
Category_Wikipedia_sockpuppets_of_TrueKapamilyaLover.csv,1422,19582222.0,500,922,500,0,0,24.50914205344585,236,70,29.404360056258792,4
Category_Wikipedia_sockpuppets_of_Ans2015kivanc.csv,149,3750651.0,55,94,46,9,0,48.93288590604027,255,33,18.59731543624161,7
Category_Wikipedia_sockpuppets_of_Notagainst.csv,2213,27486184.0,969,1244,500,469,0,59.71667419792137,405,43,22.0081337550836,10
Category_Wikipedia_sockpuppets_of_Sedej.csv,2399,8504099.0,821,1578,347,474,0,55.959983326385995,255,66,22.131304710295957,3
Category_Wikipedia_sockpuppets_of_Dr._Todd_Hanna.csv,100,181932769.0,31,69,23,8,0,37.94,241,45,21.85,9
Category_Wikipedia_sockpuppets_of_2-Factor-Auth.csv,4,80629.0,3,1,3,0,0,8.25,33,23,23.0,23
Category_Wikipedia_sockpuppets_of_Royankitkumar.csv,546,38152588.0,176,370,57,119,0,53.053113553113555,270,47,18.78205128205128,10
Category_Wikipedia_sockpuppets_of_Gladstonefan.csv,200,802182.0,82,118,63,19,0,48.45,326,54,22.8,4
Category_Wikipedia_sockpuppets_of_Sidor0o.csv,1120,4545609.0,303,817,235,68,0,52.225,500,46,13.673214285714286,4
Category_Wikipedia_sockpuppets_of_Kalelizade.csv,253,5589940.0,104,149,28,76,0,53.17786561264822,384,50,26.106719367588934,10
Category_Wikipedia_sockpuppets_of_Klangranger.csv,100,50625659.0,30,70,18,12,0,37.19,220,32,14.3,5
Category_Wikipedia_sockpuppets_of_Spoolintsi.csv,199,943392.0,77,122,40,37,0,33.02010050251256,159,40,21.678391959798994,11
Category_Wikipedia_sockpuppets_of_AswadIndia.csv,105,50183202.0,33,72,33,0,0,38.97142857142857,241,38,22.457142857142856,8
Category_Wikipedia_sockpuppets_of_AudiGuy-1204.csv,1878,24953728.0,629,1249,500,129,0,51.55857294994675,496,57,17.047923322683705,3
Category_Wikipedia_sockpuppets_of_Blendi111.csv,885,21697116.0,482,403,246,236,0,23.84406779661017,255,37,13.551412429378532,6
Category_Wikipedia_sockpuppets_of_CantStandYa.csv,11845,54956499.0,2369,9476,476,1893,0,32.09691853102575,248,69,15.879105107640354,3
Category_Wikipedia_sockpuppets_of_Radiocop.csv,103,360924.0,55,48,26,29,0,29.961165048543688,197,26,20.21359223300971,12
Category_Wikipedia_sockpuppets_of_Akmal_Hashim_Kapat.csv,3720,54176518.0,1436,2284,500,936,0,40.678225806451614,500,66,16.081989247311828,5
Category_Wikipedia_sockpuppets_of_Jakandsig.csv,4554,153773933.0,1431,3123,233,1198,0,54.357268335529206,500,58,19.819279754062364,3
Category_Wikipedia_sockpuppets_of_Dingushead42.csv,24,1115546.0,15,9,7,8,0,41.333333333333336,135,25,16.958333333333332,13
Category_Wikipedia_sockpuppets_of_Bov.csv,2395,82860013.0,776,1619,500,276,0,45.61503131524008,219,107,25.715240083507307,8
Category_Wikipedia_sockpuppets_of_OtakuWeeb.csv,158,24968819.0,52,106,25,27,0,44.037974683544306,278,38,16.360759493670887,6
Category_Wikipedia_sockpuppets_of_NewComedyMusic.csv,39,214183.0,16,23,14,2,0,39.1025641025641,196,47,32.23076923076923,11
Category_Wikipedia_sockpuppets_of_Newspaperwriter10021.csv,109,2353203.0,79,30,58,21,0,26.825688073394495,199,56,31.69724770642202,12
Category_Wikipedia_sockpuppets_of_The_Anonymous_Earthling.csv,2023,91892919.0,712,1311,500,212,0,40.69550173010381,508,60,17.288680177953534,3
Category_Wikipedia_sockpuppets_of_Craytonconstanceb.csv,1754,273882298.0,409,1345,146,263,0,44.021094640820984,253,58,18.616875712656785,3
Category_Wikipedia_sockpuppets_of_Gazpacho.csv,3727,67591000.0,1036,2691,500,536,0,45.766568285484304,255,90,18.842768983096324,4
Category_Wikipedia_sockpuppets_of_Ayobami_Azeez_Olaoluwa.csv,908,4695294.0,656,252,500,156,0,25.245594713656388,279,37,10.955947136563877,4
Category_Wikipedia_sockpuppets_of_Icaldonta.csv,3908,299030905.0,1085,2823,500,585,0,48.03659160696008,496,62,17.507164790174002,2
Category_Wikipedia_sockpuppets_of_Excellence_Photography_LLC.csv,5,25568.0,3,2,2,1,28,76.8,115,62,43.4,31
Category_Wikipedia_sockpuppets_of_JustinStanfield.csv,24,2833666.0,15,9,10,5,0,77.41666666666667,389,28,19.625,10
Category_Wikipedia_sockpuppets_of_Sidbidmidlid.csv,1728,56228480.0,534,1194,149,385,0,49.967013888888886,493,65,19.49363425925926,4
Category_Wikipedia_sockpuppets_of_Maryarsha.csv,19,168993.0,17,2,14,3,0,47.473684210526315,492,22,17.31578947368421,15
Category_Wikipedia_sockpuppets_of_WarriorsPride6565.csv,1370,15473765.0,505,865,500,5,0,48.4970802919708,250,57,16.775912408759122,5
Category_Wikipedia_sockpuppets_of_Username006.csv,3148,12694101.0,1028,2120,500,528,0,54.71696315120712,493,85,29.342757306226176,3
Category_Wikipedia_sockpuppets_of_Smithomaster.csv,47,48810973.0,11,36,9,2,0,73.1063829787234,246,29,16.51063829787234,8
Category_Wikipedia_sockpuppets_of_Jaygill.csv,435,7675774.0,120,315,70,50,0,40.754022988505746,282,64,22.229885057471265,3
Category_Wikipedia_sockpuppets_of_Slatifs.csv,1137,52100752.0,424,713,424,0,0,34.01231310466139,257,53,27.020228671943713,3
Category_Wikipedia_sockpuppets_of_Yassaarr.csv,347,55205606.0,152,195,93,59,0,36.84438040345821,492,55,17.988472622478387,10
Category_Wikipedia_sockpuppets_of_Supdiop.csv,2860,21162502.0,964,1896,500,464,0,64.06398601398601,255,104,23.49895104895105,3
Category_Wikipedia_sockpuppets_of_Bilal.farooq.csv,127,429085986.0,27,100,15,12,0,44.881889763779526,239,51,29.070866141732285,13
Category_Wikipedia_sockpuppets_of_Isidro_Halen.csv,10,15244.0,5,5,1,4,0,33.5,158,21,21.0,21
Category_Wikipedia_sockpuppets_of_TheSpirit+2020.csv,67,115917.0,18,49,7,11,0,57.59701492537314,199,45,20.35820895522388,11
Category_Wikipedia_sockpuppets_of_Astrohoundy.csv,898,304015842.0,206,692,198,8,0,61.93875278396437,334,60,20.061247216035635,3
Category_Wikipedia_sockpuppets_of_Sadakatamankhan.csv,55,6965324.0,15,40,4,11,0,63.85454545454545,229,33,22.818181818181817,12
Category_Wikipedia_sockpuppets_of_Judetadeus.csv,318,221320624.0,121,197,91,30,0,54.556603773584904,251,38,18.4874213836478,12
Category_Wikipedia_sockpuppets_of_Rajvir_Singh_Randhawa.csv,913,82136290.0,343,570,270,73,0,41.85432639649507,255,57,15.792990142387733,4
Category_Wikipedia_sockpuppets_of_Holiptholipt.csv,2085,31089934.0,910,1175,439,471,0,35.25851318944844,500,48,21.90071942446043,7
Category_Wikipedia_sockpuppets_of_Jamieparrie.csv,116,693513.0,39,77,27,12,0,56.939655172413794,270,53,32.6551724137931,9
Category_Wikipedia_sockpuppets_of_BouwMaster.csv,24373,98366558.0,6537,17836,500,6037,0,30.88819595453986,500,61,21.626102654576787,2
Category_Wikipedia_sockpuppets_of_Hablus.csv,134,4572040.0,44,90,23,21,0,41.14179104477612,251,53,16.253731343283583,6
Category_Wikipedia_sockpuppets_of_La_Cosa_Nostra786.csv,91,929956.0,27,64,13,14,0,51.582417582417584,236,34,17.175824175824175,7
Category_Wikipedia_sockpuppets_of_Frontkick45.csv,111,5608764.0,36,75,23,13,0,42.8018018018018,226,22,14.207207207207206,10
Category_Wikipedia_sockpuppets_of_Anandusuresh001.csv,270,166898951.0,83,187,68,15,0,35.52962962962963,258,25,13.35925925925926,5
Category_Wikipedia_sockpuppets_of_Legsun999.csv,54,33178502.0,27,27,15,12,0,46.388888888888886,191,44,21.88888888888889,6
Category_Wikipedia_sockpuppets_of_Dgenx_214.csv,76,295859.0,40,36,23,17,0,44.55263157894737,196,42,22.736842105263158,17
Category_Wikipedia_sockpuppets_of_Herbie_rookie.csv,452,136016155.0,148,304,118,30,0,44.2146017699115,248,48,20.938053097345133,6
Category_Wikipedia_sockpuppets_of_Elsagamma.csv,23,32892317.0,10,13,6,4,0,26.217391304347824,111,43,26.26086956521739,8
Category_Wikipedia_sockpuppets_of_ABRD.csv,84,22173549.0,28,56,19,9,0,72.75,261,36,12.75,2
Category_Wikipedia_sockpuppets_of_Poohbydz.csv,169,1242230.0,107,62,56,51,0,29.059171597633135,255,44,13.301775147928995,5
Category_Wikipedia_sockpuppets_of_Issan_Sumisu.csv,2540,209249091.0,600,1940,500,100,0,63.054724409448816,495,66,14.520866141732283,3
Category_Wikipedia_sockpuppets_of_Chutrandi.csv,10144,124077928.0,2827,7317,500,2327,0,38.24753548895899,500,106,18.3745070977918,4
Category_Wikipedia_sockpuppets_of_AndreaMimi.csv,1493,36175472.0,529,964,500,29,0,36.344273275284664,241,68,23.14735432016075,8
Category_Wikipedia_sockpuppets_of_KentHaaChe.csv,227,4979191.0,70,157,57,13,0,43.29955947136564,327,47,24.09691629955947,4
Category_Wikipedia_sockpuppets_of_Flowers_of_the_world.csv,4161,7187146.0,1398,2763,263,1135,0,48.45181446767604,255,54,16.760634462869504,4
Category_Wikipedia_sockpuppets_of_Toby's_Reports.csv,2,27.0,2,0,2,0,0,0.0,0,24,24.0,24
Category_Wikipedia_sockpuppets_of_Famiar_X.csv,465,32420790.0,93,372,27,66,0,46.131182795698926,210,37,15.133333333333333,3
Category_Wikipedia_sockpuppets_of_LukaRuckels.csv,883,67880439.0,301,582,118,183,0,49.2480181200453,260,54,23.842582106455268,10
Category_Wikipedia_sockpuppets_of_Time_consistent_eye_robotics.csv,379,6671696.0,127,252,43,84,0,62.226912928759894,253,29,18.105540897097626,7
